issuekey	starttime	endtime	days	death	priority	issuetype	fixversions	issuelinks
R-19	190	191	1	1	4	1	0	0
R-19	191	192	1	1	3	1	0	0
R-19	196	477	281	0	3	1	0	0
R-19	199	477	278	0	3	4	0	0
R-19	199	477	278	0	3	4	0	0
R-19	201	477	276	0	3	1	0	0
R-19	203	477	274	0	3	5	0	0
R-19	203	204	1	1	4	1	0	0
R-19	212	477	265	0	3	3	0	0
R-19	215	477	262	0	3	2	0	0
R-20	218	219	1	1	4	3	0	0
R-20	230	477	247	0	3	1	0	0
R-20	234	477	243	0	3	1	0	0
R-20	234	477	243	0	1	1	0	0
R-20	234	477	243	0	3	1	0	0
R-20	253	477	224	0	3	1	0	0
R-20	254	477	223	0	3	1	0	0
R-20	256	257	1	1	3	2	0	0
R-20	265	477	212	0	3	1	0	0
R-20	269	477	208	0	3	1	0	0
R-21	269	477	208	0	3	1	0	0
R-21	269	477	208	0	3	1	0	0
R-21	269	477	208	0	3	1	0	0
R-21	269	477	208	0	3	1	0	0
R-21	269	477	208	0	4	5	0	0
R-21	272	477	205	0	3	1	0	0
R-21	276	277	1	1	3	1	0	0
R-21	287	477	190	0	3	4	0	0
R-21	296	477	181	0	3	1	0	0
R-21	309	477	168	0	3	1	0	0
R-22	314	477	163	0	5	1	0	0
R-22	317	477	160	0	3	3	0	0
R-22	317	477	160	0	3	1	0	0
R-22	317	477	160	0	3	1	0	0
R-22	340	341	1	1	3	1	0	0
R-22	344	345	1	1	3	1	0	0
R-22	346	477	131	0	3	1	0	0
R-22	360	361	1	1	5	4	0	0
CUMULO-477	4	31	27	1	2	1	3	3
CUMULO-477	10	30	20	1	3	1	2	1
CUMULO-477	10	35	25	1	3	1	2	1
CUMULO-478	11	16	5	1	3	1	3	1
CUMULO-478	11	16	5	1	3	1	3	0
CUMULO-478	11	45	34	1	3	1	2	3
CUMULO-478	15	477	462	0	3	1	1	0
CUMULO-478	15	43	28	1	3	4	1	2
CUMULO-478	16	17	1	1	4	4	1	0
CUMULO-478	17	18	1	1	4	1	1	0
CUMULO-478	25	44	19	1	4	1	3	1
CUMULO-478	25	50	25	1	3	4	2	1
CUMULO-478	25	45	20	1	3	4	2	0
CUMULO-479	28	38	10	1	3	4	2	0
CUMULO-479	29	94	65	1	4	1	2	0
CUMULO-479	29	45	16	1	4	4	1	0
CUMULO-479	31	477	446	0	3	5	0	0
CUMULO-479	31	477	446	0	3	5	0	0
CUMULO-479	31	477	446	0	3	5	0	0
CUMULO-479	31	477	446	0	3	5	0	0
CUMULO-479	32	35	3	1	3	4	2	0
CUMULO-479	32	45	13	1	3	4	2	0
CUMULO-479	32	50	18	1	3	4	2	0
CUMULO-480	35	50	15	1	3	4	2	1
CUMULO-480	36	45	9	1	3	4	2	0
CUMULO-480	36	38	2	1	3	4	1	0
CUMULO-480	37	477	440	0	4	4	1	0
CUMULO-480	38	44	6	1	3	1	0	0
CUMULO-480	38	53	15	1	3	1	2	1
CUMULO-480	39	477	438	0	3	5	1	1
CUMULO-480	39	260	221	1	3	5	0	0
CUMULO-480	39	210	171	1	3	2	1	1
CUMULO-480	39	58	19	1	2	1	3	2
CUMULO-481	39	477	438	0	3	4	1	1
CUMULO-481	39	477	438	0	3	1	0	2
CUMULO-481	40	44	4	1	4	1	0	0
CUMULO-481	42	257	215	1	3	5	1	0
CUMULO-481	43	44	1	1	4	3	0	0
CUMULO-481	44	477	433	0	4	4	0	0
CUMULO-481	44	477	433	0	3	4	1	1
CUMULO-481	45	46	1	1	3	4	3	2
CUMULO-481	46	288	242	1	3	4	1	1
CUMULO-481	46	84	38	1	3	4	0	1
CUMULO-482	46	77	31	1	4	4	1	0
CUMULO-482	50	477	427	0	3	4	0	1
CUMULO-482	51	477	426	0	3	4	1	0
CUMULO-482	52	477	425	0	3	4	1	0
CUMULO-482	52	53	1	1	3	3	1	0
CUMULO-482	53	477	424	0	3	4	1	0
CUMULO-482	53	56	3	1	3	2	2	4
CUMULO-482	56	305	249	1	2	1	1	1
CUMULO-482	56	477	421	0	2	1	1	1
CUMULO-482	56	57	1	1	3	1	1	1
CUMULO-483	56	477	421	0	3	4	1	1
CUMULO-483	56	477	421	0	4	1	1	0
CUMULO-483	56	57	1	1	1	1	3	1
CUMULO-483	57	94	37	1	4	1	2	0
CUMULO-483	58	74	16	1	1	4	2	1
CUMULO-483	58	64	6	1	4	1	3	0
CUMULO-483	59	77	18	1	3	1	3	1
CUMULO-483	59	477	418	0	3	4	0	0
CUMULO-483	59	477	418	0	3	4	0	1
CUMULO-484	72	73	1	1	1	1	3	2
CUMULO-484	72	73	1	1	3	1	1	1
CUMULO-484	74	81	7	1	3	1	0	0
CUMULO-485	74	75	1	1	3	4	0	0
CUMULO-485	98	477	379	0	2	1	0	0
CUMULO-485	209	255	46	1	3	2	0	0
CUMULO-485	218	219	1	1	3	1	0	0
CUMULO-485	237	246	9	1	4	4	1	0
CUMULO-485	260	261	1	1	3	1	0	0
CUMULO-485	267	268	1	1	3	1	0	0
CUMULO-485	289	290	1	1	3	1	0	0
CUMULO-485	349	350	1	1	3	1	0	0
CUMULO-486	349	350	1	1	3	1	0	0
E-63	44	477	433	0	3	2	0	0
RAVATA-262	4	18	14	1	3	1	1	0
RAVATA-262	7	477	470	0	3	1	1	0
RAVATA-262	8	28	20	1	3	1	1	0
RAVATA-262	8	171	163	1	3	1	0	0
RAVATA-262	8	477	469	0	3	1	0	0
RAVATA-262	8	212	204	1	3	1	0	2
RAVATA-262	8	263	255	1	4	1	0	1
RAVATA-262	9	263	254	1	3	5	0	0
RAVATA-263	9	417	408	1	3	5	0	0
RAVATA-263	9	263	254	1	3	5	0	0
RAVATA-263	9	477	468	0	3	5	0	0
RAVATA-263	9	477	468	0	3	5	0	0
RAVATA-263	9	477	468	0	3	5	0	0
RAVATA-263	9	212	203	1	3	1	0	0
RAVATA-263	9	212	203	1	3	1	0	0
RAVATA-263	9	477	468	0	4	1	0	0
RAVATA-263	9	477	468	0	3	1	0	0
RAVATA-263	9	477	468	0	3	1	0	0
RAVATA-264	9	212	203	1	3	1	0	0
RAVATA-264	11	88	77	1	3	1	0	0
RAVATA-264	11	477	466	0	3	1	0	0
RAVATA-264	11	477	466	0	3	1	0	0
RAVATA-264	17	477	460	0	3	5	0	0
RAVATA-264	17	21	4	1	3	2	0	0
RAVATA-264	18	477	459	0	3	4	0	0
RAVATA-264	21	22	1	1	3	5	0	0
RAVATA-264	21	477	456	0	3	1	0	0
RAVATA-264	21	477	456	0	3	1	0	0
RAVATA-265	23	477	454	0	3	5	0	0
RAVATA-265	23	87	64	1	3	1	0	0
RAVATA-265	23	477	454	0	3	4	1	0
RAVATA-265	25	477	452	0	3	1	0	0
RAVATA-265	27	199	172	1	4	5	0	0
RAVATA-265	28	143	115	1	3	1	0	0
RAVATA-265	28	477	449	0	3	5	0	0
RAVATA-265	28	88	60	1	3	3	0	0
RAVATA-265	28	477	449	0	3	1	0	0
RAVATA-265	29	151	122	1	3	4	0	0
RAVATA-266	29	42	13	1	3	5	0	0
RAVATA-266	29	119	90	1	4	1	0	0
RAVATA-266	29	87	58	1	3	4	0	1
RAVATA-266	31	32	1	1	3	1	0	0
RAVATA-266	31	32	1	1	3	1	0	1
RAVATA-266	31	34	3	1	3	1	0	0
RAVATA-266	31	32	1	1	3	1	0	1
RAVATA-266	31	32	1	1	3	1	0	0
RAVATA-266	32	34	2	1	3	1	0	0
RAVATA-266	35	44	9	1	3	1	0	1
RAVATA-267	35	477	442	0	3	1	0	0
RAVATA-267	35	263	228	1	3	1	0	0
RAVATA-267	39	40	1	1	3	1	0	0
RAVATA-267	39	477	438	0	3	1	0	0
RAVATA-267	42	477	435	0	3	5	1	0
RAVATA-267	43	64	21	1	3	1	1	0
RAVATA-267	44	477	433	0	3	1	0	0
RAVATA-267	46	477	431	0	3	1	0	0
RAVATA-267	46	56	10	1	3	1	0	0
RAVATA-267	46	93	47	1	3	1	0	0
RAVATA-268	46	154	108	1	3	1	0	0
RAVATA-268	46	477	431	0	4	1	0	0
RAVATA-268	46	49	3	1	3	1	0	0
RAVATA-268	46	477	431	0	3	1	0	0
RAVATA-268	51	284	233	1	3	1	0	0
RAVATA-268	51	52	1	1	3	1	0	0
RAVATA-268	52	309	257	1	3	1	0	0
RAVATA-268	52	477	425	0	3	2	0	0
RAVATA-268	52	154	102	1	3	1	0	0
RAVATA-268	52	263	211	1	3	2	0	0
RAVATA-269	52	87	35	1	3	4	0	0
RAVATA-269	53	477	424	0	3	1	0	0
RAVATA-269	53	382	329	1	3	1	0	0
RAVATA-269	53	197	144	1	3	1	0	0
RAVATA-269	53	64	11	1	3	1	0	0
RAVATA-269	56	417	361	1	3	1	0	1
RAVATA-269	56	154	98	1	3	1	0	0
RAVATA-269	56	154	98	1	3	1	0	0
RAVATA-269	56	57	1	1	3	1	0	0
RAVATA-269	57	154	97	1	3	1	0	0
RAVATA-270	57	323	266	1	3	1	0	0
RAVATA-270	58	154	96	1	3	1	0	1
RAVATA-270	58	477	419	0	3	1	0	0
RAVATA-270	58	477	419	0	3	1	0	0
RAVATA-270	58	156	98	1	3	1	0	0
RAVATA-270	59	199	140	1	4	3	0	0
RAVATA-270	59	477	418	0	4	4	0	0
RAVATA-270	63	64	1	1	3	4	0	0
RAVATA-270	64	477	413	0	3	1	0	0
RAVATA-270	64	196	132	1	3	1	0	0
RAVATA-271	64	154	90	1	3	1	0	0
RAVATA-271	64	323	259	1	3	1	0	1
RAVATA-271	65	87	22	1	3	4	0	0
RAVATA-271	66	127	61	1	3	1	1	0
RAVATA-271	74	477	403	0	3	1	1	0
RAVATA-271	74	75	1	1	3	1	1	0
RAVATA-271	74	477	403	0	3	1	1	0
RAVATA-271	79	477	398	0	3	5	0	0
RAVATA-271	79	477	398	0	3	5	0	0
RAVATA-271	80	88	8	1	3	4	0	0
RAVATA-272	81	477	396	0	4	3	0	0
RAVATA-272	81	477	396	0	3	5	0	0
RAVATA-272	84	477	393	0	3	5	0	0
RAVATA-272	84	477	393	0	3	5	0	0
RAVATA-272	84	477	393	0	3	5	0	0
RAVATA-272	85	322	237	1	3	1	0	1
RAVATA-272	86	477	391	0	4	5	0	0
RAVATA-272	87	238	151	1	3	1	0	0
RAVATA-272	87	477	390	0	3	4	0	0
RAVATA-272	87	91	4	1	3	4	0	0
RAVATA-273	87	93	6	1	3	4	0	0
RAVATA-273	88	477	389	0	3	3	0	0
RAVATA-273	88	155	67	1	3	1	0	0
RAVATA-273	92	127	35	1	3	4	1	0
RAVATA-273	92	127	35	1	3	1	1	0
RAVATA-273	92	127	35	1	3	4	1	0
RAVATA-273	92	127	35	1	3	1	1	0
RAVATA-273	92	127	35	1	3	1	1	0
RAVATA-273	93	477	384	0	3	1	1	0
RAVATA-273	94	105	11	1	3	1	0	0
RAVATA-274	94	127	33	1	3	1	0	0
RAVATA-274	95	477	382	0	3	4	0	0
RAVATA-274	98	477	379	0	3	1	0	0
RAVATA-274	98	127	29	1	3	1	1	0
RAVATA-274	99	477	378	0	3	4	1	0
RAVATA-274	99	127	28	1	3	2	1	0
RAVATA-274	100	127	27	1	3	1	1	0
RAVATA-274	100	127	27	1	3	1	0	0
RAVATA-274	100	477	377	0	3	1	0	0
RAVATA-274	100	477	377	0	3	1	1	0
RAVATA-275	100	263	163	1	3	1	0	0
RAVATA-275	100	101	1	1	3	1	0	1
RAVATA-275	102	199	97	1	3	2	0	0
RAVATA-275	106	107	1	1	3	2	0	0
RAVATA-275	107	477	370	0	3	5	0	0
RAVATA-275	107	477	370	0	3	5	0	0
RAVATA-275	107	477	370	0	3	5	0	0
RAVATA-275	112	158	46	1	3	1	0	0
RAVATA-275	112	123	11	1	3	1	0	0
RAVATA-275	113	116	3	1	3	5	0	0
RAVATA-276	113	114	1	1	3	5	0	0
RAVATA-276	113	387	274	1	3	5	0	0
RAVATA-276	113	116	3	1	3	5	0	0
RAVATA-276	113	114	1	1	3	5	0	0
RAVATA-276	113	116	3	1	3	5	0	0
RAVATA-276	115	477	362	0	3	2	0	0
RAVATA-276	115	477	362	0	3	5	0	0
RAVATA-276	115	477	362	0	3	5	0	0
RAVATA-276	116	117	1	1	3	5	0	0
RAVATA-276	116	117	1	1	3	5	0	0
RAVATA-277	119	263	144	1	3	5	0	0
RAVATA-277	121	444	323	1	4	1	1	0
RAVATA-277	122	477	355	0	3	5	1	0
RAVATA-277	122	154	32	1	3	4	0	0
RAVATA-277	122	154	32	1	3	5	0	0
RAVATA-277	122	129	7	1	3	5	0	0
RAVATA-277	122	143	21	1	3	5	0	0
RAVATA-277	122	143	21	1	3	5	0	0
RAVATA-277	122	143	21	1	3	5	0	0
RAVATA-277	122	154	32	1	3	5	0	0
RAVATA-278	122	143	21	1	3	5	0	0
RAVATA-278	122	157	35	1	3	5	0	0
RAVATA-278	127	477	350	0	3	4	1	0
RAVATA-278	127	263	136	1	3	1	1	0
RAVATA-278	127	263	136	1	3	1	1	0
RAVATA-278	127	477	350	0	3	4	1	0
RAVATA-278	127	263	136	1	3	1	0	0
RAVATA-278	129	142	13	1	3	2	0	0
RAVATA-278	129	477	348	0	3	1	0	0
RAVATA-278	130	263	133	1	3	1	1	0
RAVATA-279	130	263	133	1	3	1	1	0
RAVATA-279	134	135	1	1	4	5	1	0
RAVATA-279	137	263	126	1	3	1	0	0
RAVATA-279	140	154	14	1	3	2	0	0
RAVATA-279	140	154	14	1	3	2	0	0
RAVATA-279	143	148	5	1	3	5	0	0
RAVATA-279	148	477	329	0	3	5	0	0
RAVATA-279	151	156	5	1	3	1	1	0
RAVATA-279	151	152	1	1	3	1	0	0
RAVATA-279	154	155	1	1	3	1	0	0
RAVATA-280	154	157	3	1	3	1	1	0
RAVATA-280	154	156	2	1	3	1	1	0
RAVATA-280	154	156	2	1	3	1	1	0
RAVATA-280	154	263	109	1	3	1	1	0
RAVATA-280	154	197	43	1	3	5	0	1
RAVATA-280	154	197	43	1	3	5	0	0
RAVATA-280	154	477	323	0	3	5	0	0
RAVATA-280	154	477	323	0	3	5	0	0
RAVATA-280	154	477	323	0	3	5	0	0
RAVATA-280	154	477	323	0	3	5	0	0
RAVATA-281	154	323	169	1	3	5	0	0
RAVATA-281	155	323	168	1	3	1	1	0
RAVATA-281	155	157	2	1	3	1	1	0
RAVATA-281	155	477	322	0	3	4	1	0
RAVATA-281	156	263	107	1	3	1	0	0
RAVATA-281	156	477	321	0	3	1	1	0
RAVATA-281	156	157	1	1	3	1	0	0
RAVATA-281	157	158	1	1	3	1	0	0
RAVATA-281	157	158	1	1	3	1	0	0
RAVATA-281	158	161	3	1	3	1	0	0
RAVATA-282	158	161	3	1	3	1	0	0
RAVATA-282	161	162	1	1	3	1	0	0
RAVATA-282	161	162	1	1	3	1	0	0
RAVATA-282	161	163	2	1	3	1	0	0
RAVATA-282	163	477	314	0	3	1	1	0
RAVATA-282	163	164	1	1	3	1	0	0
RAVATA-282	163	263	100	1	3	1	1	0
RAVATA-282	163	165	2	1	3	1	0	0
RAVATA-282	164	477	313	0	3	1	0	0
RAVATA-282	164	477	313	0	3	1	1	0
RAVATA-283	164	477	313	0	3	4	1	0
RAVATA-283	164	263	99	1	3	1	1	0
RAVATA-283	165	169	4	1	3	1	0	0
RAVATA-283	165	263	98	1	3	1	1	0
RAVATA-283	165	170	5	1	3	1	0	0
RAVATA-283	165	193	28	1	3	1	0	0
RAVATA-283	165	168	3	1	3	1	0	1
RAVATA-283	168	169	1	1	3	5	0	1
RAVATA-283	170	477	307	0	3	5	0	0
RAVATA-283	171	263	92	1	3	5	0	1
RAVATA-284	175	274	99	1	3	1	0	1
RAVATA-284	191	263	72	1	2	1	1	1
RAVATA-284	193	260	67	1	3	5	0	1
RAVATA-284	198	323	125	1	3	1	0	0
RAVATA-284	198	238	40	1	3	1	0	0
RAVATA-284	198	211	13	1	1	1	0	0
RAVATA-284	198	263	65	1	1	1	0	0
RAVATA-284	198	263	65	1	1	1	0	0
RAVATA-284	198	263	65	1	1	1	0	0
RAVATA-284	198	263	65	1	1	1	0	0
RAVATA-285	198	323	125	1	3	1	0	0
RAVATA-285	198	343	145	1	3	1	0	0
RAVATA-285	198	238	40	1	4	1	0	0
RAVATA-285	198	238	40	1	3	1	0	0
RAVATA-285	199	477	278	0	3	5	0	0
RAVATA-285	199	200	1	1	3	5	0	0
RAVATA-285	199	203	4	1	3	5	0	1
RAVATA-285	199	282	83	1	3	5	0	0
RAVATA-285	199	477	278	0	3	5	1	0
RAVATA-285	199	212	13	1	3	5	0	0
RAVATA-286	199	224	25	1	3	5	0	0
RAVATA-286	199	417	218	1	3	5	0	0
RAVATA-286	201	202	1	1	3	5	0	0
RAVATA-286	203	323	120	1	3	1	0	0
RAVATA-286	212	477	265	0	3	1	0	1
RAVATA-286	214	276	62	1	3	5	0	0
RAVATA-286	214	227	13	1	3	5	0	0
RAVATA-286	228	240	12	1	3	5	0	0
RAVATA-286	228	276	48	1	3	5	0	0
RAVATA-286	228	417	189	1	3	5	0	0
RAVATA-287	228	417	189	1	3	5	0	0
RAVATA-287	228	477	249	0	3	1	0	0
RAVATA-287	228	309	81	1	3	1	0	2
RAVATA-287	228	477	249	0	3	1	0	0
RAVATA-287	235	236	1	1	3	1	0	0
RAVATA-287	238	284	46	1	3	1	0	0
RAVATA-287	238	266	28	1	3	5	0	0
RAVATA-287	239	240	1	1	3	5	0	0
RAVATA-287	246	263	17	1	3	5	0	1
RAVATA-287	262	477	215	0	3	1	0	0
RAVATA-288	263	477	214	0	3	5	0	0
RAVATA-288	266	477	211	0	3	1	1	0
RAVATA-288	266	477	211	0	3	1	1	0
RAVATA-288	266	477	211	0	3	4	0	1
RAVATA-288	267	477	210	0	3	1	1	0
RAVATA-288	267	477	210	0	3	1	0	0
RAVATA-288	268	477	209	0	4	4	1	0
RAVATA-288	268	477	209	0	3	1	1	0
RAVATA-288	270	309	39	1	3	5	0	4
RAVATA-288	270	308	38	1	3	4	0	3
RAVATA-289	270	283	13	1	3	2	0	1
RAVATA-289	270	477	207	0	3	4	0	1
RAVATA-289	270	324	54	1	3	4	0	1
RAVATA-289	274	477	203	0	4	1	0	0
RAVATA-289	275	477	202	0	3	1	0	0
RAVATA-289	275	323	48	1	3	1	1	0
RAVATA-289	275	323	48	1	3	1	0	0
RAVATA-289	275	281	6	1	3	1	0	0
RAVATA-289	275	323	48	1	3	1	1	0
RAVATA-289	277	278	1	1	3	4	0	1
RAVATA-290	277	284	7	1	3	4	0	1
RAVATA-290	280	477	197	0	4	5	0	0
RAVATA-290	282	283	1	1	3	4	0	0
RAVATA-290	282	477	195	0	3	4	0	1
RAVATA-290	282	477	195	0	3	5	0	0
RAVATA-290	284	309	25	1	3	1	0	0
RAVATA-290	284	309	25	1	3	4	0	0
RAVATA-290	284	324	40	1	3	4	0	0
RAVATA-290	284	477	193	0	3	4	0	0
RAVATA-290	284	477	193	0	3	4	0	0
RAVATA-291	284	477	193	0	3	1	0	0
RAVATA-291	284	477	193	0	3	1	0	0
RAVATA-291	284	477	193	0	3	1	0	0
RAVATA-291	284	308	24	1	3	5	0	0
RAVATA-291	284	477	193	0	3	1	0	0
RAVATA-291	284	401	117	1	3	1	0	0
RAVATA-291	284	477	193	0	3	1	0	0
RAVATA-291	285	477	192	0	3	1	0	0
RAVATA-291	287	477	190	0	3	5	1	0
RAVATA-291	288	477	189	0	3	5	0	0
RAVATA-292	290	296	6	1	3	1	1	0
RAVATA-292	296	477	181	0	3	3	0	0
RAVATA-292	296	477	181	0	3	3	0	0
RAVATA-292	297	308	11	1	3	1	1	2
RAVATA-292	297	298	1	1	3	1	0	0
RAVATA-292	298	477	179	0	3	5	0	0
RAVATA-292	303	323	20	1	3	1	1	0
RAVATA-292	303	323	20	1	3	1	1	0
RAVATA-292	303	322	19	1	3	1	1	0
RAVATA-292	303	323	20	1	3	1	1	0
RAVATA-293	303	322	19	1	3	1	1	2
RAVATA-293	303	322	19	1	3	1	1	0
RAVATA-293	304	308	4	1	3	1	1	0
RAVATA-293	304	322	18	1	3	1	1	0
RAVATA-293	308	477	169	0	3	2	0	0
RAVATA-293	308	477	169	0	3	4	0	0
RAVATA-293	308	477	169	0	3	2	0	0
RAVATA-293	308	477	169	0	3	1	0	0
RAVATA-293	309	401	92	1	3	1	0	0
RAVATA-293	310	315	5	1	3	1	1	1
RAVATA-294	315	477	162	0	3	1	0	0
RAVATA-294	315	477	162	0	3	1	1	0
RAVATA-294	316	319	3	1	3	1	1	0
RAVATA-294	316	424	108	1	3	1	1	0
RAVATA-294	316	477	161	0	3	4	1	0
RAVATA-294	316	477	161	0	3	3	1	0
RAVATA-294	319	477	158	0	3	3	1	0
RAVATA-294	319	477	158	0	3	3	1	0
RAVATA-294	319	477	158	0	3	3	1	0
RAVATA-294	319	322	3	1	3	1	1	0
RAVATA-295	319	477	158	0	3	1	1	0
RAVATA-295	322	323	1	1	3	1	0	0
RAVATA-295	322	477	155	0	3	1	1	0
RAVATA-295	323	324	1	1	3	1	1	0
RAVATA-295	323	324	1	1	3	1	0	0
RAVATA-295	324	477	153	0	3	1	1	0
RAVATA-295	327	328	1	1	3	1	0	0
RAVATA-295	332	477	145	0	4	2	0	0
RAVATA-295	343	421	78	1	3	5	0	0
RAVATA-295	347	477	130	0	3	5	0	0
RAVATA-296	347	387	40	1	3	1	0	0
RAVATA-296	350	401	51	1	3	1	0	1
RAVATA-296	351	352	1	1	3	1	1	0
RAVATA-296	357	424	67	1	3	1	1	0
RAVATA-296	357	477	120	0	3	3	1	0
RAVATA-296	357	477	120	0	3	3	1	0
RAVATA-296	360	401	41	1	3	1	0	0
RAVATA-296	360	477	117	0	3	1	0	0
RAVATA-296	360	477	117	0	3	1	0	0
RAVATA-296	360	477	117	0	3	3	1	0
RFLOW-196	1	477	476	0	3	1	0	0
RFLOW-196	1	2	1	1	3	4	0	0
RFLOW-196	2	3	1	1	5	1	0	0
RFLOW-196	2	477	475	0	3	1	0	0
RFLOW-196	2	68	66	1	3	1	1	0
RFLOW-196	2	3	1	1	3	1	0	0
RFLOW-196	3	35	32	1	4	2	1	0
RFLOW-196	4	5	1	1	3	1	1	0
RFLOW-197	4	298	294	1	3	1	2	0
RFLOW-197	5	477	472	0	3	1	0	0
RFLOW-197	7	450	443	1	3	1	1	0
RFLOW-197	7	477	470	0	3	1	0	0
RFLOW-197	7	477	470	0	3	4	0	0
RFLOW-197	7	9	2	1	4	4	1	0
RFLOW-197	8	9	1	1	3	1	1	0
RFLOW-197	8	42	34	1	3	1	1	0
RFLOW-197	8	127	119	1	4	2	1	0
RFLOW-197	8	477	469	0	3	1	0	0
RFLOW-198	8	477	469	0	3	1	0	0
RFLOW-198	9	477	468	0	3	1	0	0
RFLOW-198	9	10	1	1	4	1	1	0
RFLOW-198	9	40	31	1	5	4	1	0
RFLOW-198	9	15	6	1	4	1	1	0
RFLOW-198	9	477	468	0	3	1	0	0
RFLOW-198	10	477	467	0	3	1	0	0
RFLOW-198	10	477	467	0	4	1	0	0
RFLOW-198	10	11	1	1	3	1	2	0
RFLOW-198	10	477	467	0	4	1	0	0
RFLOW-199	10	477	467	0	4	4	0	0
RFLOW-199	10	477	467	0	3	5	0	0
RFLOW-199	10	477	467	0	3	5	0	0
RFLOW-199	10	477	467	0	3	5	0	0
RFLOW-199	10	11	1	1	3	1	1	0
RFLOW-199	11	12	1	1	3	1	1	0
RFLOW-199	11	12	1	1	3	4	1	0
RFLOW-199	11	12	1	1	5	4	1	0
RFLOW-199	11	373	362	1	3	4	1	0
RFLOW-199	11	477	466	0	4	5	1	0
RFLOW-200	14	15	1	1	4	2	1	0
RFLOW-200	14	281	267	1	3	1	0	1
RFLOW-200	14	15	1	1	3	1	1	0
RFLOW-200	14	15	1	1	3	4	1	0
RFLOW-200	14	15	1	1	3	1	1	0
RFLOW-200	14	15	1	1	3	1	0	0
RFLOW-200	14	24	10	1	4	5	1	0
RFLOW-200	15	33	18	1	1	1	0	0
RFLOW-200	15	17	2	1	1	1	1	0
RFLOW-200	15	385	370	1	3	1	1	0
RFLOW-201	16	477	461	0	3	4	0	0
RFLOW-201	17	477	460	0	4	1	0	0
RFLOW-201	17	477	460	0	3	1	0	0
RFLOW-201	18	477	459	0	3	1	0	0
RFLOW-201	18	37	19	1	3	1	1	1
RFLOW-201	18	27	9	1	3	1	1	0
RFLOW-201	18	23	5	1	4	4	1	0
RFLOW-201	19	20	1	1	4	4	1	0
RFLOW-201	20	37	17	1	3	1	1	0
RFLOW-201	21	22	1	1	3	4	1	0
RFLOW-202	21	477	456	0	4	1	0	0
RFLOW-202	21	22	1	1	3	1	0	0
RFLOW-202	22	310	288	1	4	1	0	0
RFLOW-202	22	477	455	0	3	1	0	0
RFLOW-202	22	477	455	0	4	2	0	0
RFLOW-202	22	23	1	1	4	4	1	0
RFLOW-202	22	31	9	1	3	1	0	1
RFLOW-202	23	98	75	1	3	4	1	0
RFLOW-202	23	24	1	1	5	1	0	0
RFLOW-202	24	25	1	1	4	1	1	0
RFLOW-203	24	25	1	1	3	1	1	0
RFLOW-203	24	25	1	1	3	3	1	0
RFLOW-203	24	477	453	0	3	5	0	0
RFLOW-203	24	25	1	1	5	3	1	0
RFLOW-203	25	55	30	1	5	1	1	0
RFLOW-203	25	477	452	0	3	1	0	0
RFLOW-203	25	477	452	0	3	4	0	0
RFLOW-203	25	30	5	1	5	2	1	0
RFLOW-203	25	35	10	1	3	1	1	0
RFLOW-203	26	32	6	1	4	4	1	0
RFLOW-204	26	35	9	1	3	1	1	0
RFLOW-204	28	114	86	1	5	1	1	0
RFLOW-204	28	114	86	1	4	1	1	0
RFLOW-204	28	29	1	1	5	1	1	0
RFLOW-204	29	30	1	1	4	4	1	0
RFLOW-204	29	477	448	0	3	1	0	0
RFLOW-204	29	35	6	1	3	1	1	0
RFLOW-204	29	477	448	0	2	1	0	0
RFLOW-204	29	35	6	1	3	1	1	0
RFLOW-204	29	477	448	0	4	4	0	0
RFLOW-205	30	31	1	1	3	1	1	0
RFLOW-205	30	263	233	1	4	1	0	1
RFLOW-205	30	185	155	1	3	1	3	1
RFLOW-205	30	32	2	1	4	1	1	0
RFLOW-205	30	477	447	0	4	4	0	0
RFLOW-205	31	33	2	1	3	4	1	0
RFLOW-205	31	477	446	0	4	4	1	1
RFLOW-205	31	32	1	1	5	3	0	0
RFLOW-205	32	477	445	0	1	1	0	0
RFLOW-205	32	60	28	1	2	1	1	0
RFLOW-206	32	82	50	1	3	1	1	0
RFLOW-206	33	434	401	1	3	4	0	0
RFLOW-206	33	477	444	0	4	4	0	0
RFLOW-206	33	35	2	1	4	3	1	0
RFLOW-206	34	477	443	0	1	4	1	2
RFLOW-206	35	60	25	1	2	1	2	1
RFLOW-206	35	39	4	1	4	3	1	0
RFLOW-206	35	477	442	0	3	1	0	0
RFLOW-206	36	112	76	1	3	4	1	0
RFLOW-206	36	37	1	1	4	1	1	0
RFLOW-207	36	477	441	0	3	2	1	0
RFLOW-207	36	477	441	0	3	2	1	0
RFLOW-207	36	201	165	1	3	3	0	0
RFLOW-207	36	38	2	1	5	1	1	0
RFLOW-207	36	37	1	1	4	1	1	0
RFLOW-207	37	477	440	0	3	4	0	0
RFLOW-207	37	408	371	1	2	1	0	0
RFLOW-207	37	38	1	1	4	1	1	0
RFLOW-207	37	38	1	1	4	4	1	0
RFLOW-207	37	220	183	1	4	4	1	0
RFLOW-208	37	38	1	1	4	4	1	0
RFLOW-208	38	477	439	0	4	4	0	0
RFLOW-208	38	370	332	1	3	1	1	0
RFLOW-208	39	40	1	1	5	1	1	0
RFLOW-208	39	477	438	0	3	1	0	0
RFLOW-208	39	40	1	1	4	2	1	0
RFLOW-208	39	128	89	1	3	4	1	0
RFLOW-208	39	55	16	1	5	1	1	0
RFLOW-208	39	40	1	1	4	3	1	0
RFLOW-208	39	46	7	1	3	4	1	0
RFLOW-209	39	40	1	1	5	3	1	0
RFLOW-209	39	40	1	1	5	3	1	0
RFLOW-209	39	40	1	1	5	3	1	0
RFLOW-209	39	477	438	0	3	4	0	0
RFLOW-209	39	40	1	1	4	3	1	0
RFLOW-209	39	40	1	1	4	3	1	0
RFLOW-209	39	477	438	0	4	4	0	0
RFLOW-209	40	58	18	1	4	1	1	0
RFLOW-209	41	477	436	0	3	4	0	0
RFLOW-209	41	213	172	1	4	1	1	1
RFLOW-210	41	42	1	1	3	3	1	0
RFLOW-210	42	477	435	0	4	1	0	0
RFLOW-210	42	55	13	1	3	2	1	0
RFLOW-210	42	251	209	1	2	1	0	0
RFLOW-210	43	330	287	1	3	4	1	0
RFLOW-210	43	449	406	1	4	1	0	0
RFLOW-210	44	66	22	1	5	4	1	0
RFLOW-210	44	143	99	1	4	2	1	1
RFLOW-210	44	47	3	1	4	1	1	0
RFLOW-210	45	477	432	0	3	1	0	0
RFLOW-211	45	133	88	1	4	4	2	0
RFLOW-211	45	477	432	0	4	2	0	0
RFLOW-211	45	46	1	1	4	1	1	0
RFLOW-211	45	46	1	1	2	1	1	0
RFLOW-211	46	477	431	0	4	1	0	0
RFLOW-211	46	47	1	1	2	3	1	0
RFLOW-211	46	47	1	1	3	1	1	0
RFLOW-211	46	477	431	0	3	1	0	0
RFLOW-211	46	64	18	1	4	1	0	0
RFLOW-211	46	459	413	1	4	1	0	1
RFLOW-212	47	477	430	0	3	4	0	0
RFLOW-212	48	477	429	0	3	1	0	0
RFLOW-212	49	54	5	1	3	1	1	0
RFLOW-212	49	63	14	1	3	1	1	0
RFLOW-212	49	79	30	1	3	5	1	0
RFLOW-212	49	54	5	1	3	4	1	0
RFLOW-212	50	51	1	1	5	3	0	0
RFLOW-212	50	55	5	1	3	1	1	0
RFLOW-212	50	477	427	0	3	1	0	0
RFLOW-212	50	62	12	1	4	1	1	0
RFLOW-213	51	53	2	1	2	1	1	1
RFLOW-213	51	53	2	1	2	1	1	0
RFLOW-213	51	59	8	1	4	4	1	0
RFLOW-213	51	52	1	1	3	1	0	0
RFLOW-213	51	52	1	1	3	1	0	0
RFLOW-213	51	52	1	1	3	1	0	0
RFLOW-213	51	477	426	0	3	1	0	0
RFLOW-213	52	53	1	1	4	4	0	0
RFLOW-213	52	67	15	1	4	4	1	0
RFLOW-213	52	54	2	1	3	4	1	0
RFLOW-214	52	70	18	1	3	2	1	0
RFLOW-214	52	477	425	0	3	1	0	2
RFLOW-214	52	54	2	1	4	1	1	0
RFLOW-214	52	477	425	0	4	1	0	1
RFLOW-214	52	477	425	0	5	4	0	0
RFLOW-214	53	242	189	1	4	1	1	0
RFLOW-214	54	55	1	1	3	3	1	0
RFLOW-214	55	60	5	1	4	4	1	0
RFLOW-214	56	477	421	0	2	1	0	0
RFLOW-214	56	58	2	1	5	4	1	0
RFLOW-215	57	78	21	1	3	1	0	0
RFLOW-215	57	58	1	1	3	2	1	0
RFLOW-215	57	58	1	1	5	1	1	0
RFLOW-215	57	477	420	0	4	1	0	0
RFLOW-215	57	477	420	0	4	1	0	0
RFLOW-215	57	477	420	0	4	1	0	0
RFLOW-215	57	254	197	1	3	4	1	0
RFLOW-215	58	235	177	1	3	4	0	1
RFLOW-215	58	63	5	1	4	4	1	1
RFLOW-215	58	60	2	1	3	4	1	0
RFLOW-216	58	59	1	1	4	1	1	1
RFLOW-216	59	60	1	1	5	1	1	0
RFLOW-216	59	100	41	1	4	1	1	0
RFLOW-216	59	63	4	1	5	1	0	0
RFLOW-216	59	477	418	0	3	4	1	0
RFLOW-216	60	381	321	1	3	1	0	0
RFLOW-216	60	61	1	1	3	1	1	0
RFLOW-216	60	477	417	0	4	1	0	0
RFLOW-216	60	64	4	1	5	2	1	0
RFLOW-216	60	68	8	1	3	1	1	0
RFLOW-217	60	61	1	1	5	4	1	0
RFLOW-217	60	62	2	1	3	1	1	0
RFLOW-217	61	148	87	1	4	1	0	0
RFLOW-217	61	64	3	1	3	1	1	0
RFLOW-217	62	63	1	1	4	1	1	0
RFLOW-217	63	64	1	1	2	1	1	0
RFLOW-217	63	64	1	1	4	3	1	0
RFLOW-217	63	64	1	1	4	3	1	0
RFLOW-217	63	93	30	1	3	1	1	0
RFLOW-217	63	477	414	0	4	4	0	0
RFLOW-218	63	477	414	0	4	1	0	0
RFLOW-218	63	65	2	1	5	3	1	0
RFLOW-218	63	232	169	1	3	2	0	0
RFLOW-218	64	72	8	1	3	4	1	0
RFLOW-218	64	106	42	1	3	4	1	0
RFLOW-218	64	73	9	1	3	1	1	0
RFLOW-218	64	65	1	1	4	4	1	0
RFLOW-218	65	66	1	1	3	4	1	0
RFLOW-218	65	66	1	1	4	1	1	0
RFLOW-218	65	66	1	1	3	1	0	0
RFLOW-219	65	392	327	1	3	1	1	0
RFLOW-219	65	66	1	1	4	4	1	0
RFLOW-219	65	376	311	1	2	1	1	0
RFLOW-219	66	477	411	0	4	2	0	0
RFLOW-219	66	477	411	0	5	1	0	0
RFLOW-219	66	477	411	0	3	1	0	0
RFLOW-219	66	477	411	0	2	1	0	0
RFLOW-219	66	409	343	1	3	4	1	0
RFLOW-219	66	67	1	1	4	1	0	1
RFLOW-219	66	67	1	1	3	4	1	0
RFLOW-220	66	94	28	1	3	2	1	0
RFLOW-220	66	477	411	0	2	1	0	0
RFLOW-220	67	78	11	1	3	1	0	0
RFLOW-220	67	72	5	1	3	4	1	0
RFLOW-220	68	70	2	1	4	1	1	1
RFLOW-220	68	71	3	1	4	1	1	0
RFLOW-220	68	70	2	1	4	1	1	0
RFLOW-220	68	70	2	1	4	1	1	0
RFLOW-220	70	112	42	1	4	4	1	0
RFLOW-220	70	99	29	1	3	1	1	0
RFLOW-221	70	71	1	1	3	1	0	0
RFLOW-221	71	77	6	1	3	4	1	0
RFLOW-221	71	77	6	1	4	1	1	0
RFLOW-221	71	134	63	1	3	2	1	0
RFLOW-221	71	477	406	0	4	1	0	0
RFLOW-221	71	73	2	1	3	1	1	0
RFLOW-221	72	309	237	1	4	1	1	0
RFLOW-221	73	345	272	1	4	2	2	1
RFLOW-221	73	477	404	0	4	2	0	0
RFLOW-221	74	477	403	0	5	1	0	0
RFLOW-222	74	75	1	1	5	3	1	0
RFLOW-222	74	477	403	0	3	2	1	1
RFLOW-222	74	126	52	1	3	1	2	0
RFLOW-222	74	81	7	1	3	1	0	0
RFLOW-222	76	429	353	1	3	4	1	1
RFLOW-222	77	78	1	1	4	4	1	0
RFLOW-222	77	78	1	1	3	4	1	0
RFLOW-222	77	477	400	0	4	4	1	0
RFLOW-222	78	84	6	1	3	4	1	0
RFLOW-222	78	477	399	0	3	1	0	0
RFLOW-223	78	114	36	1	2	1	0	0
RFLOW-223	78	267	189	1	3	1	1	1
RFLOW-223	79	80	1	1	2	1	0	1
RFLOW-223	79	89	10	1	4	4	1	0
RFLOW-223	79	112	33	1	3	4	1	0
RFLOW-223	79	80	1	1	4	1	1	0
RFLOW-223	79	477	398	0	3	1	0	0
RFLOW-223	79	477	398	0	3	1	0	0
RFLOW-223	79	212	133	1	3	4	1	0
RFLOW-223	79	292	213	1	4	1	0	0
RFLOW-224	79	107	28	1	4	4	1	0
RFLOW-224	80	81	1	1	3	4	0	0
RFLOW-224	80	232	152	1	4	3	0	0
RFLOW-224	80	477	397	0	3	1	0	0
RFLOW-224	80	84	4	1	3	1	1	0
RFLOW-224	81	230	149	1	5	4	1	0
RFLOW-224	81	82	1	1	4	1	0	0
RFLOW-224	81	84	3	1	3	1	1	0
RFLOW-224	81	82	1	1	4	1	1	0
RFLOW-224	81	84	3	1	4	2	1	0
RFLOW-225	81	477	396	0	3	1	0	0
RFLOW-225	82	84	2	1	4	4	0	2
RFLOW-225	83	95	12	1	3	5	1	0
RFLOW-225	84	477	393	0	3	4	0	0
RFLOW-225	85	105	20	1	3	1	1	2
RFLOW-225	85	104	19	1	4	4	0	0
RFLOW-225	85	98	13	1	4	4	1	0
RFLOW-225	85	429	344	1	3	1	0	0
RFLOW-225	85	86	1	1	4	4	1	0
RFLOW-225	85	89	4	1	3	4	1	0
RFLOW-226	85	86	1	1	4	4	1	0
RFLOW-226	85	86	1	1	4	1	1	0
RFLOW-226	86	477	391	0	3	1	0	0
RFLOW-226	86	256	170	1	3	1	0	0
RFLOW-226	86	87	1	1	4	4	1	0
RFLOW-226	86	477	391	0	4	4	0	0
RFLOW-226	86	117	31	1	3	1	1	0
RFLOW-226	87	373	286	1	3	4	1	0
RFLOW-226	87	477	390	0	3	1	0	0
RFLOW-226	87	89	2	1	5	5	1	0
RFLOW-227	87	112	25	1	3	1	1	0
RFLOW-227	88	477	389	0	3	1	0	0
RFLOW-227	88	126	38	1	2	1	0	0
RFLOW-227	89	95	6	1	4	2	1	0
RFLOW-227	90	91	1	1	3	4	1	0
RFLOW-227	91	477	386	0	3	1	0	0
RFLOW-227	92	477	385	0	5	4	0	0
RFLOW-227	92	265	173	1	3	1	0	0
RFLOW-227	92	304	212	1	4	4	0	0
RFLOW-227	92	477	385	0	3	4	0	0
RFLOW-228	93	477	384	0	4	4	0	0
RFLOW-228	93	98	5	1	4	2	1	0
RFLOW-228	93	94	1	1	5	3	1	0
RFLOW-228	93	477	384	0	3	1	0	0
RFLOW-228	94	98	4	1	3	2	1	0
RFLOW-228	94	477	383	0	3	2	0	0
RFLOW-228	95	96	1	1	5	1	0	0
RFLOW-228	95	103	8	1	1	4	1	0
RFLOW-228	95	295	200	1	1	4	1	0
RFLOW-228	95	477	382	0	1	4	1	0
RFLOW-229	95	477	382	0	1	4	1	0
RFLOW-229	95	100	5	1	4	4	1	0
RFLOW-229	95	97	2	1	4	1	1	0
RFLOW-229	95	101	6	1	3	1	1	0
RFLOW-229	95	245	150	1	3	5	1	0
RFLOW-229	95	245	150	1	1	5	1	0
RFLOW-229	95	97	2	1	5	1	0	0
RFLOW-229	96	97	1	1	5	1	0	0
RFLOW-229	96	97	1	1	5	3	1	0
RFLOW-229	98	106	8	1	3	4	1	0
RFLOW-230	98	112	14	1	3	4	1	0
RFLOW-230	98	102	4	1	3	2	1	0
RFLOW-230	98	100	2	1	3	4	1	0
RFLOW-230	98	99	1	1	3	2	1	0
RFLOW-230	98	99	1	1	3	4	1	0
RFLOW-230	98	99	1	1	2	1	1	0
RFLOW-230	98	99	1	1	5	5	0	0
RFLOW-230	98	477	379	0	4	4	0	0
RFLOW-230	99	477	378	0	3	1	0	0
RFLOW-230	99	107	8	1	3	4	1	0
RFLOW-231	99	477	378	0	3	4	0	0
RFLOW-231	100	477	377	0	3	1	0	0
RFLOW-231	100	101	1	1	5	4	1	0
RFLOW-231	100	122	22	1	4	4	1	0
RFLOW-231	100	101	1	1	4	1	1	0
RFLOW-231	101	477	376	0	4	4	1	0
RFLOW-231	101	477	376	0	4	1	0	0
RFLOW-231	101	477	376	0	4	5	0	0
RFLOW-231	102	477	375	0	3	4	0	0
RFLOW-231	102	477	375	0	3	1	0	0
RFLOW-232	102	477	375	0	1	1	0	0
RFLOW-232	102	477	375	0	3	1	0	1
RFLOW-232	102	477	375	0	3	1	0	0
RFLOW-232	103	477	374	0	3	1	0	0
RFLOW-232	105	477	372	0	3	2	1	0
RFLOW-232	105	477	372	0	4	2	0	0
RFLOW-232	105	110	5	1	4	4	1	0
RFLOW-232	105	477	372	0	3	1	0	0
RFLOW-232	105	110	5	1	2	1	1	0
RFLOW-232	106	477	371	0	3	1	0	0
RFLOW-233	106	108	2	1	3	1	1	0
RFLOW-233	106	115	9	1	4	4	1	0
RFLOW-233	106	477	371	0	3	2	0	1
RFLOW-233	107	130	23	1	4	2	2	0
RFLOW-233	107	477	370	0	4	2	0	0
RFLOW-233	107	108	1	1	3	1	1	0
RFLOW-233	107	114	7	1	3	1	1	0
RFLOW-233	107	477	370	0	3	1	0	0
RFLOW-233	107	289	182	1	4	1	0	1
RFLOW-233	107	477	370	0	3	1	0	0
RFLOW-234	107	477	370	0	2	1	0	1
RFLOW-234	107	477	370	0	4	5	0	0
RFLOW-234	108	477	369	0	3	1	0	0
RFLOW-234	108	117	9	1	3	1	1	1
RFLOW-234	108	112	4	1	4	1	0	0
RFLOW-234	108	109	1	1	4	4	1	0
RFLOW-234	109	110	1	1	5	1	0	0
RFLOW-234	109	110	1	1	5	1	0	0
RFLOW-234	109	117	8	1	4	1	1	0
RFLOW-234	109	477	368	0	4	4	0	0
RFLOW-235	109	110	1	1	4	4	1	0
RFLOW-235	109	112	3	1	3	1	2	0
RFLOW-235	109	477	368	0	3	1	0	0
RFLOW-235	109	477	368	0	3	4	0	0
RFLOW-235	109	477	368	0	4	1	0	0
RFLOW-235	110	167	57	1	1	1	2	1
RFLOW-235	110	477	367	0	4	4	0	0
RFLOW-235	111	112	1	1	3	4	1	1
RFLOW-235	112	129	17	1	3	4	1	0
RFLOW-235	112	165	53	1	3	4	2	0
RFLOW-236	112	477	365	0	3	1	0	0
RFLOW-236	112	132	20	1	4	4	0	0
RFLOW-236	112	143	31	1	2	1	2	0
RFLOW-236	112	119	7	1	3	1	2	0
RFLOW-236	112	113	1	1	4	1	1	0
RFLOW-236	112	113	1	1	3	1	1	0
RFLOW-236	112	119	7	1	3	1	0	0
RFLOW-236	112	477	365	0	3	1	0	0
RFLOW-236	112	477	365	0	3	4	0	0
RFLOW-236	113	114	1	1	3	4	1	0
RFLOW-237	113	117	4	1	4	1	1	0
RFLOW-237	113	477	364	0	3	1	0	3
RFLOW-237	113	477	364	0	3	5	0	0
RFLOW-237	114	477	363	0	3	4	0	0
RFLOW-237	114	119	5	1	1	1	0	0
RFLOW-237	114	477	363	0	4	3	0	0
RFLOW-237	114	133	19	1	3	4	2	0
RFLOW-237	114	115	1	1	4	4	1	0
RFLOW-237	115	116	1	1	5	5	1	0
RFLOW-237	115	119	4	1	3	1	0	0
RFLOW-238	115	116	1	1	4	4	1	0
RFLOW-238	115	116	1	1	3	4	1	0
RFLOW-238	115	116	1	1	3	1	1	0
RFLOW-238	115	116	1	1	3	1	0	0
RFLOW-238	115	117	2	1	2	1	1	1
RFLOW-238	116	141	25	1	3	1	0	0
RFLOW-238	116	477	361	0	3	1	0	0
RFLOW-238	116	117	1	1	1	1	0	1
RFLOW-238	116	477	361	0	4	4	0	0
RFLOW-238	117	119	2	1	3	4	1	0
RFLOW-239	117	119	2	1	5	4	1	0
RFLOW-239	117	118	1	1	3	4	1	0
RFLOW-239	118	477	359	0	3	1	0	0
RFLOW-239	118	128	10	1	3	4	1	0
RFLOW-239	118	121	3	1	3	1	2	0
RFLOW-239	118	132	14	1	3	5	2	0
RFLOW-239	118	132	14	1	3	5	2	0
RFLOW-239	118	137	19	1	3	5	2	0
RFLOW-239	119	120	1	1	5	4	1	0
RFLOW-239	119	328	209	1	4	1	1	0
RFLOW-240	119	120	1	1	3	5	2	0
RFLOW-240	119	120	1	1	5	1	0	0
RFLOW-240	119	148	29	1	3	1	1	0
RFLOW-240	119	120	1	1	4	4	1	0
RFLOW-240	120	121	1	1	3	4	1	0
RFLOW-240	120	477	357	0	3	1	1	0
RFLOW-240	121	122	1	1	5	4	1	0
RFLOW-240	121	126	5	1	4	4	1	0
RFLOW-240	121	122	1	1	3	4	0	0
RFLOW-240	121	122	1	1	3	4	2	0
RFLOW-241	121	122	1	1	3	4	2	0
RFLOW-241	121	122	1	1	5	4	1	0
RFLOW-241	122	127	5	1	3	4	2	0
RFLOW-241	122	477	355	0	4	1	0	0
RFLOW-241	122	162	40	1	3	1	1	0
RFLOW-241	122	143	21	1	4	1	2	1
RFLOW-241	122	477	355	0	3	1	0	0
RFLOW-241	123	125	2	1	3	1	2	0
RFLOW-241	123	125	2	1	3	4	1	0
RFLOW-241	123	265	142	1	4	4	1	0
RFLOW-242	123	134	11	1	3	2	1	0
RFLOW-242	123	465	342	1	3	1	1	0
RFLOW-242	123	477	354	0	3	1	0	0
RFLOW-242	123	304	181	1	3	4	0	1
RFLOW-242	124	129	5	1	4	1	2	0
RFLOW-242	124	133	9	1	3	4	1	0
RFLOW-242	126	127	1	1	2	5	2	0
RFLOW-242	126	127	1	1	4	5	2	0
RFLOW-242	126	351	225	1	4	4	0	1
RFLOW-242	126	141	15	1	3	4	1	0
RFLOW-243	126	132	6	1	3	1	2	0
RFLOW-243	127	128	1	1	3	2	2	1
RFLOW-243	127	477	350	0	3	1	0	0
RFLOW-243	127	477	350	0	3	1	0	0
RFLOW-243	127	477	350	0	4	4	1	0
RFLOW-243	127	133	6	1	2	4	1	0
RFLOW-243	127	129	2	1	4	1	1	0
RFLOW-243	127	128	1	1	5	5	1	0
RFLOW-243	127	477	350	0	3	1	0	0
RFLOW-243	127	477	350	0	3	2	0	0
RFLOW-244	127	338	211	1	5	2	1	0
RFLOW-244	128	129	1	1	3	1	1	0
RFLOW-244	128	315	187	1	3	1	1	0
RFLOW-244	128	139	11	1	4	1	1	0
RFLOW-244	128	129	1	1	3	1	1	0
RFLOW-244	128	129	1	1	3	4	1	0
RFLOW-244	129	130	1	1	4	4	1	0
RFLOW-244	129	130	1	1	4	1	1	0
RFLOW-244	129	138	9	1	3	4	1	0
RFLOW-244	129	130	1	1	3	1	1	0
RFLOW-245	129	130	1	1	4	1	1	0
RFLOW-245	129	133	4	1	4	1	2	0
RFLOW-245	130	134	4	1	3	4	1	0
RFLOW-245	130	132	2	1	1	1	1	0
RFLOW-245	130	131	1	1	3	5	1	0
RFLOW-245	130	477	347	0	3	1	0	0
RFLOW-245	130	477	347	0	4	1	0	0
RFLOW-245	130	131	1	1	3	1	1	0
RFLOW-245	131	137	6	1	3	2	1	0
RFLOW-245	132	477	345	0	3	1	1	0
RFLOW-246	133	134	1	1	3	1	2	0
RFLOW-246	133	134	1	1	4	4	2	0
RFLOW-246	133	153	20	1	1	1	0	0
RFLOW-246	133	191	58	1	3	4	1	0
RFLOW-246	133	477	344	0	3	1	0	1
RFLOW-246	133	134	1	1	4	1	2	0
RFLOW-246	133	149	16	1	1	1	2	0
RFLOW-246	134	135	1	1	5	3	2	0
RFLOW-246	134	477	343	0	3	1	0	0
RFLOW-246	135	254	119	1	2	1	0	0
RFLOW-247	135	477	342	0	2	1	0	0
RFLOW-247	135	140	5	1	3	1	1	0
RFLOW-247	135	142	7	1	3	4	1	0
RFLOW-247	135	143	8	1	4	1	2	0
RFLOW-247	135	136	1	1	3	1	2	0
RFLOW-247	135	477	342	0	4	4	0	0
RFLOW-247	135	244	109	1	3	4	1	0
RFLOW-247	136	137	1	1	3	1	1	0
RFLOW-247	136	139	3	1	3	4	0	0
RFLOW-247	136	137	1	1	3	4	2	0
RFLOW-248	136	477	341	0	3	2	0	0
RFLOW-248	136	137	1	1	3	4	2	0
RFLOW-248	137	138	1	1	4	5	1	0
RFLOW-248	137	138	1	1	4	4	0	0
RFLOW-248	137	138	1	1	4	3	1	0
RFLOW-248	137	138	1	1	4	1	2	0
RFLOW-248	137	138	1	1	3	1	2	0
RFLOW-248	137	138	1	1	4	1	1	0
RFLOW-248	137	477	340	0	3	4	0	0
RFLOW-248	137	139	2	1	3	4	1	0
RFLOW-249	137	477	340	0	4	2	1	1
RFLOW-249	137	138	1	1	3	1	1	0
RFLOW-249	138	477	339	0	3	1	0	0
RFLOW-249	139	140	1	1	4	4	1	0
RFLOW-249	139	140	1	1	3	4	1	0
RFLOW-249	139	140	1	1	3	4	1	0
RFLOW-249	139	245	106	1	4	1	1	0
RFLOW-249	140	141	1	1	3	1	0	0
RFLOW-249	140	142	2	1	3	1	1	0
RFLOW-249	140	233	93	1	3	5	1	2
RFLOW-250	140	153	13	1	3	1	0	0
RFLOW-250	140	141	1	1	4	1	1	0
RFLOW-250	140	141	1	1	4	3	1	0
RFLOW-250	140	141	1	1	4	3	1	0
RFLOW-250	140	151	11	1	4	4	1	0
RFLOW-250	141	477	336	0	4	4	0	0
RFLOW-250	141	477	336	0	4	1	1	0
RFLOW-250	141	142	1	1	3	1	0	0
RFLOW-250	141	387	246	1	4	1	1	2
RFLOW-250	141	142	1	1	2	4	1	0
RFLOW-251	141	144	3	1	3	4	2	0
RFLOW-251	141	424	283	1	3	1	1	1
RFLOW-251	141	162	21	1	4	4	2	0
RFLOW-251	142	154	12	1	3	3	1	0
RFLOW-251	142	166	24	1	3	1	0	1
RFLOW-251	142	144	2	1	3	1	2	0
RFLOW-251	142	477	335	0	3	1	0	1
RFLOW-251	142	149	7	1	3	4	0	0
RFLOW-251	143	144	1	1	5	1	1	0
RFLOW-251	143	149	6	1	3	1	2	3
RFLOW-252	143	144	1	1	3	1	1	0
RFLOW-252	143	147	4	1	3	1	2	0
RFLOW-252	143	162	19	1	3	1	2	0
RFLOW-252	143	144	1	1	4	4	1	0
RFLOW-252	144	311	167	1	3	4	2	0
RFLOW-252	144	145	1	1	3	1	1	0
RFLOW-252	144	151	7	1	3	2	0	0
RFLOW-252	144	149	5	1	3	1	0	0
RFLOW-252	145	477	332	0	3	1	0	0
RFLOW-252	146	151	5	1	3	4	1	0
RFLOW-253	147	148	1	1	4	4	1	0
RFLOW-253	147	148	1	1	5	5	1	0
RFLOW-253	148	149	1	1	3	4	2	0
RFLOW-253	148	159	11	1	1	1	2	0
RFLOW-253	148	165	17	1	3	5	2	2
RFLOW-253	148	477	329	0	4	1	0	0
RFLOW-253	148	149	1	1	3	4	1	0
RFLOW-253	149	447	298	1	3	1	1	1
RFLOW-253	149	164	15	1	3	4	0	0
RFLOW-253	149	165	16	1	4	2	2	0
RFLOW-254	149	477	328	0	4	3	0	0
RFLOW-254	149	477	328	0	4	4	0	0
RFLOW-254	149	169	20	1	4	4	2	1
RFLOW-254	149	150	1	1	5	1	0	0
RFLOW-254	149	151	2	1	4	4	1	0
RFLOW-254	149	153	4	1	4	1	2	0
RFLOW-254	150	332	182	1	4	1	0	0
RFLOW-254	150	151	1	1	3	4	1	0
RFLOW-254	150	443	293	1	3	1	1	0
RFLOW-254	150	477	327	0	3	1	0	0
RFLOW-255	151	165	14	1	3	2	2	0
RFLOW-255	151	152	1	1	3	1	1	0
RFLOW-255	151	477	326	0	3	4	0	0
RFLOW-255	152	153	1	1	5	4	1	0
RFLOW-255	152	477	325	0	3	4	0	0
RFLOW-255	152	477	325	0	3	4	0	0
RFLOW-255	153	477	324	0	3	4	0	0
RFLOW-255	153	154	1	1	3	5	2	0
RFLOW-255	153	447	294	1	3	1	1	0
RFLOW-255	154	168	14	1	4	2	2	0
RFLOW-256	154	156	2	1	4	4	1	0
RFLOW-256	154	156	2	1	2	1	1	0
RFLOW-256	154	165	11	1	4	2	2	0
RFLOW-256	154	207	53	1	3	1	1	0
RFLOW-256	155	156	1	1	3	4	0	0
RFLOW-256	155	156	1	1	3	4	1	0
RFLOW-256	155	158	3	1	3	1	1	0
RFLOW-256	155	169	14	1	3	4	2	0
RFLOW-256	155	441	286	1	3	2	1	0
RFLOW-256	155	442	287	1	3	1	0	0
RFLOW-257	155	477	322	0	5	4	0	0
RFLOW-257	156	477	321	0	3	4	0	0
RFLOW-257	156	477	321	0	4	1	0	0
RFLOW-257	156	157	1	1	1	1	1	1
RFLOW-257	157	294	137	1	4	1	1	0
RFLOW-257	157	158	1	1	3	1	1	0
RFLOW-257	157	158	1	1	3	1	1	0
RFLOW-257	157	255	98	1	4	2	1	0
RFLOW-257	158	477	319	0	4	4	0	0
RFLOW-257	158	477	319	0	5	1	0	0
RFLOW-258	158	477	319	0	3	1	0	0
RFLOW-258	158	159	1	1	3	1	1	0
RFLOW-258	158	477	319	0	4	1	0	0
RFLOW-258	158	265	107	1	4	1	0	0
RFLOW-258	158	477	319	0	3	1	0	0
RFLOW-258	159	162	3	1	3	1	1	0
RFLOW-258	159	165	6	1	3	1	0	0
RFLOW-258	159	161	2	1	4	4	2	0
RFLOW-258	159	165	6	1	4	4	0	1
RFLOW-258	160	161	1	1	3	1	0	1
RFLOW-259	160	162	2	1	3	1	1	1
RFLOW-259	161	162	1	1	3	4	1	0
RFLOW-259	161	170	9	1	3	3	1	0
RFLOW-259	161	477	316	0	3	2	0	0
RFLOW-259	161	477	316	0	3	1	0	0
RFLOW-259	161	477	316	0	5	2	0	0
RFLOW-259	161	200	39	1	5	2	1	0
RFLOW-259	162	163	1	1	3	1	1	0
RFLOW-259	162	477	315	0	3	4	0	0
RFLOW-259	162	163	1	1	3	1	1	0
RFLOW-260	162	477	315	0	3	1	0	0
RFLOW-260	162	168	6	1	4	4	2	0
RFLOW-260	162	171	9	1	3	4	1	0
RFLOW-260	162	444	282	1	4	4	0	0
RFLOW-260	163	177	14	1	3	4	1	0
RFLOW-260	163	165	2	1	3	1	1	0
RFLOW-260	163	171	8	1	3	4	1	0
RFLOW-260	163	169	6	1	3	1	2	0
RFLOW-260	163	169	6	1	3	4	2	0
RFLOW-260	163	164	1	1	4	1	0	0
RFLOW-261	163	477	314	0	3	1	0	0
RFLOW-261	163	165	2	1	3	1	2	0
RFLOW-261	163	169	6	1	3	5	2	0
RFLOW-261	164	167	3	1	3	1	2	0
RFLOW-261	164	191	27	1	3	1	1	1
RFLOW-261	164	172	8	1	3	1	1	0
RFLOW-261	164	477	313	0	3	4	0	0
RFLOW-261	164	165	1	1	4	4	1	0
RFLOW-261	164	294	130	1	4	4	0	1
RFLOW-261	164	477	313	0	3	1	0	1
RFLOW-262	164	167	3	1	2	5	0	0
RFLOW-262	164	172	8	1	4	1	0	0
RFLOW-262	164	186	22	1	4	4	2	0
RFLOW-262	164	168	4	1	3	4	0	0
RFLOW-262	165	177	12	1	1	1	1	0
RFLOW-262	165	477	312	0	3	2	0	0
RFLOW-262	165	477	312	0	4	4	0	0
RFLOW-262	165	167	2	1	3	2	2	0
RFLOW-262	165	477	312	0	5	3	0	0
RFLOW-262	165	410	245	1	4	4	0	0
RFLOW-263	165	166	1	1	5	1	2	0
RFLOW-263	165	477	312	0	2	1	0	0
RFLOW-263	166	477	311	0	4	4	1	0
RFLOW-263	166	350	184	1	3	4	0	1
RFLOW-263	166	167	1	1	4	4	2	0
RFLOW-263	168	198	30	1	4	5	0	0
RFLOW-263	168	477	309	0	3	1	0	1
RFLOW-263	168	477	309	0	3	1	0	1
RFLOW-263	168	169	1	1	4	2	1	0
RFLOW-263	168	281	113	1	3	1	0	1
RFLOW-264	169	170	1	1	3	2	1	0
RFLOW-264	169	367	198	1	3	1	1	0
RFLOW-264	169	329	160	1	3	1	1	0
RFLOW-264	169	170	1	1	4	4	0	0
RFLOW-264	169	477	308	0	3	4	0	0
RFLOW-264	169	170	1	1	4	1	1	0
RFLOW-264	169	170	1	1	4	1	1	0
RFLOW-264	169	477	308	0	4	4	0	0
RFLOW-264	170	175	5	1	3	4	1	0
RFLOW-264	170	477	307	0	3	1	1	0
RFLOW-265	170	177	7	1	3	1	1	3
RFLOW-265	170	477	307	0	3	4	0	0
RFLOW-265	170	447	277	1	3	1	1	0
RFLOW-265	170	265	95	1	5	4	0	0
RFLOW-265	170	171	1	1	3	1	1	0
RFLOW-265	171	184	13	1	4	1	1	0
RFLOW-265	171	477	306	0	4	1	1	0
RFLOW-265	171	172	1	1	3	2	1	0
RFLOW-265	171	213	42	1	4	2	1	0
RFLOW-265	172	477	305	0	3	4	0	1
RFLOW-266	172	477	305	0	4	1	1	0
RFLOW-266	172	173	1	1	3	1	1	1
RFLOW-266	172	175	3	1	4	4	2	0
RFLOW-266	172	173	1	1	3	4	1	0
RFLOW-266	172	477	305	0	3	2	0	0
RFLOW-266	172	301	129	1	3	1	0	1
RFLOW-266	173	477	304	0	3	1	0	0
RFLOW-266	174	214	40	1	3	2	0	0
RFLOW-266	174	177	3	1	4	1	1	0
RFLOW-266	175	176	1	1	4	1	1	0
RFLOW-267	175	212	37	1	3	4	1	0
RFLOW-267	175	176	1	1	3	2	1	0
RFLOW-267	175	477	302	0	4	4	0	0
RFLOW-267	175	477	302	0	4	1	0	0
RFLOW-267	175	298	123	1	4	1	0	1
RFLOW-267	176	270	94	1	3	1	0	0
RFLOW-267	176	477	301	0	3	1	0	0
RFLOW-267	176	477	301	0	3	1	0	0
RFLOW-267	176	177	1	1	3	1	1	0
RFLOW-267	176	455	279	1	3	4	0	0
RFLOW-268	176	477	301	0	3	4	0	0
RFLOW-268	176	177	1	1	3	1	1	0
RFLOW-268	176	179	3	1	4	4	1	0
RFLOW-268	177	338	161	1	3	1	0	0
RFLOW-268	177	477	300	0	3	1	0	0
RFLOW-268	177	477	300	0	4	1	0	0
RFLOW-268	178	220	42	1	3	1	0	0
RFLOW-268	178	220	42	1	3	5	0	1
RFLOW-268	178	477	299	0	3	4	0	0
RFLOW-268	178	477	299	0	4	4	0	0
RFLOW-269	178	477	299	0	3	5	0	0
RFLOW-269	178	202	24	1	3	2	1	0
RFLOW-269	178	179	1	1	4	1	1	0
RFLOW-269	179	400	221	1	3	2	0	0
RFLOW-269	179	401	222	1	3	2	0	0
RFLOW-269	179	477	298	0	3	2	0	0
RFLOW-269	179	181	2	1	3	4	1	0
RFLOW-269	179	477	298	0	1	4	1	0
RFLOW-269	179	373	194	1	4	5	1	0
RFLOW-269	179	477	298	0	4	1	0	0
RFLOW-270	179	477	298	0	4	4	0	0
RFLOW-270	179	477	298	0	3	1	0	0
RFLOW-270	179	184	5	1	4	1	1	0
RFLOW-270	180	303	123	1	3	1	1	0
RFLOW-270	181	197	16	1	4	4	1	0
RFLOW-270	181	198	17	1	3	1	1	0
RFLOW-270	182	186	4	1	3	1	1	0
RFLOW-270	182	257	75	1	3	1	1	0
RFLOW-270	182	186	4	1	4	4	1	1
RFLOW-270	182	240	58	1	3	4	1	0
RFLOW-271	183	188	5	1	3	1	1	0
RFLOW-271	183	477	294	0	3	1	0	0
RFLOW-271	184	204	20	1	4	4	1	0
RFLOW-271	184	185	1	1	3	1	1	1
RFLOW-271	184	477	293	0	4	2	0	0
RFLOW-271	184	420	236	1	2	4	1	0
RFLOW-271	184	209	25	1	3	1	2	2
RFLOW-271	185	280	95	1	4	1	0	0
RFLOW-271	185	189	4	1	4	1	1	0
RFLOW-271	186	477	291	0	3	1	0	1
RFLOW-272	186	187	1	1	4	4	0	0
RFLOW-272	186	477	291	0	3	4	0	0
RFLOW-272	186	477	291	0	3	1	0	0
RFLOW-272	188	193	5	1	4	1	1	0
RFLOW-272	189	477	288	0	5	4	0	0
RFLOW-272	189	477	288	0	4	1	0	0
RFLOW-272	189	477	288	0	3	1	0	0
RFLOW-272	189	245	56	1	4	2	0	0
RFLOW-272	189	477	288	0	3	1	0	0
RFLOW-272	189	193	4	1	4	1	1	0
RFLOW-273	189	477	288	0	4	1	0	0
RFLOW-273	189	201	12	1	4	4	1	0
RFLOW-273	189	477	288	0	3	4	0	0
RFLOW-273	189	477	288	0	3	1	0	0
RFLOW-273	190	203	13	1	4	4	1	0
RFLOW-273	190	191	1	1	4	1	1	0
RFLOW-273	190	477	287	0	3	1	0	0
RFLOW-273	190	201	11	1	3	4	1	0
RFLOW-273	190	477	287	0	3	1	0	1
RFLOW-273	190	193	3	1	3	1	1	0
RFLOW-274	190	477	287	0	3	1	0	0
RFLOW-274	190	477	287	0	3	1	0	0
RFLOW-274	190	231	41	1	4	1	0	0
RFLOW-274	190	191	1	1	3	1	0	0
RFLOW-274	190	295	105	1	3	1	2	0
RFLOW-274	190	477	287	0	4	4	0	0
RFLOW-274	191	477	286	0	3	1	0	1
RFLOW-274	192	387	195	1	3	4	1	4
RFLOW-274	192	196	4	1	3	4	1	0
RFLOW-274	192	197	5	1	4	2	1	0
RFLOW-275	193	373	180	1	3	2	1	0
RFLOW-275	193	195	2	1	3	1	1	0
RFLOW-275	193	195	2	1	3	1	1	0
RFLOW-275	195	202	7	1	4	4	1	0
RFLOW-275	196	197	1	1	3	1	1	0
RFLOW-275	196	217	21	1	4	1	1	0
RFLOW-275	196	212	16	1	3	1	1	0
RFLOW-275	197	421	224	1	3	1	0	0
RFLOW-275	197	198	1	1	3	2	1	0
RFLOW-275	197	477	280	0	3	4	0	0
RFLOW-276	197	298	101	1	3	4	1	0
RFLOW-276	197	331	134	1	3	4	1	0
RFLOW-276	197	477	280	0	3	4	0	0
RFLOW-276	197	221	24	1	3	4	1	0
RFLOW-276	198	477	279	0	4	5	1	0
RFLOW-276	198	206	8	1	3	4	1	0
RFLOW-276	198	206	8	1	4	4	1	0
RFLOW-276	198	423	225	1	3	4	1	0
RFLOW-276	198	477	279	0	3	1	0	0
RFLOW-276	198	201	3	1	4	1	1	0
RFLOW-277	199	346	147	1	2	4	1	1
RFLOW-277	199	200	1	1	4	1	2	0
RFLOW-277	199	256	57	1	4	1	1	0
RFLOW-277	199	203	4	1	4	1	1	0
RFLOW-277	199	477	278	0	4	4	0	0
RFLOW-277	200	477	277	0	3	4	0	0
RFLOW-277	200	206	6	1	4	4	1	0
RFLOW-277	200	206	6	1	4	4	1	0
RFLOW-277	201	202	1	1	4	1	2	0
RFLOW-277	201	212	11	1	3	4	1	0
RFLOW-278	202	311	109	1	3	2	2	0
RFLOW-278	203	206	3	1	4	1	0	0
RFLOW-278	203	204	1	1	3	4	1	0
RFLOW-278	203	380	177	1	3	4	1	0
RFLOW-278	203	477	274	0	3	1	0	0
RFLOW-278	203	204	1	1	4	4	1	0
RFLOW-278	203	245	42	1	4	1	1	0
RFLOW-278	203	218	15	1	2	1	1	1
RFLOW-278	203	217	14	1	3	1	1	0
RFLOW-278	203	284	81	1	4	4	1	0
RFLOW-279	203	477	274	0	3	1	0	0
RFLOW-279	204	206	2	1	5	4	1	0
RFLOW-279	204	205	1	1	3	1	1	0
RFLOW-279	204	477	273	0	3	1	0	0
RFLOW-279	204	284	80	1	5	5	1	0
RFLOW-279	204	212	8	1	5	2	1	0
RFLOW-279	204	397	193	1	5	1	1	0
RFLOW-279	204	254	50	1	4	4	1	0
RFLOW-279	205	206	1	1	4	4	1	0
RFLOW-279	205	311	106	1	3	1	1	1
RFLOW-280	205	212	7	1	3	1	1	0
RFLOW-280	205	206	1	1	4	4	1	0
RFLOW-280	206	477	271	0	3	4	0	0
RFLOW-280	206	477	271	0	3	4	0	0
RFLOW-280	206	477	271	0	3	4	0	0
RFLOW-280	206	344	138	1	3	4	1	0
RFLOW-280	206	444	238	1	4	1	0	0
RFLOW-280	206	208	2	1	4	4	1	0
RFLOW-280	207	226	19	1	3	1	0	0
RFLOW-280	207	209	2	1	3	1	1	0
RFLOW-281	207	265	58	1	4	1	0	0
RFLOW-281	207	277	70	1	3	1	1	0
RFLOW-281	207	208	1	1	4	1	1	0
RFLOW-281	207	329	122	1	3	1	1	2
RFLOW-281	208	209	1	1	2	1	1	0
RFLOW-281	208	212	4	1	3	5	1	0
RFLOW-281	208	212	4	1	3	5	1	0
RFLOW-281	208	212	4	1	3	4	1	0
RFLOW-281	209	252	43	1	3	1	0	0
RFLOW-281	210	477	267	0	3	4	1	0
RFLOW-282	210	212	2	1	4	4	0	0
RFLOW-282	210	216	6	1	4	4	1	0
RFLOW-282	210	211	1	1	5	1	0	0
RFLOW-282	210	477	267	0	4	4	0	0
RFLOW-282	210	477	267	0	3	5	0	0
RFLOW-282	210	212	2	1	2	1	1	0
RFLOW-282	210	219	9	1	4	4	1	0
RFLOW-282	210	477	267	0	3	1	0	0
RFLOW-282	210	477	267	0	5	4	0	0
RFLOW-282	211	263	52	1	3	1	1	0
RFLOW-283	211	477	266	0	2	1	0	0
RFLOW-283	211	477	266	0	3	1	0	0
RFLOW-283	211	212	1	1	4	4	1	0
RFLOW-283	212	477	265	0	3	1	0	0
RFLOW-283	212	465	253	1	1	1	0	1
RFLOW-283	212	213	1	1	3	1	1	0
RFLOW-283	212	219	7	1	4	4	0	0
RFLOW-283	212	338	126	1	4	1	0	1
RFLOW-283	212	406	194	1	2	1	0	0
RFLOW-283	213	216	3	1	2	4	1	0
RFLOW-284	213	477	264	0	3	5	0	0
RFLOW-284	213	214	1	1	4	4	0	0
RFLOW-284	213	477	264	0	3	4	0	0
RFLOW-284	214	382	168	1	4	4	1	0
RFLOW-284	214	477	263	0	2	1	0	0
RFLOW-284	214	217	3	1	4	4	1	0
RFLOW-284	214	263	49	1	5	4	0	0
RFLOW-284	214	263	49	1	3	4	1	0
RFLOW-284	215	219	4	1	2	1	1	0
RFLOW-284	215	216	1	1	5	4	1	0
RFLOW-285	215	216	1	1	4	4	0	0
RFLOW-285	215	228	13	1	4	4	0	0
RFLOW-285	216	217	1	1	3	1	0	0
RFLOW-285	216	217	1	1	3	3	1	0
RFLOW-285	216	240	24	1	4	4	2	0
RFLOW-285	216	219	3	1	2	4	1	0
RFLOW-285	216	233	17	1	3	4	1	0
RFLOW-285	217	218	1	1	3	1	1	0
RFLOW-285	217	218	1	1	4	4	1	0
RFLOW-285	217	234	17	1	1	1	1	0
RFLOW-286	217	218	1	1	5	1	1	0
RFLOW-286	217	220	3	1	3	4	1	0
RFLOW-286	217	477	260	0	4	4	0	0
RFLOW-286	217	363	146	1	4	1	1	0
RFLOW-286	218	219	1	1	4	4	1	0
RFLOW-286	218	308	90	1	4	1	2	0
RFLOW-286	218	245	27	1	3	1	1	1
RFLOW-286	218	234	16	1	4	4	1	0
RFLOW-286	218	477	259	0	3	4	0	0
RFLOW-286	218	219	1	1	5	1	1	0
RFLOW-287	218	223	5	1	1	1	1	0
RFLOW-287	219	477	258	0	3	1	0	0
RFLOW-287	219	226	7	1	2	4	0	0
RFLOW-287	219	288	69	1	3	4	1	0
RFLOW-287	219	263	44	1	3	4	1	1
RFLOW-287	219	304	85	1	3	1	0	1
RFLOW-287	219	395	176	1	3	1	1	4
RFLOW-287	219	477	258	0	4	4	0	0
RFLOW-287	220	221	1	1	2	4	0	0
RFLOW-287	220	477	257	0	3	1	0	0
RFLOW-288	220	477	257	0	4	4	0	0
RFLOW-288	220	464	244	1	1	3	0	0
RFLOW-288	220	373	153	1	4	2	1	0
RFLOW-288	220	373	153	1	4	1	0	0
RFLOW-288	221	222	1	1	2	1	1	0
RFLOW-288	221	264	43	1	2	1	0	0
RFLOW-288	221	226	5	1	2	1	1	0
RFLOW-288	221	263	42	1	4	2	1	0
RFLOW-288	222	226	4	1	3	1	1	2
RFLOW-288	222	263	41	1	4	4	1	0
RFLOW-289	223	477	254	0	3	1	0	0
RFLOW-289	223	477	254	0	4	4	0	0
RFLOW-289	223	477	254	0	4	4	0	0
RFLOW-289	224	226	2	1	4	1	1	0
RFLOW-289	224	477	253	0	4	2	0	0
RFLOW-289	224	252	28	1	3	1	1	0
RFLOW-289	224	226	2	1	4	4	0	0
RFLOW-289	224	477	253	0	4	1	0	0
RFLOW-289	225	477	252	0	1	1	0	0
RFLOW-289	225	477	252	0	3	3	1	0
RFLOW-290	225	241	16	1	4	1	1	0
RFLOW-290	226	477	251	0	3	4	0	0
RFLOW-290	226	477	251	0	3	5	0	0
RFLOW-290	226	310	84	1	4	3	1	0
RFLOW-290	226	230	4	1	5	4	1	0
RFLOW-290	226	231	5	1	4	1	1	0
RFLOW-290	226	477	251	0	4	4	0	0
RFLOW-290	227	231	4	1	4	1	1	0
RFLOW-290	227	230	3	1	3	1	1	0
RFLOW-290	227	233	6	1	4	4	1	0
RFLOW-291	227	477	250	0	3	1	0	0
RFLOW-291	228	477	249	0	4	4	0	0
RFLOW-291	228	271	43	1	3	2	1	3
RFLOW-291	228	229	1	1	2	4	1	0
RFLOW-291	228	477	249	0	3	1	0	0
RFLOW-291	228	231	3	1	4	4	1	0
RFLOW-291	229	259	30	1	4	4	1	0
RFLOW-291	229	230	1	1	4	4	1	0
RFLOW-291	230	231	1	1	3	1	1	0
RFLOW-291	231	477	246	0	3	1	0	0
RFLOW-292	231	477	246	0	3	1	0	0
RFLOW-292	231	233	2	1	5	4	1	0
RFLOW-292	231	233	2	1	3	4	1	0
RFLOW-292	231	477	246	0	3	1	0	1
RFLOW-292	231	232	1	1	5	5	0	0
RFLOW-292	231	477	246	0	3	1	0	0
RFLOW-292	231	477	246	0	3	1	0	0
RFLOW-292	232	477	245	0	4	1	0	0
RFLOW-292	232	263	31	1	4	4	1	0
RFLOW-292	233	477	244	0	4	4	0	0
RFLOW-293	233	450	217	1	3	1	1	0
RFLOW-293	233	234	1	1	4	4	1	0
RFLOW-293	233	285	52	1	3	4	1	0
RFLOW-293	233	277	44	1	3	1	1	0
RFLOW-293	233	276	43	1	1	1	0	1
RFLOW-293	233	477	244	0	2	1	0	1
RFLOW-293	233	477	244	0	5	1	0	0
RFLOW-293	233	477	244	0	3	1	0	1
RFLOW-293	233	245	12	1	4	1	1	0
RFLOW-293	234	363	129	1	3	1	1	0
RFLOW-294	234	477	243	0	4	5	1	0
RFLOW-294	234	338	104	1	3	1	0	1
RFLOW-294	234	239	5	1	3	1	0	0
RFLOW-294	234	477	243	0	2	1	0	0
RFLOW-294	234	477	243	0	3	1	0	0
RFLOW-294	234	429	195	1	3	1	0	0
RFLOW-294	234	477	243	0	2	1	0	0
RFLOW-294	234	477	243	0	3	1	0	0
RFLOW-294	234	242	8	1	4	4	1	0
RFLOW-294	234	243	9	1	3	4	1	0
RFLOW-295	234	477	243	0	4	4	0	0
RFLOW-295	234	242	8	1	3	4	2	0
RFLOW-295	234	263	29	1	1	1	1	0
RFLOW-295	235	254	19	1	4	1	0	0
RFLOW-295	235	477	242	0	3	1	0	0
RFLOW-295	235	477	242	0	3	1	0	0
RFLOW-295	236	284	48	1	4	4	1	0
RFLOW-295	236	238	2	1	3	1	0	0
RFLOW-295	237	477	240	0	3	1	1	0
RFLOW-295	237	247	10	1	4	4	0	0
RFLOW-296	237	238	1	1	3	1	1	0
RFLOW-296	237	263	26	1	3	1	1	0
RFLOW-296	238	239	1	1	3	1	0	0
RFLOW-296	238	477	239	0	4	1	0	0
RFLOW-296	238	477	239	0	3	4	0	0
RFLOW-296	238	344	106	1	4	2	1	0
RFLOW-296	238	450	212	1	3	1	1	0
RFLOW-296	238	239	1	1	3	1	0	0
RFLOW-296	239	477	238	0	3	1	0	0
RFLOW-296	239	477	238	0	3	1	0	0
RFLOW-297	239	477	238	0	3	1	0	0
RFLOW-297	239	477	238	0	3	1	0	0
RFLOW-297	239	477	238	0	3	1	0	0
RFLOW-297	239	477	238	0	4	4	0	0
RFLOW-297	239	242	3	1	3	2	1	0
RFLOW-297	240	477	237	0	3	2	0	0
RFLOW-297	240	295	55	1	3	1	0	1
RFLOW-297	240	477	237	0	4	4	0	0
RFLOW-297	240	477	237	0	3	1	0	0
RFLOW-297	240	245	5	1	2	1	2	0
RFLOW-298	240	241	1	1	3	3	0	0
RFLOW-298	240	243	3	1	3	1	1	1
RFLOW-298	240	477	237	0	4	1	0	0
RFLOW-298	241	335	94	1	4	2	1	0
RFLOW-298	241	243	2	1	3	1	1	0
RFLOW-298	241	252	11	1	4	2	1	0
RFLOW-298	241	477	236	0	3	1	0	0
RFLOW-298	241	256	15	1	4	1	0	0
RFLOW-298	241	254	13	1	3	4	1	0
RFLOW-298	241	242	1	1	4	2	1	0
RFLOW-299	242	243	1	1	4	4	1	0
RFLOW-299	242	247	5	1	4	4	1	0
RFLOW-299	242	477	235	0	3	1	0	0
RFLOW-299	242	292	50	1	3	2	1	0
RFLOW-299	242	243	1	1	3	1	1	0
RFLOW-299	243	477	234	0	4	4	0	0
RFLOW-299	244	477	233	0	3	1	0	0
RFLOW-299	245	363	118	1	4	4	1	0
RFLOW-299	245	477	232	0	3	2	0	1
RFLOW-299	246	477	231	0	3	3	0	1
RFLOW-300	246	247	1	1	4	3	0	0
RFLOW-300	246	284	38	1	3	4	1	0
RFLOW-300	246	247	1	1	3	1	1	1
RFLOW-300	246	263	17	1	3	4	1	0
RFLOW-300	246	373	127	1	4	4	1	0
RFLOW-300	246	247	1	1	4	4	1	0
RFLOW-300	246	247	1	1	3	4	1	0
RFLOW-300	246	247	1	1	4	4	1	0
RFLOW-300	246	373	127	1	3	4	2	0
RFLOW-300	247	267	20	1	4	1	1	1
RFLOW-301	247	477	230	0	5	1	0	0
RFLOW-301	247	477	230	0	4	2	0	0
RFLOW-301	247	254	7	1	3	1	1	0
RFLOW-301	247	477	230	0	4	1	0	0
RFLOW-301	247	477	230	0	4	4	0	0
RFLOW-301	247	477	230	0	5	4	0	0
RFLOW-301	247	477	230	0	5	4	0	0
RFLOW-301	247	477	230	0	3	1	0	0
RFLOW-301	247	248	1	1	4	4	1	0
RFLOW-301	248	477	229	0	3	4	0	0
RFLOW-302	248	477	229	0	3	1	0	0
RFLOW-302	248	249	1	1	5	3	0	0
RFLOW-302	248	335	87	1	4	4	1	0
RFLOW-302	248	428	180	1	4	4	1	1
RFLOW-302	248	477	229	0	2	1	0	0
RFLOW-302	249	257	8	1	4	4	2	0
RFLOW-302	249	477	228	0	3	1	0	0
RFLOW-302	249	477	228	0	4	4	0	0
RFLOW-302	249	373	124	1	4	4	1	0
RFLOW-302	249	477	228	0	3	2	1	0
RFLOW-303	251	252	1	1	4	4	1	0
RFLOW-303	252	477	225	0	4	2	0	0
RFLOW-303	252	477	225	0	1	1	0	0
RFLOW-303	252	477	225	0	3	1	1	0
RFLOW-303	252	373	121	1	4	4	1	0
RFLOW-303	252	254	2	1	4	4	1	0
RFLOW-303	253	477	224	0	1	1	0	0
RFLOW-303	253	477	224	0	3	1	0	0
RFLOW-303	253	254	1	1	3	1	0	1
RFLOW-303	253	477	224	0	2	1	0	0
RFLOW-304	253	254	1	1	4	2	1	1
RFLOW-304	253	477	224	0	3	1	0	0
RFLOW-304	253	477	224	0	3	1	0	0
RFLOW-304	253	477	224	0	4	1	0	0
RFLOW-304	253	257	4	1	4	4	1	0
RFLOW-304	253	477	224	0	3	1	0	0
RFLOW-304	254	289	35	1	3	1	1	0
RFLOW-304	254	477	223	0	3	1	0	0
RFLOW-304	254	477	223	0	4	4	0	0
RFLOW-304	254	301	47	1	4	4	1	0
RFLOW-305	254	477	223	0	3	4	0	0
RFLOW-305	254	267	13	1	3	5	0	0
RFLOW-305	254	255	1	1	4	2	0	0
RFLOW-305	255	477	222	0	3	5	0	0
RFLOW-305	255	267	12	1	4	1	0	0
RFLOW-305	255	279	24	1	4	2	1	0
RFLOW-305	255	256	1	1	5	5	0	0
RFLOW-305	255	477	222	0	3	3	0	0
RFLOW-305	255	338	83	1	3	3	0	0
RFLOW-305	255	258	3	1	3	4	1	0
RFLOW-306	255	263	8	1	3	1	1	0
RFLOW-306	256	477	221	0	4	2	0	0
RFLOW-306	256	309	53	1	3	4	1	0
RFLOW-306	256	477	221	0	3	1	0	0
RFLOW-306	256	288	32	1	4	1	1	3
RFLOW-306	256	259	3	1	2	1	0	1
RFLOW-306	256	477	221	0	4	4	0	0
RFLOW-306	257	267	10	1	4	4	1	0
RFLOW-306	257	258	1	1	3	4	0	0
RFLOW-306	257	287	30	1	4	4	1	0
RFLOW-307	258	259	1	1	4	4	1	0
RFLOW-307	258	477	219	0	4	1	0	0
RFLOW-307	258	262	4	1	3	1	1	1
RFLOW-307	259	263	4	1	2	4	1	0
RFLOW-307	259	388	129	1	5	1	1	0
RFLOW-307	259	260	1	1	2	1	0	0
RFLOW-307	259	263	4	1	3	4	1	0
RFLOW-307	259	477	218	0	4	4	0	0
RFLOW-307	259	282	23	1	5	2	1	3
RFLOW-307	259	271	12	1	3	1	1	1
RFLOW-308	260	477	217	0	3	1	0	0
RFLOW-308	260	477	217	0	4	2	0	2
RFLOW-308	260	477	217	0	4	1	0	0
RFLOW-308	260	477	217	0	4	1	0	0
RFLOW-308	260	477	217	0	3	1	0	0
RFLOW-308	260	261	1	1	3	1	0	1
RFLOW-308	261	281	20	1	3	1	1	0
RFLOW-308	261	477	216	0	3	1	0	0
RFLOW-308	261	277	16	1	5	4	1	0
RFLOW-308	261	284	23	1	4	1	2	0
RFLOW-309	261	262	1	1	4	5	1	0
RFLOW-309	262	477	215	0	4	4	0	0
RFLOW-309	262	477	215	0	3	4	0	0
RFLOW-309	262	267	5	1	3	1	0	0
RFLOW-309	262	477	215	0	4	1	0	0
RFLOW-309	262	477	215	0	3	1	0	0
RFLOW-309	262	263	1	1	3	2	0	0
RFLOW-309	262	477	215	0	2	2	0	0
RFLOW-309	262	477	215	0	3	1	0	0
RFLOW-309	263	264	1	1	4	1	1	1
RFLOW-310	263	269	6	1	5	4	0	0
RFLOW-310	263	269	6	1	5	1	0	0
RFLOW-310	264	267	3	1	3	1	0	0
RFLOW-310	265	276	11	1	4	4	2	1
RFLOW-310	265	270	5	1	4	4	2	0
RFLOW-310	266	477	211	0	3	1	0	0
RFLOW-310	266	477	211	0	4	4	0	1
RFLOW-310	266	477	211	0	3	2	1	0
RFLOW-310	266	379	113	1	3	1	1	0
RFLOW-310	266	268	2	1	3	1	1	0
RFLOW-311	266	477	211	0	3	1	0	0
RFLOW-311	266	268	2	1	4	1	1	0
RFLOW-311	267	284	17	1	4	4	1	0
RFLOW-311	267	450	183	1	4	1	0	1
RFLOW-311	267	477	210	0	4	4	0	0
RFLOW-311	268	477	209	0	5	3	0	0
RFLOW-311	268	477	209	0	4	4	0	0
RFLOW-311	268	269	1	1	5	4	1	0
RFLOW-311	268	329	61	1	1	1	1	1
RFLOW-311	268	284	16	1	4	4	1	0
RFLOW-312	268	273	5	1	4	1	0	0
RFLOW-312	268	477	209	0	4	1	0	0
RFLOW-312	268	288	20	1	3	1	0	1
RFLOW-312	268	274	6	1	3	1	1	0
RFLOW-312	268	274	6	1	4	1	1	0
RFLOW-312	269	274	5	1	3	4	1	0
RFLOW-312	269	477	208	0	3	1	0	0
RFLOW-312	270	271	1	1	4	4	1	0
RFLOW-312	270	477	207	0	3	1	1	0
RFLOW-312	270	477	207	0	4	4	0	0
RFLOW-313	270	271	1	1	4	4	1	0
RFLOW-313	270	477	207	0	4	1	0	0
RFLOW-313	271	308	37	1	3	4	1	4
RFLOW-313	271	292	21	1	4	4	0	1
RFLOW-313	272	477	205	0	4	2	0	0
RFLOW-313	273	477	204	0	4	3	0	0
RFLOW-313	273	303	30	1	3	1	2	0
RFLOW-313	273	274	1	1	5	4	2	0
RFLOW-313	273	284	11	1	3	1	1	0
RFLOW-313	274	280	6	1	4	4	1	0
RFLOW-314	274	477	203	0	4	3	0	0
RFLOW-314	274	383	109	1	5	1	1	0
RFLOW-314	274	275	1	1	4	1	0	0
RFLOW-314	274	477	203	0	4	4	0	0
RFLOW-314	275	477	202	0	4	4	0	0
RFLOW-314	275	477	202	0	5	3	0	0
RFLOW-314	275	477	202	0	4	5	0	0
RFLOW-314	275	276	1	1	3	2	2	3
RFLOW-314	275	277	2	1	4	4	1	0
RFLOW-314	275	477	202	0	4	4	0	0
RFLOW-315	275	376	101	1	4	4	1	0
RFLOW-315	275	276	1	1	3	1	0	1
RFLOW-315	275	477	202	0	3	5	0	0
RFLOW-315	275	416	141	1	4	1	1	0
RFLOW-315	275	477	202	0	4	1	0	0
RFLOW-315	275	287	12	1	4	4	1	0
RFLOW-315	276	477	201	0	3	2	0	0
RFLOW-315	276	477	201	0	4	1	0	0
RFLOW-315	276	477	201	0	5	3	0	0
RFLOW-315	276	298	22	1	4	4	2	0
RFLOW-316	276	308	32	1	3	4	1	0
RFLOW-316	277	309	32	1	4	1	2	0
RFLOW-316	277	279	2	1	4	1	1	0
RFLOW-316	277	477	200	0	4	4	0	0
RFLOW-316	277	312	35	1	1	1	1	0
RFLOW-316	277	278	1	1	3	4	1	0
RFLOW-316	277	390	113	1	3	1	0	0
RFLOW-316	278	477	199	0	4	1	1	0
RFLOW-316	279	283	4	1	4	4	1	0
RFLOW-316	279	477	198	0	3	4	0	0
RFLOW-317	280	477	197	0	3	1	0	0
RFLOW-317	281	477	196	0	4	4	0	0
RFLOW-317	281	420	139	1	3	1	0	0
RFLOW-317	281	282	1	1	3	4	1	1
RFLOW-317	281	285	4	1	4	4	1	0
RFLOW-317	281	299	18	1	5	4	1	0
RFLOW-317	281	346	65	1	4	5	0	1
RFLOW-317	281	284	3	1	4	4	1	0
RFLOW-317	281	284	3	1	3	1	1	1
RFLOW-317	281	477	196	0	4	3	0	0
RFLOW-318	282	283	1	1	1	1	0	0
RFLOW-318	282	477	195	0	2	1	0	0
RFLOW-318	282	318	36	1	3	1	0	0
RFLOW-318	282	284	2	1	4	1	2	0
RFLOW-318	282	477	195	0	4	1	0	0
RFLOW-318	282	477	195	0	4	4	0	0
RFLOW-318	283	284	1	1	4	1	0	1
RFLOW-318	283	284	1	1	3	5	1	0
RFLOW-318	283	477	194	0	4	4	0	0
RFLOW-318	283	477	194	0	4	1	0	0
RFLOW-319	283	373	90	1	3	4	1	0
RFLOW-319	283	376	93	1	3	1	1	0
RFLOW-319	284	285	1	1	3	4	1	0
RFLOW-319	284	308	24	1	3	4	1	1
RFLOW-319	284	477	193	0	4	4	0	0
RFLOW-319	284	285	1	1	5	4	1	0
RFLOW-319	284	288	4	1	2	1	0	1
RFLOW-319	284	285	1	1	4	4	2	2
RFLOW-319	284	477	193	0	4	1	0	0
RFLOW-319	284	477	193	0	4	1	0	0
RFLOW-320	284	477	193	0	4	1	0	0
RFLOW-320	284	298	14	1	4	3	1	0
RFLOW-320	285	286	1	1	3	4	1	0
RFLOW-320	285	292	7	1	2	1	1	4
RFLOW-320	286	287	1	1	3	4	0	0
RFLOW-320	287	308	21	1	4	4	1	0
RFLOW-320	287	477	190	0	5	4	0	0
RFLOW-320	287	375	88	1	3	4	1	2
RFLOW-320	287	477	190	0	2	1	0	0
RFLOW-320	287	477	190	0	3	4	0	0
RFLOW-321	287	345	58	1	3	1	1	0
RFLOW-321	287	477	190	0	4	4	2	0
RFLOW-321	287	375	88	1	3	2	1	0
RFLOW-321	287	324	37	1	4	4	1	0
RFLOW-321	288	477	189	0	5	1	0	0
RFLOW-321	288	289	1	1	3	3	0	0
RFLOW-321	288	346	58	1	3	1	1	0
RFLOW-321	288	477	189	0	4	1	0	0
RFLOW-321	288	379	91	1	3	2	1	0
RFLOW-321	288	477	189	0	4	1	0	0
RFLOW-322	289	315	26	1	5	2	1	0
RFLOW-322	289	477	188	0	4	4	1	0
RFLOW-322	289	420	131	1	3	4	1	0
RFLOW-322	289	477	188	0	3	5	0	0
RFLOW-322	289	297	8	1	1	1	0	1
RFLOW-322	289	477	188	0	4	4	0	0
RFLOW-322	289	477	188	0	4	1	0	0
RFLOW-322	290	291	1	1	2	1	0	0
RFLOW-322	290	477	187	0	3	1	0	0
RFLOW-322	290	395	105	1	2	1	0	1
RFLOW-323	290	477	187	0	4	2	0	0
RFLOW-323	290	303	13	1	5	2	1	0
RFLOW-323	290	298	8	1	5	4	1	0
RFLOW-323	291	331	40	1	3	1	1	0
RFLOW-323	291	477	186	0	4	4	0	0
RFLOW-323	291	477	186	0	4	4	0	0
RFLOW-323	292	303	11	1	4	4	1	0
RFLOW-323	292	298	6	1	3	4	1	0
RFLOW-323	293	294	1	1	3	1	1	0
RFLOW-323	293	477	184	0	3	1	1	1
RFLOW-324	293	477	184	0	2	3	0	0
RFLOW-324	293	297	4	1	5	4	1	0
RFLOW-324	294	477	183	0	3	1	0	0
RFLOW-324	295	477	182	0	3	4	0	0
RFLOW-324	295	477	182	0	4	4	0	0
RFLOW-324	295	316	21	1	3	1	1	0
RFLOW-324	295	352	57	1	4	4	1	0
RFLOW-324	295	296	1	1	3	1	0	1
RFLOW-324	295	477	182	0	3	2	0	0
RFLOW-324	296	410	114	1	3	4	1	1
RFLOW-325	296	328	32	1	4	1	1	0
RFLOW-325	296	319	23	1	4	1	1	0
RFLOW-325	296	477	181	0	3	1	0	0
RFLOW-325	296	477	181	0	4	1	0	0
RFLOW-325	297	477	180	0	4	4	1	0
RFLOW-325	297	477	180	0	2	1	0	0
RFLOW-325	297	477	180	0	2	1	0	0
RFLOW-325	297	408	111	1	3	1	0	0
RFLOW-325	297	429	132	1	4	4	1	0
RFLOW-325	297	310	13	1	1	1	1	0
RFLOW-326	298	301	3	1	5	4	1	0
RFLOW-326	298	334	36	1	4	4	0	0
RFLOW-326	298	305	7	1	5	4	1	0
RFLOW-326	300	325	25	1	4	1	1	0
RFLOW-326	300	332	32	1	3	1	2	0
RFLOW-326	300	301	1	1	4	4	1	0
RFLOW-326	300	319	19	1	4	2	1	0
RFLOW-326	301	477	176	0	3	1	0	0
RFLOW-326	301	308	7	1	4	1	1	0
RFLOW-326	301	477	176	0	3	3	0	0
RFLOW-327	301	477	176	0	1	1	0	0
RFLOW-327	301	318	17	1	3	1	1	0
RFLOW-327	301	437	136	1	4	4	0	0
RFLOW-327	302	477	175	0	3	4	0	0
RFLOW-327	302	459	157	1	3	4	1	0
RFLOW-327	302	316	14	1	5	2	1	0
RFLOW-327	302	305	3	1	4	2	1	0
RFLOW-327	302	308	6	1	1	1	1	1
RFLOW-327	303	477	174	0	3	3	0	0
RFLOW-327	303	309	6	1	1	1	0	0
RFLOW-328	303	477	174	0	3	1	0	0
RFLOW-328	303	373	70	1	3	1	1	0
RFLOW-328	303	477	174	0	3	2	0	0
RFLOW-328	304	477	173	0	4	1	0	0
RFLOW-328	304	477	173	0	3	2	0	0
RFLOW-328	304	477	173	0	4	4	0	0
RFLOW-328	304	477	173	0	4	1	0	0
RFLOW-328	304	305	1	1	4	4	0	0
RFLOW-328	304	450	146	1	3	4	1	0
RFLOW-328	305	477	172	0	3	1	0	0
RFLOW-329	305	477	172	0	3	1	0	0
RFLOW-329	305	477	172	0	3	4	0	0
RFLOW-329	305	477	172	0	3	1	0	0
RFLOW-329	306	477	171	0	3	5	0	0
RFLOW-329	306	308	2	1	3	4	1	0
RFLOW-329	306	308	2	1	2	1	2	0
RFLOW-329	308	477	169	0	2	1	0	0
RFLOW-329	308	310	2	1	4	1	2	0
RFLOW-329	308	477	169	0	3	1	0	0
RFLOW-329	308	477	169	0	3	1	0	0
RFLOW-330	308	477	169	0	3	1	0	0
RFLOW-330	309	329	20	1	2	5	1	0
RFLOW-330	309	329	20	1	3	4	1	0
RFLOW-330	309	378	69	1	3	4	1	0
RFLOW-330	309	477	168	0	4	4	0	0
RFLOW-330	309	477	168	0	4	1	0	0
RFLOW-330	309	321	12	1	5	4	1	1
RFLOW-330	309	321	12	1	5	4	1	0
RFLOW-330	310	323	13	1	3	1	1	0
RFLOW-330	310	316	6	1	4	1	1	0
RFLOW-331	310	346	36	1	4	2	1	0
RFLOW-331	310	477	167	0	4	4	0	0
RFLOW-331	311	312	1	1	3	1	0	1
RFLOW-331	311	477	166	0	5	4	0	0
RFLOW-331	311	477	166	0	4	1	0	0
RFLOW-331	311	314	3	1	3	2	1	0
RFLOW-331	311	367	56	1	4	1	1	0
RFLOW-331	311	477	166	0	3	1	0	0
RFLOW-331	312	325	13	1	3	2	0	0
RFLOW-331	312	378	66	1	3	1	1	3
RFLOW-332	312	313	1	1	4	1	0	0
RFLOW-332	312	313	1	1	4	2	0	0
RFLOW-332	312	339	27	1	3	4	1	0
RFLOW-332	312	316	4	1	2	2	1	0
RFLOW-332	312	477	165	0	4	4	0	0
RFLOW-332	313	315	2	1	4	4	1	1
RFLOW-332	315	430	115	1	1	1	0	0
RFLOW-332	315	362	47	1	4	1	1	2
RFLOW-332	315	477	162	0	3	1	0	0
RFLOW-332	315	477	162	0	4	1	0	0
RFLOW-333	315	316	1	1	5	5	0	0
RFLOW-333	315	477	162	0	4	2	0	0
RFLOW-333	316	320	4	1	3	2	1	0
RFLOW-333	316	477	161	0	3	2	0	1
RFLOW-333	316	477	161	0	5	5	0	0
RFLOW-333	316	477	161	0	3	4	0	0
RFLOW-333	316	326	10	1	5	2	1	0
RFLOW-333	316	317	1	1	4	1	0	1
RFLOW-333	317	477	160	0	3	1	0	0
RFLOW-333	317	318	1	1	1	1	1	0
RFLOW-334	317	368	51	1	3	4	1	0
RFLOW-334	317	477	160	0	4	3	0	0
RFLOW-334	317	318	1	1	4	1	0	1
RFLOW-334	317	318	1	1	3	1	1	1
RFLOW-334	317	477	160	0	4	1	0	0
RFLOW-334	317	318	1	1	4	2	1	0
RFLOW-334	317	319	2	1	4	2	1	0
RFLOW-334	317	477	160	0	3	1	0	0
RFLOW-334	317	383	66	1	4	4	1	0
RFLOW-334	318	477	159	0	4	1	0	0
RFLOW-335	318	319	1	1	5	4	1	0
RFLOW-335	318	477	159	0	1	1	0	0
RFLOW-335	318	319	1	1	3	1	1	0
RFLOW-335	318	427	109	1	3	1	1	0
RFLOW-335	318	322	4	1	3	1	0	0
RFLOW-335	318	319	1	1	3	1	1	0
RFLOW-335	318	477	159	0	2	1	0	0
RFLOW-335	318	329	11	1	3	1	0	1
RFLOW-335	319	389	70	1	3	4	0	0
RFLOW-335	319	323	4	1	4	2	1	0
RFLOW-336	319	477	158	0	4	1	0	1
RFLOW-336	321	322	1	1	5	4	1	0
RFLOW-336	321	477	156	0	3	4	0	1
RFLOW-336	321	477	156	0	3	1	0	0
RFLOW-336	322	477	155	0	3	4	0	0
RFLOW-336	322	328	6	1	3	1	1	0
RFLOW-336	322	328	6	1	3	1	1	0
RFLOW-336	322	336	14	1	5	5	1	0
RFLOW-336	322	477	155	0	3	1	0	0
RFLOW-336	322	477	155	0	3	1	0	0
RFLOW-337	322	477	155	0	3	4	0	0
RFLOW-337	323	324	1	1	3	2	1	0
RFLOW-337	323	477	154	0	1	1	0	0
RFLOW-337	323	477	154	0	3	3	0	0
RFLOW-337	323	477	154	0	3	1	0	0
RFLOW-337	323	324	1	1	3	4	1	0
RFLOW-337	324	395	71	1	3	1	0	1
RFLOW-337	324	477	153	0	4	2	0	0
RFLOW-337	324	329	5	1	3	1	1	0
RFLOW-337	324	477	153	0	3	4	0	0
RFLOW-338	324	335	11	1	5	4	1	0
RFLOW-338	324	477	153	0	3	4	0	0
RFLOW-338	325	326	1	1	4	1	1	0
RFLOW-338	325	385	60	1	4	4	1	0
RFLOW-338	326	331	5	1	3	4	1	0
RFLOW-338	326	477	151	0	3	1	0	0
RFLOW-338	326	477	151	0	4	4	0	0
RFLOW-338	326	477	151	0	3	4	0	0
RFLOW-338	326	477	151	0	3	4	0	0
RFLOW-338	326	477	151	0	3	4	0	0
RFLOW-339	327	477	150	0	4	4	0	0
RFLOW-339	328	477	149	0	5	4	0	0
RFLOW-339	328	348	20	1	3	4	1	0
RFLOW-339	328	413	85	1	3	4	0	0
RFLOW-339	328	477	149	0	3	1	0	0
RFLOW-339	328	329	1	1	4	4	1	0
RFLOW-339	328	334	6	1	5	3	1	0
RFLOW-339	329	373	44	1	3	1	1	0
RFLOW-339	329	352	23	1	4	2	1	0
RFLOW-339	329	477	148	0	3	1	0	0
RFLOW-340	329	477	148	0	1	4	1	0
RFLOW-340	329	477	148	0	5	1	0	0
RFLOW-340	329	366	37	1	3	4	1	0
RFLOW-340	330	334	4	1	4	2	1	0
RFLOW-340	330	477	147	0	3	2	0	0
RFLOW-340	330	477	147	0	3	4	0	0
RFLOW-340	330	339	9	1	3	2	1	0
RFLOW-340	330	477	147	0	3	1	0	0
RFLOW-340	330	339	9	1	4	4	1	1
RFLOW-340	331	332	1	1	4	4	0	1
RFLOW-341	331	332	1	1	4	2	1	0
RFLOW-341	331	346	15	1	4	4	1	0
RFLOW-341	331	336	5	1	3	1	1	1
RFLOW-341	331	477	146	0	3	1	0	0
RFLOW-341	332	373	41	1	3	1	1	0
RFLOW-341	332	477	145	0	4	1	0	0
RFLOW-341	332	335	3	1	3	1	1	0
RFLOW-341	332	450	118	1	3	1	1	0
RFLOW-341	332	477	145	0	2	1	0	0
RFLOW-341	332	477	145	0	3	1	1	0
RFLOW-342	332	477	145	0	4	1	0	0
RFLOW-342	332	477	145	0	4	1	0	0
RFLOW-342	332	477	145	0	3	1	1	2
RFLOW-342	332	448	116	1	3	1	1	0
RFLOW-342	332	333	1	1	3	1	0	0
RFLOW-342	333	334	1	1	4	1	1	0
RFLOW-342	333	377	44	1	5	3	2	0
RFLOW-342	333	477	144	0	4	1	1	0
RFLOW-342	333	477	144	0	5	4	0	0
RFLOW-342	333	334	1	1	3	2	0	1
RFLOW-343	334	477	143	0	3	4	0	0
RFLOW-343	334	336	2	1	3	4	1	0
RFLOW-343	335	336	1	1	4	5	1	0
RFLOW-343	336	346	10	1	3	2	0	0
RFLOW-343	336	337	1	1	4	2	1	0
RFLOW-343	336	477	141	0	3	1	0	0
RFLOW-343	336	477	141	0	3	1	0	0
RFLOW-343	336	477	141	0	3	4	0	0
RFLOW-343	336	342	6	1	3	1	1	0
RFLOW-343	336	376	40	1	3	1	0	0
RFLOW-344	336	337	1	1	5	1	0	0
RFLOW-344	337	477	140	0	3	4	0	0
RFLOW-344	337	477	140	0	3	1	1	0
RFLOW-344	337	338	1	1	1	1	0	0
RFLOW-344	338	347	9	1	5	4	1	0
RFLOW-344	338	410	72	1	1	1	0	0
RFLOW-344	338	368	30	1	3	4	1	0
RFLOW-344	338	348	10	1	4	1	1	0
RFLOW-344	338	339	1	1	3	1	1	1
RFLOW-344	338	477	139	0	2	1	0	0
RFLOW-345	338	477	139	0	3	3	0	0
RFLOW-345	338	477	139	0	4	2	1	0
RFLOW-345	338	383	45	1	1	4	1	0
RFLOW-345	339	340	1	1	3	1	0	0
RFLOW-345	339	477	138	0	4	1	0	0
RFLOW-345	339	381	42	1	3	4	1	0
RFLOW-345	339	463	124	1	3	5	1	0
RFLOW-345	339	463	124	1	3	5	1	0
RFLOW-345	339	443	104	1	3	5	2	0
RFLOW-345	339	452	113	1	3	5	1	0
RFLOW-346	339	463	124	1	3	5	1	0
RFLOW-346	339	395	56	1	3	5	1	0
RFLOW-346	339	394	55	1	3	5	1	0
RFLOW-346	339	397	58	1	3	5	1	0
RFLOW-346	339	405	66	1	3	5	1	0
RFLOW-346	339	463	124	1	3	5	1	0
RFLOW-346	339	463	124	1	3	5	1	0
RFLOW-346	339	463	124	1	3	5	1	0
RFLOW-346	339	393	54	1	3	5	1	0
RFLOW-346	339	463	124	1	3	5	1	0
RFLOW-347	339	463	124	1	3	5	1	0
RFLOW-347	339	395	56	1	3	5	1	0
RFLOW-347	339	463	124	1	3	5	1	0
RFLOW-347	339	463	124	1	3	5	1	0
RFLOW-347	339	393	54	1	3	5	1	0
RFLOW-347	339	409	70	1	3	5	1	0
RFLOW-347	339	401	62	1	3	5	1	0
RFLOW-347	339	401	62	1	3	5	1	0
RFLOW-347	339	372	33	1	3	4	1	0
RFLOW-347	339	341	2	1	4	4	1	0
RFLOW-348	339	369	30	1	4	2	1	0
RFLOW-348	339	477	138	0	3	4	0	0
RFLOW-348	340	477	137	0	5	1	0	0
RFLOW-348	340	477	137	0	2	1	0	0
RFLOW-348	340	341	1	1	3	1	1	0
RFLOW-348	341	477	136	0	4	1	0	0
RFLOW-348	342	477	135	0	3	1	0	0
RFLOW-348	343	477	134	0	3	1	0	0
RFLOW-348	343	477	134	0	3	1	0	0
RFLOW-348	343	477	134	0	3	1	0	0
RFLOW-349	343	389	46	1	3	2	1	0
RFLOW-349	343	477	134	0	4	1	0	0
RFLOW-349	343	344	1	1	4	4	0	0
RFLOW-349	343	477	134	0	5	4	0	0
RFLOW-349	343	477	134	0	4	1	0	0
RFLOW-349	343	477	134	0	4	1	0	0
RFLOW-349	343	477	134	0	4	4	0	0
RFLOW-349	343	477	134	0	4	4	0	0
RFLOW-349	344	409	65	1	2	1	0	0
RFLOW-349	344	477	133	0	3	5	0	0
RFLOW-350	344	345	1	1	3	4	1	1
RFLOW-350	345	346	1	1	3	4	0	1
RFLOW-350	345	346	1	1	4	4	0	0
RFLOW-350	345	477	132	0	3	1	0	0
RFLOW-350	345	375	30	1	4	4	1	0
RFLOW-350	345	477	132	0	4	4	0	0
RFLOW-350	345	351	6	1	3	1	0	0
RFLOW-350	346	477	131	0	3	1	0	0
RFLOW-350	346	378	32	1	3	1	0	0
RFLOW-350	346	477	131	0	3	1	0	0
RFLOW-351	346	347	1	1	3	1	1	1
RFLOW-351	346	477	131	0	3	2	0	0
RFLOW-351	346	477	131	0	3	2	0	0
RFLOW-351	346	477	131	0	3	4	0	0
RFLOW-351	346	477	131	0	5	1	0	0
RFLOW-351	347	372	25	1	3	3	1	0
RFLOW-351	347	431	84	1	3	4	1	0
RFLOW-351	347	477	130	0	3	3	1	0
RFLOW-351	347	348	1	1	3	4	1	0
RFLOW-351	347	372	25	1	4	1	1	1
RFLOW-352	348	349	1	1	3	1	0	0
RFLOW-352	348	349	1	1	4	4	1	0
RFLOW-352	348	378	30	1	4	4	1	0
RFLOW-352	349	477	128	0	3	1	0	0
RFLOW-352	349	477	128	0	3	4	0	0
RFLOW-352	349	477	128	0	3	4	0	0
RFLOW-352	349	417	68	1	3	1	0	1
RFLOW-352	349	368	19	1	3	1	1	0
RFLOW-352	349	477	128	0	3	1	0	0
RFLOW-352	349	477	128	0	3	4	0	0
RFLOW-353	349	477	128	0	3	4	1	0
RFLOW-353	350	370	20	1	5	4	1	0
RFLOW-353	350	477	127	0	3	1	0	0
RFLOW-353	350	477	127	0	3	3	0	0
RFLOW-353	350	477	127	0	3	1	0	0
RFLOW-353	350	477	127	0	4	4	0	0
RFLOW-353	351	477	126	0	3	1	0	0
RFLOW-353	351	477	126	0	4	5	0	0
RFLOW-353	351	477	126	0	3	4	0	0
RFLOW-353	351	477	126	0	2	1	1	0
RFLOW-354	351	418	67	1	5	4	1	0
RFLOW-354	352	446	94	1	3	2	1	0
RFLOW-354	352	477	125	0	3	1	0	0
RFLOW-354	352	422	70	1	2	1	1	0
RFLOW-354	352	477	125	0	4	1	0	0
RFLOW-354	352	477	125	0	3	1	0	0
RFLOW-354	352	353	1	1	5	1	0	0
RFLOW-354	353	403	50	1	4	4	1	0
RFLOW-354	353	477	124	0	4	4	0	0
RFLOW-354	353	354	1	1	3	1	0	0
RFLOW-355	354	363	9	1	3	1	1	0
RFLOW-355	354	360	6	1	4	5	1	0
RFLOW-355	354	393	39	1	3	2	1	0
RFLOW-355	354	477	123	0	3	1	0	0
RFLOW-355	354	379	25	1	4	2	0	0
RFLOW-355	354	361	7	1	3	1	0	0
RFLOW-355	354	397	43	1	3	2	1	0
RFLOW-355	355	356	1	1	3	1	1	0
RFLOW-355	355	420	65	1	5	4	0	0
RFLOW-355	355	381	26	1	5	4	1	0
RFLOW-356	356	367	11	1	4	2	1	0
RFLOW-356	356	360	4	1	4	4	1	2
RFLOW-356	357	477	120	0	2	4	1	4
RFLOW-356	357	477	120	0	3	3	0	0
RFLOW-356	357	477	120	0	3	1	0	0
RFLOW-356	358	477	119	0	4	1	0	0
RFLOW-356	358	477	119	0	4	4	1	0
RFLOW-356	359	360	1	1	3	1	0	0
RFLOW-356	359	363	4	1	3	1	1	0
RFLOW-356	359	378	19	1	4	4	1	0
RFLOW-357	359	477	118	0	4	1	0	0
RFLOW-357	360	477	117	0	3	1	0	1
RFLOW-357	360	477	117	0	4	4	0	0
RFLOW-357	360	363	3	1	3	4	1	1
RFLOW-357	360	477	117	0	4	4	0	0
RFLOW-357	360	477	117	0	3	4	1	0
RFLOW-357	360	412	52	1	3	4	0	0
RFLOW-357	360	361	1	1	2	1	0	1
RFLOW-357	360	367	7	1	4	1	1	0
RFLOW-357	360	463	103	1	3	5	1	0
RFLOW-358	360	370	10	1	3	5	0	0
RFLOW-358	360	373	13	1	3	1	1	0
RFLOW-358	360	373	13	1	3	5	1	0
RFLOW-358	360	367	7	1	4	1	1	0
RFLOW-358	361	375	14	1	4	4	1	1
RFLOW-358	361	477	116	0	3	4	1	2
RFLOW-358	361	477	116	0	4	1	0	0
RFLOW-358	361	412	51	1	4	4	0	0
RFLOW-358	361	477	116	0	3	4	1	2
RFLOW-358	362	375	13	1	3	5	1	0
RFLOW-359	362	393	31	1	3	4	1	1
RFLOW-359	362	382	20	1	3	4	1	1
RFLOW-359	362	376	14	1	3	5	1	0
RFLOW-359	362	394	32	1	3	1	0	0
RFLOW-359	362	376	14	1	5	4	1	0
RFLOW-359	362	370	8	1	3	5	0	0
RFLOW-359	362	373	11	1	4	4	0	0
RFLOW-359	363	364	1	1	3	5	0	0
RFLOW-359	363	410	47	1	3	5	0	0
RFLOW-359	363	364	1	1	4	4	1	1
RFLOW-360	363	430	67	1	4	4	1	1
ATERASU-1	15	40	25	1	3	4	1	0
ATERASU-1	15	53	38	1	3	4	1	0
ATERASU-1	18	31	13	1	3	4	1	0
ATERASU-1	55	94	39	1	3	1	1	0
ATERASU-1	55	411	356	1	3	3	0	0
ATERASU-2	83	105	22	1	3	1	1	0
ATERASU-2	105	168	63	1	3	3	0	0
ATERASU-2	110	477	367	0	3	4	1	0
ATERASU-2	134	217	83	1	3	4	1	0
ATERASU-2	134	189	55	1	3	4	1	0
ATERASU-2	135	427	292	1	3	3	1	0
ATERASU-2	135	159	24	1	3	4	1	0
ATERASU-2	144	417	273	1	3	1	1	0
ATERASU-2	145	283	138	1	4	4	1	0
ATERASU-2	155	477	322	0	3	1	1	0
ATERASU-3	155	477	322	0	3	1	1	0
ATERASU-3	155	477	322	0	3	3	1	0
ATERASU-3	155	477	322	0	3	3	1	0
ATERASU-3	160	197	37	1	5	4	1	0
ATERASU-3	163	477	314	0	3	4	0	0
ATERASU-3	167	217	50	1	3	4	1	0
ATERASU-3	169	477	308	0	3	4	1	0
ATERASU-3	181	477	296	0	3	4	1	0
ATERASU-3	187	477	290	0	1	1	0	0
ATERASU-3	187	477	290	0	3	3	0	0
ATERASU-4	187	477	290	0	3	4	0	0
ATERASU-4	187	477	290	0	3	4	0	0
ATERASU-4	187	477	290	0	3	4	0	0
ATERASU-4	187	477	290	0	3	4	0	0
ATERASU-4	189	477	288	0	3	4	1	0
ATERASU-4	189	477	288	0	3	3	1	0
ATERASU-4	189	477	288	0	3	3	1	0
ATERASU-4	197	206	9	1	3	3	1	0
ATERASU-4	212	415	203	1	3	3	1	0
ATERASU-4	217	328	111	1	3	3	1	0
ATERASU-5	217	268	51	1	3	1	1	0
ATERASU-5	237	328	91	1	3	4	1	0
ATERASU-5	284	477	193	0	3	3	1	0
ATERASU-5	295	477	182	0	3	3	1	0
ATERASU-5	295	477	182	0	3	3	1	0
ATERASU-5	301	477	176	0	3	3	0	0
ATERASU-5	311	313	2	1	3	5	1	0
ATERASU-5	360	477	117	0	3	5	0	0
ATERASU-5	360	477	117	0	3	5	0	0
ATERASU-5	360	477	117	0	3	5	0	0
ATERASU-6	360	477	117	0	3	5	0	0
ATERASU-6	360	477	117	0	3	5	0	0
BARI-2271	1	410	409	1	3	1	1	0
BARI-2271	1	2	1	1	3	3	1	0
BARI-2271	1	15	14	1	2	1	1	0
BARI-2271	1	2	1	1	3	3	1	0
BARI-2271	1	191	190	1	3	1	0	0
BARI-2271	1	115	114	1	2	1	1	0
BARI-2271	1	2	1	1	2	3	0	0
BARI-2271	2	3	1	1	3	1	2	0
BARI-2271	2	3	1	1	3	1	2	0
BARI-2272	2	477	475	0	3	1	0	0
BARI-2272	2	477	475	0	2	3	1	0
BARI-2272	3	477	474	0	2	1	0	0
BARI-2272	3	115	112	1	1	1	1	0
BARI-2272	3	4	1	1	1	1	1	0
BARI-2272	3	17	14	1	2	3	1	1
BARI-2272	3	43	40	1	4	1	1	0
BARI-2272	3	477	474	0	2	1	0	0
BARI-2272	4	109	105	1	3	1	0	0
BARI-2272	4	477	473	0	3	1	0	0
BARI-2273	4	477	473	0	3	1	0	0
BARI-2273	4	8	4	1	3	4	1	0
BARI-2273	4	5	1	1	4	3	1	0
BARI-2273	4	5	1	1	3	1	1	0
BARI-2273	4	5	1	1	3	1	1	0
BARI-2273	4	5	1	1	3	1	1	0
BARI-2273	4	5	1	1	4	1	1	0
BARI-2273	4	5	1	1	3	3	1	0
BARI-2273	4	5	1	1	3	3	1	0
BARI-2273	4	8	4	1	3	3	1	0
BARI-2274	4	108	104	1	2	3	1	0
BARI-2274	4	5	1	1	3	3	1	0
BARI-2274	4	8	4	1	3	3	1	0
BARI-2274	4	477	473	0	3	3	1	0
BARI-2274	4	5	1	1	2	3	1	0
BARI-2274	4	451	447	1	2	5	1	0
BARI-2274	5	477	472	0	2	1	0	0
BARI-2274	7	477	470	0	3	1	1	0
BARI-2274	7	477	470	0	3	3	1	0
BARI-2274	8	9	1	1	3	3	0	0
BARI-2275	8	18	10	1	3	1	1	0
BARI-2275	8	35	27	1	3	1	1	1
BARI-2275	8	9	1	1	2	1	1	0
BARI-2275	8	21	13	1	2	3	1	0
BARI-2275	8	9	1	1	2	3	1	0
BARI-2275	8	70	62	1	3	4	1	0
BARI-2275	9	10	1	1	4	3	1	0
BARI-2275	9	10	1	1	3	3	1	0
BARI-2275	10	477	467	0	4	1	0	0
BARI-2275	10	32	22	1	3	1	1	0
BARI-2276	10	11	1	1	3	4	1	0
BARI-2276	10	477	467	0	4	1	0	0
BARI-2276	10	477	467	0	3	1	0	0
BARI-2276	10	11	1	1	3	3	1	0
BARI-2276	10	11	1	1	3	1	1	0
BARI-2276	10	477	467	0	3	1	0	0
BARI-2276	10	11	1	1	2	1	1	0
BARI-2276	10	15	5	1	3	1	1	0
BARI-2276	10	11	1	1	3	3	1	0
BARI-2276	10	12	2	1	3	3	0	0
BARI-2277	11	477	466	0	3	3	0	0
BARI-2277	11	12	1	1	3	1	2	0
BARI-2277	11	14	3	1	3	1	1	0
BARI-2277	11	477	466	0	3	1	0	0
BARI-2277	11	35	24	1	2	3	1	0
BARI-2277	11	14	3	1	1	1	1	0
BARI-2277	11	29	18	1	2	3	1	2
BARI-2277	12	477	465	0	3	1	0	0
BARI-2277	14	477	463	0	4	1	0	0
BARI-2277	14	15	1	1	1	1	2	0
BARI-2278	14	477	463	0	3	3	1	0
BARI-2278	14	60	46	1	3	4	1	0
BARI-2278	14	25	11	1	3	1	1	0
BARI-2278	14	15	1	1	2	1	1	0
BARI-2278	14	15	1	1	3	1	1	0
BARI-2278	14	16	2	1	3	1	1	0
BARI-2278	14	15	1	1	3	1	1	0
BARI-2278	14	290	276	1	3	4	1	0
BARI-2278	14	18	4	1	3	1	1	0
BARI-2278	14	18	4	1	3	1	1	0
BARI-2279	15	21	6	1	3	1	0	0
BARI-2279	15	29	14	1	2	3	1	2
BARI-2279	15	30	15	1	3	1	1	0
BARI-2279	15	16	1	1	3	1	1	0
BARI-2279	15	16	1	1	3	1	1	0
BARI-2279	15	18	3	1	3	1	1	0
BARI-2279	15	44	29	1	3	1	1	0
BARI-2279	15	23	8	1	2	3	1	1
BARI-2279	15	18	3	1	2	1	1	0
BARI-2279	16	25	9	1	3	4	1	0
BARI-2280	16	477	461	0	3	1	0	0
BARI-2280	16	477	461	0	3	1	1	0
BARI-2280	16	24	8	1	3	1	1	0
BARI-2280	16	67	51	1	2	3	1	3
BARI-2280	16	29	13	1	3	1	1	0
BARI-2280	16	24	8	1	2	1	2	0
BARI-2280	17	477	460	0	1	1	0	0
BARI-2280	17	44	27	1	3	1	1	0
BARI-2280	17	18	1	1	2	1	1	0
BARI-2280	17	44	27	1	3	1	1	0
BARI-2281	17	22	5	1	3	1	1	0
BARI-2281	17	21	4	1	3	1	1	0
BARI-2281	17	18	1	1	3	1	1	0
BARI-2281	18	21	3	1	3	1	1	1
BARI-2281	18	72	54	1	3	1	1	1
BARI-2281	18	24	6	1	3	1	1	0
BARI-2281	18	24	6	1	3	4	0	0
BARI-2281	18	24	6	1	2	3	1	0
BARI-2281	18	19	1	1	3	1	1	0
BARI-2281	18	71	53	1	3	1	0	0
BARI-2282	19	20	1	1	3	1	1	1
BARI-2282	20	477	457	0	3	1	0	0
BARI-2282	21	477	456	0	3	1	0	0
BARI-2282	21	477	456	0	3	1	0	0
BARI-2282	21	28	7	1	2	4	1	0
BARI-2282	21	72	51	1	3	3	1	0
BARI-2282	21	31	10	1	3	1	1	0
BARI-2282	22	126	104	1	3	1	1	0
BARI-2282	22	89	67	1	1	1	1	0
BARI-2282	22	477	455	0	4	1	0	0
BARI-2283	22	30	8	1	3	1	1	0
BARI-2283	22	477	455	0	3	1	0	0
BARI-2283	22	185	163	1	4	4	1	0
BARI-2283	22	36	14	1	3	1	3	0
BARI-2283	22	155	133	1	4	1	1	0
BARI-2283	22	33	11	1	3	3	1	0
BARI-2283	22	115	93	1	3	1	1	0
BARI-2283	22	477	455	0	4	1	1	0
BARI-2283	23	24	1	1	3	1	1	0
BARI-2283	23	477	454	0	3	1	0	0
BARI-2284	23	25	2	1	3	3	1	0
BARI-2284	23	30	7	1	3	1	1	0
BARI-2284	23	49	26	1	3	1	1	0
BARI-2284	23	25	2	1	3	1	1	0
BARI-2284	23	31	8	1	3	1	1	0
BARI-2284	24	28	4	1	3	3	1	0
BARI-2284	24	25	1	1	3	1	1	0
BARI-2284	24	28	4	1	2	4	1	0
BARI-2284	24	477	453	0	2	1	1	0
BARI-2284	25	477	452	0	4	1	0	0
BARI-2285	25	477	452	0	3	1	0	0
BARI-2285	25	26	1	1	3	1	1	0
BARI-2285	25	27	2	1	3	4	1	1
BARI-2285	25	107	82	1	3	1	1	0
BARI-2285	25	52	27	1	2	3	1	0
BARI-2285	25	28	3	1	3	3	1	0
BARI-2285	25	28	3	1	2	1	1	0
BARI-2285	25	26	1	1	3	1	1	0
BARI-2285	25	28	3	1	3	1	2	0
BARI-2285	26	477	451	0	3	1	0	0
BARI-2286	26	28	2	1	3	1	1	1
BARI-2286	27	28	1	1	3	1	1	0
BARI-2286	27	28	1	1	3	1	1	0
BARI-2286	28	477	449	0	2	4	1	0
BARI-2286	28	31	3	1	2	1	1	0
BARI-2286	28	29	1	1	2	1	0	0
BARI-2286	28	29	1	1	3	1	1	0
BARI-2286	28	29	1	1	3	1	1	0
BARI-2286	28	477	449	0	3	1	0	0
BARI-2286	28	29	1	1	3	1	1	0
BARI-2287	28	31	3	1	2	1	1	0
BARI-2287	28	36	8	1	3	3	1	0
BARI-2287	28	31	3	1	3	1	1	0
BARI-2287	28	31	3	1	2	1	1	0
BARI-2287	28	29	1	1	3	1	1	0
BARI-2287	28	179	151	1	3	3	1	0
BARI-2287	28	30	2	1	3	1	1	0
BARI-2287	29	37	8	1	1	1	2	0
BARI-2287	29	52	23	1	3	1	1	0
BARI-2287	29	30	1	1	2	1	2	0
BARI-2288	29	30	1	1	3	1	0	0
BARI-2288	29	31	2	1	2	1	1	0
BARI-2288	29	31	2	1	2	1	1	0
BARI-2288	29	52	23	1	3	1	1	0
BARI-2288	30	31	1	1	3	1	1	0
BARI-2288	30	32	2	1	2	1	1	1
BARI-2288	30	36	6	1	3	4	1	0
BARI-2288	30	477	447	0	3	1	0	0
BARI-2288	30	42	12	1	3	1	1	1
BARI-2288	30	32	2	1	2	1	1	1
BARI-2289	30	36	6	1	3	1	1	0
BARI-2289	30	44	14	1	3	1	1	0
BARI-2289	30	36	6	1	1	3	1	0
BARI-2289	31	477	446	0	2	1	1	0
BARI-2289	31	34	3	1	3	1	1	0
BARI-2289	31	42	11	1	3	1	0	0
BARI-2289	31	107	76	1	3	1	1	0
BARI-2289	31	71	40	1	3	1	2	0
BARI-2289	31	32	1	1	1	1	1	0
BARI-2289	31	40	9	1	3	1	1	0
BARI-2290	31	32	1	1	3	3	1	0
BARI-2290	31	36	5	1	3	1	1	0
BARI-2290	31	36	5	1	2	1	1	1
BARI-2290	31	36	5	1	3	1	1	0
BARI-2290	31	36	5	1	3	1	1	0
BARI-2290	32	35	3	1	2	1	1	1
BARI-2290	32	43	11	1	1	1	2	0
BARI-2290	32	60	28	1	3	1	1	0
BARI-2290	33	477	444	0	3	1	0	0
BARI-2290	35	36	1	1	3	3	1	0
BARI-2291	35	36	1	1	2	4	1	0
BARI-2291	35	36	1	1	3	3	1	0
BARI-2291	35	36	1	1	3	1	2	0
BARI-2291	35	36	1	1	3	4	1	0
BARI-2291	35	36	1	1	2	1	1	0
BARI-2291	35	36	1	1	3	1	1	0
BARI-2291	35	190	155	1	2	5	1	0
BARI-2291	35	36	1	1	3	1	1	0
BARI-2291	36	52	16	1	3	1	2	0
BARI-2291	36	477	441	0	3	1	0	0
BARI-2292	36	37	1	1	2	1	1	1
BARI-2292	36	37	1	1	3	1	1	0
BARI-2292	36	37	1	1	3	1	1	0
BARI-2292	36	44	8	1	3	3	1	0
BARI-2292	36	37	1	1	3	1	1	0
BARI-2292	36	60	24	1	3	1	1	0
BARI-2292	37	45	8	1	3	1	1	0
BARI-2292	37	44	7	1	1	1	1	0
BARI-2292	37	60	23	1	4	4	1	0
BARI-2292	37	38	1	1	3	3	1	0
BARI-2293	37	45	8	1	1	5	1	0
BARI-2293	37	45	8	1	2	3	1	0
BARI-2293	37	69	32	1	3	5	1	0
BARI-2293	37	38	1	1	3	3	1	0
BARI-2293	37	477	440	0	2	1	1	0
BARI-2293	37	39	2	1	3	1	1	0
BARI-2293	37	38	1	1	3	3	1	0
BARI-2293	37	63	26	1	3	3	1	0
BARI-2293	38	477	439	0	1	1	2	0
BARI-2293	38	39	1	1	3	1	1	0
BARI-2294	38	43	5	1	3	3	1	0
BARI-2294	38	64	26	1	3	1	1	0
BARI-2294	38	39	1	1	3	1	1	0
BARI-2294	38	477	439	0	3	1	0	0
BARI-2294	38	51	13	1	3	1	1	0
BARI-2294	38	64	26	1	2	1	1	0
BARI-2294	38	53	15	1	3	1	2	0
BARI-2294	38	67	29	1	3	1	0	0
BARI-2294	39	40	1	1	3	1	1	0
BARI-2294	39	260	221	1	3	1	1	2
BARI-2295	39	40	1	1	2	1	1	1
BARI-2295	39	221	182	1	3	1	2	0
BARI-2295	39	130	91	1	2	1	2	0
BARI-2295	39	42	3	1	3	1	1	0
BARI-2295	39	46	7	1	2	1	1	0
BARI-2295	39	45	6	1	3	1	1	0
BARI-2295	39	477	438	0	3	1	0	0
BARI-2295	39	71	32	1	3	1	1	0
BARI-2295	40	41	1	1	3	4	1	0
BARI-2295	41	43	2	1	3	1	1	0
BARI-2296	41	77	36	1	2	1	1	0
BARI-2296	42	43	1	1	3	3	1	0
BARI-2296	42	72	30	1	3	4	1	0
BARI-2296	42	477	435	0	4	5	0	0
BARI-2296	42	43	1	1	3	3	1	0
BARI-2296	42	477	435	0	3	1	0	0
BARI-2296	42	43	1	1	1	3	1	1
BARI-2296	42	43	1	1	3	1	1	0
BARI-2296	42	43	1	1	3	1	1	0
BARI-2296	43	71	28	1	3	1	1	0
BARI-2297	43	477	434	0	3	1	1	0
BARI-2297	43	52	9	1	2	1	1	0
BARI-2297	43	477	434	0	3	1	0	0
BARI-2297	43	44	1	1	1	1	1	0
BARI-2297	43	85	42	1	3	5	1	0
BARI-2297	43	44	1	1	3	3	1	0
BARI-2297	43	44	1	1	3	3	1	0
BARI-2297	43	44	1	1	3	1	1	0
BARI-2297	43	44	1	1	1	1	0	0
BARI-2297	43	52	9	1	2	1	1	1
BARI-2298	43	477	434	0	3	1	1	0
BARI-2298	44	67	23	1	2	3	1	2
BARI-2298	44	46	2	1	3	1	1	0
BARI-2298	44	45	1	1	1	1	0	0
BARI-2298	44	45	1	1	2	1	1	0
BARI-2298	44	45	1	1	3	3	1	0
BARI-2298	44	45	1	1	1	1	1	0
BARI-2298	44	50	6	1	3	1	0	1
BARI-2298	44	45	1	1	2	1	1	0
BARI-2298	44	477	433	0	3	1	1	0
BARI-2299	44	67	23	1	1	1	1	0
BARI-2299	44	45	1	1	3	1	0	0
BARI-2299	44	85	41	1	3	1	1	0
BARI-2299	44	45	1	1	3	1	1	0
BARI-2299	44	477	433	0	2	5	1	1
BARI-2299	44	45	1	1	2	3	1	0
BARI-2299	44	51	7	1	4	1	1	0
BARI-2299	44	71	27	1	3	1	1	0
BARI-2299	45	49	4	1	3	1	2	0
BARI-2299	45	60	15	1	3	1	1	1
BARI-2300	45	107	62	1	3	1	1	0
BARI-2300	45	46	1	1	3	3	1	0
BARI-2300	45	58	13	1	3	1	1	0
BARI-2300	45	46	1	1	3	3	1	0
BARI-2300	45	53	8	1	3	3	1	0
BARI-2300	45	190	145	1	3	1	1	0
BARI-2300	45	60	15	1	3	1	0	0
BARI-2300	45	56	11	1	3	1	1	0
BARI-2300	45	50	5	1	2	1	1	0
BARI-2300	45	171	126	1	1	5	0	2
BARI-2301	45	47	2	1	3	1	1	0
BARI-2301	46	116	70	1	3	1	1	0
BARI-2301	46	47	1	1	3	1	1	0
BARI-2301	46	47	1	1	3	1	1	0
BARI-2301	46	47	1	1	2	3	1	0
BARI-2301	46	47	1	1	2	1	0	0
BARI-2301	46	47	1	1	3	1	1	0
BARI-2301	49	50	1	1	3	1	1	0
BARI-2301	49	253	204	1	3	4	1	0
BARI-2301	49	50	1	1	3	1	1	0
BARI-2302	49	51	2	1	3	1	1	0
BARI-2302	49	72	23	1	4	1	1	0
BARI-2302	49	50	1	1	3	1	0	0
BARI-2302	49	68	19	1	3	1	2	0
BARI-2302	49	77	28	1	3	3	0	0
BARI-2302	49	51	2	1	3	3	1	0
BARI-2302	50	298	248	1	4	1	1	0
BARI-2302	50	51	1	1	3	1	1	0
BARI-2302	50	51	1	1	3	1	1	0
BARI-2302	50	51	1	1	2	1	1	0
BARI-2303	50	51	1	1	3	3	1	0
BARI-2303	50	51	1	1	2	1	1	0
BARI-2303	50	477	427	0	2	3	1	0
BARI-2303	50	52	2	1	2	3	0	1
BARI-2303	50	51	1	1	2	3	1	0
BARI-2303	50	51	1	1	3	1	2	1
BARI-2303	50	51	1	1	2	3	1	0
BARI-2303	51	67	16	1	3	1	1	0
BARI-2303	51	72	21	1	3	1	1	0
BARI-2303	51	52	1	1	2	1	1	0
BARI-2304	51	52	1	1	3	1	1	0
BARI-2304	51	52	1	1	2	1	1	0
BARI-2304	51	60	9	1	2	1	1	0
BARI-2304	51	56	5	1	2	1	1	0
BARI-2304	51	53	2	1	1	1	1	0
BARI-2304	52	53	1	1	2	1	1	0
BARI-2304	52	68	16	1	3	1	2	0
BARI-2304	52	477	425	0	3	1	0	0
BARI-2304	52	56	4	1	3	1	2	0
BARI-2304	52	53	1	1	3	1	1	0
BARI-2305	52	60	8	1	2	1	1	0
BARI-2305	52	60	8	1	2	1	1	0
BARI-2305	52	53	1	1	3	3	1	0
BARI-2305	52	53	1	1	3	3	1	0
BARI-2305	52	59	7	1	1	1	1	1
BARI-2305	52	65	13	1	2	1	1	0
BARI-2305	52	74	22	1	2	3	2	0
BARI-2305	52	457	405	1	3	1	0	0
BARI-2305	52	277	225	1	3	4	1	0
BARI-2305	53	64	11	1	3	1	1	0
BARI-2306	53	64	11	1	3	1	1	0
BARI-2306	53	64	11	1	3	1	1	0
BARI-2306	53	64	11	1	3	1	1	0
BARI-2306	53	54	1	1	3	1	1	0
BARI-2306	53	59	6	1	1	1	1	1
BARI-2306	53	59	6	1	2	1	1	1
BARI-2306	53	56	3	1	3	1	1	0
BARI-2306	53	59	6	1	1	1	1	1
BARI-2306	53	60	7	1	2	1	1	0
BARI-2306	53	58	5	1	1	1	1	0
BARI-2307	53	477	424	0	3	1	0	0
BARI-2307	53	54	1	1	3	1	1	0
BARI-2307	53	54	1	1	3	1	1	0
BARI-2307	53	67	14	1	3	1	1	0
BARI-2307	54	92	38	1	4	1	1	0
BARI-2307	54	205	151	1	3	1	1	0
BARI-2307	54	199	145	1	3	1	1	0
BARI-2307	54	249	195	1	3	1	1	0
BARI-2307	54	98	44	1	3	1	1	0
BARI-2307	54	203	149	1	3	1	1	0
BARI-2308	54	93	39	1	3	1	1	0
BARI-2308	56	57	1	1	2	1	1	0
BARI-2308	56	64	8	1	3	1	1	0
BARI-2308	56	232	176	1	2	1	1	0
BARI-2308	56	94	38	1	1	1	1	0
BARI-2308	56	59	3	1	3	3	1	0
BARI-2308	56	60	4	1	2	1	1	0
BARI-2308	56	64	8	1	3	1	1	0
BARI-2308	57	477	420	0	4	4	0	0
BARI-2308	57	64	7	1	3	3	1	0
BARI-2309	57	64	7	1	3	3	1	0
BARI-2309	57	115	58	1	2	1	1	0
BARI-2309	57	64	7	1	3	3	1	0
BARI-2309	57	59	2	1	1	1	1	1
BARI-2309	57	64	7	1	3	1	1	0
BARI-2309	57	477	420	0	3	1	0	0
BARI-2309	57	477	420	0	4	1	0	0
BARI-2309	57	79	22	1	3	1	1	0
BARI-2309	57	61	4	1	3	1	1	0
BARI-2309	57	68	11	1	3	1	1	0
BARI-2310	57	90	33	1	2	3	1	1
BARI-2310	57	64	7	1	3	1	1	0
BARI-2310	57	477	420	0	4	1	0	0
BARI-2310	58	66	8	1	3	1	1	0
BARI-2310	58	59	1	1	3	5	0	0
BARI-2310	58	107	49	1	3	1	1	0
BARI-2310	58	477	419	0	3	1	0	0
BARI-2310	58	59	1	1	1	3	1	1
BARI-2310	58	59	1	1	1	1	1	1
BARI-2310	58	59	1	1	1	1	1	1
BARI-2311	58	60	2	1	2	1	1	0
BARI-2311	58	59	1	1	3	3	1	0
BARI-2311	58	219	161	1	3	1	1	0
BARI-2311	58	64	6	1	2	1	1	0
BARI-2311	58	64	6	1	3	1	1	0
BARI-2311	59	60	1	1	3	1	1	0
BARI-2311	59	94	35	1	2	1	1	0
BARI-2311	59	60	1	1	1	1	1	0
BARI-2311	59	60	1	1	3	1	1	0
BARI-2311	59	190	131	1	3	1	1	0
BARI-2312	59	477	418	0	3	3	1	0
BARI-2312	59	60	1	1	3	1	1	0
BARI-2312	59	410	351	1	3	1	0	0
BARI-2312	59	70	11	1	1	1	1	4
BARI-2312	59	477	418	0	4	4	0	0
BARI-2312	59	60	1	1	3	3	1	0
BARI-2312	59	60	1	1	2	1	0	0
BARI-2312	59	60	1	1	2	1	1	0
BARI-2312	59	477	418	0	3	1	0	0
BARI-2312	59	68	9	1	2	1	1	1
BARI-2313	60	102	42	1	2	3	1	0
BARI-2313	60	63	3	1	2	1	1	0
BARI-2313	60	61	1	1	2	1	1	0
BARI-2313	60	477	417	0	3	1	1	0
BARI-2313	60	63	3	1	3	1	1	0
BARI-2313	60	61	1	1	2	1	2	0
BARI-2313	60	95	35	1	3	1	1	0
BARI-2313	60	63	3	1	2	1	1	0
BARI-2313	62	477	415	0	3	1	0	0
BARI-2313	63	64	1	1	1	1	1	1
BARI-2314	63	64	1	1	1	1	1	0
BARI-2314	63	70	7	1	1	1	1	2
BARI-2314	63	106	43	1	3	4	1	0
BARI-2314	63	67	4	1	1	1	1	0
BARI-2314	63	64	1	1	3	3	2	0
BARI-2314	63	64	1	1	3	1	1	1
BARI-2314	63	64	1	1	2	1	1	0
BARI-2314	63	64	1	1	2	3	1	0
BARI-2314	64	477	413	0	4	4	0	0
BARI-2314	64	71	7	1	3	1	1	0
BARI-2315	64	72	8	1	2	1	2	0
BARI-2315	64	275	211	1	3	3	1	0
BARI-2315	64	65	1	1	4	1	1	0
BARI-2315	64	70	6	1	2	1	1	0
BARI-2315	64	477	413	0	3	2	0	0
BARI-2315	64	67	3	1	3	1	1	0
BARI-2315	64	67	3	1	2	3	1	0
BARI-2315	64	65	1	1	4	1	1	0
BARI-2315	64	477	413	0	2	1	1	0
BARI-2315	64	477	413	0	2	1	1	0
BARI-2316	64	66	2	1	3	3	1	0
BARI-2316	64	71	7	1	1	1	1	0
BARI-2316	65	66	1	1	3	1	1	0
BARI-2316	65	66	1	1	1	1	1	0
BARI-2316	65	67	2	1	2	1	1	0
BARI-2316	65	71	6	1	2	1	1	0
BARI-2316	65	69	4	1	3	3	1	0
BARI-2316	65	66	1	1	2	1	1	0
BARI-2316	65	477	412	0	3	2	0	0
BARI-2316	65	66	1	1	2	3	1	0
BARI-2317	65	66	1	1	3	1	1	0
BARI-2317	65	70	5	1	1	1	1	0
BARI-2317	65	66	1	1	2	1	1	0
BARI-2317	65	66	1	1	3	1	1	0
BARI-2317	65	66	1	1	2	1	1	0
BARI-2317	65	66	1	1	2	1	1	0
BARI-2317	66	67	1	1	3	3	1	0
BARI-2317	66	477	411	0	3	1	1	0
BARI-2317	66	175	109	1	3	1	1	0
BARI-2317	66	163	97	1	3	1	0	0
BARI-2318	66	67	1	1	2	1	1	0
BARI-2318	66	74	8	1	2	1	1	0
BARI-2318	66	70	4	1	3	1	1	0
BARI-2318	66	67	1	1	3	1	1	0
BARI-2318	67	68	1	1	3	1	1	0
BARI-2318	67	70	3	1	1	1	1	0
BARI-2318	67	477	410	0	3	1	0	0
BARI-2318	67	71	4	1	3	1	1	0
BARI-2318	67	70	3	1	2	1	1	0
BARI-2318	67	72	5	1	2	1	1	0
BARI-2319	67	386	319	1	3	4	1	0
BARI-2319	67	116	49	1	3	1	1	0
BARI-2319	67	68	1	1	3	1	2	0
BARI-2319	67	477	410	0	3	1	0	0
BARI-2319	67	68	1	1	2	1	1	0
BARI-2319	67	68	1	1	3	1	1	0
BARI-2319	67	477	410	0	3	1	0	0
BARI-2319	68	84	16	1	3	1	1	0
BARI-2319	68	279	211	1	3	1	1	0
BARI-2319	70	72	2	1	3	1	1	0
BARI-2320	70	72	2	1	3	1	1	0
BARI-2320	70	92	22	1	3	3	1	1
BARI-2320	70	77	7	1	2	1	1	0
BARI-2320	70	477	407	0	3	1	1	0
BARI-2320	70	71	1	1	1	1	1	0
BARI-2320	70	73	3	1	2	3	1	0
BARI-2320	70	74	4	1	2	3	1	0
BARI-2320	70	94	24	1	3	1	1	0
BARI-2320	70	71	1	1	2	3	1	0
BARI-2320	70	86	16	1	3	1	1	0
BARI-2321	70	71	1	1	3	1	1	0
BARI-2321	70	107	37	1	3	1	1	0
BARI-2321	70	90	20	1	2	3	1	3
BARI-2321	70	78	8	1	2	3	1	0
BARI-2321	70	73	3	1	3	1	1	0
BARI-2321	70	71	1	1	3	1	1	0
BARI-2321	71	72	1	1	3	1	1	0
BARI-2321	71	477	406	0	1	1	1	0
BARI-2321	71	72	1	1	3	1	1	0
BARI-2321	71	72	1	1	3	3	1	0
BARI-2322	71	77	6	1	3	1	1	0
BARI-2322	71	72	1	1	3	1	1	0
BARI-2322	71	107	36	1	3	1	1	0
BARI-2322	71	74	3	1	3	1	1	0
BARI-2322	71	72	1	1	2	1	1	0
BARI-2322	71	74	3	1	1	1	0	0
BARI-2322	71	72	1	1	3	1	1	0
BARI-2322	72	74	2	1	3	1	1	0
BARI-2322	72	477	405	0	1	1	0	1
BARI-2322	72	477	405	0	1	1	0	1
BARI-2323	72	79	7	1	3	1	0	0
BARI-2323	72	477	405	0	3	1	1	0
BARI-2323	72	75	3	1	4	1	1	0
BARI-2323	72	85	13	1	2	1	1	0
BARI-2323	72	74	2	1	1	1	1	0
BARI-2323	72	73	1	1	1	1	1	0
BARI-2323	72	73	1	1	1	1	1	0
BARI-2323	72	477	405	0	4	5	0	0
BARI-2323	72	73	1	1	3	1	1	0
BARI-2324	72	94	22	1	1	3	0	0
BARI-2324	72	86	14	1	3	3	1	0
BARI-2324	73	477	404	0	3	4	0	0
BARI-2324	73	81	8	1	3	1	1	0
BARI-2324	73	220	147	1	3	1	1	0
BARI-2324	73	74	1	1	1	1	1	0
BARI-2324	73	101	28	1	2	3	1	0
BARI-2324	73	77	4	1	1	1	1	0
BARI-2324	73	477	404	0	3	3	1	0
BARI-2324	73	477	404	0	3	2	1	0
BARI-2325	73	74	1	1	2	1	1	0
BARI-2325	73	100	27	1	3	1	1	0
BARI-2325	73	75	2	1	2	3	1	0
BARI-2325	73	190	117	1	3	5	1	0
BARI-2325	73	74	1	1	3	1	1	0
BARI-2325	73	93	20	1	3	1	1	0
BARI-2325	74	477	403	0	3	1	0	0
BARI-2325	74	78	4	1	3	1	1	0
BARI-2325	74	78	4	1	3	1	1	0
BARI-2325	74	87	13	1	1	1	1	0
BARI-2326	74	75	1	1	2	1	1	0
BARI-2326	74	85	11	1	3	1	1	0
BARI-2326	74	77	3	1	3	3	1	0
BARI-2326	74	100	26	1	1	1	1	0
BARI-2326	74	75	1	1	3	3	1	0
BARI-2326	74	75	1	1	1	3	1	0
BARI-2326	74	77	3	1	1	1	1	0
BARI-2326	74	77	3	1	1	1	1	0
BARI-2326	74	100	26	1	3	1	1	0
BARI-2326	74	100	26	1	3	1	1	0
BARI-2327	74	75	1	1	3	1	2	1
BARI-2327	74	75	1	1	3	3	1	0
BARI-2327	74	232	158	1	3	1	1	0
BARI-2327	74	232	158	1	3	1	1	1
BARI-2327	75	76	1	1	1	1	1	0
BARI-2327	76	477	401	0	4	4	1	0
BARI-2327	76	79	3	1	3	3	1	0
BARI-2327	77	78	1	1	1	3	1	0
BARI-2327	77	80	3	1	4	1	0	0
BARI-2327	77	93	16	1	3	3	1	3
BARI-2328	77	78	1	1	1	1	1	0
BARI-2328	77	87	10	1	3	1	1	0
BARI-2328	77	82	5	1	4	1	1	0
BARI-2328	77	93	16	1	1	1	2	0
BARI-2328	77	79	2	1	3	1	1	1
BARI-2328	77	477	400	0	3	4	0	0
BARI-2328	77	477	400	0	3	1	1	0
BARI-2328	77	477	400	0	4	1	0	0
BARI-2328	77	477	400	0	4	1	0	0
BARI-2328	77	84	7	1	3	3	1	0
BARI-2329	77	477	400	0	3	1	0	0
BARI-2329	77	477	400	0	3	1	0	0
BARI-2329	78	79	1	1	1	1	1	1
BARI-2329	78	79	1	1	3	1	1	0
BARI-2329	78	105	27	1	3	1	2	0
BARI-2329	78	79	1	1	3	1	1	0
BARI-2329	78	79	1	1	3	1	1	0
BARI-2329	78	79	1	1	3	1	1	0
BARI-2329	78	220	142	1	3	1	1	0
BARI-2329	78	190	112	1	3	1	1	0
BARI-2330	78	80	2	1	3	1	1	0
BARI-2330	78	80	2	1	3	1	1	0
BARI-2330	78	80	2	1	1	1	1	0
BARI-2330	78	79	1	1	3	1	1	0
BARI-2330	78	85	7	1	2	3	1	0
BARI-2330	78	107	29	1	3	1	1	0
BARI-2330	78	155	77	1	1	1	1	0
BARI-2330	79	80	1	1	3	1	1	0
BARI-2330	79	115	36	1	1	3	1	0
BARI-2330	79	85	6	1	2	1	1	0
BARI-2331	79	82	3	1	3	3	1	0
BARI-2331	79	86	7	1	3	3	1	0
BARI-2331	79	85	6	1	1	1	2	0
BARI-2331	79	85	6	1	1	1	1	0
BARI-2331	79	86	7	1	2	1	1	0
BARI-2331	79	87	8	1	4	1	1	0
BARI-2331	79	80	1	1	3	1	1	0
BARI-2331	79	477	398	0	2	5	1	1
BARI-2331	79	92	13	1	2	3	1	0
BARI-2331	79	477	398	0	3	1	1	0
BARI-2332	79	477	398	0	3	4	0	0
BARI-2332	80	81	1	1	3	1	1	0
BARI-2332	80	86	6	1	3	1	1	0
BARI-2332	80	107	27	1	3	1	1	0
BARI-2332	80	81	1	1	2	1	1	0
BARI-2332	80	477	397	0	4	1	0	0
BARI-2332	80	84	4	1	3	4	1	0
BARI-2332	80	477	397	0	3	1	1	0
BARI-2332	80	477	397	0	3	5	1	0
BARI-2332	80	87	7	1	2	3	1	0
BARI-2333	80	107	27	1	3	1	1	0
BARI-2333	80	85	5	1	3	1	1	0
BARI-2333	81	89	8	1	3	3	1	0
BARI-2333	81	477	396	0	3	3	0	0
BARI-2333	81	86	5	1	2	1	1	0
BARI-2333	81	84	3	1	1	1	1	0
BARI-2333	81	336	255	1	3	1	1	0
BARI-2333	81	107	26	1	3	1	1	0
BARI-2333	81	86	5	1	3	1	1	0
BARI-2333	81	477	396	0	3	1	0	0
BARI-2334	81	477	396	0	3	1	0	0
BARI-2334	81	477	396	0	3	4	1	0
BARI-2334	81	87	6	1	3	1	1	1
BARI-2334	81	100	19	1	1	1	1	0
BARI-2334	81	477	396	0	3	1	0	0
BARI-2334	81	87	6	1	3	3	1	0
BARI-2334	81	95	14	1	2	1	1	0
BARI-2334	81	477	396	0	3	1	0	0
BARI-2334	81	87	6	1	3	4	1	0
BARI-2334	81	85	4	1	3	3	1	0
BARI-2335	81	477	396	0	3	1	1	0
BARI-2335	82	86	4	1	3	1	1	0
BARI-2335	82	85	3	1	3	1	1	0
BARI-2335	82	477	395	0	3	3	0	0
BARI-2335	83	87	4	1	3	3	1	0
BARI-2335	84	477	393	0	3	1	0	0
BARI-2335	84	477	393	0	3	5	0	0
BARI-2335	84	93	9	1	4	3	1	0
BARI-2335	84	87	3	1	3	3	1	0
BARI-2335	84	107	23	1	3	1	1	0
BARI-2336	84	477	393	0	3	1	0	0
BARI-2336	84	93	9	1	3	3	1	1
BARI-2336	84	87	3	1	3	1	1	0
BARI-2336	84	86	2	1	3	1	1	0
BARI-2336	84	85	1	1	3	1	1	0
BARI-2336	84	87	3	1	3	1	1	0
BARI-2336	84	86	2	1	2	3	1	0
BARI-2336	85	477	392	0	3	1	0	0
BARI-2336	85	477	392	0	3	1	1	0
BARI-2336	85	86	1	1	2	1	1	0
BARI-2337	85	114	29	1	1	1	1	1
BARI-2337	85	87	2	1	3	1	1	0
BARI-2337	85	86	1	1	3	1	1	0
BARI-2337	85	107	22	1	3	1	1	0
BARI-2337	85	87	2	1	2	1	1	0
BARI-2337	85	477	392	0	3	3	1	0
BARI-2337	85	86	1	1	3	1	1	0
BARI-2337	85	477	392	0	3	1	0	0
BARI-2337	85	95	10	1	2	1	1	0
BARI-2337	85	93	8	1	3	1	1	0
BARI-2338	85	86	1	1	3	1	1	0
BARI-2338	85	477	392	0	3	1	1	0
BARI-2338	85	119	34	1	4	1	1	0
BARI-2338	85	477	392	0	3	1	1	0
BARI-2338	86	87	1	1	2	1	1	0
BARI-2338	86	87	1	1	3	1	1	1
BARI-2338	86	87	1	1	3	1	0	0
BARI-2338	86	477	391	0	3	4	0	0
BARI-2338	86	477	391	0	3	1	1	1
BARI-2338	86	87	1	1	3	4	1	0
BARI-2339	86	94	8	1	3	3	1	0
BARI-2339	86	87	1	1	2	3	1	0
BARI-2339	86	87	1	1	3	1	1	0
BARI-2339	86	91	5	1	2	1	1	0
BARI-2339	86	87	1	1	3	1	1	0
BARI-2339	86	87	1	1	3	1	1	0
BARI-2339	86	477	391	0	3	1	0	0
BARI-2339	86	87	1	1	2	1	1	0
BARI-2339	87	88	1	1	1	1	1	0
BARI-2339	87	190	103	1	3	1	1	0
BARI-2340	87	88	1	1	3	4	1	0
BARI-2340	87	92	5	1	1	1	1	0
BARI-2340	87	88	1	1	3	1	1	0
BARI-2340	87	190	103	1	2	1	1	0
BARI-2340	87	88	1	1	2	1	1	0
BARI-2340	87	95	8	1	1	1	1	0
BARI-2340	87	88	1	1	1	1	1	0
BARI-2340	87	92	5	1	3	1	1	0
BARI-2340	87	93	6	1	3	1	1	0
BARI-2340	88	190	102	1	1	1	1	0
BARI-2341	88	477	389	0	1	1	0	0
BARI-2341	88	95	7	1	2	1	1	0
BARI-2341	88	107	19	1	3	1	1	0
BARI-2341	88	477	389	0	3	1	0	0
BARI-2341	88	477	389	0	3	1	0	0
BARI-2341	88	106	18	1	3	1	1	0
BARI-2341	88	95	7	1	4	1	1	0
BARI-2341	88	91	3	1	1	3	1	0
BARI-2341	88	94	6	1	1	1	1	1
BARI-2341	89	477	388	0	2	1	1	0
BARI-2342	89	93	4	1	3	1	1	0
BARI-2342	90	91	1	1	3	1	1	0
BARI-2342	91	99	8	1	3	3	1	0
BARI-2342	91	99	8	1	3	1	1	0
BARI-2342	91	92	1	1	2	1	1	0
BARI-2342	91	100	9	1	3	1	1	0
BARI-2342	91	92	1	1	3	1	1	0
BARI-2342	91	94	3	1	2	1	1	0
BARI-2342	92	93	1	1	3	1	1	0
BARI-2342	92	94	2	1	1	1	1	0
BARI-2343	92	93	1	1	1	1	1	0
BARI-2343	92	101	9	1	2	1	1	0
BARI-2343	92	99	7	1	3	1	1	0
BARI-2343	92	93	1	1	3	3	1	0
BARI-2343	92	107	15	1	3	1	1	0
BARI-2343	92	100	8	1	3	1	1	0
BARI-2343	92	98	6	1	3	3	1	1
BARI-2343	92	93	1	1	3	1	1	0
BARI-2343	92	106	14	1	1	1	1	0
BARI-2343	92	94	2	1	3	1	1	0
BARI-2344	92	93	1	1	2	1	1	0
BARI-2344	92	93	1	1	3	3	0	0
BARI-2344	92	94	2	1	3	1	1	0
BARI-2344	92	477	385	0	3	1	0	0
BARI-2344	93	381	288	1	2	3	1	0
BARI-2344	93	115	22	1	2	1	1	0
BARI-2344	93	94	1	1	3	1	1	0
BARI-2344	93	106	13	1	3	4	1	0
BARI-2344	93	477	384	0	3	1	0	0
BARI-2344	93	99	6	1	1	3	1	0
BARI-2345	93	94	1	1	1	1	1	0
BARI-2345	93	94	1	1	3	1	1	0
BARI-2345	93	95	2	1	3	3	1	3
BARI-2345	93	94	1	1	3	3	1	3
BARI-2345	93	114	21	1	3	3	1	1
BARI-2345	93	96	3	1	4	4	1	0
BARI-2345	93	368	275	1	3	1	1	0
BARI-2345	93	99	6	1	3	1	2	0
BARI-2345	93	477	384	0	3	3	1	0
BARI-2345	93	106	13	1	3	4	1	0
BARI-2346	93	99	6	1	2	1	1	0
BARI-2346	93	94	1	1	3	1	1	0
BARI-2346	93	94	1	1	3	1	1	0
BARI-2346	93	95	2	1	1	1	1	0
BARI-2346	93	190	97	1	3	1	1	0
BARI-2346	93	477	384	0	3	1	0	0
BARI-2346	93	334	241	1	2	5	1	0
BARI-2346	93	95	2	1	1	1	1	0
BARI-2346	93	232	139	1	3	1	1	1
BARI-2346	94	477	383	0	3	1	0	0
BARI-2347	94	107	13	1	3	1	0	0
BARI-2347	94	95	1	1	1	1	1	0
BARI-2347	94	95	1	1	2	1	1	0
BARI-2347	94	99	5	1	1	1	1	0
BARI-2347	94	95	1	1	3	1	1	0
BARI-2347	94	95	1	1	3	1	1	0
BARI-2347	94	477	383	0	2	1	1	0
BARI-2347	94	95	1	1	3	3	1	0
BARI-2347	94	317	223	1	3	1	1	0
BARI-2347	94	95	1	1	3	1	1	0
BARI-2348	94	96	2	1	3	4	1	0
BARI-2348	94	99	5	1	3	1	0	0
BARI-2348	94	95	1	1	2	1	1	0
BARI-2348	94	99	5	1	3	1	1	0
BARI-2348	94	95	1	1	4	3	1	0
BARI-2348	94	95	1	1	4	3	1	0
BARI-2348	95	100	5	1	3	3	1	0
BARI-2348	95	99	4	1	3	1	1	0
BARI-2348	95	477	382	0	4	5	0	0
BARI-2348	95	477	382	0	1	1	0	0
BARI-2349	95	107	12	1	3	1	1	0
BARI-2349	95	129	34	1	2	1	1	0
BARI-2349	95	96	1	1	2	1	1	0
BARI-2349	95	133	38	1	1	1	1	0
BARI-2349	95	96	1	1	1	1	1	0
BARI-2349	95	96	1	1	3	1	1	0
BARI-2349	95	96	1	1	2	1	1	0
BARI-2349	95	96	1	1	1	1	1	0
BARI-2349	95	96	1	1	2	1	1	0
BARI-2349	95	96	1	1	3	1	1	0
BARI-2350	95	100	5	1	2	1	1	0
BARI-2350	95	96	1	1	2	1	1	0
BARI-2350	95	107	12	1	3	1	1	0
BARI-2350	95	477	382	0	1	1	1	0
BARI-2350	95	98	3	1	1	1	1	0
BARI-2350	95	98	3	1	2	1	1	0
BARI-2350	95	99	4	1	3	1	1	0
BARI-2350	95	96	1	1	2	1	1	0
BARI-2350	95	119	24	1	3	1	1	0
BARI-2350	95	102	7	1	2	1	1	0
BARI-2351	96	108	12	1	3	1	0	0
BARI-2351	96	107	11	1	3	1	1	0
BARI-2351	98	101	3	1	3	3	1	0
BARI-2351	98	99	1	1	3	1	1	0
BARI-2351	98	101	3	1	3	3	1	0
BARI-2351	98	109	11	1	3	1	1	0
BARI-2351	98	99	1	1	3	1	1	0
BARI-2351	98	99	1	1	3	1	0	0
BARI-2351	98	100	2	1	3	1	1	0
BARI-2351	98	99	1	1	3	3	1	0
BARI-2352	98	99	1	1	2	1	1	0
BARI-2352	98	99	1	1	3	1	1	0
BARI-2352	99	190	91	1	3	1	1	0
BARI-2352	99	100	1	1	3	1	1	0
BARI-2352	99	167	68	1	3	1	1	0
BARI-2352	99	101	2	1	3	1	1	0
BARI-2352	99	104	5	1	1	1	1	0
BARI-2352	99	101	2	1	2	1	1	0
BARI-2352	99	105	6	1	2	4	1	0
BARI-2352	99	102	3	1	3	1	1	0
BARI-2353	99	119	20	1	3	3	1	0
BARI-2353	99	100	1	1	3	4	1	0
BARI-2353	99	100	1	1	1	1	1	0
BARI-2353	100	101	1	1	2	1	0	0
BARI-2353	100	101	1	1	3	1	1	0
BARI-2353	100	105	5	1	3	1	1	0
BARI-2353	100	107	7	1	3	1	1	0
BARI-2353	100	105	5	1	3	1	1	0
BARI-2353	100	105	5	1	1	1	1	0
BARI-2353	100	102	2	1	2	1	1	1
BARI-2354	100	477	377	0	4	4	0	0
BARI-2354	100	101	1	1	1	1	1	0
BARI-2354	100	101	1	1	2	1	1	0
BARI-2354	100	101	1	1	3	3	1	0
BARI-2354	100	101	1	1	2	1	1	0
BARI-2354	100	106	6	1	1	1	1	0
BARI-2354	100	477	377	0	3	1	0	0
BARI-2354	100	477	377	0	3	1	1	0
BARI-2354	100	128	28	1	3	1	1	0
BARI-2354	100	105	5	1	2	1	1	0
BARI-2355	100	101	1	1	2	1	1	0
BARI-2355	100	101	1	1	3	1	1	0
BARI-2355	100	106	6	1	3	1	1	0
BARI-2355	101	109	8	1	1	1	1	0
BARI-2355	101	102	1	1	2	1	1	0
BARI-2355	101	106	5	1	3	4	1	0
BARI-2355	101	102	1	1	3	1	1	0
BARI-2355	101	102	1	1	1	1	1	0
BARI-2355	101	477	376	0	3	4	1	0
BARI-2355	101	149	48	1	1	1	1	0
BARI-2356	101	107	6	1	3	1	1	0
BARI-2356	101	102	1	1	3	1	1	0
BARI-2356	101	123	22	1	3	1	0	0
BARI-2356	101	105	4	1	2	1	1	0
BARI-2356	101	176	75	1	1	1	0	0
BARI-2356	101	123	22	1	1	1	1	0
BARI-2356	101	102	1	1	3	1	1	0
BARI-2356	101	105	4	1	2	1	1	0
BARI-2356	101	102	1	1	2	1	1	1
BARI-2356	101	105	4	1	3	1	1	0
BARI-2357	101	102	1	1	1	1	1	0
BARI-2357	102	105	3	1	3	3	1	0
BARI-2357	102	105	3	1	3	3	1	0
BARI-2357	102	477	375	0	1	1	1	0
BARI-2357	102	103	1	1	3	1	1	0
BARI-2357	102	477	375	0	3	1	0	0
BARI-2357	102	105	3	1	1	1	1	0
BARI-2357	102	105	3	1	3	1	1	0
BARI-2357	102	110	8	1	4	3	0	0
BARI-2357	102	105	3	1	2	1	1	0
BARI-2358	102	105	3	1	2	1	1	0
BARI-2358	102	103	1	1	3	1	1	0
BARI-2358	102	106	4	1	3	1	2	0
BARI-2358	102	103	1	1	3	1	1	0
BARI-2358	102	103	1	1	1	1	1	0
BARI-2358	105	288	183	1	3	1	1	0
BARI-2358	105	113	8	1	3	1	1	0
BARI-2358	105	107	2	1	2	1	1	0
BARI-2358	105	106	1	1	2	1	1	0
BARI-2358	105	109	4	1	2	2	1	0
BARI-2359	105	108	3	1	3	1	1	0
BARI-2359	105	477	372	0	3	5	0	0
BARI-2359	106	114	8	1	3	1	1	0
BARI-2359	106	110	4	1	3	3	1	0
BARI-2359	106	107	1	1	1	1	1	0
BARI-2359	106	126	20	1	2	1	1	0
BARI-2359	106	108	2	1	2	1	1	0
BARI-2359	106	108	2	1	2	3	1	0
BARI-2359	106	107	1	1	2	1	1	0
BARI-2359	106	107	1	1	2	1	1	0
BARI-2360	106	107	1	1	2	1	1	0
BARI-2360	106	107	1	1	1	1	1	0
BARI-2360	106	107	1	1	2	1	1	0
BARI-2360	106	477	371	0	3	1	0	0
BARI-2360	106	136	30	1	2	1	0	0
BARI-2360	106	126	20	1	3	1	1	0
BARI-2360	106	108	2	1	3	1	1	0
BARI-2360	106	477	371	0	3	1	1	0
BARI-2360	107	108	1	1	2	1	1	0
BARI-2360	107	133	26	1	2	1	1	0
BARI-2361	107	108	1	1	2	1	1	0
BARI-2361	107	116	9	1	3	1	1	0
BARI-2361	107	232	125	1	3	1	1	0
BARI-2361	107	108	1	1	1	1	1	0
BARI-2361	107	108	1	1	2	1	1	0
BARI-2361	107	108	1	1	3	1	1	1
BARI-2361	107	108	1	1	1	1	1	0
BARI-2361	107	108	1	1	1	1	1	0
BARI-2361	108	109	1	1	2	1	1	0
BARI-2361	108	150	42	1	3	2	1	0
BARI-2362	108	114	6	1	2	1	1	1
BARI-2362	108	190	82	1	3	1	1	0
BARI-2362	108	109	1	1	2	1	1	0
BARI-2362	108	109	1	1	2	1	1	0
BARI-2362	108	109	1	1	2	1	1	0
BARI-2362	108	109	1	1	2	1	1	1
BARI-2362	108	109	1	1	3	1	1	0
BARI-2362	108	119	11	1	2	1	1	0
BARI-2362	108	109	1	1	3	1	1	0
BARI-2362	108	119	11	1	3	1	1	0
BARI-2363	109	450	341	1	3	1	0	0
BARI-2363	109	190	81	1	3	1	1	0
BARI-2363	109	113	4	1	3	4	1	0
BARI-2363	109	110	1	1	2	1	1	0
BARI-2363	109	110	1	1	2	1	1	0
BARI-2363	109	477	368	0	2	5	1	1
BARI-2363	109	477	368	0	3	3	1	0
BARI-2363	109	477	368	0	2	3	1	0
BARI-2363	109	137	28	1	2	3	1	1
BARI-2363	109	477	368	0	2	3	1	1
BARI-2364	109	477	368	0	2	3	1	0
BARI-2364	109	477	368	0	2	3	1	0
BARI-2364	109	477	368	0	2	3	1	0
BARI-2364	109	157	48	1	2	3	1	0
BARI-2364	109	133	24	1	3	1	1	0
BARI-2364	110	477	367	0	3	1	0	0
BARI-2364	110	111	1	1	3	1	1	0
BARI-2364	110	111	1	1	2	1	1	1
BARI-2364	110	112	2	1	3	3	1	0
BARI-2364	110	111	1	1	3	1	1	0
BARI-2365	110	477	367	0	3	1	0	1
BARI-2365	110	112	2	1	3	1	1	0
BARI-2365	110	112	2	1	3	1	1	0
BARI-2365	111	113	2	1	2	1	1	1
BARI-2365	112	115	3	1	1	1	1	0
BARI-2365	112	477	365	0	3	1	1	0
BARI-2365	112	113	1	1	2	1	1	0
BARI-2365	112	190	78	1	3	1	1	0
BARI-2365	112	113	1	1	2	1	1	0
BARI-2365	112	113	1	1	3	1	1	0
BARI-2366	112	114	2	1	1	1	1	0
BARI-2366	112	117	5	1	3	1	1	0
BARI-2366	112	121	9	1	3	3	1	0
BARI-2366	112	113	1	1	2	1	1	2
BARI-2366	112	113	1	1	3	1	0	0
BARI-2366	112	477	365	0	3	1	0	0
BARI-2366	112	477	365	0	3	1	0	0
BARI-2366	113	128	15	1	3	1	1	0
BARI-2366	113	114	1	1	3	3	1	0
BARI-2366	113	114	1	1	2	1	1	0
BARI-2367	113	114	1	1	2	1	1	0
BARI-2367	113	114	1	1	1	1	1	0
BARI-2367	113	477	364	0	3	4	0	0
BARI-2367	113	114	1	1	1	1	1	0
BARI-2367	113	477	364	0	3	4	0	0
BARI-2367	113	477	364	0	5	1	1	0
BARI-2367	113	114	1	1	2	1	1	0
BARI-2367	113	114	1	1	3	1	1	0
BARI-2367	113	114	1	1	3	1	1	0
BARI-2367	114	115	1	1	2	1	1	0
BARI-2368	114	121	7	1	2	1	1	0
BARI-2368	114	115	1	1	2	1	1	0
BARI-2368	114	190	76	1	3	1	1	0
BARI-2368	114	115	1	1	3	1	1	1
BARI-2368	114	115	1	1	2	1	1	1
BARI-2368	114	133	19	1	2	1	1	0
BARI-2368	114	115	1	1	2	1	1	0
BARI-2368	114	126	12	1	3	3	1	0
BARI-2368	114	115	1	1	3	4	1	0
BARI-2368	114	119	5	1	1	1	0	0
BARI-2369	114	122	8	1	2	1	1	0
BARI-2369	114	115	1	1	2	1	1	0
BARI-2369	114	117	3	1	3	1	1	0
BARI-2369	114	117	3	1	3	1	1	0
BARI-2369	114	115	1	1	2	1	1	1
BARI-2369	114	477	363	0	3	1	0	0
BARI-2369	114	116	2	1	2	3	1	0
BARI-2369	114	116	2	1	2	1	1	0
BARI-2369	115	116	1	1	3	1	0	0
BARI-2370	115	190	75	1	3	1	1	0
BARI-2370	115	116	1	1	2	1	1	0
BARI-2370	115	477	362	0	3	1	0	0
BARI-2370	115	126	11	1	2	1	1	0
BARI-2370	115	116	1	1	2	1	1	0
BARI-2370	115	116	1	1	2	1	1	0
BARI-2370	115	116	1	1	2	3	1	0
BARI-2370	115	149	34	1	2	1	1	0
BARI-2370	115	232	117	1	3	1	1	0
BARI-2370	115	116	1	1	2	1	1	0
BARI-2371	115	116	1	1	2	1	1	0
BARI-2371	115	119	4	1	3	1	1	0
BARI-2371	115	134	19	1	1	5	0	0
BARI-2371	116	117	1	1	1	1	1	0
BARI-2371	116	117	1	1	3	1	1	0
BARI-2371	116	119	3	1	2	1	1	0
BARI-2371	116	117	1	1	2	1	1	0
BARI-2371	116	121	5	1	2	1	1	0
BARI-2371	116	119	3	1	2	4	1	0
BARI-2371	116	117	1	1	3	4	1	0
BARI-2372	116	119	3	1	1	1	1	0
BARI-2372	116	117	1	1	2	1	1	0
BARI-2372	116	119	3	1	2	1	1	0
BARI-2372	116	477	361	0	3	1	0	0
BARI-2372	116	477	361	0	3	1	0	0
BARI-2372	116	119	3	1	2	3	1	0
BARI-2372	116	120	4	1	2	3	1	0
BARI-2372	119	120	1	1	2	1	1	0
BARI-2372	119	121	2	1	2	1	1	0
BARI-2372	119	120	1	1	2	1	1	0
BARI-2373	119	120	1	1	2	1	1	0
BARI-2373	119	149	30	1	2	1	1	0
BARI-2373	119	120	1	1	3	1	1	0
BARI-2373	119	477	358	0	3	1	0	0
BARI-2373	119	121	2	1	3	1	1	0
BARI-2373	120	121	1	1	3	3	1	0
BARI-2373	120	477	357	0	3	1	0	0
BARI-2373	120	121	1	1	3	1	1	0
BARI-2373	121	134	13	1	3	1	1	0
BARI-2373	121	122	1	1	2	1	1	0
BARI-2374	121	122	1	1	2	1	1	0
BARI-2374	121	122	1	1	2	1	1	0
BARI-2374	121	126	5	1	2	1	1	0
BARI-2374	121	122	1	1	1	1	1	0
BARI-2374	121	122	1	1	2	1	1	1
BARI-2374	121	122	1	1	2	3	1	0
BARI-2374	121	133	12	1	3	1	1	0
BARI-2374	121	477	356	0	4	1	0	0
BARI-2374	122	129	7	1	2	3	1	0
BARI-2374	122	123	1	1	3	1	1	0
BARI-2375	122	123	1	1	2	1	1	0
BARI-2375	122	133	11	1	2	1	1	0
BARI-2375	122	158	36	1	2	1	1	0
BARI-2375	122	477	355	0	3	1	0	0
BARI-2375	122	130	8	1	3	1	1	0
BARI-2375	122	190	68	1	1	1	1	0
BARI-2375	122	123	1	1	2	1	1	0
BARI-2375	122	132	10	1	3	1	1	0
BARI-2375	122	127	5	1	2	1	1	0
BARI-2375	122	130	8	1	2	1	1	0
BARI-2376	123	126	3	1	2	1	1	0
BARI-2376	123	124	1	1	2	1	1	0
BARI-2376	123	149	26	1	3	1	1	0
BARI-2376	123	126	3	1	2	1	1	0
BARI-2376	123	477	354	0	3	1	0	0
BARI-2376	123	129	6	1	2	1	1	0
BARI-2376	123	124	1	1	3	1	1	0
BARI-2376	123	477	354	0	3	1	0	0
BARI-2376	123	124	1	1	2	1	1	0
BARI-2376	123	126	3	1	2	3	1	0
BARI-2377	124	125	1	1	3	1	1	0
BARI-2377	124	134	10	1	3	1	1	0
BARI-2377	124	125	1	1	3	1	1	0
BARI-2377	124	126	2	1	3	4	1	0
BARI-2377	125	477	352	0	4	1	0	0
BARI-2377	126	127	1	1	2	1	1	0
BARI-2377	126	127	1	1	2	3	1	0
BARI-2377	126	127	1	1	3	1	1	0
BARI-2377	126	147	21	1	2	1	1	0
BARI-2377	126	129	3	1	3	3	1	0
BARI-2378	126	190	64	1	2	1	1	0
BARI-2378	126	477	351	0	3	1	0	1
BARI-2378	126	127	1	1	3	1	1	0
BARI-2378	126	128	2	1	2	1	1	0
BARI-2378	127	128	1	1	1	1	1	0
BARI-2378	127	190	63	1	1	1	1	0
BARI-2378	127	477	350	0	2	1	0	0
BARI-2378	127	147	20	1	3	4	0	0
BARI-2378	127	190	63	1	3	1	1	1
BARI-2378	127	128	1	1	2	1	1	0
BARI-2379	127	128	1	1	2	1	1	0
BARI-2379	127	134	7	1	2	1	1	0
BARI-2379	127	149	22	1	2	1	1	0
BARI-2379	127	130	3	1	3	1	1	0
BARI-2379	127	135	8	1	3	1	1	0
BARI-2379	127	147	20	1	1	1	0	0
BARI-2379	127	134	7	1	3	1	1	0
BARI-2379	128	176	48	1	3	1	1	0
BARI-2379	128	129	1	1	3	1	1	0
BARI-2379	128	129	1	1	2	1	1	0
BARI-2380	128	133	5	1	3	1	1	0
BARI-2380	128	130	2	1	1	1	1	1
BARI-2380	128	130	2	1	1	1	1	0
BARI-2380	128	133	5	1	3	1	1	0
BARI-2380	129	134	5	1	2	1	1	0
BARI-2380	129	154	25	1	3	1	1	0
BARI-2380	129	196	67	1	1	1	1	0
BARI-2380	129	130	1	1	1	1	1	0
BARI-2380	129	190	61	1	3	1	1	0
BARI-2380	129	130	1	1	1	1	1	0
BARI-2381	129	130	1	1	1	1	1	0
BARI-2381	129	235	106	1	3	1	2	1
BARI-2381	129	190	61	1	1	1	1	0
BARI-2381	129	133	4	1	1	1	1	0
BARI-2381	129	477	348	0	3	1	0	0
BARI-2381	129	134	5	1	3	1	1	1
BARI-2381	130	477	347	0	2	3	1	0
BARI-2381	130	234	104	1	2	1	1	0
BARI-2381	130	131	1	1	3	1	0	0
BARI-2381	130	190	60	1	3	1	1	0
BARI-2382	130	339	209	1	3	3	0	0
BARI-2382	130	133	3	1	3	1	1	0
BARI-2382	130	134	4	1	3	1	1	0
BARI-2382	130	232	102	1	1	1	1	0
BARI-2382	130	131	1	1	1	1	1	1
BARI-2382	130	151	21	1	3	1	1	0
BARI-2382	130	149	19	1	3	1	1	1
BARI-2382	130	477	347	0	3	1	0	0
BARI-2382	130	190	60	1	2	1	1	0
BARI-2382	130	140	10	1	2	1	1	0
BARI-2383	131	134	3	1	3	1	1	0
BARI-2383	133	134	1	1	3	1	1	0
BARI-2383	133	190	57	1	1	1	1	0
BARI-2383	133	137	4	1	1	1	1	0
BARI-2383	133	134	1	1	1	1	1	0
BARI-2383	133	142	9	1	3	1	1	0
BARI-2383	133	135	2	1	3	1	1	0
BARI-2383	133	137	4	1	2	1	0	0
BARI-2383	134	135	1	1	3	1	1	0
BARI-2384	134	142	8	1	1	3	1	0
BARI-2384	134	190	56	1	3	1	1	1
BARI-2384	134	190	56	1	3	1	1	0
BARI-2384	134	135	1	1	1	1	1	0
BARI-2384	134	135	1	1	3	1	1	0
BARI-2384	134	135	1	1	1	1	1	0
BARI-2384	134	135	1	1	1	1	1	1
BARI-2384	134	135	1	1	1	1	1	0
BARI-2384	134	135	1	1	1	1	1	0
BARI-2384	134	135	1	1	1	1	1	0
BARI-2385	134	477	343	0	4	1	0	0
BARI-2385	134	142	8	1	3	1	1	0
BARI-2385	134	137	3	1	2	3	1	0
BARI-2385	134	331	197	1	4	1	1	1
BARI-2385	134	135	1	1	1	1	1	0
BARI-2385	134	135	1	1	1	1	1	0
BARI-2385	134	135	1	1	1	1	1	0
BARI-2385	134	135	1	1	3	1	1	0
BARI-2385	134	477	343	0	4	2	0	0
BARI-2385	135	136	1	1	3	1	1	0
BARI-2386	135	140	5	1	3	1	1	0
BARI-2386	135	137	2	1	1	1	1	0
BARI-2386	135	136	1	1	1	1	1	0
BARI-2386	135	142	7	1	2	1	1	0
BARI-2386	135	143	8	1	3	1	1	0
BARI-2386	135	136	1	1	3	1	1	0
BARI-2386	135	141	6	1	4	4	1	0
BARI-2386	135	142	7	1	2	1	1	0
BARI-2386	135	136	1	1	3	1	1	0
BARI-2386	135	190	55	1	2	1	1	0
BARI-2387	136	141	5	1	3	3	1	2
BARI-2387	136	169	33	1	3	1	1	0
BARI-2387	136	190	54	1	3	1	1	0
BARI-2387	136	137	1	1	3	1	1	0
BARI-2387	136	137	1	1	2	3	1	0
BARI-2387	136	137	1	1	1	1	1	0
BARI-2387	136	477	341	0	2	1	1	0
BARI-2387	136	141	5	1	1	1	1	0
BARI-2387	136	137	1	1	1	1	1	0
BARI-2387	136	137	1	1	1	1	1	0
BARI-2388	136	137	1	1	1	1	1	0
BARI-2388	136	137	1	1	1	1	1	0
BARI-2388	136	140	4	1	1	1	1	0
BARI-2388	136	139	3	1	3	1	1	0
BARI-2388	136	137	1	1	3	1	1	0
BARI-2388	136	142	6	1	3	1	1	1
BARI-2388	136	137	1	1	3	1	1	0
BARI-2388	136	143	7	1	2	1	1	2
BARI-2388	136	143	7	1	3	1	1	1
BARI-2388	136	144	8	1	3	1	1	0
BARI-2389	136	199	63	1	4	1	1	0
BARI-2389	137	150	13	1	3	4	1	0
BARI-2389	137	138	1	1	3	4	1	0
BARI-2389	137	138	1	1	1	4	1	0
BARI-2389	137	190	53	1	3	1	1	0
BARI-2389	137	138	1	1	1	1	1	0
BARI-2389	137	138	1	1	1	1	1	0
BARI-2389	137	142	5	1	3	3	1	0
BARI-2389	137	138	1	1	1	1	1	0
BARI-2389	137	150	13	1	3	4	1	0
BARI-2390	137	140	3	1	1	1	1	0
BARI-2390	137	150	13	1	3	4	1	0
BARI-2390	137	190	53	1	1	1	1	0
BARI-2390	137	232	95	1	3	4	3	0
BARI-2390	137	140	3	1	1	1	1	0
BARI-2390	137	477	340	0	3	3	1	0
BARI-2390	137	140	3	1	3	1	1	0
BARI-2390	137	138	1	1	2	1	1	0
BARI-2390	137	150	13	1	3	1	1	0
BARI-2390	140	190	50	1	3	1	1	0
BARI-2391	140	477	337	0	3	1	0	0
BARI-2391	140	141	1	1	1	1	1	0
BARI-2391	140	141	1	1	1	1	1	0
BARI-2391	140	141	1	1	1	1	1	0
BARI-2391	140	143	3	1	2	1	1	0
BARI-2391	140	232	92	1	2	1	1	0
BARI-2391	140	142	2	1	1	1	1	2
BARI-2391	140	141	1	1	3	1	1	0
BARI-2391	140	143	3	1	3	1	1	1
BARI-2391	140	141	1	1	1	1	1	0
BARI-2392	140	148	8	1	3	1	1	0
BARI-2392	141	190	49	1	1	1	1	1
BARI-2392	141	144	3	1	1	1	1	0
BARI-2392	141	144	3	1	3	3	1	0
BARI-2392	141	477	336	0	3	1	0	0
BARI-2392	141	477	336	0	2	1	1	0
BARI-2392	141	142	1	1	1	1	1	0
BARI-2392	141	142	1	1	1	1	1	0
BARI-2392	141	142	1	1	1	1	1	0
BARI-2392	141	190	49	1	1	1	1	0
BARI-2393	141	144	3	1	1	1	1	1
BARI-2393	141	477	336	0	4	1	0	0
BARI-2393	141	143	2	1	2	1	1	0
BARI-2393	141	142	1	1	1	1	1	0
BARI-2393	141	190	49	1	1	1	1	0
BARI-2393	142	143	1	1	1	1	1	0
BARI-2393	142	143	1	1	1	1	1	1
BARI-2393	142	143	1	1	1	1	1	0
BARI-2393	142	150	8	1	3	1	1	0
BARI-2393	142	150	8	1	3	1	1	0
BARI-2394	142	477	335	0	3	3	1	0
BARI-2394	142	155	13	1	1	1	1	0
BARI-2394	143	150	7	1	3	1	1	1
BARI-2394	143	190	47	1	3	1	1	0
BARI-2394	143	144	1	1	3	1	1	0
BARI-2394	143	148	5	1	3	1	1	0
BARI-2394	143	144	1	1	2	1	1	0
BARI-2394	143	150	7	1	3	1	1	0
BARI-2394	143	144	1	1	1	1	1	0
BARI-2394	144	148	4	1	2	1	1	0
BARI-2395	144	145	1	1	1	1	1	0
BARI-2395	144	145	1	1	1	1	1	0
BARI-2395	144	145	1	1	1	1	1	0
BARI-2395	144	145	1	1	3	1	1	0
BARI-2395	144	145	1	1	3	1	0	1
BARI-2395	144	477	333	0	3	3	1	0
BARI-2395	144	150	6	1	3	1	1	0
BARI-2395	145	148	3	1	3	1	1	0
BARI-2395	146	477	331	0	4	4	0	0
BARI-2395	147	200	53	1	2	3	1	0
BARI-2396	147	148	1	1	1	1	0	0
BARI-2396	147	477	330	0	3	1	0	0
BARI-2396	147	150	3	1	3	2	0	1
BARI-2396	148	149	1	1	3	1	1	0
BARI-2396	148	149	1	1	1	1	1	0
BARI-2396	148	231	83	1	1	1	1	0
BARI-2396	148	149	1	1	1	1	1	0
BARI-2396	148	149	1	1	1	1	1	0
BARI-2396	148	150	2	1	3	1	1	0
BARI-2396	148	149	1	1	3	1	1	0
BARI-2397	148	232	84	1	3	1	1	0
BARI-2397	148	477	329	0	3	1	0	0
BARI-2397	148	149	1	1	3	3	1	0
BARI-2397	148	151	3	1	2	1	1	0
BARI-2397	149	477	328	0	2	3	1	0
BARI-2397	149	154	5	1	3	1	1	0
BARI-2397	149	190	41	1	3	1	1	0
BARI-2397	149	190	41	1	3	1	1	0
BARI-2397	149	150	1	1	1	1	1	1
BARI-2397	149	154	5	1	3	1	1	0
BARI-2398	149	150	1	1	1	1	1	0
BARI-2398	149	150	1	1	1	1	1	0
BARI-2398	149	150	1	1	1	1	1	0
BARI-2398	149	150	1	1	1	1	1	1
BARI-2398	149	477	328	0	3	1	0	0
BARI-2398	149	150	1	1	3	1	1	0
BARI-2398	149	154	5	1	3	1	1	0
BARI-2398	149	151	2	1	3	3	1	1
BARI-2398	149	477	328	0	3	3	1	1
BARI-2398	149	150	1	1	2	3	1	0
BARI-2399	149	150	1	1	3	1	1	1
BARI-2399	149	150	1	1	3	1	1	0
BARI-2399	150	151	1	1	3	1	1	0
BARI-2399	150	477	327	0	3	2	1	0
BARI-2399	150	180	30	1	3	4	1	0
BARI-2399	150	151	1	1	3	4	1	0
BARI-2399	150	156	6	1	2	1	1	0
BARI-2399	150	151	1	1	1	1	1	0
BARI-2399	150	190	40	1	1	1	1	0
BARI-2399	150	151	1	1	1	1	1	0
BARI-2400	150	151	1	1	2	1	1	0
BARI-2400	150	151	1	1	1	1	1	0
BARI-2400	150	151	1	1	1	1	1	0
BARI-2400	150	151	1	1	1	1	1	0
BARI-2400	151	190	39	1	3	1	1	0
BARI-2400	151	184	33	1	3	1	1	0
BARI-2400	151	477	326	0	3	1	1	0
BARI-2400	151	152	1	1	3	1	1	0
BARI-2400	151	477	326	0	3	1	0	0
BARI-2400	151	154	3	1	3	1	1	0
BARI-2401	151	152	1	1	3	1	1	0
BARI-2401	151	477	326	0	1	3	0	0
BARI-2401	151	152	1	1	3	1	1	0
BARI-2401	151	152	1	1	3	1	1	0
BARI-2401	151	477	326	0	3	2	1	0
BARI-2401	153	159	6	1	3	1	1	0
BARI-2401	153	154	1	1	1	1	1	0
BARI-2401	153	155	2	1	1	1	1	0
BARI-2401	154	156	2	1	1	1	1	0
BARI-2401	154	155	1	1	1	1	1	1
BARI-2402	154	155	1	1	1	1	1	0
BARI-2402	154	155	1	1	3	4	1	0
BARI-2402	154	190	36	1	1	1	1	0
BARI-2402	154	155	1	1	1	1	1	0
BARI-2402	154	156	2	1	3	1	1	0
BARI-2402	154	155	1	1	1	1	1	0
BARI-2402	154	155	1	1	1	1	1	0
BARI-2402	154	155	1	1	1	1	1	0
BARI-2402	154	477	323	0	3	1	0	0
BARI-2402	154	477	323	0	3	1	0	0
BARI-2403	154	477	323	0	3	1	1	1
BARI-2403	154	477	323	0	1	1	1	2
BARI-2403	154	477	323	0	3	1	0	0
BARI-2403	155	156	1	1	3	1	1	0
BARI-2403	155	190	35	1	3	1	1	0
BARI-2403	155	156	1	1	3	1	1	0
BARI-2403	155	156	1	1	1	1	1	0
BARI-2403	155	156	1	1	1	1	1	0
BARI-2403	155	156	1	1	1	1	1	0
BARI-2403	155	156	1	1	3	1	1	0
BARI-2404	155	158	3	1	1	1	1	0
BARI-2404	155	156	1	1	1	1	1	0
BARI-2404	156	157	1	1	3	4	1	0
BARI-2404	156	157	1	1	1	1	1	0
BARI-2404	156	157	1	1	1	1	1	0
BARI-2404	156	477	321	0	3	4	0	0
BARI-2404	156	477	321	0	1	1	1	1
BARI-2404	157	428	271	1	3	1	1	0
BARI-2404	157	158	1	1	3	1	1	0
BARI-2404	157	190	33	1	3	1	1	0
BARI-2405	157	190	33	1	1	1	1	0
BARI-2405	157	158	1	1	2	1	1	0
BARI-2405	157	158	1	1	3	1	1	0
BARI-2405	157	158	1	1	3	1	1	0
BARI-2405	157	158	1	1	1	1	1	0
BARI-2405	158	170	12	1	3	1	1	0
BARI-2405	158	190	32	1	3	1	1	0
BARI-2405	158	161	3	1	1	1	1	1
BARI-2405	158	180	22	1	3	1	1	0
BARI-2405	158	161	3	1	2	1	1	0
BARI-2406	158	163	5	1	2	1	1	0
BARI-2406	158	159	1	1	1	1	1	0
BARI-2406	158	161	3	1	1	1	1	0
BARI-2406	158	180	22	1	3	1	1	0
BARI-2406	158	190	32	1	1	1	1	0
BARI-2406	158	159	1	1	3	1	1	0
BARI-2406	158	161	3	1	2	1	1	0
BARI-2406	159	161	2	1	2	1	1	0
BARI-2406	159	160	1	1	3	1	1	0
BARI-2406	161	175	14	1	3	1	1	0
BARI-2407	161	162	1	1	2	1	1	0
BARI-2407	161	162	1	1	1	1	1	0
BARI-2407	161	190	29	1	3	1	1	0
BARI-2407	161	162	1	1	1	1	1	0
BARI-2407	161	163	2	1	1	1	1	0
BARI-2407	161	162	1	1	1	1	1	1
BARI-2407	161	163	2	1	1	1	1	0
BARI-2407	161	162	1	1	3	1	1	0
BARI-2407	161	162	1	1	1	1	1	0
BARI-2407	161	477	316	0	5	4	0	0
BARI-2408	162	163	1	1	2	1	1	0
BARI-2408	162	163	1	1	1	1	1	0
BARI-2408	162	163	1	1	1	1	1	0
BARI-2408	162	168	6	1	3	1	1	0
BARI-2408	162	163	1	1	1	1	1	0
BARI-2408	162	171	9	1	2	1	1	1
BARI-2408	163	190	27	1	3	1	1	0
BARI-2408	163	164	1	1	3	1	1	0
BARI-2408	163	165	2	1	3	1	1	0
BARI-2408	163	164	1	1	1	1	1	0
BARI-2409	163	164	1	1	1	1	1	0
BARI-2409	163	169	6	1	3	4	1	0
BARI-2409	163	164	1	1	3	1	1	0
BARI-2409	163	164	1	1	2	1	1	0
BARI-2409	163	164	1	1	3	1	1	1
BARI-2409	163	170	7	1	3	1	1	0
BARI-2409	163	165	2	1	2	3	1	0
BARI-2409	164	190	26	1	3	1	1	0
BARI-2409	164	165	1	1	1	1	1	0
BARI-2409	164	190	26	1	1	1	1	0
BARI-2410	164	165	1	1	1	1	1	0
BARI-2410	164	171	7	1	3	1	1	0
BARI-2410	164	165	1	1	1	1	1	0
BARI-2410	164	190	26	1	1	1	1	0
BARI-2410	164	477	313	0	1	1	1	0
BARI-2410	164	165	1	1	2	1	1	0
BARI-2410	164	168	4	1	2	3	1	0
BARI-2410	164	177	13	1	3	1	1	0
BARI-2410	165	166	1	1	1	1	1	0
BARI-2410	165	477	312	0	4	1	0	0
BARI-2411	165	166	1	1	1	1	1	0
BARI-2411	165	168	3	1	3	1	1	0
BARI-2411	165	166	1	1	1	1	1	0
BARI-2411	165	166	1	1	1	1	1	0
BARI-2411	165	166	1	1	1	1	1	0
BARI-2411	165	168	3	1	3	1	1	0
BARI-2411	165	168	3	1	2	1	1	0
BARI-2411	165	166	1	1	2	1	1	0
BARI-2411	165	477	312	0	3	1	1	0
BARI-2411	165	166	1	1	3	1	1	0
BARI-2412	165	212	47	1	3	1	1	0
BARI-2412	165	171	6	1	1	1	1	0
BARI-2412	165	178	13	1	2	1	1	0
BARI-2412	165	477	312	0	5	1	0	0
BARI-2412	165	166	1	1	3	1	1	1
BARI-2412	166	168	2	1	3	1	1	0
BARI-2412	166	167	1	1	3	1	1	0
BARI-2412	166	167	1	1	2	1	1	0
BARI-2412	166	167	1	1	1	1	1	0
BARI-2412	166	168	2	1	1	1	1	0
BARI-2413	167	178	11	1	3	1	1	0
BARI-2413	168	170	2	1	1	1	1	0
BARI-2413	168	169	1	1	1	1	1	0
BARI-2413	168	169	1	1	2	1	1	0
BARI-2413	168	169	1	1	2	1	1	0
BARI-2413	168	190	22	1	1	1	1	0
BARI-2413	168	169	1	1	1	1	1	0
BARI-2413	168	170	2	1	3	1	1	0
BARI-2413	168	169	1	1	1	1	1	0
BARI-2413	168	169	1	1	3	1	0	0
BARI-2414	168	170	2	1	3	1	1	0
BARI-2414	169	170	1	1	1	1	1	0
BARI-2414	169	178	9	1	3	1	1	0
BARI-2414	169	170	1	1	3	1	1	0
BARI-2414	169	477	308	0	4	4	0	0
BARI-2414	169	170	1	1	2	1	1	0
BARI-2414	169	190	21	1	1	1	1	0
BARI-2414	169	172	3	1	1	1	1	0
BARI-2414	169	477	308	0	3	4	0	0
BARI-2414	170	171	1	1	3	1	0	1
BARI-2415	170	171	1	1	3	1	1	0
BARI-2415	170	477	307	0	3	1	0	0
BARI-2415	170	429	259	1	3	1	0	1
BARI-2415	170	171	1	1	1	1	1	0
BARI-2415	170	171	1	1	1	1	1	0
BARI-2415	170	171	1	1	1	1	1	0
BARI-2415	170	171	1	1	2	3	1	0
BARI-2415	171	172	1	1	1	1	1	0
BARI-2415	171	172	1	1	3	3	1	0
BARI-2415	171	477	306	0	3	1	0	0
BARI-2416	171	172	1	1	1	1	1	0
BARI-2416	171	199	28	1	3	1	1	1
BARI-2416	171	198	27	1	2	3	1	0
BARI-2416	172	188	16	1	1	1	1	0
BARI-2416	172	206	34	1	3	4	0	0
BARI-2416	172	234	62	1	3	1	1	0
BARI-2416	172	190	18	1	3	1	1	0
BARI-2416	172	173	1	1	3	1	1	0
BARI-2416	172	176	4	1	3	1	1	0
BARI-2416	172	173	1	1	3	1	1	0
BARI-2417	172	173	1	1	1	1	1	0
BARI-2417	172	175	3	1	1	1	1	0
BARI-2417	172	477	305	0	3	1	0	0
BARI-2417	172	232	60	1	3	1	1	0
BARI-2417	173	190	17	1	3	1	1	0
BARI-2417	175	176	1	1	3	1	1	0
BARI-2417	175	176	1	1	1	1	1	0
BARI-2417	175	176	1	1	1	1	1	0
BARI-2417	175	176	1	1	2	1	1	0
BARI-2417	175	176	1	1	2	1	1	1
BARI-2418	175	176	1	1	1	1	1	1
BARI-2418	175	176	1	1	3	1	1	0
BARI-2418	175	190	15	1	1	1	1	0
BARI-2418	175	196	21	1	3	1	1	0
BARI-2418	176	197	21	1	3	4	0	0
BARI-2418	176	477	301	0	4	1	0	0
BARI-2418	176	177	1	1	3	1	1	0
BARI-2418	176	231	55	1	3	1	1	0
BARI-2418	176	178	2	1	2	1	1	0
BARI-2418	176	190	14	1	3	1	1	0
BARI-2419	176	477	301	0	3	1	0	0
BARI-2419	176	177	1	1	2	1	1	0
BARI-2419	176	232	56	1	1	1	1	0
BARI-2419	176	177	1	1	1	1	1	0
BARI-2419	176	219	43	1	3	1	1	0
BARI-2419	176	178	2	1	1	1	1	0
BARI-2419	176	179	3	1	3	2	1	0
BARI-2419	176	177	1	1	2	3	1	0
BARI-2419	177	178	1	1	3	1	1	0
BARI-2419	177	221	44	1	3	1	1	0
BARI-2420	177	178	1	1	2	1	1	0
BARI-2420	177	190	13	1	3	1	1	0
BARI-2420	177	178	1	1	1	1	1	0
BARI-2420	178	182	4	1	3	1	1	1
BARI-2420	178	190	12	1	2	1	1	0
BARI-2420	178	477	299	0	3	1	1	0
BARI-2420	178	179	1	1	1	1	1	0
BARI-2420	178	199	21	1	3	1	1	1
BARI-2420	178	477	299	0	3	1	0	0
BARI-2420	178	477	299	0	3	1	0	0
BARI-2421	178	179	1	1	3	1	1	0
BARI-2421	178	232	54	1	3	1	1	0
BARI-2421	178	232	54	1	3	1	1	0
BARI-2421	178	181	3	1	1	1	1	0
BARI-2421	179	188	9	1	3	1	1	0
BARI-2421	179	477	298	0	3	1	1	0
BARI-2421	179	180	1	1	3	1	1	0
BARI-2421	179	191	12	1	3	1	1	0
BARI-2421	179	477	298	0	3	3	1	0
BARI-2421	179	477	298	0	3	1	1	0
BARI-2422	179	199	20	1	3	1	1	0
BARI-2422	179	180	1	1	1	1	1	0
BARI-2422	179	180	1	1	3	1	1	0
BARI-2422	179	190	11	1	3	1	1	0
BARI-2422	179	190	11	1	1	1	1	0
BARI-2422	179	190	11	1	3	1	1	0
BARI-2422	179	180	1	1	3	1	1	0
BARI-2422	179	232	53	1	3	1	1	0
BARI-2422	179	181	2	1	2	1	1	0
BARI-2422	180	190	10	1	1	1	1	0
BARI-2423	180	183	3	1	3	1	1	0
BARI-2423	181	298	117	1	3	1	1	0
BARI-2423	182	183	1	1	1	1	1	0
BARI-2423	182	183	1	1	3	1	1	0
BARI-2423	182	183	1	1	3	1	1	0
BARI-2423	182	477	295	0	3	1	0	0
BARI-2423	182	183	1	1	1	1	1	0
BARI-2423	182	184	2	1	2	1	1	0
BARI-2423	183	185	2	1	3	3	1	0
BARI-2423	183	477	294	0	3	1	0	0
BARI-2424	184	185	1	1	3	1	1	0
BARI-2424	184	185	1	1	3	1	1	0
BARI-2424	184	185	1	1	3	1	1	0
BARI-2424	184	477	293	0	3	1	0	0
BARI-2424	184	477	293	0	3	1	0	1
BARI-2424	185	423	238	1	4	4	1	0
BARI-2424	185	220	35	1	1	3	1	0
BARI-2424	185	190	5	1	3	1	1	0
BARI-2424	185	200	15	1	3	1	1	0
BARI-2424	185	186	1	1	3	1	1	0
BARI-2425	185	190	5	1	1	1	1	0
BARI-2425	185	221	36	1	1	1	0	0
BARI-2425	186	187	1	1	1	1	1	0
BARI-2425	186	477	291	0	3	4	0	4
BARI-2425	186	187	1	1	3	1	1	0
BARI-2425	186	477	291	0	3	4	0	4
BARI-2425	186	477	291	0	3	1	0	2
BARI-2425	186	190	4	1	3	1	1	0
BARI-2425	186	477	291	0	2	3	1	0
BARI-2425	186	187	1	1	1	1	1	0
BARI-2426	186	205	19	1	3	1	1	0
BARI-2426	187	188	1	1	3	1	1	0
BARI-2426	187	188	1	1	1	1	1	0
BARI-2426	188	189	1	1	1	1	1	0
BARI-2426	188	189	1	1	3	1	1	0
BARI-2426	188	189	1	1	3	1	1	0
BARI-2426	189	477	288	0	3	1	1	0
BARI-2426	189	190	1	1	1	1	1	0
BARI-2426	189	219	30	1	1	1	1	0
BARI-2426	189	204	15	1	2	1	1	0
BARI-2427	189	199	10	1	3	1	1	0
BARI-2427	189	190	1	1	1	1	1	0
BARI-2427	190	199	9	1	3	1	1	0
BARI-2427	190	199	9	1	3	1	1	0
BARI-2427	190	191	1	1	3	3	0	0
BARI-2427	190	191	1	1	3	1	1	0
BARI-2427	190	199	9	1	3	1	1	0
BARI-2427	190	477	287	0	3	1	0	0
BARI-2427	191	192	1	1	3	1	1	0
BARI-2427	191	477	286	0	5	4	0	0
BARI-2428	191	192	1	1	2	1	1	1
BARI-2428	191	199	8	1	3	1	1	0
BARI-2428	191	192	1	1	2	3	1	0
BARI-2428	191	212	21	1	4	1	0	0
BARI-2428	192	200	8	1	4	1	1	0
BARI-2428	192	477	285	0	3	1	0	0
BARI-2428	193	218	25	1	3	1	1	0
BARI-2428	193	194	1	1	2	3	1	0
BARI-2428	193	199	6	1	3	1	1	0
BARI-2428	193	428	235	1	1	1	1	0
BARI-2429	194	204	10	1	2	1	1	0
BARI-2429	196	291	95	1	2	1	1	0
BARI-2429	196	212	16	1	3	1	1	0
BARI-2429	196	477	281	0	3	1	0	0
BARI-2429	197	477	280	0	3	2	0	0
BARI-2429	197	477	280	0	3	4	0	0
BARI-2429	197	477	280	0	3	1	0	0
BARI-2429	197	203	6	1	3	3	1	0
BARI-2429	197	199	2	1	3	1	1	0
BARI-2429	198	332	134	1	3	1	1	0
BARI-2430	198	199	1	1	3	1	1	0
BARI-2430	198	477	279	0	3	2	0	2
BARI-2430	198	210	12	1	1	1	1	0
BARI-2430	199	200	1	1	5	1	1	0
BARI-2430	199	200	1	1	3	1	1	0
BARI-2430	199	477	278	0	3	2	0	0
BARI-2430	199	477	278	0	3	2	0	1
BARI-2430	199	200	1	1	2	1	1	1
BARI-2430	199	200	1	1	2	1	1	0
BARI-2430	199	231	32	1	3	1	1	0
BARI-2431	199	200	1	1	2	1	1	0
BARI-2431	199	200	1	1	3	1	1	0
BARI-2431	199	205	6	1	2	1	1	0
BARI-2431	199	200	1	1	3	1	1	0
BARI-2431	199	200	1	1	2	1	1	0
BARI-2431	199	200	1	1	2	1	1	0
BARI-2431	199	200	1	1	2	1	1	0
BARI-2431	199	232	33	1	3	1	1	0
BARI-2431	199	200	1	1	1	3	1	0
BARI-2431	200	231	31	1	2	1	1	0
BARI-2432	200	205	5	1	3	1	1	0
BARI-2432	200	201	1	1	3	1	1	0
BARI-2432	200	201	1	1	3	1	1	0
BARI-2432	200	231	31	1	3	1	1	0
BARI-2432	200	231	31	1	3	1	1	0
BARI-2432	200	205	5	1	4	1	1	0
BARI-2432	200	221	21	1	3	1	1	0
BARI-2432	200	203	3	1	1	1	1	0
BARI-2432	200	207	7	1	3	3	1	1
BARI-2432	202	203	1	1	3	1	1	0
BARI-2433	202	477	275	0	3	1	0	0
BARI-2433	203	204	1	1	3	3	1	0
BARI-2433	203	205	2	1	3	1	1	0
BARI-2433	203	205	2	1	2	1	1	0
BARI-2433	203	204	1	1	3	4	0	0
BARI-2433	203	231	28	1	3	1	1	0
BARI-2433	203	255	52	1	2	1	1	0
BARI-2433	203	477	274	0	3	4	0	4
BARI-2433	203	205	2	1	4	5	1	0
BARI-2433	203	204	1	1	3	3	1	0
BARI-2434	203	204	1	1	2	1	1	0
BARI-2434	203	205	2	1	3	3	1	2
BARI-2434	203	205	2	1	3	1	1	0
BARI-2434	204	246	42	1	3	1	1	0
BARI-2434	204	206	2	1	3	1	1	0
BARI-2434	204	477	273	0	3	4	0	0
BARI-2434	204	205	1	1	3	1	1	0
BARI-2434	204	205	1	1	1	1	1	0
BARI-2434	204	220	16	1	3	3	1	0
BARI-2434	204	231	27	1	3	1	1	0
BARI-2435	204	205	1	1	3	1	1	1
BARI-2435	205	232	27	1	3	1	1	0
BARI-2435	205	207	2	1	2	1	1	0
BARI-2435	205	206	1	1	3	1	1	0
BARI-2435	205	206	1	1	3	1	1	0
BARI-2435	205	247	42	1	3	1	1	0
BARI-2435	205	207	2	1	3	1	0	0
BARI-2435	205	477	272	0	3	4	0	4
BARI-2435	205	477	272	0	3	4	0	0
BARI-2435	206	207	1	1	2	1	1	0
BARI-2436	206	477	271	0	3	1	0	0
BARI-2436	206	207	1	1	3	3	1	0
BARI-2436	206	207	1	1	2	1	1	0
BARI-2436	206	207	1	1	3	3	1	0
BARI-2436	206	219	13	1	3	1	1	0
BARI-2436	206	228	22	1	3	4	1	0
BARI-2436	206	228	22	1	3	4	1	0
BARI-2436	206	220	14	1	2	1	1	0
BARI-2436	207	477	270	0	3	1	0	0
BARI-2436	207	477	270	0	3	4	0	4
BARI-2437	207	477	270	0	3	2	0	2
BARI-2437	207	477	270	0	3	1	0	2
BARI-2437	207	208	1	1	2	3	1	0
BARI-2437	207	477	270	0	3	2	0	4
BARI-2437	207	208	1	1	1	1	1	0
BARI-2437	208	219	11	1	2	1	1	1
BARI-2437	210	211	1	1	3	2	0	0
BARI-2437	210	477	267	0	4	1	0	0
BARI-2437	210	211	1	1	3	1	1	0
BARI-2437	210	477	267	0	3	1	0	0
BARI-2438	210	477	267	0	2	1	0	2
BARI-2438	210	477	267	0	3	4	0	2
BARI-2438	210	226	16	1	1	1	1	3
BARI-2438	210	221	11	1	3	1	1	0
BARI-2438	210	211	1	1	3	1	0	0
BARI-2438	210	221	11	1	2	1	1	1
BARI-2438	211	212	1	1	1	1	1	0
BARI-2438	211	219	8	1	3	2	2	1
BARI-2438	211	212	1	1	3	3	1	0
BARI-2438	211	212	1	1	2	1	1	0
BARI-2439	211	213	2	1	2	1	1	0
BARI-2439	211	212	1	1	2	1	1	0
BARI-2439	211	212	1	1	3	1	1	0
BARI-2439	211	212	1	1	3	4	0	0
BARI-2439	211	213	2	1	3	4	0	0
BARI-2439	211	212	1	1	1	1	2	0
BARI-2439	211	305	94	1	3	1	1	0
BARI-2439	212	217	5	1	2	3	1	0
BARI-2439	212	213	1	1	2	1	1	0
BARI-2439	212	231	19	1	3	1	1	0
BARI-2440	213	297	84	1	3	1	0	1
BARI-2440	213	214	1	1	3	1	1	0
BARI-2440	213	214	1	1	3	3	1	0
BARI-2440	213	215	2	1	3	1	2	0
BARI-2440	213	217	4	1	2	1	1	0
BARI-2440	213	217	4	1	3	1	1	0
BARI-2440	214	215	1	1	2	1	1	0
BARI-2440	217	232	15	1	3	4	1	1
BARI-2440	217	231	14	1	2	1	1	0
BARI-2440	217	218	1	1	3	1	1	0
BARI-2441	217	219	2	1	3	3	1	0
BARI-2441	218	219	1	1	3	1	1	0
BARI-2441	218	220	2	1	3	3	1	0
BARI-2441	218	219	1	1	1	3	1	0
BARI-2441	218	219	1	1	3	1	1	0
BARI-2441	218	220	2	1	2	3	1	0
BARI-2441	218	231	13	1	3	1	1	0
BARI-2441	218	305	87	1	3	1	1	0
BARI-2441	219	477	258	0	2	1	0	0
BARI-2441	219	477	258	0	2	1	0	0
BARI-2442	219	477	258	0	2	1	0	0
BARI-2442	219	477	258	0	4	4	0	0
BARI-2442	219	220	1	1	3	1	1	0
BARI-2442	219	477	258	0	3	4	0	0
BARI-2442	219	225	6	1	4	1	1	0
BARI-2442	219	225	6	1	3	1	1	0
BARI-2442	219	238	19	1	3	1	1	0
BARI-2442	219	477	258	0	3	1	1	0
BARI-2442	219	220	1	1	3	1	1	0
BARI-2442	219	220	1	1	2	3	1	0
BARI-2443	219	220	1	1	2	3	1	0
BARI-2443	219	220	1	1	3	1	1	0
BARI-2443	220	221	1	1	3	3	1	0
BARI-2443	220	228	8	1	4	1	0	0
BARI-2443	220	221	1	1	2	1	1	0
BARI-2443	220	238	18	1	4	1	1	0
BARI-2443	220	228	8	1	5	1	1	0
BARI-2443	220	228	8	1	5	1	0	0
BARI-2443	220	226	6	1	4	1	0	0
BARI-2443	220	226	6	1	5	1	0	0
BARI-2444	220	225	5	1	5	1	0	0
BARI-2444	220	226	6	1	3	1	0	0
BARI-2444	220	221	1	1	3	1	1	0
BARI-2444	220	221	1	1	2	1	1	0
BARI-2444	220	477	257	0	4	1	0	0
BARI-2444	220	225	5	1	4	1	1	0
BARI-2444	220	223	3	1	1	3	1	0
BARI-2444	220	221	1	1	3	1	1	0
BARI-2444	220	477	257	0	3	1	0	0
BARI-2444	220	477	257	0	2	3	1	0
BARI-2445	220	221	1	1	1	1	1	0
BARI-2445	220	231	11	1	2	1	1	0
BARI-2445	220	232	12	1	3	1	1	0
BARI-2445	220	231	11	1	2	1	1	0
BARI-2445	220	232	12	1	2	1	1	1
BARI-2445	221	232	11	1	1	1	1	0
BARI-2445	221	231	10	1	3	1	1	0
BARI-2445	221	232	11	1	3	1	1	0
BARI-2445	221	241	20	1	3	1	1	0
BARI-2445	221	224	3	1	3	1	1	0
BARI-2446	221	223	2	1	3	3	1	0
BARI-2446	221	477	256	0	3	4	0	0
BARI-2446	224	225	1	1	1	1	1	0
BARI-2446	224	477	253	0	3	1	1	0
BARI-2446	224	477	253	0	2	1	1	0
BARI-2446	224	225	1	1	1	1	1	0
BARI-2446	224	269	45	1	3	4	1	0
BARI-2446	224	226	2	1	2	3	1	0
BARI-2446	224	234	10	1	3	2	1	0
BARI-2446	224	477	253	0	3	2	1	0
BARI-2447	224	225	1	1	2	1	1	0
BARI-2447	224	225	1	1	2	1	1	0
BARI-2447	225	226	1	1	2	1	1	0
BARI-2447	225	226	1	1	1	1	1	0
BARI-2447	225	226	1	1	3	1	1	0
BARI-2447	225	226	1	1	3	3	0	0
BARI-2447	225	226	1	1	1	1	1	0
BARI-2447	225	231	6	1	3	1	1	0
BARI-2447	225	226	1	1	3	1	1	0
BARI-2447	225	477	252	0	2	1	0	0
BARI-2448	225	227	2	1	3	1	1	0
BARI-2448	225	228	3	1	2	3	1	0
BARI-2448	226	227	1	1	1	1	1	0
BARI-2448	226	227	1	1	1	1	1	0
BARI-2448	226	227	1	1	1	1	1	0
BARI-2448	226	230	4	1	2	1	1	0
BARI-2448	227	228	1	1	3	1	1	0
BARI-2448	227	276	49	1	1	1	1	0
BARI-2448	227	231	4	1	3	1	1	0
BARI-2448	227	228	1	1	3	3	0	0
BARI-2449	227	231	4	1	5	1	0	0
BARI-2449	227	298	71	1	1	1	1	0
BARI-2449	227	254	27	1	3	1	1	0
BARI-2449	227	477	250	0	1	3	1	0
BARI-2449	228	230	2	1	3	1	1	0
BARI-2449	228	231	3	1	3	1	1	0
BARI-2449	228	229	1	1	3	1	1	0
BARI-2449	228	477	249	0	3	1	0	0
BARI-2449	228	231	3	1	3	1	1	0
BARI-2449	228	232	4	1	2	1	1	0
BARI-2450	228	229	1	1	3	1	1	0
BARI-2450	228	234	6	1	2	3	1	0
BARI-2450	229	477	248	0	3	3	1	0
BARI-2450	229	231	2	1	3	1	1	0
BARI-2450	229	230	1	1	3	1	1	0
BARI-2450	231	232	1	1	1	1	1	0
BARI-2450	231	232	1	1	3	1	1	0
BARI-2450	231	232	1	1	1	1	1	0
BARI-2450	231	477	246	0	3	1	0	0
BARI-2450	232	234	2	1	3	1	1	0
BARI-2451	232	477	245	0	4	1	1	0
BARI-2451	232	477	245	0	3	4	1	1
BARI-2451	232	477	245	0	2	1	1	1
BARI-2451	232	233	1	1	1	1	1	0
BARI-2451	232	233	1	1	3	1	1	0
BARI-2451	232	233	1	1	1	1	1	0
BARI-2451	232	275	43	1	3	1	1	0
BARI-2451	232	477	245	0	3	3	0	0
BARI-2451	232	233	1	1	1	1	1	1
BARI-2451	232	260	28	1	3	3	0	0
BARI-2452	232	233	1	1	4	1	1	0
BARI-2452	232	233	1	1	1	1	1	1
BARI-2452	232	241	9	1	2	1	1	0
BARI-2452	232	298	66	1	3	1	1	0
BARI-2452	233	234	1	1	2	1	1	0
BARI-2452	233	242	9	1	1	1	1	0
BARI-2452	233	242	9	1	3	1	1	0
BARI-2452	233	288	55	1	3	1	1	0
BARI-2452	234	477	243	0	3	1	0	1
BARI-2452	234	235	1	1	3	3	1	0
BARI-2453	234	235	1	1	1	3	1	0
BARI-2453	235	333	98	1	3	1	0	0
BARI-2453	235	298	63	1	3	1	0	0
BARI-2453	235	241	6	1	2	1	1	1
BARI-2453	235	477	242	0	1	1	0	0
BARI-2453	235	268	33	1	3	1	0	0
BARI-2453	235	241	6	1	3	1	1	0
BARI-2453	235	242	7	1	1	3	1	0
BARI-2453	236	242	6	1	3	1	0	0
BARI-2453	236	242	6	1	3	1	0	0
BARI-2454	236	241	5	1	3	4	1	0
BARI-2454	238	247	9	1	3	1	1	0
BARI-2454	238	298	60	1	2	1	1	0
BARI-2454	238	240	2	1	3	1	1	0
BARI-2454	238	290	52	1	3	1	1	0
BARI-2454	238	239	1	1	3	1	1	0
BARI-2454	238	298	60	1	3	1	1	0
BARI-2454	239	477	238	0	2	1	0	0
BARI-2454	239	267	28	1	3	4	1	0
BARI-2454	239	248	9	1	2	1	1	0
BARI-2455	239	295	56	1	3	1	1	0
BARI-2455	239	318	79	1	4	1	1	0
BARI-2455	239	298	59	1	1	1	1	0
BARI-2455	239	240	1	1	3	1	1	0
BARI-2455	239	255	16	1	3	1	1	0
BARI-2455	239	242	3	1	2	1	1	0
BARI-2455	239	266	27	1	2	1	1	0
BARI-2455	239	240	1	1	3	3	1	0
BARI-2455	240	241	1	1	3	1	1	0
BARI-2455	240	477	237	0	3	1	1	0
BARI-2456	240	288	48	1	3	1	1	0
BARI-2456	240	242	2	1	3	3	1	0
BARI-2456	240	241	1	1	3	1	1	0
BARI-2456	240	295	55	1	3	1	1	0
BARI-2456	240	477	237	0	2	4	0	0
BARI-2456	240	477	237	0	2	4	0	0
BARI-2456	240	477	237	0	3	1	1	0
BARI-2456	241	477	236	0	3	3	1	0
BARI-2456	241	477	236	0	3	3	1	0
BARI-2456	241	295	54	1	3	1	1	0
BARI-2457	241	242	1	1	3	1	1	0
BARI-2457	241	477	236	0	2	3	1	0
BARI-2457	241	316	75	1	2	1	1	0
BARI-2457	241	248	7	1	3	1	1	0
BARI-2457	241	245	4	1	3	3	0	0
BARI-2457	241	255	14	1	3	1	1	0
BARI-2457	241	246	5	1	3	1	1	0
BARI-2457	241	242	1	1	3	1	1	0
BARI-2457	242	243	1	1	2	1	1	0
BARI-2457	242	477	235	0	4	1	0	0
BARI-2458	242	280	38	1	3	1	0	0
BARI-2458	242	477	235	0	4	4	0	0
BARI-2458	242	243	1	1	2	1	1	0
BARI-2458	244	288	44	1	3	1	1	0
BARI-2458	245	477	232	0	3	1	0	0
BARI-2458	245	246	1	1	1	1	1	0
BARI-2458	245	253	8	1	3	1	1	0
BARI-2458	245	288	43	1	3	1	1	0
BARI-2458	245	246	1	1	2	3	0	0
BARI-2458	246	477	231	0	3	1	1	0
BARI-2459	246	477	231	0	3	1	0	0
BARI-2459	246	477	231	0	3	1	0	0
BARI-2459	246	247	1	1	2	1	1	0
BARI-2459	247	248	1	1	3	1	1	0
BARI-2459	247	298	51	1	1	1	1	0
BARI-2459	247	260	13	1	3	1	1	0
BARI-2459	248	249	1	1	3	1	0	0
BARI-2459	248	255	7	1	2	1	1	0
BARI-2459	248	255	7	1	3	1	1	0
BARI-2459	248	249	1	1	4	1	1	0
BARI-2460	248	477	229	0	3	4	0	0
BARI-2460	248	477	229	0	4	1	0	1
BARI-2460	248	249	1	1	4	1	0	1
BARI-2460	248	316	68	1	3	1	1	0
BARI-2460	249	253	4	1	2	1	1	0
BARI-2460	249	298	49	1	2	1	1	0
BARI-2460	249	477	228	0	3	1	0	0
BARI-2460	249	477	228	0	4	1	0	0
BARI-2460	249	250	1	1	2	3	1	0
BARI-2460	250	252	2	1	3	1	1	0
BARI-2461	252	280	28	1	4	1	0	0
BARI-2461	252	254	2	1	2	1	1	0
BARI-2461	252	253	1	1	1	1	1	0
BARI-2461	252	280	28	1	4	1	0	0
BARI-2461	252	288	36	1	3	1	1	0
BARI-2461	252	477	225	0	3	3	0	0
BARI-2461	252	260	8	1	3	1	1	1
BARI-2461	252	253	1	1	3	1	1	0
BARI-2461	253	254	1	1	3	3	0	0
BARI-2461	253	254	1	1	3	1	1	0
BARI-2462	253	254	1	1	2	1	1	0
BARI-2462	253	255	2	1	2	1	1	0
BARI-2462	254	270	16	1	3	4	1	0
BARI-2462	254	288	34	1	3	1	1	0
BARI-2462	254	255	1	1	1	1	1	0
BARI-2462	254	260	6	1	3	4	0	0
BARI-2462	254	256	2	1	1	1	1	0
BARI-2462	254	255	1	1	2	1	1	0
BARI-2462	254	255	1	1	3	1	1	0
BARI-2462	254	477	223	0	3	1	0	0
BARI-2463	254	280	26	1	3	1	1	1
BARI-2463	254	280	26	1	3	1	1	0
BARI-2463	255	326	71	1	4	1	1	0
BARI-2463	255	256	1	1	3	3	1	0
BARI-2463	255	382	127	1	3	1	0	0
BARI-2463	255	298	43	1	3	1	1	0
BARI-2463	255	256	1	1	3	1	1	0
BARI-2463	255	266	11	1	2	1	1	0
BARI-2463	256	288	32	1	3	1	1	0
BARI-2463	256	257	1	1	2	1	1	0
BARI-2464	256	259	3	1	1	1	1	0
BARI-2464	256	259	3	1	3	1	1	0
BARI-2464	256	477	221	0	3	1	0	0
BARI-2464	256	477	221	0	4	1	0	0
BARI-2464	256	259	3	1	1	1	1	0
BARI-2464	256	257	1	1	3	1	1	0
BARI-2464	256	262	6	1	1	1	1	0
BARI-2464	259	288	29	1	3	1	1	0
BARI-2464	259	261	2	1	3	1	1	0
BARI-2464	259	477	218	0	4	4	0	0
BARI-2465	259	477	218	0	3	1	0	0
BARI-2465	259	269	10	1	3	1	1	0
BARI-2465	259	451	192	1	3	1	0	0
BARI-2465	260	266	6	1	3	1	1	0
BARI-2465	260	288	28	1	3	1	1	0
BARI-2465	260	477	217	0	3	1	0	0
BARI-2465	260	280	20	1	3	3	1	0
BARI-2465	260	477	217	0	2	1	1	0
BARI-2465	260	288	28	1	1	1	1	0
BARI-2465	260	477	217	0	2	3	1	0
BARI-2466	261	477	216	0	4	1	0	0
BARI-2466	261	288	27	1	3	1	1	0
BARI-2466	261	262	1	1	3	1	1	0
BARI-2466	261	262	1	1	1	1	1	0
BARI-2466	261	477	216	0	3	1	0	0
BARI-2466	261	262	1	1	3	1	1	0
BARI-2466	262	263	1	1	3	3	1	0
BARI-2466	262	263	1	1	3	1	1	0
BARI-2466	262	477	215	0	3	3	0	0
BARI-2466	262	298	36	1	1	1	1	0
BARI-2467	263	288	25	1	3	4	1	0
BARI-2467	263	277	14	1	3	3	0	0
BARI-2467	263	288	25	1	1	1	1	0
BARI-2467	263	266	3	1	2	1	1	0
BARI-2467	263	265	2	1	3	3	1	0
BARI-2467	263	477	214	0	3	1	0	0
BARI-2467	265	266	1	1	2	1	1	0
BARI-2467	266	288	22	1	3	1	1	0
BARI-2467	266	268	2	1	2	1	1	0
BARI-2467	266	267	1	1	2	1	1	0
BARI-2468	266	276	10	1	3	1	1	0
BARI-2468	267	268	1	1	2	1	1	0
BARI-2468	267	477	210	0	3	1	1	0
BARI-2468	267	477	210	0	3	1	1	0
BARI-2468	267	268	1	1	1	3	1	0
BARI-2468	267	268	1	1	1	3	1	0
BARI-2468	267	477	210	0	3	5	1	0
BARI-2468	267	268	1	1	2	3	1	0
BARI-2468	267	274	7	1	2	1	1	0
BARI-2468	268	288	20	1	3	1	1	0
BARI-2469	268	276	8	1	3	3	0	0
BARI-2469	268	269	1	1	2	3	0	0
BARI-2469	268	428	160	1	3	1	2	0
BARI-2469	268	270	2	1	1	1	1	0
BARI-2469	268	280	12	1	3	1	1	1
BARI-2469	268	269	1	1	3	3	1	0
BARI-2469	268	305	37	1	3	3	1	0
BARI-2469	269	477	208	0	1	1	1	0
BARI-2469	269	477	208	0	2	1	1	0
BARI-2469	269	477	208	0	2	4	0	1
BARI-2470	269	275	6	1	3	1	1	0
BARI-2470	269	477	208	0	3	1	0	0
BARI-2470	269	274	5	1	3	3	0	0
BARI-2470	269	477	208	0	3	1	0	0
BARI-2470	269	380	111	1	3	1	1	0
BARI-2470	269	270	1	1	2	3	1	0
BARI-2470	269	270	1	1	3	3	1	0
BARI-2470	269	270	1	1	3	1	1	0
BARI-2470	270	273	3	1	3	3	1	0
BARI-2470	270	296	26	1	3	4	1	0
BARI-2471	270	477	207	0	2	2	0	0
BARI-2471	270	477	207	0	3	1	1	0
BARI-2471	270	277	7	1	3	5	2	0
BARI-2471	271	477	206	0	3	1	1	0
BARI-2471	273	288	15	1	1	1	1	0
BARI-2471	273	288	15	1	3	1	1	0
BARI-2471	273	276	3	1	3	1	1	0
BARI-2471	273	288	15	1	3	1	1	0
BARI-2471	273	274	1	1	1	1	1	0
BARI-2471	273	477	204	0	2	4	0	2
BARI-2472	273	274	1	1	3	3	1	0
BARI-2472	274	275	1	1	3	3	1	0
BARI-2472	274	277	3	1	2	1	1	1
BARI-2472	274	277	3	1	3	3	1	0
BARI-2472	275	276	1	1	2	3	1	0
BARI-2472	275	290	15	1	3	1	1	0
BARI-2472	275	477	202	0	3	1	1	0
BARI-2472	275	290	15	1	3	1	1	0
BARI-2472	275	276	1	1	2	3	1	0
BARI-2472	275	277	2	1	3	1	1	0
BARI-2473	275	280	5	1	4	1	1	0
BARI-2473	276	284	8	1	3	1	1	0
BARI-2473	276	308	32	1	3	1	1	0
BARI-2473	276	477	201	0	3	3	1	0
BARI-2473	276	277	1	1	3	3	0	0
BARI-2473	276	477	201	0	3	1	0	0
BARI-2473	276	477	201	0	3	3	1	0
BARI-2473	276	280	4	1	2	3	1	0
BARI-2473	276	311	35	1	3	3	1	0
BARI-2473	276	277	1	1	3	3	1	0
BARI-2474	277	477	200	0	2	3	1	0
BARI-2474	277	309	32	1	1	1	1	0
BARI-2474	277	280	3	1	3	3	1	0
BARI-2474	277	477	200	0	3	5	2	0
BARI-2474	280	382	102	1	3	3	1	0
BARI-2474	280	282	2	1	3	3	1	0
BARI-2474	280	288	8	1	3	1	1	0
BARI-2474	280	477	197	0	3	2	0	0
BARI-2474	280	281	1	1	3	1	1	0
BARI-2475	281	298	17	1	3	1	1	0
BARI-2475	281	283	2	1	3	3	0	0
BARI-2475	281	291	10	1	3	1	1	0
BARI-2475	281	477	196	0	3	1	0	0
BARI-2475	281	477	196	0	3	1	0	0
BARI-2475	281	477	196	0	3	4	0	0
BARI-2475	281	282	1	1	3	1	1	0
BARI-2475	282	288	6	1	3	1	1	0
BARI-2475	282	288	6	1	3	1	1	0
BARI-2475	283	477	194	0	3	1	1	0
BARI-2476	283	284	1	1	3	3	0	0
BARI-2476	283	289	6	1	3	1	1	0
BARI-2476	283	291	8	1	2	1	1	0
BARI-2476	283	284	1	1	1	1	1	0
BARI-2476	283	298	15	1	2	3	1	0
BARI-2476	283	284	1	1	3	1	1	0
BARI-2476	284	477	193	0	4	1	0	0
BARI-2476	284	298	14	1	3	3	1	0
BARI-2476	284	288	4	1	2	3	1	0
BARI-2476	284	477	193	0	3	2	0	0
BARI-2477	284	285	1	1	3	1	1	0
BARI-2477	284	289	5	1	1	3	1	0
BARI-2477	284	477	193	0	1	3	1	0
BARI-2477	284	477	193	0	1	3	1	0
BARI-2477	286	289	3	1	3	1	1	0
BARI-2477	287	290	3	1	3	1	1	0
BARI-2477	287	323	36	1	3	3	1	0
BARI-2477	287	290	3	1	3	1	1	0
BARI-2477	287	288	1	1	1	1	1	0
BARI-2477	287	288	1	1	3	1	1	0
BARI-2478	287	288	1	1	2	3	1	0
BARI-2478	287	289	2	1	3	1	1	0
BARI-2478	288	477	189	0	3	1	1	0
BARI-2478	288	293	5	1	3	1	1	0
BARI-2478	288	316	28	1	3	1	1	0
BARI-2478	288	309	21	1	2	1	1	0
BARI-2478	288	295	7	1	3	3	0	0
BARI-2478	288	289	1	1	3	3	1	0
BARI-2478	288	289	1	1	3	1	1	0
BARI-2478	288	294	6	1	3	1	1	0
BARI-2479	288	289	1	1	3	3	1	0
BARI-2479	288	289	1	1	3	1	1	0
BARI-2479	289	290	1	1	3	1	1	0
BARI-2479	289	477	188	0	4	4	0	0
BARI-2479	289	295	6	1	3	1	2	0
BARI-2479	289	290	1	1	3	4	1	0
BARI-2479	289	331	42	1	2	1	1	1
BARI-2479	289	290	1	1	3	3	1	0
BARI-2479	289	477	188	0	3	1	1	0
BARI-2479	289	294	5	1	3	1	1	0
BARI-2480	289	294	5	1	2	1	1	0
BARI-2480	290	295	5	1	3	3	0	0
BARI-2480	290	291	1	1	3	3	0	0
BARI-2480	290	291	1	1	3	1	1	0
BARI-2480	290	294	4	1	2	3	1	0
BARI-2480	290	477	187	0	4	1	1	0
BARI-2480	291	292	1	1	1	1	1	0
BARI-2480	291	318	27	1	3	1	1	0
BARI-2480	294	296	2	1	3	1	0	0
BARI-2480	294	477	183	0	3	1	0	0
BARI-2481	294	477	183	0	2	3	1	0
BARI-2481	294	477	183	0	3	1	1	0
BARI-2481	294	295	1	1	3	3	1	0
BARI-2481	295	298	3	1	3	1	1	0
BARI-2481	295	477	182	0	3	3	1	0
BARI-2481	295	296	1	1	3	3	1	0
BARI-2481	295	296	1	1	3	3	0	0
BARI-2481	295	296	1	1	3	3	1	0
BARI-2481	295	477	182	0	3	1	0	0
BARI-2481	295	477	182	0	3	1	1	0
BARI-2482	296	297	1	1	3	3	1	0
BARI-2482	296	297	1	1	1	1	1	0
BARI-2482	296	297	1	1	4	4	1	0
BARI-2482	297	298	1	1	3	3	1	0
BARI-2482	297	380	83	1	1	1	1	0
BARI-2482	297	298	1	1	3	1	1	0
BARI-2482	297	338	41	1	3	1	1	0
BARI-2482	297	298	1	1	3	1	1	1
BARI-2482	297	298	1	1	3	1	1	0
BARI-2482	297	302	5	1	2	1	1	0
BARI-2483	297	298	1	1	3	1	1	0
BARI-2483	298	318	20	1	3	1	1	0
BARI-2483	298	318	20	1	3	1	1	0
BARI-2483	298	316	18	1	3	1	1	0
BARI-2483	298	305	7	1	3	3	1	0
BARI-2483	298	299	1	1	4	1	1	0
BARI-2483	298	311	13	1	3	1	1	0
BARI-2483	298	303	5	1	4	4	1	0
BARI-2483	301	318	17	1	1	1	1	0
BARI-2483	301	477	176	0	3	1	1	0
BARI-2484	301	304	3	1	2	1	1	0
BARI-2484	301	477	176	0	3	3	1	0
BARI-2484	301	323	22	1	3	3	1	0
BARI-2484	301	309	8	1	3	4	1	0
BARI-2484	301	304	3	1	3	4	1	0
BARI-2484	302	316	14	1	1	1	1	0
BARI-2484	302	477	175	0	3	1	1	0
BARI-2484	302	318	16	1	3	1	1	0
BARI-2484	302	400	98	1	3	1	1	1
BARI-2484	302	303	1	1	2	3	1	0
BARI-2485	302	303	1	1	3	1	1	0
BARI-2485	303	318	15	1	3	1	1	0
BARI-2485	303	305	2	1	3	1	1	0
BARI-2485	304	305	1	1	3	1	1	0
BARI-2485	304	305	1	1	2	3	1	0
BARI-2485	304	477	173	0	2	1	0	0
BARI-2485	304	477	173	0	3	1	1	0
BARI-2485	305	311	6	1	3	3	1	0
BARI-2485	308	477	169	0	3	1	0	0
BARI-2485	308	316	8	1	1	1	1	0
BARI-2486	309	477	168	0	3	1	0	0
BARI-2486	309	310	1	1	3	1	1	0
BARI-2486	309	311	2	1	1	3	0	0
BARI-2486	309	477	168	0	2	1	1	0
BARI-2486	309	311	2	1	3	1	1	0
BARI-2486	310	311	1	1	3	1	1	0
BARI-2486	310	314	4	1	3	3	1	0
BARI-2486	311	312	1	1	3	1	1	0
BARI-2486	311	312	1	1	3	1	1	0
BARI-2486	311	312	1	1	3	1	1	1
BARI-2487	311	316	5	1	2	1	0	0
BARI-2487	311	319	8	1	3	3	1	0
BARI-2487	311	477	166	0	2	1	0	1
BARI-2487	311	312	1	1	2	3	1	0
BARI-2487	312	477	165	0	3	1	0	0
BARI-2487	314	316	2	1	3	1	1	0
BARI-2487	315	323	8	1	3	1	1	0
BARI-2487	315	316	1	1	3	3	1	0
BARI-2487	315	318	3	1	3	4	1	0
BARI-2487	315	319	4	1	3	3	1	0
BARI-2488	315	333	18	1	3	3	0	0
BARI-2488	315	316	1	1	2	3	1	0
BARI-2488	315	326	11	1	3	4	0	0
BARI-2488	315	316	1	1	2	1	1	0
BARI-2488	316	317	1	1	3	1	1	0
BARI-2488	316	358	42	1	3	1	2	0
BARI-2488	316	331	15	1	3	1	1	0
BARI-2488	316	317	1	1	1	1	1	0
BARI-2488	316	317	1	1	2	3	1	0
BARI-2488	316	317	1	1	2	3	0	0
BARI-2489	316	317	1	1	3	1	1	0
BARI-2489	316	319	3	1	1	1	0	0
BARI-2489	316	331	15	1	3	1	1	0
BARI-2489	316	477	161	0	3	1	0	0
BARI-2489	317	323	6	1	3	3	1	0
BARI-2489	317	318	1	1	3	3	1	0
BARI-2489	317	340	23	1	3	3	0	0
BARI-2489	317	318	1	1	2	3	1	0
BARI-2489	317	318	1	1	3	1	1	0
BARI-2489	318	319	1	1	5	3	0	0
BARI-2490	318	332	14	1	3	3	0	0
BARI-2490	318	319	1	1	3	3	1	0
BARI-2490	318	477	159	0	3	1	1	0
BARI-2490	318	477	159	0	3	1	1	0
BARI-2490	318	477	159	0	3	1	1	0
BARI-2490	318	319	1	1	3	3	1	0
BARI-2490	318	319	1	1	2	3	1	0
BARI-2490	318	323	5	1	1	3	1	0
BARI-2490	318	477	159	0	3	1	0	0
BARI-2490	318	319	1	1	2	1	1	0
BARI-2491	318	319	1	1	3	1	1	0
BARI-2491	319	320	1	1	3	4	1	0
BARI-2491	319	329	10	1	3	1	1	0
BARI-2491	319	323	4	1	1	3	1	0
BARI-2491	319	330	11	1	2	3	1	0
BARI-2491	322	477	155	0	3	1	0	0
BARI-2491	322	324	2	1	4	1	1	0
BARI-2491	322	323	1	1	3	3	1	0
BARI-2491	322	331	9	1	3	4	1	0
BARI-2491	322	323	1	1	2	3	1	0
BARI-2492	322	477	155	0	3	1	1	0
BARI-2492	322	323	1	1	3	3	1	0
BARI-2492	322	330	8	1	4	4	1	0
BARI-2492	322	325	3	1	3	3	1	0
BARI-2492	323	477	154	0	3	1	1	0
BARI-2492	323	477	154	0	3	1	1	0
BARI-2492	323	324	1	1	2	3	1	0
BARI-2492	323	325	2	1	1	3	1	0
BARI-2492	323	324	1	1	3	1	1	0
BARI-2492	323	325	2	1	3	3	0	0
BARI-2493	323	330	7	1	2	1	1	0
BARI-2493	323	326	3	1	2	1	1	0
BARI-2493	324	325	1	1	3	1	1	0
BARI-2493	324	477	153	0	3	5	0	0
BARI-2493	324	325	1	1	3	4	1	0
BARI-2493	324	325	1	1	3	1	1	0
BARI-2493	324	326	2	1	3	3	1	0
BARI-2493	324	325	1	1	3	1	1	0
BARI-2493	324	325	1	1	2	3	1	0
BARI-2493	324	326	2	1	3	1	1	0
BARI-2494	325	477	152	0	3	1	0	0
BARI-2494	325	477	152	0	3	1	0	0
BARI-2494	325	477	152	0	3	1	1	0
BARI-2494	325	326	1	1	3	1	1	0
BARI-2494	325	477	152	0	3	3	0	0
BARI-2494	325	326	1	1	2	1	0	0
BARI-2494	326	331	5	1	3	3	1	0
BARI-2494	326	332	6	1	3	3	1	0
BARI-2494	326	327	1	1	3	1	1	0
BARI-2494	326	329	3	1	3	1	1	0
BARI-2495	329	331	2	1	3	1	1	0
BARI-2495	329	346	17	1	1	3	1	0
BARI-2495	329	331	2	1	3	1	1	0
BARI-2495	329	477	148	0	4	1	0	0
BARI-2495	329	330	1	1	3	1	1	0
BARI-2495	329	332	3	1	3	3	1	1
BARI-2495	329	330	1	1	3	1	1	0
BARI-2495	330	477	147	0	3	1	0	0
BARI-2495	330	403	73	1	4	1	0	0
BARI-2495	330	336	6	1	3	1	1	0
BARI-2496	330	346	16	1	4	3	1	0
BARI-2496	331	477	146	0	3	1	0	0
BARI-2496	331	332	1	1	3	3	1	0
BARI-2496	331	477	146	0	3	1	0	0
BARI-2496	331	332	1	1	2	3	1	0
BARI-2496	331	332	1	1	1	3	1	0
BARI-2496	331	477	146	0	1	1	1	0
BARI-2496	332	346	14	1	3	5	1	0
BARI-2496	332	477	145	0	5	3	0	0
BARI-2496	332	337	5	1	3	1	1	0
BARI-2497	332	333	1	1	3	1	0	0
BARI-2497	332	333	1	1	1	1	1	0
BARI-2497	332	334	2	1	3	4	1	0
BARI-2497	332	337	5	1	3	3	0	0
BARI-2497	332	366	34	1	3	1	1	0
BARI-2497	333	334	1	1	1	1	0	0
BARI-2497	333	477	144	0	3	1	1	0
BARI-2497	333	336	3	1	3	1	1	0
BARI-2497	333	361	28	1	3	1	1	0
BARI-2497	333	334	1	1	3	1	0	0
BARI-2498	334	337	3	1	3	4	1	0
BARI-2498	334	400	66	1	3	1	1	0
BARI-2498	334	337	3	1	4	1	1	0
BARI-2498	335	477	142	0	3	1	0	0
BARI-2498	335	477	142	0	3	1	1	0
BARI-2498	335	336	1	1	3	3	1	0
BARI-2498	336	338	2	1	3	3	1	0
BARI-2498	337	352	15	1	3	4	1	0
BARI-2498	337	338	1	1	3	4	1	0
BARI-2498	337	338	1	1	2	1	1	0
BARI-2499	337	338	1	1	3	3	0	0
BARI-2499	337	477	140	0	3	1	1	0
BARI-2499	337	339	2	1	3	1	1	1
BARI-2499	337	477	140	0	3	4	0	0
BARI-2499	337	343	6	1	1	3	1	0
BARI-2499	337	477	140	0	3	1	0	0
BARI-2499	337	340	3	1	2	1	1	0
BARI-2499	338	477	139	0	3	4	1	0
BARI-2499	338	339	1	1	2	1	1	0
BARI-2499	338	339	1	1	3	3	1	0
BARI-2500	338	344	6	1	3	1	1	0
BARI-2500	338	339	1	1	3	1	1	1
BARI-2500	338	344	6	1	2	3	1	0
BARI-2500	339	340	1	1	3	1	1	1
BARI-2500	339	477	138	0	3	1	1	0
BARI-2500	339	477	138	0	3	1	1	0
BARI-2500	339	353	14	1	3	4	1	0
BARI-2500	339	344	5	1	3	3	1	0
BARI-2500	339	340	1	1	2	1	1	0
BARI-2500	339	477	138	0	3	4	0	0
BARI-2501	339	344	5	1	3	3	0	0
BARI-2501	339	344	5	1	3	3	0	0
BARI-2501	340	341	1	1	1	4	0	0
BARI-2501	340	346	6	1	3	1	1	0
BARI-2501	340	477	137	0	3	1	1	0
BARI-2501	340	341	1	1	3	4	0	0
BARI-2501	340	341	1	1	5	4	0	0
BARI-2501	340	341	1	1	5	4	0	0
BARI-2501	340	346	6	1	3	1	1	0
BARI-2501	340	366	26	1	3	3	1	0
BARI-2502	340	399	59	1	3	4	1	0
BARI-2502	340	477	137	0	4	4	1	0
BARI-2502	340	477	137	0	3	4	1	0
BARI-2502	340	343	3	1	1	1	1	0
BARI-2502	340	477	137	0	2	3	1	0
BARI-2502	342	343	1	1	4	1	1	0
BARI-2502	343	344	1	1	3	4	0	0
BARI-2502	343	477	134	0	4	3	0	0
BARI-2502	343	374	31	1	4	5	0	0
BARI-2502	343	367	24	1	4	5	0	0
BARI-2503	344	345	1	1	2	4	1	0
BARI-2503	344	477	133	0	3	1	1	0
BARI-2503	344	345	1	1	3	3	1	0
BARI-2503	344	345	1	1	3	1	1	0
BARI-2503	344	361	17	1	3	1	3	0
BARI-2503	344	351	7	1	3	3	0	0
BARI-2503	344	345	1	1	3	3	1	0
BARI-2503	344	346	2	1	3	4	1	0
BARI-2503	345	477	132	0	3	1	0	0
BARI-2503	345	346	1	1	4	4	1	0
BARI-2504	345	346	1	1	3	4	1	0
BARI-2504	345	346	1	1	3	1	1	0
BARI-2504	346	347	1	1	3	3	1	0
BARI-2504	346	378	32	1	3	1	1	0
BARI-2504	346	477	131	0	3	5	0	0
BARI-2504	350	351	1	1	2	1	1	0
BARI-2504	351	477	126	0	3	3	1	0
BARI-2504	351	477	126	0	2	1	1	0
BARI-2504	351	352	1	1	3	3	1	0
BARI-2504	351	354	3	1	3	3	0	0
BARI-2505	351	477	126	0	2	3	1	0
BARI-2505	352	477	125	0	3	1	0	0
BARI-2505	352	353	1	1	1	1	2	0
BARI-2505	352	388	36	1	3	2	1	0
BARI-2505	352	428	76	1	3	1	1	0
BARI-2505	352	353	1	1	3	1	2	0
BARI-2505	353	422	69	1	4	1	1	0
BARI-2505	353	477	124	0	4	1	0	0
BARI-2505	353	354	1	1	3	1	1	0
BARI-2505	353	366	13	1	2	3	1	0
BARI-2506	353	477	124	0	3	3	0	0
BARI-2506	353	371	18	1	3	4	1	0
BARI-2506	353	354	1	1	3	1	1	0
BARI-2506	353	359	6	1	1	1	1	0
BARI-2506	353	477	124	0	3	1	0	0
BARI-2506	354	378	24	1	3	1	2	1
BARI-2506	354	359	5	1	2	1	1	0
BARI-2506	358	360	2	1	3	1	1	0
BARI-2506	359	477	118	0	3	1	0	0
BARI-2506	359	379	20	1	3	1	2	0
BARI-2507	361	477	116	0	3	5	1	0
BARI-2507	361	477	116	0	3	3	1	0
BARI-2507	361	477	116	0	3	3	1	0
BARI-2507	361	477	116	0	3	3	1	0
BARI-2507	361	477	116	0	3	3	1	0
BARI-2507	362	477	115	0	3	1	0	0
Q-687	0	1	1	1	3	1	0	0
Q-688	2	3	1	1	3	1	1	0
Q-688	3	477	474	0	4	1	0	0
Q-688	3	4	1	1	1	1	0	0
Q-688	8	477	469	0	4	1	0	0
Q-688	10	11	1	1	4	4	2	1
Q-688	11	477	466	0	3	1	0	0
Q-688	11	477	466	0	4	1	0	0
Q-688	18	19	1	1	3	1	1	0
Q-688	21	477	456	0	2	1	0	1
Q-688	21	22	1	1	4	1	0	0
Q-689	23	477	454	0	3	1	0	0
Q-689	24	29	5	1	3	1	1	0
Q-689	25	477	452	0	4	1	1	0
Q-689	28	477	449	0	3	1	0	0
Q-689	29	477	448	0	3	1	0	0
Q-689	35	477	442	0	3	1	0	0
Q-689	38	477	439	0	4	1	0	0
Q-689	41	43	2	1	3	1	0	0
Q-689	42	43	1	1	3	1	0	0
Q-689	44	477	433	0	4	1	0	0
Q-690	44	477	433	0	4	1	0	0
Q-690	46	47	1	1	3	1	2	2
Q-690	48	477	429	0	3	1	0	2
Q-690	51	316	265	1	2	1	0	0
Q-690	54	477	423	0	3	4	0	0
Q-690	57	477	420	0	4	1	0	0
Q-690	58	59	1	1	3	1	1	0
Q-690	58	59	1	1	3	4	1	0
Q-690	60	477	417	0	3	1	0	0
Q-690	60	127	67	1	3	3	2	0
Q-691	64	65	1	1	3	3	0	0
Q-691	65	66	1	1	3	1	0	0
Q-691	65	477	412	0	3	3	0	0
Q-691	65	477	412	0	3	5	0	0
Q-691	65	477	412	0	3	5	0	0
Q-691	65	477	412	0	3	5	0	0
Q-691	65	477	412	0	3	5	0	0
Q-691	65	477	412	0	3	5	0	0
Q-691	65	477	412	0	3	5	0	0
Q-691	65	477	412	0	3	5	0	0
Q-692	65	477	412	0	3	5	0	0
Q-692	65	477	412	0	3	5	0	0
Q-692	65	477	412	0	3	5	0	0
Q-692	66	67	1	1	3	1	0	0
Q-692	67	68	1	1	3	1	2	0
Q-692	70	477	407	0	3	1	0	0
Q-692	71	72	1	1	3	1	0	0
Q-692	72	477	405	0	3	1	0	0
Q-692	74	75	1	1	3	4	1	0
Q-692	74	477	403	0	2	1	1	1
Q-693	74	99	25	1	3	5	2	0
Q-693	76	477	401	0	3	1	0	0
Q-693	80	477	397	0	3	4	0	0
Q-693	80	81	1	1	3	4	2	0
Q-693	80	81	1	1	3	4	2	0
Q-693	81	108	27	1	2	1	0	0
Q-693	81	477	396	0	3	1	0	0
Q-693	84	477	393	0	3	1	0	1
Q-693	85	477	392	0	4	4	0	0
Q-694	86	87	1	1	3	1	2	0
Q-694	87	477	390	0	4	2	0	0
Q-694	89	477	388	0	4	1	0	0
Q-694	94	95	1	1	3	1	0	0
Q-694	98	99	1	1	4	4	0	0
Q-694	98	99	1	1	2	1	0	0
Q-694	99	477	378	0	3	1	0	0
Q-694	106	477	371	0	4	1	0	0
Q-694	106	107	1	1	3	4	0	0
Q-694	108	477	369	0	3	1	0	0
Q-695	109	110	1	1	2	3	0	0
Q-695	112	477	365	0	3	2	0	1
Q-695	113	114	1	1	3	2	0	1
Q-695	115	116	1	1	3	3	1	0
Q-695	116	205	89	1	3	1	2	1
Q-695	123	128	5	1	3	1	0	1
Q-695	124	125	1	1	3	4	1	0
Q-695	129	130	1	1	4	4	2	0
Q-695	133	134	1	1	4	4	2	0
Q-696	133	142	9	1	3	2	0	0
Q-696	134	477	343	0	3	1	0	0
Q-696	134	135	1	1	3	4	2	0
Q-696	134	477	343	0	4	4	1	0
Q-696	135	477	342	0	3	1	0	0
Q-696	135	477	342	0	3	1	0	0
Q-696	139	191	52	1	3	1	0	0
Q-696	140	207	67	1	3	1	2	1
Q-696	140	141	1	1	4	1	2	0
Q-696	142	143	1	1	1	1	0	0
Q-697	142	207	65	1	3	1	2	0
Q-697	142	143	1	1	2	1	0	0
Q-697	142	477	335	0	3	1	0	1
Q-697	142	143	1	1	3	1	0	0
Q-697	142	207	65	1	3	4	2	0
Q-697	143	204	61	1	3	1	0	1
Q-697	147	196	49	1	2	1	1	0
Q-697	148	477	329	0	1	1	0	0
Q-697	149	150	1	1	3	1	0	0
Q-697	149	151	2	1	3	1	1	1
Q-698	149	477	328	0	3	2	0	0
Q-698	150	477	327	0	3	1	0	0
Q-698	154	477	323	0	3	1	0	0
Q-698	158	477	319	0	2	1	0	0
Q-698	159	477	318	0	3	1	0	0
Q-698	161	162	1	1	3	1	0	0
Q-698	163	477	314	0	3	1	0	0
Q-698	165	204	39	1	1	1	0	0
Q-698	165	204	39	1	1	1	0	0
Q-698	165	204	39	1	1	1	0	0
Q-699	165	207	42	1	1	1	2	0
Q-699	165	204	39	1	1	1	0	0
Q-699	165	204	39	1	1	1	2	0
Q-699	165	204	39	1	1	1	0	0
Q-699	165	204	39	1	1	1	1	0
Q-699	165	204	39	1	1	1	0	0
Q-699	165	203	38	1	1	1	2	0
Q-699	165	204	39	1	3	3	2	0
Q-699	168	477	309	0	3	1	0	0
Q-699	170	171	1	1	1	1	0	0
Q-700	176	177	1	1	3	1	1	1
Q-700	176	212	36	1	3	1	1	0
Q-700	176	177	1	1	3	1	2	0
Q-700	178	477	299	0	4	5	1	0
Q-700	179	210	31	1	5	4	2	1
Q-700	182	477	295	0	3	4	0	0
Q-700	183	199	16	1	3	1	1	1
Q-700	184	185	1	1	3	4	1	0
Q-700	190	477	287	0	3	4	1	0
Q-700	190	317	127	1	2	1	1	0
Q-701	192	207	15	1	3	1	0	1
Q-701	195	196	1	1	3	1	2	0
Q-701	197	199	2	1	3	1	1	0
Q-701	198	199	1	1	3	1	2	0
Q-701	199	477	278	0	4	4	1	0
Q-701	199	200	1	1	4	2	2	1
Q-701	200	201	1	1	3	1	0	1
Q-701	201	207	6	1	5	1	2	0
Q-701	203	207	4	1	2	1	0	0
Q-701	203	207	4	1	1	1	2	0
Q-702	204	205	1	1	3	4	0	0
Q-702	205	206	1	1	3	4	2	1
Q-702	207	477	270	0	4	5	1	0
Q-702	208	209	1	1	3	2	2	0
Q-702	209	210	1	1	2	1	0	1
Q-702	209	211	2	1	2	1	0	1
Q-702	209	210	1	1	3	3	2	0
Q-702	212	213	1	1	2	4	2	1
Q-702	212	477	265	0	3	4	0	0
Q-702	213	214	1	1	4	4	2	1
Q-703	213	214	1	1	3	1	1	0
Q-703	215	477	262	0	3	3	1	0
Q-703	216	217	1	1	3	3	2	0
Q-703	218	477	259	0	3	1	0	0
Q-703	223	477	254	0	4	1	0	0
Q-703	226	227	1	1	3	1	1	1
Q-703	228	246	18	1	3	4	2	1
Q-703	231	232	1	1	3	4	1	1
Q-703	231	232	1	1	5	4	1	0
Q-703	234	477	243	0	3	1	0	0
Q-704	234	477	243	0	3	1	0	0
Q-704	234	477	243	0	3	1	0	0
Q-704	234	477	243	0	3	2	0	0
Q-704	238	477	239	0	3	4	0	0
Q-704	241	477	236	0	4	1	0	0
Q-704	241	477	236	0	3	1	1	0
Q-704	242	477	235	0	3	1	0	0
Q-704	242	246	4	1	3	4	2	1
Q-704	246	477	231	0	3	1	0	0
Q-704	248	249	1	1	3	1	0	0
Q-705	251	477	226	0	3	4	0	0
Q-705	255	477	222	0	2	1	0	0
Q-705	256	260	4	1	4	5	1	1
Q-705	257	477	220	0	3	3	1	0
Q-705	259	477	218	0	3	1	0	0
Q-705	261	262	1	1	4	4	2	0
Q-705	262	263	1	1	4	5	2	1
Q-705	262	263	1	1	4	4	1	0
Q-705	263	477	214	0	3	1	0	0
Q-705	263	477	214	0	3	1	0	0
Q-706	264	265	1	1	3	3	2	1
Q-706	266	477	211	0	4	1	0	0
Q-706	267	268	1	1	3	1	1	0
Q-706	271	283	12	1	3	4	2	0
Q-706	273	274	1	1	3	1	0	0
Q-706	274	275	1	1	3	1	2	0
Q-706	275	477	202	0	2	1	0	0
Q-706	276	289	13	1	2	1	2	0
Q-706	279	477	198	0	4	2	0	0
Q-706	282	477	195	0	4	1	0	0
Q-707	282	477	195	0	4	5	0	0
Q-707	284	285	1	1	4	4	2	0
Q-707	285	477	192	0	3	4	1	0
Q-707	286	477	191	0	3	1	0	0
Q-707	286	287	1	1	3	1	0	0
Q-707	287	288	1	1	3	1	2	0
Q-707	287	325	38	1	3	1	2	0
Q-707	288	289	1	1	3	1	1	1
Q-707	289	477	188	0	3	1	0	0
Q-707	290	291	1	1	4	1	1	1
Q-708	290	477	187	0	3	4	1	1
Q-708	291	292	1	1	3	1	0	0
Q-708	291	310	19	1	3	1	2	3
Q-708	294	477	183	0	3	1	0	0
Q-708	295	296	1	1	3	1	2	1
Q-708	295	381	86	1	3	1	2	0
Q-708	297	303	6	1	3	1	1	1
Q-708	298	477	179	0	2	4	1	1
Q-708	304	305	1	1	3	1	1	0
Q-708	305	308	3	1	3	1	0	0
Q-709	306	477	171	0	3	1	0	0
Q-709	307	315	8	1	3	1	2	0
Q-709	308	477	169	0	3	3	0	0
Q-709	310	311	1	1	3	1	2	1
Q-709	311	312	1	1	3	4	1	0
Q-709	311	477	166	0	3	1	1	0
Q-709	315	477	162	0	2	1	0	0
Q-709	316	319	3	1	4	3	1	0
Q-709	317	318	1	1	4	4	0	0
Q-709	318	319	1	1	4	1	0	0
Q-710	318	477	159	0	4	5	0	0
Q-710	318	319	1	1	3	4	1	1
Q-710	318	477	159	0	3	4	2	0
Q-710	319	325	6	1	3	1	1	0
Q-710	319	477	158	0	4	4	0	0
Q-710	324	325	1	1	3	1	2	0
Q-710	324	477	153	0	4	5	0	0
Q-710	324	477	153	0	4	1	0	0
Q-710	325	326	1	1	2	1	1	0
Q-711	325	326	1	1	4	3	1	0
Q-711	326	327	1	1	3	1	0	0
Q-711	329	438	109	1	3	5	2	0
Q-711	330	477	147	0	3	1	0	0
Q-711	331	477	146	0	3	1	1	0
Q-711	331	332	1	1	3	1	1	1
Q-711	332	477	145	0	3	5	0	0
Q-711	333	334	1	1	3	1	0	0
Q-711	334	337	3	1	2	1	2	0
Q-711	337	338	1	1	3	1	0	0
Q-712	338	477	139	0	1	1	0	0
Q-712	340	477	137	0	4	1	1	2
Q-712	340	342	2	1	3	1	0	0
Q-712	344	345	1	1	4	1	0	0
Q-712	352	353	1	1	3	4	0	0
QCPP-62	21	22	1	1	3	1	1	0
QCPP-62	24	477	453	0	3	1	0	0
QCPP-62	57	477	420	0	2	1	0	0
QCPP-62	70	477	407	0	3	1	0	0
QCPP-62	72	477	405	0	3	5	0	0
QCPP-62	77	318	241	1	3	4	0	0
QCPP-62	80	477	397	0	4	1	0	0
QCPP-63	119	120	1	1	3	1	0	0
QCPP-63	249	250	1	1	3	1	0	0
QCPP-63	269	477	208	0	4	4	0	0
QCPP-63	273	477	204	0	3	4	0	0
QCPP-63	289	477	188	0	3	1	0	0
QCPP-64	289	477	188	0	3	1	0	0
QCPP-64	318	319	1	1	3	1	0	0
QCPP-64	340	341	1	1	3	3	1	0
QCPP-64	344	388	44	1	3	2	1	3
QNET-57	18	256	238	1	3	3	0	0
QNET-57	18	189	171	1	3	5	0	0
QNET-57	18	256	238	1	3	5	0	0
QNET-57	18	256	238	1	3	5	0	0
QNET-57	235	477	242	0	3	1	0	0
NO-	94	477	383	0	3	1	0	0
Y23-32	0	108	108	1	3	1	1	0
Y23-32	2	92	90	1	4	4	1	0
Y23-32	7	23	16	1	3	4	1	2
Y23-32	7	8	1	1	3	4	1	0
Y23-32	16	24	8	1	3	1	1	1
Y23-32	27	64	37	1	4	1	1	0
Y23-32	39	53	14	1	3	1	1	0
Y23-32	41	44	3	1	1	1	1	0
Y23-33	59	477	418	0	3	1	1	0
Y23-33	59	102	43	1	3	1	1	0
Y23-33	59	301	242	1	4	4	1	0
Y23-33	63	85	22	1	4	3	1	0
Y23-33	85	102	17	1	3	1	1	0
Y23-33	85	477	392	0	4	4	1	0
Y23-33	85	91	6	1	2	1	1	0
Y23-33	85	102	17	1	3	1	1	0
Y23-33	86	87	1	1	3	1	1	0
Y23-33	88	89	1	1	3	1	1	1
Y23-34	88	91	3	1	3	1	1	1
Y23-34	92	93	1	1	4	4	1	0
Y23-34	95	477	382	0	4	4	1	0
Y23-34	101	102	1	1	3	4	1	0
Y23-34	101	102	1	1	3	1	1	1
Y23-34	102	299	197	1	3	1	1	0
Y23-34	104	105	1	1	2	1	1	0
Y23-34	105	178	73	1	4	1	1	0
Y23-34	105	141	36	1	3	1	1	0
Y23-34	105	136	31	1	3	1	1	0
Y23-35	105	177	72	1	4	1	1	0
Y23-35	105	177	72	1	3	1	1	0
Y23-35	134	135	1	1	3	4	1	0
Y23-35	178	179	1	1	3	1	1	0
Y23-35	178	191	13	1	3	4	1	0
Y23-35	179	182	3	1	4	4	1	0
Y23-35	179	185	6	1	3	5	1	0
Y23-35	189	190	1	1	4	5	1	0
Y23-35	189	190	1	1	4	5	1	0
Y23-35	189	190	1	1	4	5	1	0
Y23-36	190	191	1	1	4	5	1	0
Y23-36	190	191	1	1	4	5	1	0
Y23-36	190	191	1	1	4	5	1	0
Y23-36	191	192	1	1	4	5	1	0
Y23-36	191	192	1	1	4	5	1	0
Y23-36	191	192	1	1	4	5	1	0
Y23-36	192	193	1	1	4	5	1	0
Y23-36	193	212	19	1	4	1	1	0
Y23-36	193	196	3	1	2	1	1	0
Y23-36	198	199	1	1	3	5	1	0
Y23-37	199	477	278	0	3	1	1	0
Y23-37	200	477	277	0	3	1	1	0
Y23-37	200	208	8	1	3	1	1	1
Y23-37	205	295	90	1	4	1	1	0
Y23-37	207	211	4	1	4	4	1	0
Y23-37	208	477	269	0	3	1	1	0
Y23-37	211	212	1	1	3	1	1	0
Y23-37	211	212	1	1	3	1	1	0
Y23-37	212	213	1	1	3	1	1	0
Y23-37	212	213	1	1	3	1	1	0
Y23-38	212	213	1	1	3	1	1	0
Y23-38	213	214	1	1	3	1	1	0
Y23-38	214	215	1	1	3	1	1	0
Y23-38	214	215	1	1	3	1	1	0
Y23-38	215	241	26	1	2	1	0	0
Y23-38	216	217	1	1	3	4	1	0
Y23-38	219	220	1	1	3	1	1	1
Y23-38	219	220	1	1	2	1	1	0
Y23-38	220	231	11	1	4	5	1	0
Y23-38	228	229	1	1	3	1	1	0
Y23-39	229	238	9	1	3	4	1	0
Y23-39	231	232	1	1	3	1	1	0
Y23-39	233	241	8	1	3	1	1	0
Y23-39	236	248	12	1	3	4	1	0
Y23-39	240	248	8	1	3	4	1	0
Y23-39	242	311	69	1	3	1	1	0
Y23-39	247	295	48	1	3	4	1	0
Y23-39	253	477	224	0	5	2	1	0
Y23-39	254	477	223	0	4	4	1	0
Y23-39	263	267	4	1	3	4	1	0
Y23-40	269	477	208	0	3	4	1	0
Y23-40	269	299	30	1	3	4	1	0
Y23-40	274	301	27	1	5	4	1	0
Y23-40	276	299	23	1	3	4	1	0
Y23-40	295	296	1	1	3	5	1	0
Y23-40	296	297	1	1	3	5	1	0
Y23-40	296	301	5	1	3	1	1	0
Y23-40	296	297	1	1	3	5	1	0
Y23-40	296	297	1	1	3	5	1	0
Y23-40	296	297	1	1	3	5	1	0
Y23-41	297	298	1	1	3	5	1	0
Y23-41	297	298	1	1	3	1	1	0
Y23-41	298	477	179	0	3	1	1	0
Y23-41	301	477	176	0	4	1	1	0
Y23-41	302	303	1	1	3	4	1	0
Y23-41	303	404	101	1	4	1	1	0
Y23-41	303	326	23	1	3	1	1	0
Y23-41	304	477	173	0	3	1	1	0
Y23-41	304	402	98	1	3	4	1	0
Y23-41	311	318	7	1	2	4	1	0
Y23-42	321	326	5	1	3	1	1	0
Y23-42	337	477	140	0	3	3	1	0
Y23-42	339	399	60	1	4	5	1	0
EXCORE-80	16	22	6	1	5	3	1	0
EXCORE-80	19	23	4	1	5	3	1	0
EXCORE-80	22	477	455	0	3	4	0	0
EXCORE-80	42	477	435	0	4	1	0	0
EXCORE-80	92	95	3	1	4	5	1	0
EXCORE-80	107	170	63	1	3	1	1	0
EXCORE-80	107	112	5	1	3	4	1	0
EXCORE-80	107	477	370	0	3	4	0	0
EXCORE-81	108	166	58	1	4	1	1	0
EXCORE-81	124	129	5	1	3	3	1	0
EXCORE-81	124	477	353	0	3	3	0	0
EXCORE-81	124	477	353	0	3	3	0	0
EXCORE-81	125	477	352	0	3	3	0	0
EXCORE-81	134	135	1	1	3	3	1	1
EXCORE-81	136	477	341	0	4	1	0	0
EXCORE-81	170	171	1	1	3	1	1	0
EXMALHAR-255	8	477	469	0	4	3	1	0
EXMALHAR-255	25	477	452	0	4	4	0	0
EXMALHAR-255	42	477	435	0	3	1	1	0
EXMALHAR-255	81	477	396	0	3	1	1	1
EXMALHAR-255	166	477	311	0	2	2	0	0
EXMALHAR-255	166	477	311	0	2	2	0	0
EXMALHAR-256	166	477	311	0	3	5	0	0
EXMALHAR-256	166	477	311	0	3	5	0	0
EXMALHAR-256	166	477	311	0	3	5	0	0
EXMALHAR-256	166	477	311	0	3	5	0	0
EXMALHAR-256	166	477	311	0	3	5	0	0
EXMALHAR-256	225	226	1	1	3	4	0	0
LO-40	224	477	253	0	3	5	1	0
LO-40	284	285	1	1	3	1	0	0
CHETYPE-53	22	477	455	0	4	1	0	0
CHETYPE-53	30	477	447	0	3	1	0	0
CHETYPE-54	43	477	434	0	3	5	0	0
CHETYPE-54	51	477	426	0	2	1	0	0
CHETYPE-54	76	77	1	1	3	3	1	1
CHETYPE-54	96	97	1	1	4	5	1	0
CHETYPE-54	96	97	1	1	4	5	1	0
CHETYPE-54	96	97	1	1	4	5	1	0
CHETYPE-54	97	98	1	1	3	1	0	0
CHETYPE-54	113	477	364	0	3	1	0	0
CHETYPE-54	119	477	358	0	3	1	0	1
CHETYPE-54	143	477	334	0	3	1	0	0
CHETYPE-55	163	477	314	0	3	1	0	0
CHETYPE-55	174	439	265	1	4	5	1	0
CHETYPE-55	205	477	272	0	3	1	0	0
CHETYPE-55	221	439	218	1	3	2	1	0
CHETYPE-55	222	223	1	1	3	2	1	2
CHETYPE-55	229	439	210	1	1	1	0	0
CHETYPE-55	283	477	194	0	3	1	0	2
CHETYPE-55	306	307	1	1	4	5	1	0
IA-43	3	477	474	0	4	1	0	0
IA-43	4	477	473	0	4	1	0	0
IA-43	4	477	473	0	4	5	0	0
IA-43	8	477	469	0	4	1	0	0
IA-43	45	477	432	0	3	5	0	0
IA-43	77	477	400	0	3	5	0	0
IA-44	135	477	342	0	3	1	0	0
IES-176	14	15	1	1	3	1	1	0
IES-176	30	38	8	1	3	4	1	0
IES-177	30	32	2	1	3	1	1	0
IES-177	32	38	6	1	3	4	1	0
IES-177	35	41	6	1	3	2	0	1
IES-177	36	43	7	1	3	3	0	0
IES-177	37	38	1	1	3	4	1	0
IES-177	37	38	1	1	3	4	1	0
IES-177	38	39	1	1	3	4	1	0
IES-177	40	477	437	0	3	1	0	0
IES-177	42	115	73	1	3	4	1	0
IES-177	42	269	227	1	3	5	1	0
IES-178	45	477	432	0	3	4	1	0
IES-178	45	46	1	1	3	1	1	0
IES-178	45	50	5	1	3	1	1	0
IES-178	50	329	279	1	3	1	1	0
IES-178	50	113	63	1	3	1	0	0
IES-178	50	53	3	1	3	1	0	0
IES-178	51	52	1	1	3	4	3	0
IES-178	58	477	419	0	3	1	0	0
IES-178	62	269	207	1	3	1	1	0
IES-178	64	113	49	1	3	1	0	0
IES-179	77	78	1	1	3	1	1	0
IES-179	94	100	6	1	4	1	1	1
IES-179	102	116	14	1	3	4	1	1
IES-179	108	151	43	1	1	1	1	1
IES-179	113	114	1	1	3	1	0	0
IES-179	113	122	9	1	2	5	0	0
IES-179	114	156	42	1	3	3	1	1
IES-179	123	156	33	1	3	4	1	0
IES-179	124	157	33	1	3	5	0	0
IES-179	124	125	1	1	3	1	0	0
IES-180	126	134	8	1	3	1	1	0
IES-180	137	155	18	1	3	1	1	0
IES-180	141	142	1	1	3	5	0	0
IES-180	143	156	13	1	3	5	1	2
IES-180	148	154	6	1	2	1	0	0
IES-180	150	151	1	1	3	1	1	0
IES-180	150	323	173	1	3	2	1	0
IES-180	150	231	81	1	3	1	1	1
IES-180	150	477	327	0	3	1	0	0
IES-180	154	194	40	1	3	4	1	0
IES-181	165	168	3	1	3	1	1	0
IES-181	165	168	3	1	3	1	1	0
IES-181	165	168	3	1	4	1	1	0
IES-181	168	169	1	1	3	1	1	0
IES-181	176	197	21	1	3	4	1	2
IES-181	182	183	1	1	3	1	1	0
IES-181	183	184	1	1	3	1	1	0
IES-181	186	269	83	1	3	1	1	0
IES-181	193	194	1	1	3	4	1	0
IES-181	203	477	274	0	3	1	0	0
IES-182	204	205	1	1	3	1	1	1
IES-182	206	267	61	1	4	1	1	0
IES-182	213	215	2	1	3	5	1	0
IES-182	228	229	1	1	3	4	1	0
IES-182	228	267	39	1	3	1	1	0
IES-182	248	267	19	1	3	1	1	0
IES-182	259	260	1	1	3	1	1	0
IES-182	262	267	5	1	4	2	1	0
IES-182	262	267	5	1	3	1	1	0
IES-182	264	477	213	0	4	5	0	0
IES-183	267	268	1	1	4	2	1	0
IES-183	267	268	1	1	3	1	1	0
IES-183	267	268	1	1	4	1	1	0
IES-183	267	268	1	1	3	1	1	0
IES-183	267	268	1	1	3	1	1	0
IES-183	269	270	1	1	3	5	1	0
IES-183	269	477	208	0	3	5	1	0
IES-183	270	271	1	1	3	1	1	0
IES-183	270	271	1	1	3	1	1	0
IES-183	270	271	1	1	3	1	1	0
IES-184	270	271	1	1	3	1	1	0
IES-184	275	477	202	0	3	4	2	0
IES-184	275	276	1	1	3	1	1	0
IES-184	276	277	1	1	3	1	1	2
IES-184	281	302	21	1	3	5	1	0
IES-184	282	477	195	0	5	4	0	0
IES-184	289	290	1	1	3	1	1	0
IES-184	290	291	1	1	3	1	1	0
IES-184	290	294	4	1	3	1	0	0
IES-184	290	378	88	1	3	1	1	1
IES-185	290	291	1	1	3	1	1	0
IES-185	290	291	1	1	3	1	1	0
IES-185	294	295	1	1	3	1	1	0
IES-185	295	310	15	1	5	1	1	0
IES-185	301	302	1	1	3	4	1	0
IES-185	302	303	1	1	3	4	1	0
IES-185	305	306	1	1	3	1	1	2
IES-185	307	316	9	1	3	1	1	0
IES-185	311	312	1	1	3	4	2	3
IES-185	312	323	11	1	4	4	1	0
IES-186	314	316	2	1	3	1	1	0
IES-186	317	318	1	1	3	1	1	0
IES-186	318	319	1	1	3	4	1	0
IES-186	319	320	1	1	3	1	1	0
IES-186	323	324	1	1	3	1	1	0
IES-186	326	327	1	1	3	1	1	0
IES-186	328	338	10	1	3	1	1	0
IES-186	328	330	2	1	3	1	0	0
IES-186	329	338	9	1	3	1	1	0
IES-186	330	336	6	1	3	1	1	2
IES-187	330	338	8	1	3	1	1	0
IES-187	330	477	147	0	3	1	0	0
IES-187	338	341	3	1	3	2	1	0
IES-187	341	342	1	1	3	1	1	1
IES-187	345	346	1	1	3	1	1	0
IES-187	345	346	1	1	3	1	1	0
IES-187	345	346	1	1	3	4	1	0
IES-187	345	477	132	0	3	1	0	0
ROW-195	1	477	476	0	3	4	1	0
ROW-196	1	23	22	1	3	1	0	0
ROW-196	1	24	23	1	3	1	1	0
ROW-196	2	4	2	1	3	4	1	0
ROW-196	2	254	252	1	3	4	1	0
ROW-196	3	129	126	1	3	2	1	0
ROW-196	3	9	6	1	4	2	1	0
ROW-196	3	17	14	1	3	1	1	0
ROW-196	3	57	54	1	3	1	1	0
ROW-196	3	229	226	1	3	4	1	0
ROW-196	3	7	4	1	3	4	1	0
ROW-197	4	6	2	1	4	2	1	0
ROW-197	5	9	4	1	4	1	1	0
ROW-197	5	6	1	1	3	1	1	0
ROW-197	6	39	33	1	3	1	1	0
ROW-197	6	477	471	0	3	2	0	0
ROW-197	6	36	30	1	3	1	1	1
ROW-197	7	9	2	1	4	4	1	0
ROW-197	7	9	2	1	3	4	1	0
ROW-197	8	10	2	1	3	1	1	0
ROW-198	8	9	1	1	3	1	1	0
ROW-198	9	12	3	1	4	1	0	1
ROW-198	9	63	54	1	3	1	1	0
ROW-198	9	477	468	0	3	4	1	1
ROW-198	9	477	468	0	4	1	0	0
ROW-198	9	32	23	1	4	1	1	0
ROW-198	10	24	14	1	3	1	1	0
ROW-198	10	477	467	0	3	1	1	0
ROW-198	10	477	467	0	3	1	1	0
ROW-198	10	477	467	0	3	4	1	0
ROW-199	10	31	21	1	3	2	1	0
ROW-199	10	16	6	1	3	1	1	0
ROW-199	11	27	16	1	3	1	1	0
ROW-199	11	329	318	1	3	4	1	0
ROW-199	12	309	297	1	3	4	1	0
ROW-199	13	14	1	1	3	1	0	0
ROW-199	14	267	253	1	3	1	1	0
ROW-199	14	22	8	1	3	1	1	0
ROW-199	14	42	28	1	3	1	1	0
ROW-199	14	27	13	1	3	1	1	0
ROW-200	15	19	4	1	3	1	1	0
ROW-200	15	477	462	0	4	4	0	0
ROW-200	16	17	1	1	3	1	1	0
ROW-200	16	24	8	1	3	1	1	0
ROW-200	16	17	1	1	3	4	1	0
ROW-200	16	18	2	1	3	1	1	0
ROW-200	17	477	460	0	3	4	1	0
ROW-200	17	25	8	1	3	4	1	0
ROW-200	17	52	35	1	3	1	1	0
ROW-200	17	477	460	0	3	4	0	0
ROW-201	17	25	8	1	3	1	1	0
ROW-201	18	19	1	1	3	4	1	0
ROW-201	18	20	2	1	4	4	1	0
ROW-201	18	477	459	0	4	2	0	0
ROW-201	18	92	74	1	3	4	1	0
ROW-201	19	431	412	1	4	4	1	1
ROW-201	20	29	9	1	3	4	0	0
ROW-201	22	24	2	1	3	1	1	0
ROW-201	22	23	1	1	4	4	1	0
ROW-201	22	52	30	1	2	4	1	0
ROW-202	23	106	83	1	3	1	1	1
ROW-202	23	401	378	1	3	4	0	0
ROW-202	23	435	412	1	3	4	1	0
ROW-202	23	57	34	1	3	1	1	1
ROW-202	23	31	8	1	4	4	1	0
ROW-202	23	24	1	1	3	1	1	0
ROW-202	23	348	325	1	3	1	1	1
ROW-202	23	267	244	1	3	1	1	0
ROW-202	23	27	4	1	3	4	1	0
ROW-202	23	24	1	1	3	1	1	0
ROW-203	23	37	14	1	3	1	0	0
ROW-203	24	25	1	1	4	4	1	0
ROW-203	24	25	1	1	3	1	1	0
ROW-203	24	29	5	1	4	1	1	0
ROW-203	24	477	453	0	3	2	0	0
ROW-203	24	25	1	1	3	4	1	0
ROW-203	24	29	5	1	4	4	1	0
ROW-203	24	477	453	0	3	1	1	0
ROW-203	24	373	349	1	3	1	1	0
ROW-203	25	45	20	1	4	1	1	0
ROW-204	25	58	33	1	3	1	1	0
ROW-204	25	477	452	0	3	1	1	0
ROW-204	25	30	5	1	3	4	1	0
ROW-204	25	26	1	1	4	4	1	0
ROW-204	25	36	11	1	4	1	1	0
ROW-204	26	477	451	0	4	2	0	0
ROW-204	26	58	32	1	3	4	1	0
ROW-204	27	29	2	1	4	1	1	0
ROW-204	27	29	2	1	3	4	1	0
ROW-204	27	40	13	1	5	1	1	0
ROW-205	27	32	5	1	4	4	1	0
ROW-205	28	477	449	0	3	1	0	0
ROW-205	28	32	4	1	5	3	1	0
ROW-205	29	401	372	1	4	4	1	0
ROW-205	29	30	1	1	5	3	1	0
ROW-205	29	115	86	1	3	3	1	1
ROW-205	29	30	1	1	3	5	0	0
ROW-205	29	477	448	0	3	4	1	0
ROW-205	29	401	372	1	3	3	0	1
ROW-205	29	207	178	1	3	1	1	1
ROW-206	29	78	49	1	3	4	1	1
ROW-206	29	217	188	1	3	4	1	0
ROW-206	29	30	1	1	1	1	1	0
ROW-206	29	477	448	0	3	4	0	0
ROW-206	29	30	1	1	4	4	1	0
ROW-206	30	31	1	1	3	4	1	0
ROW-206	30	53	23	1	3	4	1	0
ROW-206	30	220	190	1	3	1	0	1
ROW-206	30	45	15	1	3	4	1	0
ROW-206	30	52	22	1	3	4	1	0
ROW-207	30	31	1	1	4	1	1	0
ROW-207	30	35	5	1	3	4	1	0
ROW-207	31	32	1	1	4	1	1	0
ROW-207	31	38	7	1	3	4	1	0
ROW-207	31	114	83	1	4	4	1	0
ROW-207	31	477	446	0	3	4	0	0
ROW-207	31	32	1	1	3	4	1	0
ROW-207	31	477	446	0	3	4	1	0
ROW-207	31	477	446	0	3	4	0	0
ROW-207	31	477	446	0	4	4	0	0
ROW-208	31	35	4	1	3	1	1	0
ROW-208	31	477	446	0	3	1	0	0
ROW-208	32	38	6	1	3	4	1	0
ROW-208	32	34	2	1	3	4	1	0
ROW-208	32	33	1	1	3	1	1	0
ROW-208	34	35	1	1	3	4	1	0
ROW-208	34	37	3	1	3	4	1	0
ROW-208	34	35	1	1	4	4	1	0
ROW-208	34	35	1	1	4	4	1	0
ROW-209	35	36	1	1	4	4	1	0
ROW-209	35	36	1	1	4	4	0	0
ROW-209	35	233	198	1	3	4	0	0
ROW-209	35	53	18	1	3	4	1	0
ROW-209	35	56	21	1	3	4	1	0
ROW-209	35	37	2	1	3	4	1	0
ROW-209	35	37	2	1	3	4	1	1
ROW-209	35	100	65	1	3	4	1	0
ROW-209	36	477	441	0	3	2	1	0
ROW-209	36	70	34	1	3	4	1	0
ROW-210	36	98	62	1	3	4	1	0
ROW-210	36	105	69	1	3	1	1	0
ROW-210	36	463	427	1	3	5	1	1
ROW-210	36	477	441	0	3	5	1	2
ROW-210	36	477	441	0	3	5	1	1
ROW-210	36	477	441	0	3	5	1	0
ROW-210	37	42	5	1	4	1	1	0
ROW-210	37	38	1	1	4	4	1	0
ROW-210	37	38	1	1	5	3	1	0
ROW-210	37	38	1	1	3	1	1	0
ROW-211	37	38	1	1	3	4	1	0
ROW-211	37	38	1	1	5	4	1	0
ROW-211	37	401	364	1	3	4	1	0
ROW-211	38	319	281	1	3	1	1	0
ROW-211	38	39	1	1	3	3	1	0
ROW-211	38	142	104	1	3	4	1	2
ROW-211	38	142	104	1	3	4	1	1
ROW-211	38	46	8	1	3	4	1	0
ROW-211	38	70	32	1	3	4	1	0
ROW-211	38	477	439	0	3	1	1	0
ROW-212	39	40	1	1	3	4	1	0
ROW-212	39	50	11	1	3	4	1	0
ROW-212	39	92	53	1	3	1	1	0
ROW-212	39	40	1	1	3	3	1	0
ROW-212	40	42	2	1	3	1	1	0
ROW-212	40	477	437	0	3	4	0	0
ROW-212	40	477	437	0	3	4	0	0
ROW-212	40	477	437	0	3	4	1	0
ROW-212	41	42	1	1	3	1	1	0
ROW-212	41	42	1	1	3	1	1	0
ROW-213	41	477	436	0	3	4	1	0
ROW-213	41	52	11	1	3	1	1	0
ROW-213	41	52	11	1	3	4	1	0
ROW-213	41	42	1	1	3	1	1	0
ROW-213	42	43	1	1	4	3	1	0
ROW-213	42	70	28	1	3	1	1	1
ROW-213	42	477	435	0	3	1	1	0
ROW-213	42	43	1	1	3	4	1	0
ROW-213	42	43	1	1	5	4	1	0
ROW-213	42	46	4	1	4	1	1	0
ROW-214	42	87	45	1	3	4	1	0
ROW-214	42	92	50	1	3	4	1	1
ROW-214	42	71	29	1	3	4	1	0
ROW-214	42	49	7	1	3	4	1	0
ROW-214	42	49	7	1	3	4	1	0
ROW-214	43	59	16	1	3	1	1	1
ROW-214	43	44	1	1	3	4	1	0
ROW-214	43	107	64	1	3	4	1	0
ROW-214	43	401	358	1	3	1	0	0
ROW-214	43	44	1	1	5	3	1	0
ROW-215	43	67	24	1	4	1	1	0
ROW-215	43	45	2	1	4	1	1	0
ROW-215	43	477	434	0	3	4	0	0
ROW-215	44	59	15	1	3	1	1	1
ROW-215	44	64	20	1	4	4	1	0
ROW-215	44	45	1	1	4	4	1	0
ROW-215	44	45	1	1	5	3	1	0
ROW-215	44	59	15	1	3	1	1	0
ROW-215	44	45	1	1	3	1	1	0
ROW-215	44	49	5	1	3	2	1	0
ROW-216	44	59	15	1	3	1	1	0
ROW-216	44	46	2	1	3	1	1	0
ROW-216	45	51	6	1	3	1	1	0
ROW-216	45	49	4	1	3	4	1	0
ROW-216	45	477	432	0	3	4	1	0
ROW-216	45	275	230	1	4	4	1	0
ROW-216	46	47	1	1	3	2	1	0
ROW-216	46	67	21	1	3	1	1	0
ROW-216	47	49	2	1	3	4	1	0
ROW-216	48	49	1	1	3	4	1	0
ROW-217	48	49	1	1	3	1	1	0
ROW-217	49	50	1	1	3	1	1	0
ROW-217	49	50	1	1	3	1	1	0
ROW-217	49	50	1	1	3	1	1	0
ROW-217	49	50	1	1	3	4	1	0
ROW-217	49	50	1	1	3	1	1	0
ROW-217	49	60	11	1	3	2	1	0
ROW-217	49	59	10	1	3	4	1	0
ROW-217	49	50	1	1	4	1	1	0
ROW-217	49	50	1	1	4	1	1	0
ROW-218	49	52	3	1	3	4	1	0
ROW-218	49	68	19	1	3	4	1	0
ROW-218	49	101	52	1	3	1	1	1
ROW-218	49	401	352	1	3	4	1	0
ROW-218	50	54	4	1	3	4	1	0
ROW-218	50	55	5	1	3	4	1	0
ROW-218	50	477	427	0	3	4	1	0
ROW-218	50	401	351	1	3	4	0	0
ROW-218	50	51	1	1	3	1	0	0
ROW-218	50	205	155	1	3	1	1	0
ROW-219	50	51	1	1	3	2	1	0
ROW-219	50	54	4	1	3	4	1	0
ROW-219	51	52	1	1	3	1	1	0
ROW-219	51	100	49	1	3	1	1	1
ROW-219	51	59	8	1	4	1	1	0
ROW-219	51	93	42	1	3	1	1	1
ROW-219	51	477	426	0	3	4	0	0
ROW-219	52	53	1	1	5	3	1	0
ROW-219	52	59	7	1	3	4	1	0
ROW-219	52	63	11	1	3	4	1	0
ROW-220	52	477	425	0	3	1	0	0
ROW-220	52	53	1	1	4	3	1	0
ROW-220	52	477	425	0	3	4	0	0
ROW-220	53	57	4	1	5	4	1	0
ROW-220	53	55	2	1	3	4	1	0
ROW-220	53	60	7	1	3	2	1	0
ROW-220	53	56	3	1	3	4	1	0
ROW-220	54	130	76	1	3	2	1	0
ROW-220	54	56	2	1	1	1	1	0
ROW-220	55	60	5	1	3	1	1	0
ROW-221	55	57	2	1	3	1	1	0
ROW-221	55	325	270	1	3	4	1	1
ROW-221	55	56	1	1	3	1	1	0
ROW-221	56	57	1	1	3	1	1	0
ROW-221	56	57	1	1	3	1	1	0
ROW-221	56	59	3	1	3	4	1	0
ROW-221	56	317	261	1	4	4	1	0
ROW-221	56	477	421	0	3	4	1	0
ROW-221	56	58	2	1	4	4	1	0
ROW-221	56	57	1	1	3	1	1	0
ROW-222	56	217	161	1	3	1	1	0
ROW-222	56	477	421	0	3	4	1	0
ROW-222	56	110	54	1	3	4	1	0
ROW-222	56	57	1	1	3	1	1	0
ROW-222	56	100	44	1	3	4	1	2
ROW-222	57	58	1	1	3	1	1	0
ROW-222	57	58	1	1	3	1	1	0
ROW-222	57	71	14	1	1	1	1	1
ROW-222	57	62	5	1	3	1	1	0
ROW-222	57	477	420	0	3	2	0	0
ROW-223	57	58	1	1	3	1	1	0
ROW-223	58	59	1	1	3	4	1	0
ROW-223	58	60	2	1	3	1	1	0
ROW-223	58	59	1	1	3	1	1	0
ROW-223	58	64	6	1	3	1	1	0
ROW-223	58	377	319	1	3	3	1	0
ROW-223	58	67	9	1	3	3	1	0
ROW-223	59	477	418	0	3	1	1	0
ROW-223	59	65	6	1	4	4	1	0
ROW-223	59	66	7	1	4	3	1	0
ROW-224	59	70	11	1	4	1	1	0
ROW-224	59	102	43	1	3	4	1	1
ROW-224	59	401	342	1	4	4	1	0
ROW-224	59	63	4	1	3	1	1	0
ROW-224	60	62	2	1	3	1	1	0
ROW-224	60	62	2	1	1	1	1	0
ROW-224	60	100	40	1	3	1	1	2
ROW-224	60	477	417	0	3	1	1	0
ROW-224	61	477	416	0	3	2	1	4
ROW-225	62	67	5	1	3	4	1	0
ROW-225	62	63	1	1	4	1	1	0
ROW-225	62	63	1	1	3	2	1	1
ROW-225	62	63	1	1	3	2	1	0
ROW-225	62	63	1	1	3	1	1	0
ROW-225	62	477	415	0	3	1	0	1
ROW-225	63	477	414	0	3	1	1	0
ROW-225	63	64	1	1	3	4	1	0
ROW-225	63	64	1	1	1	1	1	0
ROW-225	63	64	1	1	3	1	0	1
ROW-226	63	477	414	0	4	4	1	0
ROW-226	63	64	1	1	3	4	1	0
ROW-226	63	67	4	1	3	2	1	0
ROW-226	63	67	4	1	3	1	1	0
ROW-226	63	110	47	1	3	4	1	0
ROW-226	63	64	1	1	4	1	1	0
ROW-226	63	401	338	1	3	4	0	0
ROW-226	64	95	31	1	3	2	1	0
ROW-226	64	67	3	1	3	1	1	0
ROW-226	64	67	3	1	3	1	1	0
ROW-227	64	67	3	1	3	1	1	0
ROW-227	64	65	1	1	5	4	0	0
ROW-227	64	65	1	1	5	1	1	0
ROW-227	64	124	60	1	3	1	1	0
ROW-227	64	477	413	0	2	1	0	0
ROW-227	64	67	3	1	4	1	1	0
ROW-227	64	93	29	1	3	4	1	0
ROW-227	64	71	7	1	3	4	0	0
ROW-227	64	477	413	0	3	1	0	0
ROW-227	64	65	1	1	3	4	1	0
ROW-228	64	65	1	1	1	1	1	0
ROW-228	64	80	16	1	3	4	1	0
ROW-228	64	70	6	1	3	4	1	0
ROW-228	65	66	1	1	4	4	1	0
ROW-228	65	67	2	1	5	1	1	0
ROW-228	65	126	61	1	3	4	1	0
ROW-228	65	115	50	1	3	5	1	0
ROW-228	65	157	92	1	3	4	1	0
ROW-228	66	67	1	1	3	1	1	0
ROW-228	66	67	1	1	4	4	1	0
ROW-229	66	477	411	0	3	4	0	0
ROW-229	67	68	1	1	5	4	1	0
ROW-229	67	70	3	1	3	4	1	0
ROW-229	67	70	3	1	3	4	1	0
ROW-229	67	477	410	0	3	1	0	0
ROW-229	67	477	410	0	4	4	0	0
ROW-229	68	477	409	0	4	4	0	0
ROW-229	70	71	1	1	3	1	1	0
ROW-229	70	477	407	0	3	4	1	0
ROW-229	71	79	8	1	3	2	1	0
ROW-230	71	203	132	1	1	1	1	0
ROW-230	71	84	13	1	3	4	1	0
ROW-230	71	120	49	1	3	4	1	0
ROW-230	71	477	406	0	3	1	0	0
ROW-230	71	72	1	1	2	1	1	0
ROW-230	71	98	27	1	3	1	1	0
ROW-230	71	72	1	1	1	1	1	0
ROW-230	71	73	2	1	3	1	1	0
ROW-230	72	93	21	1	3	4	1	0
ROW-230	72	73	1	1	5	3	1	0
ROW-231	73	280	207	1	3	1	1	0
ROW-231	73	74	1	1	3	1	1	0
ROW-231	73	74	1	1	1	1	1	0
ROW-231	73	74	1	1	3	1	1	0
ROW-231	73	110	37	1	3	1	1	0
ROW-231	73	106	33	1	3	4	1	1
ROW-231	73	74	1	1	3	1	1	0
ROW-231	73	477	404	0	4	1	0	0
ROW-231	73	74	1	1	3	1	1	0
ROW-231	74	107	33	1	3	2	1	0
ROW-232	74	75	1	1	1	1	1	0
ROW-232	74	75	1	1	3	4	1	0
ROW-232	74	81	7	1	3	4	1	0
ROW-232	74	400	326	1	3	4	1	0
ROW-232	74	194	120	1	3	4	1	0
ROW-232	74	94	20	1	3	4	1	0
ROW-232	75	199	124	1	1	1	1	0
ROW-232	77	87	10	1	3	1	1	0
ROW-232	77	98	21	1	3	1	1	0
ROW-232	78	79	1	1	3	3	1	0
ROW-233	78	162	84	1	3	2	1	0
ROW-233	78	81	3	1	4	1	1	0
ROW-233	79	121	42	1	3	4	1	0
ROW-233	79	80	1	1	3	1	1	0
ROW-233	79	80	1	1	3	3	1	0
ROW-233	79	180	101	1	3	4	1	0
ROW-233	79	80	1	1	3	4	1	0
ROW-233	79	277	198	1	3	3	1	0
ROW-233	79	252	173	1	3	3	1	0
ROW-233	80	477	397	0	4	4	1	0
ROW-234	80	81	1	1	3	4	1	0
ROW-234	80	81	1	1	3	4	1	0
ROW-234	80	81	1	1	3	1	1	0
ROW-234	80	81	1	1	3	3	1	0
ROW-234	80	182	102	1	3	2	1	0
ROW-234	80	81	1	1	3	3	1	0
ROW-234	81	82	1	1	3	1	1	0
ROW-234	81	477	396	0	4	1	0	0
ROW-234	81	83	2	1	4	4	1	0
ROW-234	82	83	1	1	3	1	1	0
ROW-235	82	83	1	1	4	4	1	0
ROW-235	83	92	9	1	3	1	1	0
ROW-235	83	233	150	1	3	4	1	0
ROW-235	84	98	14	1	3	3	1	0
ROW-235	84	85	1	1	3	1	1	0
ROW-235	84	95	11	1	3	1	1	0
ROW-235	84	132	48	1	3	1	1	0
ROW-235	84	92	8	1	3	1	1	0
ROW-235	85	477	392	0	4	2	0	0
ROW-235	85	87	2	1	4	3	0	0
ROW-236	86	477	391	0	3	4	0	0
ROW-236	86	89	3	1	3	2	1	0
ROW-236	86	477	391	0	3	5	0	0
ROW-236	87	477	390	0	3	4	0	1
ROW-236	87	94	7	1	3	5	1	1
ROW-236	87	477	390	0	3	1	1	0
ROW-236	87	477	390	0	3	4	1	0
ROW-236	87	477	390	0	3	1	1	0
ROW-236	87	88	1	1	1	1	1	0
ROW-236	88	101	13	1	3	1	1	1
ROW-237	88	90	2	1	4	1	1	0
ROW-237	88	90	2	1	4	1	1	0
ROW-237	88	154	66	1	3	1	1	1
ROW-237	89	400	311	1	4	2	0	0
ROW-237	89	338	249	1	3	2	1	0
ROW-237	90	92	2	1	3	1	1	0
ROW-237	90	91	1	1	3	4	1	0
ROW-237	91	92	1	1	3	1	1	0
ROW-237	91	92	1	1	4	4	1	0
ROW-237	91	477	386	0	3	4	1	0
ROW-238	91	94	3	1	3	1	1	0
ROW-238	91	92	1	1	3	2	1	0
ROW-238	92	93	1	1	3	1	1	0
ROW-238	92	191	99	1	3	1	1	0
ROW-238	92	94	2	1	5	4	1	0
ROW-238	92	93	1	1	3	2	1	0
ROW-238	92	93	1	1	3	4	0	1
ROW-238	92	102	10	1	3	1	1	0
ROW-238	93	94	1	1	4	4	1	0
ROW-238	93	126	33	1	3	5	1	0
ROW-239	93	110	17	1	3	5	1	0
ROW-239	93	98	5	1	3	1	1	0
ROW-239	93	422	329	1	4	1	1	0
ROW-239	93	110	17	1	5	1	1	0
ROW-239	93	207	114	1	4	4	1	0
ROW-239	93	165	72	1	4	4	1	0
ROW-239	94	95	1	1	5	4	1	0
ROW-239	94	103	9	1	3	4	1	0
ROW-239	94	95	1	1	3	2	1	0
ROW-239	94	372	278	1	3	1	1	0
ROW-240	94	173	79	1	3	4	1	0
ROW-240	94	95	1	1	4	2	1	0
ROW-240	94	95	1	1	3	4	1	0
ROW-240	94	96	2	1	3	1	1	0
ROW-240	95	96	1	1	5	4	1	0
ROW-240	95	96	1	1	4	1	1	0
ROW-240	95	98	3	1	3	1	1	0
ROW-240	95	100	5	1	3	2	1	0
ROW-240	95	98	3	1	3	2	1	0
ROW-240	95	433	338	1	3	3	1	0
ROW-241	95	477	382	0	3	4	1	0
ROW-241	95	99	4	1	3	4	1	0
ROW-241	95	477	382	0	3	3	1	0
ROW-241	96	98	2	1	4	4	1	0
ROW-241	96	98	2	1	5	4	1	0
ROW-241	96	98	2	1	3	4	1	0
ROW-241	96	98	2	1	3	5	1	0
ROW-241	97	120	23	1	3	4	1	0
ROW-241	98	99	1	1	3	1	1	0
ROW-241	98	99	1	1	3	1	1	0
ROW-242	98	99	1	1	3	1	1	0
ROW-242	98	127	29	1	5	1	1	1
ROW-242	98	120	22	1	4	4	1	0
ROW-242	98	108	10	1	4	1	1	0
ROW-242	98	99	1	1	3	1	1	0
ROW-242	98	99	1	1	3	1	1	0
ROW-242	98	99	1	1	3	1	1	0
ROW-242	98	112	14	1	3	4	1	0
ROW-242	98	477	379	0	3	4	1	0
ROW-242	98	106	8	1	4	1	0	0
ROW-243	98	151	53	1	3	4	1	0
ROW-243	98	477	379	0	3	4	0	0
ROW-243	98	101	3	1	3	1	1	1
ROW-243	98	99	1	1	3	4	1	0
ROW-243	99	100	1	1	3	4	1	0
ROW-243	99	104	5	1	3	4	1	0
ROW-243	99	120	21	1	3	4	1	0
ROW-243	99	101	2	1	3	1	1	0
ROW-243	99	100	1	1	3	1	1	0
ROW-243	99	179	80	1	3	4	1	0
ROW-244	99	100	1	1	3	2	1	0
ROW-244	99	100	1	1	3	1	1	0
ROW-244	99	107	8	1	3	4	1	0
ROW-244	99	108	9	1	4	1	1	0
ROW-244	99	477	378	0	3	4	1	0
ROW-244	100	101	1	1	5	4	1	0
ROW-244	100	477	377	0	3	4	1	1
ROW-244	100	477	377	0	3	4	1	2
ROW-244	100	114	14	1	3	4	1	1
ROW-244	101	477	376	0	3	4	0	0
ROW-245	101	110	9	1	3	1	1	1
ROW-245	101	102	1	1	3	4	1	0
ROW-245	102	117	15	1	3	1	1	0
ROW-245	102	110	8	1	3	4	1	0
ROW-245	102	105	3	1	3	1	1	0
ROW-245	102	103	1	1	3	1	1	0
ROW-245	102	103	1	1	3	1	0	0
ROW-245	102	110	8	1	3	1	1	0
ROW-245	102	108	6	1	3	4	1	0
ROW-245	103	123	20	1	3	1	1	0
ROW-246	103	427	324	1	4	4	1	0
ROW-246	104	477	373	0	1	1	1	1
ROW-246	104	120	16	1	3	1	1	0
ROW-246	105	106	1	1	3	4	1	0
ROW-246	105	106	1	1	4	3	1	0
ROW-246	105	107	2	1	3	1	1	0
ROW-246	106	121	15	1	3	1	1	0
ROW-246	106	462	356	1	3	2	1	0
ROW-246	107	108	1	1	4	1	1	0
ROW-246	107	108	1	1	3	4	1	0
ROW-247	107	112	5	1	3	4	1	0
ROW-247	107	109	2	1	3	1	1	0
ROW-247	107	109	2	1	3	4	1	0
ROW-247	108	109	1	1	3	1	1	0
ROW-247	108	120	12	1	3	1	1	0
ROW-247	108	347	239	1	5	4	1	0
ROW-247	108	401	293	1	4	4	1	0
ROW-247	108	126	18	1	3	3	1	0
ROW-247	108	123	15	1	3	4	1	0
ROW-247	108	129	21	1	3	5	1	0
ROW-248	108	215	107	1	3	4	1	0
ROW-248	109	110	1	1	3	4	1	0
ROW-248	109	120	11	1	3	2	1	0
ROW-248	109	289	180	1	3	4	1	0
ROW-248	110	120	10	1	3	4	1	0
ROW-248	110	120	10	1	3	4	1	0
ROW-248	110	136	26	1	3	4	1	0
ROW-248	110	431	321	1	3	4	1	0
ROW-248	110	164	54	1	3	4	1	0
ROW-248	110	113	3	1	3	1	1	0
ROW-249	110	477	367	0	3	1	1	0
ROW-249	110	127	17	1	3	1	1	0
ROW-249	110	112	2	1	3	1	1	0
ROW-249	110	121	11	1	3	2	1	1
ROW-249	112	113	1	1	3	5	1	0
ROW-249	112	477	365	0	4	4	0	0
ROW-249	112	477	365	0	3	4	0	0
ROW-249	112	115	3	1	3	5	1	0
ROW-249	112	120	8	1	3	5	1	0
ROW-250	112	130	18	1	2	1	1	0
ROW-250	112	477	365	0	4	4	1	0
ROW-250	113	114	1	1	3	1	1	0
ROW-250	113	120	7	1	4	1	1	0
ROW-250	113	357	244	1	3	4	1	0
ROW-250	113	121	8	1	3	5	1	0
ROW-250	113	114	1	1	3	4	1	1
ROW-250	114	120	6	1	5	4	1	0
ROW-250	114	115	1	1	3	4	1	0
ROW-250	114	120	6	1	3	1	1	1
ROW-251	114	121	7	1	4	1	1	0
ROW-251	114	121	7	1	4	1	1	0
ROW-251	114	477	363	0	4	4	1	0
ROW-251	115	119	4	1	4	4	1	0
ROW-251	115	203	88	1	3	1	1	0
ROW-251	115	119	4	1	3	1	1	0
ROW-251	115	122	7	1	3	4	1	0
ROW-251	116	437	321	1	3	2	0	0
ROW-251	116	117	1	1	1	1	1	0
ROW-251	117	232	115	1	3	2	1	0
ROW-252	117	251	134	1	4	4	1	0
ROW-252	117	136	19	1	3	4	1	0
ROW-252	117	122	5	1	3	4	1	0
ROW-252	117	427	310	1	4	2	1	1
ROW-252	118	477	359	0	3	4	0	0
ROW-252	119	120	1	1	4	4	1	0
ROW-252	119	120	1	1	5	4	1	0
ROW-252	119	120	1	1	4	4	1	0
ROW-252	119	120	1	1	3	4	1	0
ROW-252	120	121	1	1	4	4	1	1
ROW-253	120	121	1	1	4	1	1	0
ROW-253	120	121	1	1	3	4	1	0
ROW-253	120	477	357	0	3	4	1	1
ROW-253	120	121	1	1	3	4	1	0
ROW-253	120	121	1	1	3	1	1	0
ROW-253	121	304	183	1	3	3	1	0
ROW-253	121	122	1	1	5	4	1	0
ROW-253	122	144	22	1	3	2	1	0
ROW-253	123	477	354	0	3	4	0	0
ROW-253	123	124	1	1	4	4	1	0
ROW-254	123	126	3	1	4	4	1	0
ROW-254	123	124	1	1	3	4	1	0
ROW-254	123	477	354	0	3	4	0	0
ROW-254	125	126	1	1	5	3	1	0
ROW-254	126	127	1	1	3	4	1	0
ROW-254	126	127	1	1	3	1	1	0
ROW-254	126	127	1	1	3	1	1	0
ROW-254	126	127	1	1	3	4	1	0
ROW-254	126	127	1	1	3	4	1	0
ROW-254	127	128	1	1	4	4	1	0
ROW-255	127	128	1	1	4	4	1	0
ROW-255	127	159	32	1	4	4	1	0
ROW-255	127	136	9	1	1	4	1	0
ROW-255	127	195	68	1	1	4	1	0
ROW-255	127	164	37	1	3	1	1	0
ROW-255	127	273	146	1	3	4	1	0
ROW-255	128	130	2	1	4	1	0	0
ROW-255	128	129	1	1	4	5	1	0
ROW-255	128	134	6	1	4	4	1	0
ROW-255	128	130	2	1	4	4	0	0
ROW-256	128	351	223	1	5	3	1	0
ROW-256	128	135	7	1	3	1	1	0
ROW-256	128	129	1	1	3	3	1	0
ROW-256	128	133	5	1	3	4	1	0
ROW-256	128	129	1	1	4	1	1	0
ROW-256	129	130	1	1	3	1	1	0
ROW-256	129	130	1	1	5	3	1	0
ROW-256	129	131	2	1	3	4	1	0
ROW-256	129	144	15	1	3	4	1	0
ROW-256	129	132	3	1	3	4	1	0
ROW-257	130	131	1	1	4	1	1	0
ROW-257	130	132	2	1	4	1	1	0
ROW-257	130	477	347	0	4	4	1	0
ROW-257	130	139	9	1	3	1	0	0
ROW-257	130	136	6	1	3	4	1	0
ROW-257	130	204	74	1	4	1	1	0
ROW-257	132	133	1	1	3	2	1	0
ROW-257	133	134	1	1	3	4	1	0
ROW-257	133	134	1	1	3	1	1	0
ROW-257	133	477	344	0	3	1	1	0
ROW-258	133	134	1	1	3	4	1	0
ROW-258	133	134	1	1	3	4	0	0
ROW-258	134	135	1	1	3	4	1	0
ROW-258	134	228	94	1	3	4	1	0
ROW-258	134	135	1	1	3	1	1	1
ROW-258	134	141	7	1	3	4	1	0
ROW-258	134	204	70	1	1	4	1	0
ROW-258	135	477	342	0	3	1	1	0
ROW-258	135	477	342	0	3	1	0	0
ROW-258	135	136	1	1	3	1	1	0
ROW-259	135	477	342	0	2	1	0	0
ROW-259	135	329	194	1	3	1	1	0
ROW-259	135	356	221	1	3	1	1	0
ROW-259	135	148	13	1	3	1	1	0
ROW-259	135	136	1	1	2	1	1	0
ROW-259	136	137	1	1	4	4	1	0
ROW-259	136	179	43	1	4	4	1	0
ROW-259	136	138	2	1	4	4	1	0
ROW-259	136	407	271	1	3	1	1	0
ROW-259	136	176	40	1	4	1	1	0
ROW-260	136	477	341	0	4	4	1	0
ROW-260	136	188	52	1	4	1	1	0
ROW-260	136	477	341	0	3	5	0	0
ROW-260	136	154	18	1	4	1	1	0
ROW-260	136	142	6	1	3	2	1	1
ROW-260	136	477	341	0	3	2	1	1
ROW-260	136	477	341	0	3	2	1	1
ROW-260	136	477	341	0	3	2	1	1
ROW-260	136	176	40	1	3	2	1	1
ROW-260	136	477	341	0	3	2	1	1
ROW-261	136	477	341	0	3	2	1	1
ROW-261	137	138	1	1	3	4	1	0
ROW-261	137	138	1	1	3	4	1	0
ROW-261	138	140	2	1	3	2	1	0
ROW-261	138	140	2	1	3	3	1	0
ROW-261	138	140	2	1	3	1	1	0
ROW-261	139	477	338	0	3	1	0	0
ROW-261	139	252	113	1	5	4	1	0
ROW-261	139	437	298	1	5	4	1	0
ROW-261	139	477	338	0	4	4	1	0
ROW-262	139	435	296	1	3	4	1	0
ROW-262	140	477	337	0	3	3	1	0
ROW-262	140	401	261	1	3	1	1	1
ROW-262	140	477	337	0	3	4	0	0
ROW-262	141	343	202	1	3	4	1	0
ROW-262	141	477	336	0	3	4	1	1
ROW-262	141	162	21	1	4	4	1	0
ROW-262	141	423	282	1	3	4	1	0
ROW-262	141	477	336	0	3	4	1	1
ROW-262	141	142	1	1	3	1	1	0
ROW-263	141	142	1	1	4	1	1	0
ROW-263	141	477	336	0	3	2	0	0
ROW-263	142	148	6	1	3	1	1	1
ROW-263	142	401	259	1	3	1	0	0
ROW-263	143	187	44	1	1	4	1	0
ROW-263	144	162	18	1	5	4	1	0
ROW-263	144	145	1	1	4	4	1	0
ROW-263	144	350	206	1	3	4	1	1
ROW-263	145	154	9	1	3	4	1	0
ROW-263	146	154	8	1	3	4	1	0
ROW-264	146	154	8	1	3	1	1	0
ROW-264	147	150	3	1	3	4	1	1
ROW-264	148	149	1	1	3	1	1	0
ROW-264	148	150	2	1	2	1	1	0
ROW-264	148	149	1	1	3	1	1	0
ROW-264	148	150	2	1	3	4	1	1
ROW-264	149	255	106	1	4	1	1	1
ROW-264	149	477	328	0	3	2	0	0
ROW-264	149	291	142	1	3	3	1	0
ROW-264	149	158	9	1	3	4	1	0
ROW-265	150	184	34	1	3	1	1	0
ROW-265	150	477	327	0	3	2	0	0
ROW-265	150	477	327	0	3	4	1	0
ROW-265	150	325	175	1	3	3	1	2
ROW-265	150	324	174	1	3	1	1	1
ROW-265	150	154	4	1	3	1	1	0
ROW-265	150	204	54	1	3	4	1	0
ROW-265	150	184	34	1	3	1	1	0
ROW-265	151	477	326	0	3	2	0	0
ROW-265	151	477	326	0	3	1	1	0
ROW-266	151	210	59	1	3	5	1	0
ROW-266	151	154	3	1	4	2	1	0
ROW-266	152	176	24	1	3	4	1	0
ROW-266	152	197	45	1	3	4	1	0
ROW-266	152	154	2	1	3	4	1	0
ROW-266	152	477	325	0	3	4	0	0
ROW-266	152	215	63	1	3	4	1	0
ROW-266	152	477	325	0	3	4	1	1
ROW-266	153	154	1	1	3	1	1	0
ROW-266	154	155	1	1	3	1	1	0
ROW-267	154	337	183	1	3	4	1	0
ROW-267	154	477	323	0	3	4	1	0
ROW-267	154	158	4	1	3	4	1	0
ROW-267	155	313	158	1	3	4	1	0
ROW-267	155	198	43	1	3	4	1	0
ROW-267	155	157	2	1	3	1	1	0
ROW-267	156	174	18	1	3	4	1	0
ROW-267	156	164	8	1	3	4	1	0
ROW-267	156	157	1	1	3	4	1	0
ROW-267	156	158	2	1	3	1	0	1
ROW-268	158	159	1	1	3	4	1	0
ROW-268	158	477	319	0	3	4	0	1
ROW-268	158	159	1	1	3	4	1	0
ROW-268	158	177	19	1	3	1	1	0
ROW-268	158	373	215	1	3	4	1	0
ROW-268	158	477	319	0	3	2	0	1
ROW-268	158	224	66	1	3	4	1	0
ROW-268	158	226	68	1	3	4	1	0
ROW-268	158	477	319	0	3	4	0	0
ROW-268	159	161	2	1	4	4	1	0
ROW-269	159	197	38	1	3	1	1	0
ROW-269	159	160	1	1	3	1	1	0
ROW-269	159	162	3	1	3	4	1	0
ROW-269	159	162	3	1	3	1	1	0
ROW-269	160	164	4	1	4	1	1	0
ROW-269	161	162	1	1	3	4	1	0
ROW-269	161	182	21	1	3	4	1	0
ROW-269	161	264	103	1	3	4	1	0
ROW-269	161	179	18	1	4	1	1	0
ROW-269	162	171	9	1	3	2	1	0
ROW-270	162	209	47	1	3	4	1	0
ROW-270	162	205	43	1	3	2	1	0
ROW-270	162	477	315	0	3	4	1	0
ROW-270	162	477	315	0	3	4	1	0
ROW-270	162	209	47	1	2	4	1	0
ROW-270	163	234	71	1	4	4	1	0
ROW-270	163	164	1	1	3	1	0	0
ROW-270	163	477	314	0	3	4	1	0
ROW-270	163	325	162	1	3	1	1	0
ROW-270	163	477	314	0	2	4	1	1
ROW-271	164	477	313	0	3	1	0	0
ROW-271	164	203	39	1	3	1	1	0
ROW-271	165	299	134	1	3	2	1	0
ROW-271	165	198	33	1	3	4	1	0
ROW-271	165	477	312	0	4	2	0	0
ROW-271	166	186	20	1	3	1	1	0
ROW-271	167	173	6	1	3	1	1	0
ROW-271	168	174	6	1	3	5	1	0
ROW-271	168	190	22	1	3	5	1	0
ROW-271	168	477	309	0	4	1	1	0
ROW-272	168	323	155	1	3	3	1	0
ROW-272	169	170	1	1	4	1	1	0
ROW-272	169	189	20	1	3	1	1	0
ROW-272	170	171	1	1	4	1	1	0
ROW-272	170	190	20	1	3	4	1	0
ROW-272	171	182	11	1	4	4	1	0
ROW-272	171	172	1	1	4	1	1	0
ROW-272	171	176	5	1	3	1	1	0
ROW-272	171	477	306	0	4	1	1	0
ROW-272	171	173	2	1	3	2	1	0
ROW-273	172	401	229	1	3	4	0	0
ROW-273	172	175	3	1	4	4	1	0
ROW-273	173	174	1	1	4	4	1	0
ROW-273	173	174	1	1	3	4	1	0
ROW-273	174	239	65	1	4	4	1	0
ROW-273	174	176	2	1	3	1	0	1
ROW-273	175	176	1	1	3	1	0	1
ROW-273	175	477	302	0	3	4	0	0
ROW-273	175	176	1	1	4	4	1	0
ROW-273	175	176	1	1	4	4	1	0
ROW-274	175	176	1	1	3	4	1	0
ROW-274	175	176	1	1	3	1	1	0
ROW-274	175	176	1	1	4	4	1	0
ROW-274	176	453	277	1	3	1	0	0
ROW-274	176	203	27	1	3	1	1	1
ROW-274	176	177	1	1	3	1	1	0
ROW-274	176	178	2	1	3	4	0	0
ROW-274	176	179	3	1	3	1	1	0
ROW-274	176	177	1	1	4	4	1	0
ROW-274	176	178	2	1	4	4	1	0
ROW-275	176	250	74	1	3	2	1	0
ROW-275	177	178	1	1	4	2	1	0
ROW-275	177	178	1	1	4	4	1	0
ROW-275	177	178	1	1	4	2	1	0
ROW-275	177	186	9	1	3	1	1	0
ROW-275	177	178	1	1	4	4	1	0
ROW-275	177	204	27	1	4	4	1	0
ROW-275	177	178	1	1	3	4	0	0
ROW-275	177	178	1	1	3	4	1	0
ROW-275	178	336	158	1	3	4	1	0
ROW-276	178	207	29	1	3	4	1	0
ROW-276	178	180	2	1	4	4	1	0
ROW-276	178	477	299	0	3	3	0	0
ROW-276	179	180	1	1	4	4	1	0
ROW-276	179	416	237	1	3	4	1	0
ROW-276	179	477	298	0	3	2	0	0
ROW-276	179	377	198	1	3	2	1	0
ROW-276	180	298	118	1	3	4	1	0
ROW-276	180	182	2	1	3	4	1	0
ROW-276	180	477	297	0	4	4	1	0
ROW-277	180	190	10	1	3	1	1	0
ROW-277	180	196	16	1	3	4	1	0
ROW-277	181	264	83	1	3	3	1	0
ROW-277	181	183	2	1	4	1	1	0
ROW-277	181	477	296	0	3	4	0	0
ROW-277	181	257	76	1	3	1	1	0
ROW-277	181	267	86	1	4	1	1	0
ROW-277	182	205	23	1	3	4	1	0
ROW-277	182	377	195	1	3	4	1	0
ROW-277	182	185	3	1	3	1	1	0
ROW-278	182	183	1	1	4	4	1	0
ROW-278	182	183	1	1	3	1	1	0
ROW-278	182	257	75	1	3	1	1	0
ROW-278	182	184	2	1	3	3	1	0
ROW-278	182	188	6	1	3	2	1	0
ROW-278	182	257	75	1	3	1	1	0
ROW-278	182	477	295	0	3	2	0	0
ROW-278	183	197	14	1	3	1	1	1
ROW-278	183	477	294	0	3	4	0	0
ROW-278	184	189	5	1	3	4	1	0
ROW-279	184	189	5	1	3	2	1	0
ROW-279	184	196	12	1	3	3	1	0
ROW-279	184	196	12	1	3	3	1	0
ROW-279	184	477	293	0	3	2	0	0
ROW-279	184	185	1	1	3	4	1	0
ROW-279	185	186	1	1	3	1	1	0
ROW-279	185	477	292	0	3	4	1	0
ROW-279	186	477	291	0	3	1	1	0
ROW-279	186	187	1	1	3	4	1	0
ROW-279	186	250	64	1	3	4	1	2
ROW-280	186	477	291	0	4	2	1	1
ROW-280	186	187	1	1	3	4	1	0
ROW-280	186	325	139	1	3	4	1	0
ROW-280	186	205	19	1	3	4	1	0
ROW-280	186	187	1	1	3	4	1	0
ROW-280	187	197	10	1	3	1	1	0
ROW-280	187	317	130	1	3	4	1	0
ROW-280	187	282	95	1	3	4	1	0
ROW-280	187	188	1	1	3	4	1	0
ROW-281	187	199	12	1	3	1	1	0
ROW-281	188	189	1	1	3	4	1	0
ROW-281	188	190	2	1	3	1	1	0
ROW-281	188	215	27	1	3	4	1	0
ROW-281	189	220	31	1	3	1	1	0
ROW-281	189	217	28	1	3	4	1	0
ROW-281	189	203	14	1	3	4	1	0
ROW-281	189	274	85	1	3	4	1	2
ROW-281	189	477	288	0	3	4	1	0
ROW-281	189	228	39	1	3	1	1	0
ROW-282	189	191	2	1	1	1	1	0
ROW-282	189	190	1	1	3	4	1	0
ROW-282	189	199	10	1	3	4	1	0
ROW-282	190	191	1	1	3	1	1	0
ROW-282	190	192	2	1	4	2	1	0
ROW-282	190	194	4	1	3	5	1	0
ROW-282	190	205	15	1	3	5	1	1
ROW-282	191	192	1	1	4	4	1	0
ROW-282	191	377	186	1	3	3	1	1
ROW-282	191	194	3	1	3	4	1	0
ROW-283	191	193	2	1	4	4	1	0
ROW-283	191	322	131	1	3	1	1	0
ROW-283	191	199	8	1	3	4	1	0
ROW-283	191	252	61	1	3	4	1	0
ROW-283	192	193	1	1	4	4	1	0
ROW-283	192	477	285	0	3	2	1	0
ROW-283	192	194	2	1	3	3	1	0
ROW-283	192	202	10	1	3	3	1	2
ROW-283	192	193	1	1	3	4	1	1
ROW-283	192	377	185	1	3	4	1	1
ROW-284	192	267	75	1	3	4	1	0
ROW-284	192	196	4	1	3	1	1	0
ROW-284	192	205	13	1	3	1	0	0
ROW-284	192	200	8	1	3	1	0	0
ROW-284	193	196	3	1	3	4	1	0
ROW-284	193	203	10	1	3	3	1	0
ROW-284	193	194	1	1	3	3	1	0
ROW-284	193	197	4	1	3	4	1	0
ROW-284	194	195	1	1	4	4	1	0
ROW-284	194	195	1	1	3	4	1	0
ROW-285	194	195	1	1	3	1	1	0
ROW-285	194	195	1	1	3	1	1	0
ROW-285	195	205	10	1	3	1	1	0
ROW-285	195	477	282	0	3	4	1	1
ROW-285	195	266	71	1	3	1	1	1
ROW-285	195	201	6	1	3	3	1	0
ROW-285	196	197	1	1	4	1	1	0
ROW-285	196	477	281	0	3	4	0	0
ROW-285	196	477	281	0	3	3	1	0
ROW-285	196	204	8	1	3	4	1	0
ROW-286	196	477	281	0	3	1	1	0
ROW-286	197	198	1	1	3	4	1	0
ROW-286	197	199	2	1	3	1	1	0
ROW-286	197	477	280	0	3	4	0	0
ROW-286	197	204	7	1	3	4	1	0
ROW-286	197	221	24	1	3	4	1	0
ROW-286	197	477	280	0	4	4	0	0
ROW-286	197	198	1	1	3	1	1	1
ROW-286	197	198	1	1	3	3	1	0
ROW-286	197	216	19	1	3	4	1	0
ROW-287	197	477	280	0	3	4	1	0
ROW-287	197	198	1	1	3	1	1	0
ROW-287	197	198	1	1	3	1	1	0
ROW-287	198	477	279	0	4	3	1	0
ROW-287	198	199	1	1	3	3	1	0
ROW-287	198	211	13	1	3	3	1	0
ROW-287	199	203	4	1	3	1	1	0
ROW-287	199	201	2	1	3	1	1	0
ROW-287	199	202	3	1	3	1	1	0
ROW-287	199	477	278	0	3	1	1	0
ROW-288	199	477	278	0	3	2	1	0
ROW-288	199	205	6	1	3	2	1	0
ROW-288	199	477	278	0	3	2	0	0
ROW-288	199	201	2	1	3	1	1	0
ROW-288	199	202	3	1	3	3	1	0
ROW-288	199	477	278	0	3	3	1	0
ROW-288	200	202	2	1	4	4	1	0
ROW-288	200	477	277	0	3	1	1	0
ROW-288	200	477	277	0	3	1	1	0
ROW-288	200	257	57	1	3	4	1	0
ROW-289	200	201	1	1	3	4	1	0
ROW-289	201	203	2	1	3	1	1	0
ROW-289	201	477	276	0	3	4	0	0
ROW-289	202	205	3	1	3	4	1	2
ROW-289	202	203	1	1	3	1	1	0
ROW-289	203	204	1	1	4	5	1	0
ROW-289	203	204	1	1	4	5	1	0
ROW-289	203	204	1	1	3	4	1	0
ROW-289	203	204	1	1	1	3	1	0
ROW-289	203	477	274	0	3	4	0	0
ROW-290	203	221	18	1	3	4	1	0
ROW-290	203	205	2	1	2	1	1	0
ROW-290	204	205	1	1	3	1	1	0
ROW-290	204	205	1	1	4	1	1	0
ROW-290	204	401	197	1	3	4	1	0
ROW-290	204	477	273	0	3	4	1	0
ROW-290	205	206	1	1	3	4	1	0
ROW-290	205	206	1	1	3	4	1	0
ROW-290	205	206	1	1	5	3	1	0
ROW-290	205	337	132	1	3	4	1	0
ROW-291	205	477	272	0	3	3	1	0
ROW-291	205	212	7	1	3	1	1	1
ROW-291	205	477	272	0	3	4	1	0
ROW-291	205	401	196	1	3	4	0	0
ROW-291	205	206	1	1	4	4	1	0
ROW-291	205	206	1	1	3	3	1	0
ROW-291	205	477	272	0	4	2	0	0
ROW-291	206	207	1	1	3	1	1	0
ROW-291	206	207	1	1	3	4	1	0
ROW-291	206	351	145	1	4	4	1	0
ROW-292	206	207	1	1	3	1	1	0
ROW-292	207	208	1	1	3	4	1	0
ROW-292	207	208	1	1	4	4	1	0
ROW-292	207	208	1	1	3	4	1	0
ROW-292	208	209	1	1	3	3	1	0
ROW-292	208	226	18	1	3	1	1	0
ROW-292	208	210	2	1	2	1	1	0
ROW-292	208	209	1	1	3	3	1	0
ROW-292	208	220	12	1	3	3	1	0
ROW-292	208	209	1	1	3	3	1	0
ROW-293	208	212	4	1	3	1	1	0
ROW-293	208	477	269	0	3	3	0	0
ROW-293	208	477	269	0	3	3	0	0
ROW-293	208	477	269	0	3	3	0	0
ROW-293	209	210	1	1	3	3	1	0
ROW-293	209	211	2	1	3	3	1	0
ROW-293	209	254	45	1	3	4	1	0
ROW-293	210	211	1	1	3	4	1	0
ROW-293	210	454	244	1	3	3	0	0
ROW-293	210	477	267	0	4	4	1	0
ROW-294	210	211	1	1	3	1	1	0
ROW-294	211	477	266	0	3	3	0	0
ROW-294	211	477	266	0	3	3	0	0
ROW-294	211	212	1	1	3	4	1	0
ROW-294	211	212	1	1	4	3	1	0
ROW-294	211	212	1	1	4	1	1	0
ROW-294	211	212	1	1	4	4	1	0
ROW-294	211	212	1	1	4	4	1	0
ROW-294	211	249	38	1	3	5	1	0
ROW-294	211	212	1	1	3	4	1	0
ROW-295	211	219	8	1	4	3	1	0
ROW-295	211	217	6	1	3	4	1	0
ROW-295	211	225	14	1	3	4	1	0
ROW-295	212	213	1	1	3	4	1	0
ROW-295	212	213	1	1	3	4	1	0
ROW-295	212	213	1	1	4	1	1	0
ROW-295	212	477	265	0	3	1	0	0
ROW-295	212	477	265	0	3	4	0	0
ROW-295	212	257	45	1	3	3	1	0
ROW-295	212	382	170	1	3	4	0	0
ROW-296	212	213	1	1	3	3	1	0
ROW-296	212	213	1	1	3	1	0	1
ROW-296	212	215	3	1	3	3	1	0
ROW-296	213	214	1	1	3	1	1	0
ROW-296	213	217	4	1	5	4	1	0
ROW-296	213	233	20	1	3	1	1	0
ROW-296	214	220	6	1	3	1	1	0
ROW-296	214	477	263	0	3	4	1	0
ROW-296	214	374	160	1	3	4	1	0
ROW-296	214	477	263	0	3	2	0	0
ROW-297	214	354	140	1	3	1	1	0
ROW-297	214	229	15	1	3	4	1	0
ROW-297	214	268	54	1	3	4	1	0
ROW-297	214	218	4	1	3	1	1	0
ROW-297	214	249	35	1	3	1	1	0
ROW-297	215	219	4	1	3	4	1	0
ROW-297	215	219	4	1	3	4	1	0
ROW-297	215	216	1	1	3	3	1	0
ROW-297	215	216	1	1	1	1	1	0
ROW-297	215	222	7	1	4	2	1	0
ROW-298	215	477	262	0	3	4	0	0
ROW-298	215	477	262	0	3	4	1	0
ROW-298	215	217	2	1	3	1	1	0
ROW-298	215	273	58	1	3	4	1	0
ROW-298	216	477	261	0	3	4	1	0
ROW-298	216	217	1	1	3	4	1	0
ROW-298	217	219	2	1	3	1	1	0
ROW-298	217	317	100	1	3	1	1	0
ROW-298	217	218	1	1	3	4	1	0
ROW-298	217	246	29	1	1	4	1	0
ROW-299	217	218	1	1	4	4	1	0
ROW-299	217	218	1	1	3	3	1	0
ROW-299	217	218	1	1	3	1	1	0
ROW-299	217	338	121	1	3	4	1	0
ROW-299	217	219	2	1	3	4	1	0
ROW-299	217	346	129	1	3	4	1	0
ROW-299	217	218	1	1	3	4	1	0
ROW-299	217	477	260	0	3	4	0	0
ROW-299	217	220	3	1	3	4	1	0
ROW-299	217	218	1	1	3	4	1	0
ROW-300	217	220	3	1	3	4	1	0
ROW-300	217	218	1	1	3	3	1	0
ROW-300	217	219	2	1	4	5	1	0
ROW-300	217	218	1	1	3	3	1	0
ROW-300	218	477	259	0	3	1	1	0
ROW-300	218	219	1	1	3	4	1	0
ROW-300	218	219	1	1	4	1	1	0
ROW-300	218	219	1	1	4	1	1	0
ROW-300	218	219	1	1	4	4	1	0
ROW-300	218	219	1	1	3	4	1	0
ROW-301	218	219	1	1	4	4	1	0
ROW-301	218	219	1	1	3	1	1	0
ROW-301	218	220	2	1	3	1	1	1
ROW-301	218	270	52	1	3	1	1	0
ROW-301	218	477	259	0	3	2	0	0
ROW-301	218	220	2	1	3	1	1	0
ROW-301	218	477	259	0	3	2	1	0
ROW-301	218	238	20	1	3	4	1	0
ROW-301	218	236	18	1	3	4	1	0
ROW-301	219	220	1	1	4	4	1	0
ROW-302	219	361	142	1	3	2	1	0
ROW-302	219	220	1	1	3	4	1	0
ROW-302	219	224	5	1	3	4	1	0
ROW-302	219	220	1	1	3	4	1	0
ROW-302	219	220	1	1	3	4	1	0
ROW-302	219	257	38	1	3	4	1	0
ROW-302	219	220	1	1	3	4	1	0
ROW-302	220	221	1	1	4	4	1	0
ROW-302	220	221	1	1	3	4	1	0
ROW-302	220	221	1	1	3	4	1	0
ROW-303	220	477	257	0	3	1	0	0
ROW-303	220	225	5	1	3	4	1	0
ROW-303	220	477	257	0	3	4	1	0
ROW-303	220	233	13	1	3	4	1	0
ROW-303	221	225	4	1	4	4	1	0
ROW-303	221	226	5	1	4	4	1	0
ROW-303	221	225	4	1	3	4	1	0
ROW-303	221	225	4	1	3	4	1	0
ROW-303	221	303	82	1	3	4	1	0
ROW-303	221	477	256	0	3	4	0	0
ROW-304	221	477	256	0	3	4	0	0
ROW-304	221	477	256	0	3	4	0	0
ROW-304	221	224	3	1	3	4	1	0
ROW-304	221	225	4	1	4	4	1	0
ROW-304	221	225	4	1	3	4	1	0
ROW-304	222	225	3	1	3	3	1	0
ROW-304	222	223	1	1	4	4	1	0
ROW-304	224	225	1	1	3	1	1	0
ROW-304	224	387	163	1	3	1	1	0
ROW-304	224	239	15	1	3	1	1	0
ROW-305	225	232	7	1	3	2	1	0
ROW-305	225	252	27	1	3	4	1	0
ROW-305	225	477	252	0	3	4	1	0
ROW-305	225	229	4	1	3	1	1	0
ROW-305	225	477	252	0	3	3	1	0
ROW-305	225	401	176	1	3	4	0	0
ROW-305	225	260	35	1	3	1	1	0
ROW-305	226	227	1	1	3	3	1	0
ROW-305	226	351	125	1	3	1	1	0
ROW-305	226	227	1	1	3	3	1	1
ROW-306	226	229	3	1	3	3	1	0
ROW-306	226	249	23	1	3	1	1	0
ROW-306	226	227	1	1	3	4	1	0
ROW-306	227	307	80	1	3	4	1	0
ROW-306	227	228	1	1	3	4	1	1
ROW-306	228	269	41	1	3	1	1	0
ROW-306	228	454	226	1	3	4	1	0
ROW-306	228	229	1	1	4	4	1	0
ROW-306	228	229	1	1	4	4	1	0
ROW-306	228	262	34	1	3	4	1	0
ROW-307	228	327	99	1	3	4	1	0
ROW-307	228	401	173	1	3	4	0	0
ROW-307	228	261	33	1	3	4	1	0
ROW-307	228	270	42	1	3	2	1	0
ROW-307	228	270	42	1	3	1	1	0
ROW-307	228	250	22	1	3	2	1	0
ROW-307	228	273	45	1	3	4	1	0
ROW-307	228	477	249	0	3	4	1	0
ROW-307	228	477	249	0	3	1	1	0
ROW-307	228	477	249	0	3	4	0	0
ROW-308	228	477	249	0	3	4	1	0
ROW-308	229	477	248	0	3	4	0	0
ROW-308	229	477	248	0	3	4	1	0
ROW-308	229	231	2	1	3	1	1	0
ROW-308	229	401	172	1	3	4	1	0
ROW-308	230	477	247	0	3	2	1	0
ROW-308	230	427	197	1	3	1	1	0
ROW-308	230	477	247	0	3	2	1	2
ROW-308	231	232	1	1	4	4	1	0
ROW-308	231	477	246	0	3	2	0	0
ROW-309	231	247	16	1	4	2	1	1
ROW-309	231	232	1	1	3	1	0	0
ROW-309	231	232	1	1	3	1	0	0
ROW-309	231	232	1	1	3	1	1	1
ROW-309	231	232	1	1	3	5	1	0
ROW-309	231	232	1	1	3	1	1	0
ROW-309	231	440	209	1	3	1	1	1
ROW-309	231	477	246	0	3	4	1	0
ROW-309	232	233	1	1	3	1	1	0
ROW-309	232	233	1	1	3	5	1	0
ROW-310	232	233	1	1	3	1	1	0
ROW-310	232	477	245	0	3	2	0	0
ROW-310	232	477	245	0	3	2	0	0
ROW-310	232	477	245	0	3	2	1	0
ROW-310	232	477	245	0	3	2	1	0
ROW-310	233	234	1	1	3	4	1	0
ROW-310	233	234	1	1	4	4	1	0
ROW-310	233	426	193	1	3	2	1	0
ROW-310	233	311	78	1	3	2	1	0
ROW-310	233	234	1	1	3	3	1	1
ROW-311	233	234	1	1	3	3	1	0
ROW-311	233	235	2	1	3	4	1	0
ROW-311	234	265	31	1	4	1	1	0
ROW-311	234	237	3	1	3	4	1	0
ROW-311	235	242	7	1	3	5	1	0
ROW-311	235	237	2	1	3	4	1	0
ROW-311	236	238	2	1	3	4	1	0
ROW-311	237	477	240	0	3	4	0	0
ROW-311	237	240	3	1	3	3	1	0
ROW-312	237	477	240	0	3	2	0	4
ROW-312	237	423	186	1	3	2	1	2
ROW-312	237	477	240	0	3	2	1	2
ROW-312	237	428	191	1	3	2	1	1
ROW-312	237	238	1	1	3	2	0	0
ROW-312	238	239	1	1	3	1	1	0
ROW-312	239	374	135	1	3	2	1	0
ROW-312	239	249	10	1	4	4	1	0
ROW-312	239	255	16	1	4	4	1	0
ROW-312	239	240	1	1	4	4	1	0
ROW-313	239	240	1	1	3	4	1	0
ROW-313	239	293	54	1	3	4	1	0
ROW-313	239	257	18	1	3	1	1	0
ROW-313	239	420	181	1	3	1	1	0
ROW-313	239	477	238	0	3	2	1	0
ROW-313	239	420	181	1	3	2	1	0
ROW-313	239	269	30	1	3	4	1	0
ROW-313	239	240	1	1	4	1	1	1
ROW-313	240	316	76	1	3	1	0	1
ROW-314	240	241	1	1	3	1	1	0
ROW-314	240	268	28	1	3	1	1	1
ROW-314	240	241	1	1	3	4	1	0
ROW-314	240	264	24	1	3	4	1	0
ROW-314	240	477	237	0	3	4	1	0
ROW-314	241	263	22	1	3	1	1	0
ROW-314	241	262	21	1	3	2	1	0
ROW-314	241	242	1	1	4	4	1	0
ROW-314	241	242	1	1	4	4	1	0
ROW-314	241	407	166	1	3	4	1	1
ROW-315	241	477	236	0	3	4	1	0
ROW-315	241	477	236	0	3	2	0	0
ROW-315	242	265	23	1	3	4	1	0
ROW-315	242	243	1	1	3	3	1	0
ROW-315	242	477	235	0	3	4	1	0
ROW-315	242	477	235	0	3	2	0	0
ROW-315	242	477	235	0	3	2	0	0
ROW-315	243	259	16	1	3	4	1	0
ROW-315	244	246	2	1	3	4	1	1
ROW-315	244	477	233	0	3	4	0	0
ROW-316	244	247	3	1	3	4	1	0
ROW-316	244	300	56	1	3	4	1	0
ROW-316	245	421	176	1	3	2	1	0
ROW-316	245	246	1	1	4	4	1	0
ROW-316	245	477	232	0	3	4	0	0
ROW-316	246	477	231	0	3	4	0	0
ROW-316	246	477	231	0	3	4	1	0
ROW-316	246	247	1	1	3	4	1	0
ROW-316	246	252	6	1	3	4	1	0
ROW-316	246	332	86	1	3	4	1	1
ROW-317	246	252	6	1	3	4	1	0
ROW-317	246	249	3	1	3	5	1	0
ROW-317	247	248	1	1	4	4	1	0
ROW-317	247	251	4	1	4	1	1	0
ROW-317	247	270	23	1	5	4	1	0
ROW-317	247	270	23	1	1	1	1	0
ROW-317	247	477	230	0	4	1	1	0
ROW-317	247	249	2	1	5	4	1	1
ROW-317	247	248	1	1	5	2	0	2
ROW-317	248	477	229	0	3	4	1	0
ROW-318	248	272	24	1	3	4	1	0
ROW-318	248	256	8	1	3	4	1	1
ROW-318	248	271	23	1	3	2	1	0
ROW-318	248	259	11	1	4	1	1	0
ROW-318	248	347	99	1	3	2	1	0
ROW-318	249	477	228	0	3	2	1	1
ROW-318	249	318	69	1	3	1	1	0
ROW-318	249	261	12	1	3	2	1	0
ROW-318	249	251	2	1	3	1	1	0
ROW-318	249	477	228	0	3	4	1	0
ROW-319	249	259	10	1	1	1	1	0
ROW-319	249	477	228	0	3	2	1	1
ROW-319	249	477	228	0	3	4	1	0
ROW-319	249	477	228	0	3	2	0	0
ROW-319	249	319	70	1	3	3	1	0
ROW-319	250	251	1	1	4	4	1	0
ROW-319	250	264	14	1	3	2	1	0
ROW-319	250	265	15	1	3	2	1	0
ROW-319	250	281	31	1	3	2	1	0
ROW-319	250	336	86	1	3	4	1	0
ROW-320	251	463	212	1	3	4	1	2
ROW-320	251	477	226	0	3	4	0	0
ROW-320	251	333	82	1	3	1	1	2
ROW-320	251	477	226	0	3	1	0	0
ROW-320	252	477	225	0	3	2	0	4
ROW-320	252	477	225	0	4	2	0	0
ROW-320	252	273	21	1	3	1	1	0
ROW-320	252	253	1	1	5	3	0	0
ROW-320	252	443	191	1	3	1	1	0
ROW-320	252	339	87	1	3	4	1	0
ROW-321	252	477	225	0	3	1	1	0
ROW-321	253	254	1	1	4	4	1	0
ROW-321	253	267	14	1	3	4	1	0
ROW-321	253	254	1	1	4	4	1	0
ROW-321	253	254	1	1	4	4	1	0
ROW-321	253	254	1	1	4	4	1	0
ROW-321	253	254	1	1	4	4	1	0
ROW-321	253	254	1	1	4	4	1	0
ROW-321	253	254	1	1	4	4	1	0
ROW-321	253	254	1	1	4	4	1	0
ROW-322	253	477	224	0	3	4	1	0
ROW-322	253	477	224	0	3	4	1	0
ROW-322	253	477	224	0	3	4	0	0
ROW-322	254	255	1	1	4	4	1	0
ROW-322	254	295	41	1	4	1	0	1
ROW-322	254	279	25	1	3	1	1	0
ROW-322	254	477	223	0	3	1	0	0
ROW-322	254	259	5	1	3	1	1	0
ROW-322	254	258	4	1	3	1	1	0
ROW-322	255	256	1	1	3	4	1	1
ROW-323	255	348	93	1	3	4	1	0
ROW-323	255	256	1	1	3	1	1	0
ROW-323	255	477	222	0	3	4	1	0
ROW-323	255	373	118	1	3	4	1	0
ROW-323	256	257	1	1	4	4	1	0
ROW-323	256	257	1	1	4	4	1	0
ROW-323	256	257	1	1	1	4	1	0
ROW-323	256	257	1	1	4	1	1	0
ROW-323	256	315	59	1	3	1	0	0
ROW-323	257	400	143	1	3	4	1	0
ROW-324	257	263	6	1	4	4	1	0
ROW-324	258	259	1	1	1	1	1	0
ROW-324	258	259	1	1	3	4	1	0
ROW-324	258	477	219	0	3	4	0	0
ROW-324	258	477	219	0	3	4	1	0
ROW-324	258	477	219	0	3	4	1	0
ROW-324	259	477	218	0	4	4	1	0
ROW-324	259	477	218	0	4	4	0	0
ROW-324	259	343	84	1	3	5	1	0
ROW-324	259	262	3	1	3	4	1	0
ROW-325	259	273	14	1	3	2	1	0
ROW-325	259	260	1	1	3	1	1	0
ROW-325	259	261	2	1	3	4	1	0
ROW-325	259	477	218	0	3	3	0	1
ROW-325	259	332	73	1	3	4	1	1
ROW-325	259	448	189	1	3	4	1	1
ROW-325	259	269	10	1	3	1	1	0
ROW-325	260	261	1	1	4	4	1	0
ROW-325	260	261	1	1	4	4	1	0
ROW-325	260	261	1	1	4	4	1	0
ROW-326	260	297	37	1	3	5	1	0
ROW-326	260	262	2	1	3	4	1	0
ROW-326	260	262	2	1	3	4	1	0
ROW-326	260	477	217	0	3	4	0	0
ROW-326	260	263	3	1	3	5	1	0
ROW-326	260	477	217	0	3	4	0	0
ROW-326	260	477	217	0	3	2	0	0
ROW-326	261	262	1	1	3	4	1	0
ROW-326	261	262	1	1	3	4	1	0
ROW-326	261	264	3	1	3	4	1	0
ROW-327	261	262	1	1	3	4	1	0
ROW-327	261	264	3	1	3	1	1	0
ROW-327	261	338	77	1	3	5	1	0
ROW-327	261	331	70	1	3	5	1	0
ROW-327	261	262	1	1	3	4	1	0
ROW-327	261	477	216	0	3	4	1	0
ROW-327	262	271	9	1	4	4	1	0
ROW-327	262	477	215	0	3	4	1	0
ROW-327	262	289	27	1	3	4	1	0
ROW-327	262	264	2	1	3	1	1	0
ROW-328	263	401	138	1	4	1	0	0
ROW-328	263	270	7	1	5	4	1	0
ROW-328	263	278	15	1	4	2	1	0
ROW-328	263	477	214	0	3	4	1	0
ROW-328	263	264	1	1	4	2	1	0
ROW-328	263	264	1	1	4	4	1	0
ROW-328	263	264	1	1	4	4	1	0
ROW-328	263	264	1	1	4	4	1	0
ROW-328	263	264	1	1	4	4	1	0
ROW-328	263	400	137	1	3	2	1	0
ROW-329	263	477	214	0	3	4	1	0
ROW-329	263	339	76	1	3	4	1	0
ROW-329	263	407	144	1	3	4	1	2
ROW-329	263	265	2	1	3	4	1	1
ROW-329	263	477	214	0	3	4	1	0
ROW-329	263	401	138	1	3	4	1	0
ROW-329	263	264	1	1	3	4	1	0
ROW-329	263	409	146	1	3	4	1	0
ROW-329	263	477	214	0	3	4	1	0
ROW-329	263	264	1	1	1	1	1	0
ROW-330	264	265	1	1	4	4	1	0
ROW-330	264	272	8	1	3	4	1	0
ROW-330	265	477	212	0	3	3	0	1
ROW-330	265	342	77	1	3	2	1	0
ROW-330	266	287	21	1	3	4	1	0
ROW-330	266	267	1	1	3	4	1	0
ROW-330	266	316	50	1	3	2	1	0
ROW-330	266	298	32	1	3	2	1	0
ROW-330	266	477	211	0	3	2	1	0
ROW-330	266	267	1	1	3	4	1	0
ROW-331	266	333	67	1	3	2	1	0
ROW-331	266	448	182	1	3	2	1	0
ROW-331	266	317	51	1	3	4	1	0
ROW-331	266	268	2	1	3	4	1	0
ROW-331	266	477	211	0	3	4	1	0
ROW-331	266	401	135	1	3	4	1	0
ROW-331	266	477	211	0	3	4	1	0
ROW-331	266	477	211	0	3	4	1	0
ROW-331	266	338	72	1	3	4	1	0
ROW-331	266	268	2	1	3	4	1	0
ROW-332	266	270	4	1	3	4	1	0
ROW-332	266	267	1	1	3	4	1	0
ROW-332	266	267	1	1	3	1	1	0
ROW-332	266	292	26	1	3	5	1	0
ROW-332	267	360	93	1	3	1	1	0
ROW-332	267	477	210	0	3	4	1	2
ROW-332	267	401	134	1	3	2	0	0
ROW-332	267	269	2	1	3	1	1	0
ROW-332	267	393	126	1	3	4	1	0
ROW-332	267	477	210	0	3	1	0	0
ROW-333	268	465	197	1	3	4	1	0
ROW-333	268	276	8	1	3	4	1	0
ROW-333	268	477	209	0	3	4	1	0
ROW-333	268	477	209	0	3	4	1	0
ROW-333	268	269	1	1	3	4	1	0
ROW-333	268	269	1	1	3	4	1	0
ROW-333	268	269	1	1	3	4	1	0
ROW-333	269	377	108	1	3	4	1	1
ROW-333	269	270	1	1	3	1	1	0
ROW-333	269	271	2	1	4	2	1	0
ROW-334	269	340	71	1	4	2	1	0
ROW-334	269	270	1	1	3	2	1	0
ROW-334	269	270	1	1	3	1	1	1
ROW-334	269	285	16	1	3	1	1	0
ROW-334	269	477	208	0	3	1	1	0
ROW-334	269	477	208	0	3	4	1	0
ROW-334	269	395	126	1	3	1	0	0
ROW-334	270	304	34	1	3	5	1	0
ROW-334	270	272	2	1	3	1	1	0
ROW-334	270	271	1	1	4	4	1	0
ROW-335	270	271	1	1	5	3	1	0
ROW-335	270	295	25	1	3	1	0	0
ROW-335	270	271	1	1	2	3	1	0
ROW-335	270	282	12	1	3	4	2	1
ROW-335	270	271	1	1	3	1	1	0
ROW-335	270	280	10	1	3	2	1	0
ROW-335	270	272	2	1	3	4	1	0
ROW-335	271	272	1	1	3	5	1	0
ROW-335	271	301	30	1	3	4	1	0
ROW-335	271	477	206	0	3	4	1	0
ROW-336	271	273	2	1	3	2	1	0
ROW-336	271	422	151	1	3	4	1	0
ROW-336	271	317	46	1	3	4	1	0
ROW-336	271	272	1	1	3	4	1	0
ROW-336	271	437	166	1	3	4	1	1
ROW-336	271	477	206	0	3	4	0	0
ROW-336	271	321	50	1	3	4	1	0
ROW-336	271	390	119	1	3	4	1	0
ROW-336	271	350	79	1	3	4	1	0
ROW-336	271	272	1	1	3	1	1	0
ROW-337	272	273	1	1	3	1	1	0
ROW-337	272	273	1	1	4	3	1	0
ROW-337	272	477	205	0	3	4	0	0
ROW-337	272	273	1	1	3	1	1	0
ROW-337	273	274	1	1	3	1	1	0
ROW-337	273	274	1	1	5	4	1	0
ROW-337	273	274	1	1	3	4	1	0
ROW-337	273	274	1	1	3	4	1	0
ROW-337	273	477	204	0	3	2	1	0
ROW-337	273	477	204	0	3	2	1	0
ROW-338	273	292	19	1	3	2	1	0
ROW-338	273	296	23	1	3	2	1	0
ROW-338	273	278	5	1	3	3	1	1
ROW-338	273	282	9	1	3	3	1	0
ROW-338	273	281	8	1	3	3	1	0
ROW-338	273	299	26	1	3	3	1	1
ROW-338	273	477	204	0	3	3	0	1
ROW-338	273	351	78	1	3	2	1	0
ROW-338	273	477	204	0	3	1	1	0
ROW-338	273	274	1	1	3	1	0	1
ROW-339	273	274	1	1	3	1	1	1
ROW-339	273	477	204	0	3	4	1	0
ROW-339	273	274	1	1	3	4	1	0
ROW-339	273	274	1	1	1	1	1	0
ROW-339	273	274	1	1	4	1	1	0
ROW-339	273	274	1	1	3	4	1	0
ROW-339	273	477	204	0	3	1	0	0
ROW-339	273	274	1	1	3	4	1	0
ROW-339	274	282	8	1	4	2	1	0
ROW-339	274	477	203	0	3	1	1	0
ROW-340	274	275	1	1	3	4	1	0
ROW-340	274	477	203	0	3	2	1	0
ROW-340	274	280	6	1	3	4	1	1
ROW-340	274	275	1	1	3	1	1	0
ROW-340	274	275	1	1	3	4	1	0
ROW-340	274	301	27	1	3	1	1	1
ROW-340	274	477	203	0	3	4	1	0
ROW-340	274	312	38	1	3	2	1	0
ROW-340	274	477	203	0	3	2	1	1
ROW-340	274	287	13	1	3	4	1	1
ROW-341	274	477	203	0	3	2	1	0
ROW-341	275	276	1	1	4	4	1	0
ROW-341	275	276	1	1	3	4	1	0
ROW-341	275	276	1	1	3	4	1	0
ROW-341	275	276	1	1	3	4	0	0
ROW-341	275	276	1	1	3	4	1	0
ROW-341	275	276	1	1	3	4	1	0
ROW-341	275	276	1	1	3	4	1	0
ROW-341	275	276	1	1	3	2	1	0
ROW-341	275	477	202	0	3	2	1	0
ROW-342	275	279	4	1	3	1	1	0
ROW-342	275	317	42	1	3	4	1	0
ROW-342	275	402	127	1	3	4	1	0
ROW-342	275	276	1	1	3	4	1	0
ROW-342	275	477	202	0	3	4	1	0
ROW-342	275	283	8	1	3	1	1	0
ROW-342	275	401	126	1	4	1	1	1
ROW-342	275	281	6	1	3	3	1	0
ROW-342	275	374	99	1	3	1	1	1
ROW-342	276	279	3	1	3	4	1	0
ROW-343	276	277	1	1	3	4	1	0
ROW-343	276	277	1	1	4	4	1	0
ROW-343	276	277	1	1	3	4	1	0
ROW-343	276	401	125	1	3	4	1	0
ROW-343	276	453	177	1	3	3	1	0
ROW-343	276	477	201	0	3	4	1	0
ROW-343	276	323	47	1	3	1	1	0
ROW-343	276	323	47	1	1	1	1	0
ROW-343	276	277	1	1	4	1	1	0
ROW-343	276	317	41	1	3	2	1	0
ROW-344	276	285	9	1	3	4	1	0
ROW-344	276	338	62	1	3	4	1	0
ROW-344	276	283	7	1	3	4	1	0
ROW-344	276	277	1	1	3	4	1	0
ROW-344	277	477	200	0	4	2	1	0
ROW-344	277	279	2	1	3	1	1	0
ROW-344	277	477	200	0	3	2	1	0
ROW-344	277	287	10	1	3	1	0	0
ROW-344	278	477	199	0	3	1	1	0
ROW-344	278	348	70	1	3	1	1	0
ROW-345	278	283	5	1	3	2	1	0
ROW-345	278	296	18	1	3	4	1	0
ROW-345	278	283	5	1	3	1	0	0
ROW-345	278	477	199	0	3	1	0	0
ROW-345	278	477	199	0	4	1	0	0
ROW-345	279	281	2	1	4	4	1	0
ROW-345	279	285	6	1	3	4	1	0
ROW-345	279	477	198	0	4	1	0	0
ROW-345	280	477	197	0	3	2	0	0
ROW-345	280	477	197	0	3	2	0	0
ROW-346	280	281	1	1	4	4	1	0
ROW-346	280	281	1	1	4	4	1	0
ROW-346	280	281	1	1	3	4	1	0
ROW-346	280	281	1	1	3	4	1	0
ROW-346	280	283	3	1	3	4	1	2
ROW-346	280	282	2	1	3	4	1	0
ROW-346	280	281	1	1	2	1	1	0
ROW-346	280	281	1	1	4	1	1	0
ROW-346	281	283	2	1	3	4	0	1
ROW-346	281	296	15	1	3	3	1	0
ROW-347	281	345	64	1	3	1	1	1
ROW-347	281	477	196	0	3	3	1	0
ROW-347	281	295	14	1	3	3	1	0
ROW-347	281	282	1	1	3	4	1	0
ROW-347	281	283	2	1	4	4	1	0
ROW-347	281	477	196	0	4	4	1	0
ROW-347	281	477	196	0	3	1	0	0
ROW-347	281	310	29	1	3	1	1	0
ROW-347	281	282	1	1	4	4	0	0
ROW-347	281	282	1	1	3	4	1	0
ROW-348	282	283	1	1	3	1	1	0
ROW-348	282	285	3	1	3	1	0	0
ROW-348	282	283	1	1	3	4	1	0
ROW-348	282	318	36	1	3	1	1	0
ROW-348	282	288	6	1	3	4	0	0
ROW-348	283	285	2	1	2	1	1	0
ROW-348	283	435	152	1	3	4	0	2
ROW-348	283	298	15	1	3	3	1	0
ROW-348	283	314	31	1	3	4	1	1
ROW-348	283	297	14	1	3	3	1	0
ROW-349	283	290	7	1	3	2	1	0
ROW-349	283	477	194	0	4	5	0	0
ROW-349	283	284	1	1	4	4	1	0
ROW-349	283	330	47	1	3	4	1	0
ROW-349	283	288	5	1	3	1	1	0
ROW-349	283	477	194	0	3	4	1	0
ROW-349	283	477	194	0	3	4	1	0
ROW-349	283	477	194	0	3	4	0	0
ROW-349	283	338	55	1	3	1	1	1
ROW-349	283	311	28	1	3	2	1	1
ROW-350	284	401	117	1	3	2	0	0
ROW-350	284	323	39	1	3	3	1	0
ROW-350	284	401	117	1	3	1	0	0
ROW-350	284	477	193	0	3	2	1	0
ROW-350	285	287	2	1	3	2	1	0
ROW-350	285	340	55	1	3	2	1	0
ROW-350	286	309	23	1	3	4	1	1
ROW-350	286	401	115	1	3	4	0	0
ROW-350	286	401	115	1	3	4	1	0
ROW-350	286	477	191	0	4	4	0	0
ROW-351	286	477	191	0	3	4	0	0
ROW-351	286	427	141	1	3	3	1	0
ROW-351	286	477	191	0	3	4	0	0
ROW-351	287	477	190	0	3	4	0	0
ROW-351	287	288	1	1	3	1	1	0
ROW-351	287	297	10	1	3	2	1	0
ROW-351	287	288	1	1	3	1	1	0
ROW-351	287	307	20	1	4	1	1	0
ROW-351	287	288	1	1	3	4	1	0
ROW-351	287	302	15	1	3	3	1	0
ROW-352	287	477	190	0	3	2	1	0
ROW-352	287	288	1	1	3	4	1	0
ROW-352	287	402	115	1	3	5	0	0
ROW-352	287	477	190	0	3	4	1	1
ROW-352	287	311	24	1	3	1	1	0
ROW-352	288	456	168	1	4	3	0	1
ROW-352	288	340	52	1	5	1	0	0
ROW-352	288	289	1	1	5	1	1	0
ROW-352	288	289	1	1	5	1	1	0
ROW-352	288	302	14	1	3	2	1	0
ROW-353	288	289	1	1	3	4	1	0
ROW-353	288	477	189	0	3	4	0	0
ROW-353	288	415	127	1	3	4	1	0
ROW-353	288	289	1	1	3	4	1	0
ROW-353	288	289	1	1	3	4	1	0
ROW-353	288	361	73	1	1	1	1	0
ROW-353	289	312	23	1	3	2	1	0
ROW-353	289	303	14	1	3	2	1	0
ROW-353	289	477	188	0	3	5	0	0
ROW-353	289	293	4	1	3	4	1	0
ROW-354	289	290	1	1	4	2	1	0
ROW-354	289	297	8	1	4	1	1	0
ROW-354	289	290	1	1	4	4	1	0
ROW-354	289	477	188	0	2	1	1	0
ROW-354	289	371	82	1	3	1	1	0
ROW-354	289	352	63	1	3	4	1	0
ROW-354	289	290	1	1	3	4	1	0
ROW-354	289	294	5	1	4	4	1	0
ROW-354	290	291	1	1	3	4	1	0
ROW-354	290	291	1	1	4	1	1	0
ROW-355	290	430	140	1	4	4	1	0
ROW-355	290	291	1	1	3	4	1	0
ROW-355	290	477	187	0	3	2	0	0
ROW-355	290	296	6	1	3	2	1	1
ROW-355	290	402	112	1	4	4	1	0
ROW-355	290	301	11	1	3	2	1	0
ROW-355	290	291	1	1	4	4	1	0
ROW-355	290	295	5	1	4	4	1	0
ROW-355	290	291	1	1	4	4	1	0
ROW-355	291	292	1	1	3	4	1	0
ROW-356	291	377	86	1	4	3	1	1
ROW-356	291	377	86	1	3	3	1	0
ROW-356	291	292	1	1	3	4	1	0
ROW-356	291	314	23	1	3	4	1	0
ROW-356	291	380	89	1	3	1	2	0
ROW-356	291	292	1	1	3	3	1	0
ROW-356	291	302	11	1	3	4	1	0
ROW-356	291	297	6	1	3	2	1	0
ROW-356	291	293	2	1	3	5	1	0
ROW-356	291	299	8	1	3	5	1	0
ROW-357	291	402	111	1	3	4	1	0
ROW-357	291	477	186	0	3	4	1	0
ROW-357	291	477	186	0	3	4	0	0
ROW-357	292	293	1	1	4	1	1	0
ROW-357	292	295	3	1	3	4	1	0
ROW-357	292	301	9	1	3	4	1	1
ROW-357	292	301	9	1	3	4	1	0
ROW-357	292	294	2	1	3	4	1	0
ROW-357	292	449	157	1	1	1	1	0
ROW-357	292	477	185	0	3	4	1	0
ROW-358	292	293	1	1	3	1	1	0
ROW-358	292	293	1	1	4	4	1	0
ROW-358	293	294	1	1	3	4	1	0
ROW-358	293	299	6	1	3	2	1	0
ROW-358	293	301	8	1	3	4	1	0
ROW-358	294	477	183	0	5	3	0	0
ROW-358	294	339	45	1	3	1	1	0
ROW-358	294	311	17	1	3	4	1	0
ROW-358	294	296	2	1	3	5	1	0
ROW-358	294	295	1	1	3	4	1	0
ROW-359	294	477	183	0	4	4	0	1
ROW-359	295	298	3	1	3	4	1	0
ROW-359	295	301	6	1	3	2	1	0
ROW-359	295	367	72	1	3	1	1	0
ROW-359	295	401	106	1	3	5	1	0
ROW-359	295	401	106	1	3	5	1	0
ROW-359	295	407	112	1	3	5	1	0
ROW-359	295	339	44	1	3	3	1	0
ROW-359	295	296	1	1	2	1	1	0
ROW-359	295	477	182	0	3	1	0	0
ROW-360	295	299	4	1	3	4	1	0
ROW-360	295	311	16	1	4	4	1	0
ROW-360	296	311	15	1	3	4	1	0
ROW-360	296	297	1	1	3	4	1	0
ROW-360	296	477	181	0	3	4	0	1
ROW-360	296	297	1	1	3	4	1	0
ROW-360	296	402	106	1	3	1	1	0
ROW-360	296	327	31	1	3	4	1	0
ROW-360	296	302	6	1	3	2	1	0
ROW-360	296	323	27	1	4	3	1	0
ROW-361	296	306	10	1	3	2	1	0
ROW-361	296	312	16	1	4	4	1	0
ROW-361	297	303	6	1	3	4	1	0
ROW-361	297	332	35	1	3	1	1	0
ROW-361	297	317	20	1	3	1	1	0
ROW-361	298	310	12	1	3	4	1	0
ROW-361	298	303	5	1	3	5	1	0
ROW-361	298	299	1	1	3	2	0	0
ROW-361	298	299	1	1	4	4	1	0
ROW-361	298	435	137	1	3	4	1	0
ROW-362	298	352	54	1	3	4	1	0
ROW-362	298	303	5	1	3	4	1	0
ROW-362	298	303	5	1	3	4	1	0
ROW-362	298	303	5	1	3	4	1	0
ROW-362	298	303	5	1	3	4	1	0
ROW-362	298	311	13	1	3	4	1	0
ROW-362	298	303	5	1	3	4	1	0
ROW-362	298	311	13	1	3	4	1	0
ROW-362	298	477	179	0	3	2	1	0
ROW-362	298	338	40	1	3	4	1	0
ROW-363	299	303	4	1	3	2	1	0
ROW-363	299	406	107	1	3	2	1	0
ROW-363	299	300	1	1	4	4	1	0
ROW-363	299	300	1	1	4	4	1	0
ROW-363	299	300	1	1	3	1	1	0
ROW-363	299	477	178	0	3	4	0	0
ROW-363	299	301	2	1	3	4	1	0
ROW-363	299	311	12	1	5	1	1	0
ROW-363	299	300	1	1	4	4	1	0
ROW-363	299	300	1	1	3	4	1	0
ROW-364	299	303	4	1	3	4	1	0
ROW-364	300	343	43	1	3	4	1	0
ROW-364	300	301	1	1	3	4	1	0
ROW-364	301	477	176	0	4	4	0	0
ROW-364	301	340	39	1	3	5	1	0
ROW-364	301	310	9	1	3	4	1	1
ROW-364	301	310	9	1	3	4	1	1
ROW-364	302	303	1	1	3	4	1	0
ROW-364	302	306	4	1	3	4	1	0
ROW-364	302	304	2	1	3	4	1	0
ROW-365	302	477	175	0	3	1	1	0
ROW-365	302	477	175	0	3	1	0	0
ROW-365	302	477	175	0	3	1	1	0
ROW-365	302	407	105	1	3	4	1	1
ROW-365	302	477	175	0	3	1	0	0
ROW-365	302	477	175	0	3	3	1	0
ROW-365	302	308	6	1	3	4	1	0
ROW-365	302	304	2	1	3	4	1	1
ROW-365	303	304	1	1	3	1	1	0
ROW-365	303	304	1	1	3	4	1	0
ROW-366	303	304	1	1	4	2	1	0
ROW-366	303	304	1	1	4	4	1	0
ROW-366	303	304	1	1	4	2	1	0
ROW-366	303	374	71	1	5	1	0	0
ROW-366	303	309	6	1	3	5	1	0
ROW-366	303	372	69	1	3	5	1	0
ROW-366	303	308	5	1	3	4	1	0
ROW-366	304	425	121	1	3	1	1	1
ROW-366	304	305	1	1	4	1	0	1
ROW-366	304	410	106	1	3	1	1	0
ROW-367	304	305	1	1	3	1	1	0
ROW-367	304	477	173	0	3	4	0	0
ROW-367	304	318	14	1	3	4	1	0
ROW-367	304	318	14	1	3	4	1	0
ROW-367	304	350	46	1	3	4	1	1
ROW-367	304	350	46	1	3	4	1	1
ROW-367	304	477	173	0	3	4	0	0
ROW-367	304	328	24	1	3	4	1	0
ROW-367	304	477	173	0	3	4	0	0
ROW-367	304	477	173	0	3	4	0	0
ROW-368	304	477	173	0	3	4	0	0
ROW-368	304	338	34	1	3	4	1	0
ROW-368	304	305	1	1	3	4	1	0
ROW-368	304	305	1	1	3	4	1	0
ROW-368	304	335	31	1	3	4	1	0
ROW-368	304	477	173	0	3	4	0	0
ROW-368	304	477	173	0	3	4	1	0
ROW-368	304	343	39	1	4	1	1	0
ROW-368	304	477	173	0	3	5	0	0
ROW-368	304	377	73	1	3	3	1	0
ROW-369	304	477	173	0	3	2	0	0
ROW-369	305	306	1	1	3	3	1	0
ROW-369	306	308	2	1	3	2	1	0
ROW-369	306	311	5	1	3	4	1	0
ROW-369	306	307	1	1	4	4	1	0
ROW-369	306	307	1	1	4	4	1	0
ROW-369	306	307	1	1	4	4	1	0
ROW-369	306	308	2	1	3	4	1	0
ROW-369	307	312	5	1	3	1	1	0
ROW-369	307	477	170	0	3	2	0	0
ROW-370	307	312	5	1	3	1	1	0
ROW-370	308	372	64	1	3	3	1	0
ROW-370	308	477	169	0	3	4	1	0
ROW-370	308	355	47	1	3	1	1	1
ROW-370	309	310	1	1	4	1	1	0
ROW-370	309	477	168	0	3	2	1	0
ROW-370	309	477	168	0	3	2	1	0
ROW-370	309	310	1	1	3	1	1	0
ROW-370	309	310	1	1	3	4	1	0
ROW-370	309	477	168	0	3	1	1	0
ROW-371	309	477	168	0	3	4	1	0
ROW-371	309	311	2	1	3	1	1	0
ROW-371	309	310	1	1	3	1	1	0
ROW-371	310	325	15	1	3	5	1	0
ROW-371	310	403	93	1	3	4	1	0
ROW-371	310	311	1	1	3	1	1	0
ROW-371	310	313	3	1	3	1	1	0
ROW-371	311	477	166	0	3	2	0	0
ROW-371	311	312	1	1	4	4	1	0
ROW-371	311	312	1	1	4	4	1	0
ROW-372	311	312	1	1	4	4	1	0
ROW-372	311	312	1	1	3	4	1	0
ROW-372	311	317	6	1	3	4	1	0
ROW-372	311	312	1	1	3	2	1	0
ROW-372	311	312	1	1	4	4	1	0
ROW-372	311	312	1	1	4	4	1	0
ROW-372	311	324	13	1	3	2	1	0
ROW-372	311	343	32	1	3	4	1	0
ROW-372	311	328	17	1	3	1	1	1
ROW-372	311	477	166	0	3	4	1	1
ROW-373	311	477	166	0	3	4	1	0
ROW-373	311	369	58	1	3	2	1	0
ROW-373	311	477	166	0	3	2	0	0
ROW-373	312	313	1	1	4	4	1	0
ROW-373	312	313	1	1	3	1	1	0
ROW-373	312	435	123	1	3	4	1	0
ROW-373	312	313	1	1	3	4	1	0
ROW-373	312	477	165	0	3	4	0	0
ROW-373	312	325	13	1	3	2	1	0
ROW-373	312	477	165	0	3	2	1	0
ROW-374	312	332	20	1	3	1	1	0
ROW-374	312	327	15	1	3	2	1	0
ROW-374	312	313	1	1	3	1	1	0
ROW-374	313	314	1	1	4	4	1	0
ROW-374	313	314	1	1	4	4	1	0
ROW-374	313	314	1	1	3	1	1	0
ROW-374	313	314	1	1	3	4	1	0
ROW-374	313	314	1	1	3	4	1	0
ROW-374	313	314	1	1	4	4	1	0
ROW-374	313	314	1	1	5	4	1	0
ROW-375	313	477	164	0	3	2	0	0
ROW-375	313	318	5	1	3	4	1	0
ROW-375	313	314	1	1	4	4	1	0
ROW-375	313	314	1	1	4	4	1	0
ROW-375	313	318	5	1	3	1	1	0
ROW-375	313	323	10	1	3	2	1	0
ROW-375	314	325	11	1	3	1	1	0
ROW-375	314	477	163	0	3	2	0	0
ROW-375	314	477	163	0	3	4	0	0
ROW-375	314	477	163	0	3	4	0	1
ROW-376	314	368	54	1	3	2	1	0
ROW-376	314	393	79	1	3	2	1	0
ROW-376	59	347	288	1	3	1	1	4
ROW-376	314	477	163	0	3	4	1	0
ROW-376	314	319	5	1	3	1	1	0
ROW-376	315	324	9	1	3	1	1	0
ROW-376	315	477	162	0	3	4	1	0
ROW-376	315	319	4	1	3	1	1	0
ROW-376	267	441	174	1	3	4	1	2
ROW-377	209	429	220	1	3	4	1	0
ROW-377	86	477	391	0	4	4	0	0
ROW-377	163	477	314	0	3	4	1	1
ROW-377	230	346	116	1	3	4	0	1
ROW-377	4	323	319	1	3	1	1	0
ROW-377	316	477	161	0	4	4	0	0
ROW-377	316	477	161	0	3	2	1	0
ROW-377	316	325	9	1	3	4	1	0
ROW-377	316	477	161	0	3	4	1	0
ROW-378	316	477	161	0	3	4	1	0
ROW-378	316	319	3	1	3	4	1	0
ROW-378	316	327	11	1	3	2	1	0
ROW-378	316	477	161	0	3	4	0	0
ROW-378	316	318	2	1	3	4	1	0
ROW-378	317	325	8	1	3	4	1	0
ROW-378	317	477	160	0	4	4	0	0
ROW-378	317	323	6	1	3	4	1	0
ROW-378	317	319	2	1	4	4	1	0
ROW-378	317	477	160	0	3	4	1	0
ROW-379	317	330	13	1	3	1	1	0
ROW-379	317	456	139	1	3	2	1	0
ROW-379	317	343	26	1	3	1	1	0
ROW-379	317	321	4	1	4	1	1	0
ROW-379	318	477	159	0	3	4	0	0
ROW-379	318	319	1	1	3	4	1	0
ROW-379	318	319	1	1	3	4	1	0
ROW-379	318	319	1	1	4	1	1	0
ROW-379	318	319	1	1	3	2	1	0
ROW-379	318	477	159	0	3	4	0	0
ROW-380	318	319	1	1	3	4	1	1
ROW-380	318	477	159	0	3	1	1	0
ROW-380	318	477	159	0	3	1	1	0
ROW-380	318	352	34	1	3	4	1	0
ROW-380	318	462	144	1	3	4	1	0
ROW-380	319	320	1	1	3	1	1	0
ROW-380	319	477	158	0	4	4	1	0
ROW-380	319	332	13	1	3	2	1	0
ROW-380	319	477	158	0	3	2	0	0
ROW-380	319	477	158	0	3	2	0	0
ROW-381	319	477	158	0	3	2	0	0
ROW-381	319	477	158	0	3	2	0	0
ROW-381	319	477	158	0	3	2	0	0
ROW-381	319	477	158	0	3	2	0	0
ROW-381	319	477	158	0	3	2	0	0
ROW-381	319	477	158	0	3	2	0	0
ROW-381	319	422	103	1	3	2	1	0
ROW-381	319	477	158	0	3	2	0	0
ROW-381	319	477	158	0	3	2	0	0
ROW-381	319	374	55	1	3	4	1	0
ROW-382	319	477	158	0	3	4	0	0
ROW-382	319	320	1	1	4	4	1	0
ROW-382	319	477	158	0	3	1	1	0
ROW-382	319	331	12	1	3	2	1	0
ROW-382	319	441	122	1	3	4	1	0
ROW-382	319	320	1	1	3	4	1	0
ROW-382	319	320	1	1	3	4	1	0
ROW-382	320	477	157	0	3	2	1	0
ROW-382	320	321	1	1	5	1	0	0
ROW-382	320	477	157	0	3	4	1	0
ROW-383	320	321	1	1	3	2	1	0
ROW-383	320	328	8	1	3	1	1	0
ROW-383	321	322	1	1	3	1	0	0
ROW-383	321	477	156	0	3	4	0	0
ROW-383	321	339	18	1	3	4	1	1
ROW-383	322	323	1	1	4	1	1	0
ROW-383	322	323	1	1	3	4	1	0
ROW-383	322	323	1	1	3	1	1	0
ROW-383	322	427	105	1	4	4	1	1
ROW-383	322	372	50	1	4	4	1	0
ROW-384	322	477	155	0	3	4	1	0
ROW-384	323	324	1	1	4	4	1	0
ROW-384	323	336	13	1	3	2	1	0
ROW-384	323	445	122	1	4	1	1	0
ROW-384	323	332	9	1	3	5	1	0
ROW-384	324	325	1	1	3	4	1	0
ROW-384	324	396	72	1	3	4	1	0
ROW-384	324	325	1	1	4	4	1	0
ROW-384	324	477	153	0	4	2	0	0
ROW-384	325	332	7	1	4	4	1	0
ROW-385	325	477	152	0	3	2	0	0
ROW-385	325	326	1	1	3	5	1	0
ROW-385	325	326	1	1	4	4	1	0
ROW-385	325	336	11	1	3	4	1	0
ROW-385	325	326	1	1	4	4	1	0
ROW-385	325	331	6	1	3	4	1	0
ROW-385	325	326	1	1	3	4	1	0
ROW-385	325	326	1	1	4	3	0	0
ROW-385	325	326	1	1	4	4	1	0
ROW-385	326	330	4	1	3	3	1	0
ROW-386	326	330	4	1	3	3	1	0
ROW-386	326	477	151	0	3	1	1	0
ROW-386	326	330	4	1	5	4	1	0
ROW-386	326	361	35	1	3	4	1	0
ROW-386	327	328	1	1	3	2	1	0
ROW-386	327	328	1	1	3	4	1	0
ROW-386	327	346	19	1	3	1	1	0
ROW-386	327	328	1	1	3	3	1	0
ROW-386	327	331	4	1	3	4	1	0
ROW-386	327	339	12	1	3	1	1	0
ROW-387	327	335	8	1	3	4	1	0
ROW-387	327	338	11	1	3	4	1	0
ROW-387	328	477	149	0	4	3	0	0
ROW-387	328	477	149	0	3	4	1	0
ROW-387	328	337	9	1	3	1	1	0
ROW-387	328	477	149	0	3	4	0	0
ROW-387	328	403	75	1	3	4	0	0
ROW-387	328	477	149	0	3	4	1	0
ROW-387	329	333	4	1	3	4	1	0
ROW-387	329	350	21	1	3	1	1	0
ROW-388	329	344	15	1	3	4	1	1
ROW-388	329	345	16	1	3	4	1	1
ROW-388	329	436	107	1	3	4	1	1
ROW-388	329	338	9	1	4	4	1	0
ROW-388	329	337	8	1	3	4	1	1
ROW-388	329	343	14	1	4	4	1	0
ROW-388	329	333	4	1	3	4	1	0
ROW-388	329	477	148	0	3	2	0	0
ROW-388	329	332	3	1	4	1	1	0
ROW-388	329	331	2	1	3	1	1	0
ROW-389	330	335	5	1	3	1	1	0
ROW-389	330	331	1	1	3	5	1	0
ROW-389	330	337	7	1	3	1	1	0
ROW-389	330	333	3	1	3	4	1	0
ROW-389	330	338	8	1	3	1	1	0
ROW-389	331	332	1	1	4	4	1	0
ROW-389	331	477	146	0	3	4	1	0
ROW-389	331	477	146	0	3	2	1	0
ROW-389	332	335	3	1	4	1	1	0
ROW-389	332	403	71	1	3	4	1	2
ROW-390	332	333	1	1	3	2	1	0
ROW-390	332	477	145	0	3	4	1	0
ROW-390	332	477	145	0	3	3	0	0
ROW-390	332	402	70	1	3	4	1	0
ROW-390	332	465	133	1	3	4	1	1
ROW-390	332	333	1	1	3	4	1	0
ROW-390	332	337	5	1	3	4	1	0
ROW-390	332	336	4	1	3	1	1	0
ROW-390	332	339	7	1	3	4	1	0
ROW-390	333	334	1	1	3	1	1	0
ROW-391	333	365	32	1	3	4	1	1
ROW-391	333	371	38	1	3	4	1	2
ROW-391	333	335	2	1	3	2	1	0
ROW-391	333	345	12	1	3	4	1	0
ROW-391	333	337	4	1	3	4	1	0
ROW-391	333	339	6	1	3	2	0	0
ROW-391	333	374	41	1	3	2	1	0
ROW-391	333	477	144	0	3	2	1	0
ROW-391	333	374	41	1	3	1	1	1
ROW-391	333	477	144	0	3	4	1	0
ROW-392	333	334	1	1	3	1	1	0
ROW-392	334	339	5	1	3	5	1	0
ROW-392	334	335	1	1	3	4	1	0
ROW-392	334	400	66	1	4	1	1	0
ROW-392	334	335	1	1	3	2	1	0
ROW-392	335	336	1	1	3	4	1	0
ROW-392	335	387	52	1	3	4	1	1
ROW-392	335	477	142	0	3	1	0	0
ROW-392	335	360	25	1	3	4	1	1
ROW-392	336	338	2	1	3	4	1	0
ROW-393	336	340	4	1	4	4	1	0
ROW-393	336	337	1	1	4	1	1	0
ROW-393	336	360	24	1	3	4	1	0
ROW-393	337	477	140	0	4	1	1	0
ROW-393	337	338	1	1	4	4	1	0
ROW-393	337	477	140	0	3	4	0	0
ROW-393	337	338	1	1	3	1	1	0
ROW-393	338	339	1	1	3	1	1	0
ROW-393	338	357	19	1	3	2	1	0
ROW-393	338	339	1	1	3	5	1	0
ROW-394	338	342	4	1	4	1	1	0
ROW-394	338	339	1	1	3	1	1	0
ROW-394	338	343	5	1	3	1	1	0
ROW-394	338	477	139	0	3	1	0	0
ROW-394	338	342	4	1	3	4	0	0
ROW-394	339	340	1	1	3	2	1	0
ROW-394	339	340	1	1	3	2	1	0
ROW-394	339	477	138	0	4	2	1	0
ROW-394	339	340	1	1	3	5	1	0
ROW-395	339	341	2	1	3	4	1	0
ROW-395	340	434	94	1	3	4	1	0
ROW-395	340	341	1	1	4	4	1	1
ROW-395	340	348	8	1	3	1	1	0
ROW-395	340	433	93	1	3	4	1	1
ROW-395	340	341	1	1	3	1	1	0
ROW-395	340	341	1	1	3	1	0	0
ROW-395	340	351	11	1	3	1	1	0
ROW-395	340	346	6	1	3	4	1	0
ROW-395	341	373	32	1	3	2	1	0
ROW-396	341	345	4	1	5	4	1	1
ROW-396	341	342	1	1	5	1	1	0
ROW-396	341	477	136	0	4	1	0	0
ROW-396	341	342	1	1	3	4	1	0
ROW-396	341	343	2	1	4	4	1	0
ROW-396	342	394	52	1	4	4	1	1
ROW-396	342	401	59	1	4	4	1	1
ROW-396	342	343	1	1	3	4	1	0
ROW-396	342	359	17	1	3	2	0	0
ROW-396	342	343	1	1	3	1	1	0
ROW-397	342	343	1	1	3	3	1	0
ROW-397	342	348	6	1	3	4	1	0
ROW-397	342	401	59	1	3	4	1	0
ROW-397	342	477	135	0	3	3	1	0
ROW-397	342	347	5	1	3	4	1	0
ROW-397	342	477	135	0	3	4	1	0
ROW-397	342	345	3	1	3	1	1	0
ROW-397	342	343	1	1	3	1	1	0
ROW-397	342	477	135	0	3	2	1	0
ROW-397	343	352	9	1	3	1	1	0
ROW-398	343	344	1	1	4	1	1	0
ROW-398	343	416	73	1	3	5	1	0
ROW-398	343	353	10	1	3	4	1	0
ROW-398	343	344	1	1	3	3	1	0
ROW-398	343	348	5	1	3	4	1	0
ROW-398	343	416	73	1	3	4	1	0
ROW-398	343	345	2	1	3	4	1	0
ROW-398	343	344	1	1	4	4	1	1
ROW-398	343	345	2	1	3	4	1	0
ROW-398	343	352	9	1	3	1	1	0
ROW-399	343	344	1	1	5	1	0	0
ROW-399	343	346	3	1	3	1	0	0
ROW-399	343	344	1	1	4	1	0	0
ROW-399	344	345	1	1	3	3	1	0
ROW-399	344	347	3	1	3	4	1	0
ROW-399	344	345	1	1	3	4	1	0
ROW-399	344	345	1	1	3	1	1	0
ROW-399	344	373	29	1	3	4	1	0
ROW-399	344	477	133	0	4	5	0	0
ROW-399	344	345	1	1	3	1	0	0
ROW-400	344	403	59	1	4	1	0	0
ROW-400	344	477	133	0	3	2	1	0
ROW-400	345	346	1	1	3	4	1	0
ROW-400	345	477	132	0	3	3	0	0
ROW-400	345	346	1	1	3	4	1	0
ROW-400	345	346	1	1	3	4	1	0
ROW-400	345	348	3	1	3	4	1	0
ROW-400	345	435	90	1	2	1	1	0
ROW-400	345	346	1	1	3	1	1	0
ROW-400	345	367	22	1	3	4	1	0
ROW-401	345	403	58	1	3	4	1	0
ROW-401	346	354	8	1	3	1	1	0
ROW-401	346	437	91	1	3	4	1	0
ROW-401	346	477	131	0	3	4	1	0
ROW-401	346	404	58	1	3	4	1	0
ROW-401	346	347	1	1	4	4	1	0
ROW-401	346	452	106	1	3	1	0	1
ROW-401	346	350	4	1	3	4	1	0
ROW-401	346	477	131	0	3	1	0	0
ROW-401	346	347	1	1	3	1	1	0
ROW-402	346	477	131	0	3	4	1	0
ROW-402	346	477	131	0	3	1	0	0
ROW-402	346	477	131	0	3	4	1	0
ROW-402	346	403	57	1	3	4	1	0
ROW-402	347	404	57	1	3	4	1	0
ROW-402	347	477	130	0	3	4	0	0
ROW-402	347	350	3	1	3	4	1	0
ROW-402	347	348	1	1	3	1	0	0
ROW-402	347	350	3	1	3	2	1	0
ROW-402	347	348	1	1	3	4	1	0
ROW-403	347	352	5	1	3	4	1	0
ROW-403	347	387	40	1	4	4	1	0
ROW-403	347	477	130	0	4	3	0	0
ROW-403	347	350	3	1	3	1	1	0
ROW-403	347	350	3	1	3	1	1	0
ROW-403	348	349	1	1	3	4	1	0
ROW-403	348	477	129	0	3	4	1	0
ROW-403	348	349	1	1	3	4	1	0
ROW-403	348	353	5	1	4	4	1	0
ROW-403	348	349	1	1	3	3	1	0
ROW-404	348	421	73	1	4	4	1	0
ROW-404	348	350	2	1	3	1	1	0
ROW-404	348	372	24	1	4	4	1	0
ROW-404	348	350	2	1	3	3	1	0
ROW-404	348	349	1	1	3	3	1	0
ROW-404	348	350	2	1	3	3	1	0
ROW-404	348	477	129	0	3	3	1	0
ROW-404	348	477	129	0	3	4	1	0
ROW-404	349	350	1	1	3	4	1	0
ROW-404	349	350	1	1	3	1	1	0
ROW-405	349	443	94	1	1	1	1	1
ROW-405	350	352	2	1	3	4	1	0
ROW-405	350	353	3	1	1	1	1	0
ROW-405	350	351	1	1	3	1	1	0
ROW-405	350	351	1	1	3	4	1	0
ROW-405	350	351	1	1	3	1	1	1
ROW-405	351	438	87	1	3	4	1	1
ROW-405	351	477	126	0	3	4	1	0
ROW-405	351	354	3	1	3	1	1	0
ROW-405	351	477	126	0	3	2	0	0
ROW-406	351	372	21	1	3	5	1	0
ROW-406	351	402	51	1	3	5	1	0
ROW-406	351	370	19	1	4	1	0	1
ROW-406	351	477	126	0	3	4	0	0
ROW-406	351	477	126	0	3	4	0	0
ROW-406	351	374	23	1	3	1	1	0
ROW-406	351	352	1	1	4	1	1	0
ROW-406	351	477	126	0	4	4	1	0
ROW-406	351	403	52	1	3	4	1	0
ROW-406	351	352	1	1	3	4	1	0
ROW-407	351	352	1	1	3	1	1	0
ROW-407	351	424	73	1	4	3	1	0
ROW-407	351	424	73	1	4	3	1	0
ROW-407	351	352	1	1	3	1	1	0
ROW-407	351	352	1	1	3	1	1	0
ROW-407	352	355	3	1	3	5	1	0
ROW-407	352	477	125	0	4	1	1	0
ROW-407	352	353	1	1	3	1	0	0
ROW-407	352	360	8	1	3	1	1	0
ROW-407	352	353	1	1	4	5	1	0
ROW-408	352	360	8	1	3	4	1	0
ROW-408	352	441	89	1	3	1	1	0
ROW-408	352	353	1	1	5	4	1	0
ROW-408	352	477	125	0	3	4	1	0
ROW-408	352	353	1	1	4	4	1	0
ROW-408	353	354	1	1	3	4	1	0
ROW-408	353	477	124	0	3	3	0	0
ROW-408	353	354	1	1	3	4	1	0
ROW-408	353	360	7	1	3	1	1	0
ROW-408	353	354	1	1	4	1	1	0
ROW-409	353	477	124	0	4	2	1	0
ROW-409	353	477	124	0	3	5	1	0
ROW-409	353	432	79	1	3	4	1	0
ROW-409	354	355	1	1	4	4	1	0
ROW-409	354	442	88	1	3	4	1	0
ROW-409	354	477	123	0	3	4	1	0
ROW-409	354	477	123	0	3	4	0	0
ROW-409	354	477	123	0	3	2	1	0
ROW-409	354	355	1	1	3	4	1	0
ROW-409	354	477	123	0	3	4	1	0
ROW-410	354	359	5	1	3	3	1	1
ROW-410	354	355	1	1	3	1	1	0
ROW-410	354	360	6	1	3	4	1	0
ROW-410	354	359	5	1	3	4	1	0
ROW-410	355	408	53	1	3	1	1	0
ROW-410	355	356	1	1	4	4	1	0
ROW-410	355	356	1	1	3	1	1	0
ROW-410	356	357	1	1	3	4	1	0
ROW-410	356	427	71	1	3	1	1	0
ROW-410	356	357	1	1	3	1	1	0
ROW-411	356	410	54	1	3	4	1	0
ROW-411	356	477	121	0	3	4	1	0
ROW-411	357	360	3	1	3	2	1	0
ROW-411	357	361	4	1	3	1	1	0
ROW-411	358	359	1	1	5	1	1	0
ROW-411	359	360	1	1	3	1	1	0
ROW-411	359	360	1	1	3	4	1	0
ROW-411	359	415	56	1	3	1	1	0
ROW-411	359	373	14	1	3	1	1	0
ROW-411	359	477	118	0	3	4	1	0
ROW-412	359	477	118	0	3	4	1	0
ROW-412	360	398	38	1	3	5	0	0
ROW-412	360	368	8	1	4	4	1	0
ROW-412	360	384	24	1	3	4	1	0
ROW-412	360	405	45	1	3	4	1	4
ROW-412	360	371	11	1	3	1	1	0
ROW-412	360	371	11	1	3	1	1	0
ROW-412	360	368	8	1	4	4	1	0
ROW-412	361	364	3	1	4	1	1	0
ROW-412	361	362	1	1	3	4	1	0
ROW-413	361	369	8	1	3	1	1	0
ROW-413	362	477	115	0	3	4	1	0
ROW-413	362	363	1	1	3	2	1	0
ROW-413	363	477	114	0	3	1	1	1
ROW-413	363	364	1	1	3	1	1	1
ROW-413	363	364	1	1	3	1	1	0
TEMIS-157	1	17	16	1	3	1	1	0
TEMIS-157	3	7	4	1	4	1	0	0
TEMIS-157	3	22	19	1	3	4	1	0
TEMIS-158	3	22	19	1	3	1	1	0
TEMIS-158	3	7	4	1	3	1	1	0
TEMIS-158	3	4	1	1	3	1	0	0
TEMIS-158	4	477	473	0	3	2	0	0
TEMIS-158	4	477	473	0	3	2	0	0
TEMIS-158	4	21	17	1	3	4	1	0
TEMIS-158	4	18	14	1	3	4	0	0
TEMIS-158	4	477	473	0	3	2	0	0
TEMIS-158	6	7	1	1	3	1	0	0
TEMIS-158	7	17	10	1	4	1	1	0
TEMIS-159	7	21	14	1	3	4	1	0
TEMIS-159	7	21	14	1	3	1	1	0
TEMIS-159	8	477	469	0	4	1	0	0
TEMIS-159	8	18	10	1	3	1	0	0
TEMIS-159	8	9	1	1	4	1	1	0
TEMIS-159	9	21	12	1	3	1	1	0
TEMIS-159	9	11	2	1	3	1	1	1
TEMIS-159	9	10	1	1	3	1	1	0
TEMIS-159	9	10	1	1	3	1	1	0
TEMIS-159	10	21	11	1	3	1	1	0
TEMIS-160	10	17	7	1	3	2	1	1
TEMIS-160	10	11	1	1	4	1	1	0
TEMIS-160	10	21	11	1	3	1	1	0
TEMIS-160	11	60	49	1	4	1	0	1
TEMIS-160	11	437	426	1	3	1	1	0
TEMIS-160	12	119	107	1	3	1	1	2
TEMIS-160	12	21	9	1	3	4	1	0
TEMIS-160	14	49	35	1	3	1	1	0
TEMIS-160	14	58	44	1	3	1	1	1
TEMIS-160	15	16	1	1	3	1	1	0
TEMIS-161	15	17	2	1	3	1	1	0
TEMIS-161	15	48	33	1	3	1	1	0
TEMIS-161	15	21	6	1	3	1	1	0
TEMIS-161	15	18	3	1	3	4	1	1
TEMIS-161	16	477	461	0	4	1	0	0
TEMIS-161	16	18	2	1	3	1	0	0
TEMIS-161	16	49	33	1	3	4	1	0
TEMIS-161	17	18	1	1	4	1	1	0
TEMIS-161	17	155	138	1	3	1	0	0
TEMIS-161	17	18	1	1	3	4	1	1
TEMIS-162	17	21	4	1	3	1	0	1
TEMIS-162	18	21	3	1	3	1	1	0
TEMIS-162	18	21	3	1	3	4	1	0
TEMIS-162	18	48	30	1	4	2	1	0
TEMIS-162	20	21	1	1	5	1	1	0
TEMIS-162	21	49	28	1	3	1	1	0
TEMIS-162	21	49	28	1	3	4	1	0
TEMIS-162	21	23	2	1	3	1	1	0
TEMIS-162	21	22	1	1	3	1	1	0
TEMIS-162	22	23	1	1	3	1	1	0
TEMIS-163	22	35	13	1	3	4	1	0
TEMIS-163	23	477	454	0	3	4	0	0
TEMIS-163	23	44	21	1	3	3	1	0
TEMIS-163	23	24	1	1	3	1	1	1
TEMIS-163	23	477	454	0	3	1	0	1
TEMIS-163	23	477	454	0	3	1	0	1
TEMIS-163	23	477	454	0	3	1	0	2
TEMIS-163	23	49	26	1	3	1	0	2
TEMIS-163	25	48	23	1	3	1	1	1
TEMIS-163	25	31	6	1	3	1	1	1
TEMIS-164	25	58	33	1	3	4	0	0
TEMIS-164	26	48	22	1	3	4	1	1
TEMIS-164	29	31	2	1	3	3	1	0
TEMIS-164	29	31	2	1	3	1	1	0
TEMIS-164	29	31	2	1	3	1	1	0
TEMIS-164	30	31	1	1	2	1	1	0
TEMIS-164	30	59	29	1	3	1	1	0
TEMIS-164	30	31	1	1	3	4	1	0
TEMIS-164	30	48	18	1	3	1	0	0
TEMIS-164	31	35	4	1	3	2	1	2
TEMIS-165	31	64	33	1	4	4	1	0
TEMIS-165	31	44	13	1	3	4	1	1
TEMIS-165	31	32	1	1	3	1	1	0
TEMIS-165	31	136	105	1	3	4	1	0
TEMIS-165	32	33	1	1	3	1	1	0
TEMIS-165	32	33	1	1	3	1	1	0
TEMIS-165	32	58	26	1	4	4	1	0
TEMIS-165	32	33	1	1	3	1	1	0
TEMIS-165	32	48	16	1	3	4	1	0
TEMIS-165	33	136	103	1	3	1	1	0
TEMIS-166	33	64	31	1	3	1	1	0
TEMIS-166	35	64	29	1	4	2	1	0
TEMIS-166	35	47	12	1	3	1	1	0
TEMIS-166	35	38	3	1	3	2	1	1
TEMIS-166	36	52	16	1	3	1	1	0
TEMIS-166	36	477	441	0	4	4	0	0
TEMIS-166	37	56	19	1	3	1	2	0
TEMIS-166	37	42	5	1	4	1	1	0
TEMIS-166	37	477	440	0	3	1	0	0
TEMIS-166	38	64	26	1	3	1	1	0
TEMIS-167	39	56	17	1	3	1	1	0
TEMIS-167	39	477	438	0	3	1	0	1
TEMIS-167	39	477	438	0	3	1	0	1
TEMIS-167	39	477	438	0	3	1	0	1
TEMIS-167	39	49	10	1	4	1	0	0
TEMIS-167	39	47	8	1	3	4	1	0
TEMIS-167	39	477	438	0	3	4	0	0
TEMIS-167	42	52	10	1	3	1	1	0
TEMIS-167	42	64	22	1	3	1	1	0
TEMIS-167	43	64	21	1	3	4	1	0
TEMIS-168	43	49	6	1	3	1	1	0
TEMIS-168	44	60	16	1	3	1	1	0
TEMIS-168	44	67	23	1	1	1	1	0
TEMIS-168	45	477	432	0	3	1	0	0
TEMIS-168	45	47	2	1	3	3	1	0
TEMIS-168	46	51	5	1	3	4	1	0
TEMIS-168	46	477	431	0	3	1	0	0
TEMIS-168	46	50	4	1	3	3	1	0
TEMIS-168	46	49	3	1	3	1	1	0
TEMIS-168	47	48	1	1	5	4	0	0
TEMIS-169	47	64	17	1	5	4	1	0
TEMIS-169	49	477	428	0	4	1	0	0
TEMIS-169	49	60	11	1	4	1	0	0
TEMIS-169	51	56	5	1	3	1	1	1
TEMIS-169	52	56	4	1	4	1	1	0
TEMIS-169	52	53	1	1	3	4	1	0
TEMIS-169	52	60	8	1	3	1	1	0
TEMIS-169	52	53	1	1	4	4	1	0
TEMIS-169	52	64	12	1	3	4	1	0
TEMIS-169	53	477	424	0	3	2	0	0
TEMIS-170	53	64	11	1	3	1	1	0
TEMIS-170	53	136	83	1	3	1	1	1
TEMIS-170	56	58	2	1	4	4	1	0
TEMIS-170	56	60	4	1	3	1	1	0
TEMIS-170	56	57	1	1	3	1	1	0
TEMIS-170	57	64	7	1	4	1	1	0
TEMIS-170	57	58	1	1	4	4	1	0
TEMIS-170	57	58	1	1	3	1	1	1
TEMIS-170	58	59	1	1	4	4	0	1
TEMIS-170	58	72	14	1	3	1	1	0
TEMIS-171	58	382	324	1	3	1	2	0
TEMIS-171	58	59	1	1	3	1	1	0
TEMIS-171	58	59	1	1	4	1	1	0
TEMIS-171	58	64	6	1	3	1	1	0
TEMIS-171	59	66	7	1	3	1	1	0
TEMIS-171	59	65	6	1	3	1	0	0
TEMIS-171	59	64	5	1	3	1	0	0
TEMIS-171	59	64	5	1	3	1	1	0
TEMIS-171	59	64	5	1	3	1	1	0
TEMIS-171	60	64	4	1	4	3	1	0
TEMIS-172	60	61	1	1	3	1	1	1
TEMIS-172	60	61	1	1	4	1	1	0
TEMIS-172	60	64	4	1	3	4	1	0
TEMIS-172	60	64	4	1	4	4	1	0
TEMIS-172	60	63	3	1	3	4	1	0
TEMIS-172	60	63	3	1	4	1	0	1
TEMIS-172	60	64	4	1	3	1	1	0
TEMIS-172	60	64	4	1	3	1	1	0
TEMIS-172	63	64	1	1	4	4	1	0
TEMIS-172	63	477	414	0	4	5	0	0
TEMIS-173	63	64	1	1	3	1	1	0
TEMIS-173	64	65	1	1	3	1	1	0
TEMIS-173	65	228	163	1	3	1	1	0
TEMIS-173	65	66	1	1	3	1	0	0
TEMIS-173	65	477	412	0	3	1	0	0
TEMIS-173	66	84	18	1	3	1	0	0
TEMIS-173	66	95	29	1	3	1	1	0
TEMIS-173	66	67	1	1	3	1	1	1
TEMIS-173	66	477	411	0	3	1	0	0
TEMIS-173	66	67	1	1	3	4	1	0
TEMIS-174	67	136	69	1	3	4	1	0
TEMIS-174	67	68	1	1	3	1	1	0
TEMIS-174	67	129	62	1	3	1	0	0
TEMIS-174	70	136	66	1	3	1	1	0
TEMIS-174	70	136	66	1	3	1	1	0
TEMIS-174	70	477	407	0	3	4	0	1
TEMIS-174	72	136	64	1	3	1	1	1
TEMIS-174	73	136	63	1	1	1	1	0
TEMIS-174	73	136	63	1	3	1	1	1
TEMIS-174	73	129	56	1	3	1	0	0
TEMIS-175	74	477	403	0	3	4	1	0
TEMIS-175	74	75	1	1	3	1	1	1
TEMIS-175	77	136	59	1	3	1	1	0
TEMIS-175	77	136	59	1	3	1	1	0
TEMIS-175	78	136	58	1	3	1	1	0
TEMIS-175	78	80	2	1	4	4	0	0
TEMIS-175	79	477	398	0	3	1	0	0
TEMIS-175	79	136	57	1	3	1	1	0
TEMIS-175	79	136	57	1	3	4	1	0
TEMIS-175	79	477	398	0	3	1	0	0
TEMIS-176	79	136	57	1	3	4	1	0
TEMIS-176	79	136	57	1	3	1	1	0
TEMIS-176	80	136	56	1	3	1	1	1
TEMIS-176	80	136	56	1	3	1	1	0
TEMIS-176	80	136	56	1	3	1	1	0
TEMIS-176	80	136	56	1	3	1	1	0
TEMIS-176	80	136	56	1	1	1	1	1
TEMIS-176	80	136	56	1	3	4	1	0
TEMIS-176	81	136	55	1	3	1	1	1
TEMIS-176	84	477	393	0	4	4	0	0
TEMIS-177	85	136	51	1	3	1	1	1
TEMIS-177	85	87	2	1	3	2	0	0
TEMIS-177	86	136	50	1	3	3	1	0
TEMIS-177	86	129	43	1	3	1	0	0
TEMIS-177	86	136	50	1	3	4	1	0
TEMIS-177	86	136	50	1	3	1	1	0
TEMIS-177	86	136	50	1	3	4	1	0
TEMIS-177	87	136	49	1	3	4	1	0
TEMIS-177	87	348	261	1	4	4	1	0
TEMIS-177	91	136	45	1	3	1	1	0
TEMIS-178	91	136	45	1	3	1	1	0
TEMIS-178	92	136	44	1	3	1	1	0
TEMIS-178	92	136	44	1	3	1	1	0
TEMIS-178	93	136	43	1	5	1	1	0
TEMIS-178	93	136	43	1	3	4	1	0
TEMIS-178	93	136	43	1	3	1	1	0
TEMIS-178	94	95	1	1	3	1	0	0
TEMIS-178	94	477	383	0	3	1	0	0
TEMIS-178	95	136	41	1	3	4	1	0
TEMIS-178	95	477	382	0	3	1	0	1
TEMIS-179	97	136	39	1	3	4	1	0
TEMIS-179	98	136	38	1	3	1	1	0
TEMIS-179	98	136	38	1	3	1	1	0
TEMIS-179	98	136	38	1	4	4	1	0
TEMIS-179	98	136	38	1	3	1	1	1
TEMIS-179	98	268	170	1	3	1	2	1
TEMIS-179	98	136	38	1	3	1	1	0
TEMIS-179	99	136	37	1	3	1	1	1
TEMIS-179	99	136	37	1	5	1	1	0
TEMIS-179	99	136	37	1	3	4	1	0
TEMIS-180	99	136	37	1	3	1	1	1
TEMIS-180	100	136	36	1	4	1	1	0
TEMIS-180	100	477	377	0	4	4	0	0
TEMIS-180	101	136	35	1	4	4	1	0
TEMIS-180	101	136	35	1	3	1	1	1
TEMIS-180	102	136	34	1	4	1	1	0
TEMIS-180	103	136	33	1	3	1	1	0
TEMIS-180	104	477	373	0	3	4	0	0
TEMIS-180	104	136	32	1	3	1	1	0
TEMIS-180	105	136	31	1	4	4	1	0
TEMIS-181	105	136	31	1	3	1	1	0
TEMIS-181	105	477	372	0	3	4	0	0
TEMIS-181	105	107	2	1	1	1	0	0
TEMIS-181	105	136	31	1	3	1	1	0
TEMIS-181	105	136	31	1	3	1	1	0
TEMIS-181	106	136	30	1	4	4	1	0
TEMIS-181	108	136	28	1	4	4	1	0
TEMIS-181	108	109	1	1	3	1	0	0
TEMIS-181	108	136	28	1	3	1	1	0
TEMIS-181	109	168	59	1	4	1	1	1
TEMIS-182	109	477	368	0	3	1	0	0
TEMIS-182	109	136	27	1	3	1	1	0
TEMIS-182	110	136	26	1	5	3	1	0
TEMIS-182	112	136	24	1	3	1	1	0
TEMIS-182	112	136	24	1	3	1	1	0
TEMIS-182	113	382	269	1	3	1	2	0
TEMIS-182	113	136	23	1	3	4	1	0
TEMIS-182	114	477	363	0	3	4	0	0
TEMIS-182	114	129	15	1	3	4	1	0
TEMIS-182	114	136	22	1	4	1	1	0
TEMIS-183	114	136	22	1	3	1	1	1
TEMIS-183	114	115	1	1	3	1	0	1
TEMIS-183	114	136	22	1	4	5	1	0
TEMIS-183	115	477	362	0	3	1	0	0
TEMIS-183	116	136	20	1	3	1	1	1
TEMIS-183	116	150	34	1	3	1	0	0
TEMIS-183	116	136	20	1	4	1	1	0
TEMIS-183	119	136	17	1	3	1	1	0
TEMIS-183	119	136	17	1	3	1	1	0
TEMIS-183	120	136	16	1	3	1	1	0
TEMIS-184	120	136	16	1	3	4	1	0
TEMIS-184	121	129	8	1	3	1	0	1
TEMIS-184	121	136	15	1	3	1	1	0
TEMIS-184	121	136	15	1	3	4	1	1
TEMIS-184	122	136	14	1	3	1	1	0
TEMIS-184	122	136	14	1	3	4	1	0
TEMIS-184	122	136	14	1	3	1	1	0
TEMIS-184	122	136	14	1	4	4	1	0
TEMIS-184	122	136	14	1	3	1	1	0
TEMIS-184	122	127	5	1	3	1	0	1
TEMIS-185	126	310	184	1	3	1	1	0
TEMIS-185	126	136	10	1	3	1	1	0
TEMIS-185	126	136	10	1	3	1	1	0
TEMIS-185	128	150	22	1	3	5	2	1
TEMIS-185	128	477	349	0	4	1	0	0
TEMIS-185	128	284	156	1	3	2	0	1
TEMIS-185	128	298	170	1	3	2	1	0
TEMIS-185	128	129	1	1	3	1	0	0
TEMIS-185	128	150	22	1	1	1	2	2
TEMIS-185	130	477	347	0	3	1	0	0
TEMIS-186	130	157	27	1	5	1	1	1
TEMIS-186	130	136	6	1	4	4	1	1
TEMIS-186	130	136	6	1	3	1	1	0
TEMIS-186	133	477	344	0	3	1	0	0
TEMIS-186	133	477	344	0	3	1	0	0
TEMIS-186	133	477	344	0	4	1	0	0
TEMIS-186	133	141	8	1	3	4	1	0
TEMIS-186	134	387	253	1	3	4	1	0
TEMIS-186	135	141	6	1	3	5	2	0
TEMIS-186	135	162	27	1	3	1	0	0
TEMIS-187	135	150	15	1	3	1	2	0
TEMIS-187	136	141	5	1	3	1	0	1
TEMIS-187	137	150	13	1	3	1	2	0
TEMIS-187	140	150	10	1	3	1	2	1
TEMIS-187	140	169	29	1	2	1	2	0
TEMIS-187	140	141	1	1	2	1	2	1
TEMIS-187	141	150	9	1	3	1	2	1
TEMIS-187	141	142	1	1	4	3	0	0
TEMIS-187	141	477	336	0	3	1	0	1
TEMIS-187	142	477	335	0	3	1	0	0
TEMIS-188	142	477	335	0	3	4	0	0
TEMIS-188	142	477	335	0	3	1	0	0
TEMIS-188	142	150	8	1	3	3	2	0
TEMIS-188	143	477	334	0	3	1	0	0
TEMIS-188	143	477	334	0	3	2	0	0
TEMIS-188	143	169	26	1	2	1	2	0
TEMIS-188	143	144	1	1	4	4	0	0
TEMIS-188	143	169	26	1	2	1	2	0
TEMIS-188	143	169	26	1	3	4	1	0
TEMIS-188	144	477	333	0	3	1	0	0
TEMIS-189	145	169	24	1	2	1	1	0
TEMIS-189	147	169	22	1	2	1	2	0
TEMIS-189	149	154	5	1	4	2	1	0
TEMIS-189	149	168	19	1	3	1	2	0
TEMIS-189	149	382	233	1	2	5	2	0
TEMIS-189	149	169	20	1	4	4	1	0
TEMIS-189	150	154	4	1	3	1	1	1
TEMIS-189	150	154	4	1	3	4	1	1
TEMIS-189	150	257	107	1	3	1	1	0
TEMIS-189	150	477	327	0	4	1	0	0
TEMIS-190	151	169	18	1	2	1	2	1
TEMIS-190	151	170	19	1	3	1	0	0
TEMIS-190	151	154	3	1	2	1	2	0
TEMIS-190	151	154	3	1	4	4	1	1
TEMIS-190	154	477	323	0	3	5	1	1
TEMIS-190	154	155	1	1	3	1	0	0
TEMIS-190	154	477	323	0	3	1	0	1
TEMIS-190	154	157	3	1	4	1	1	1
TEMIS-190	155	157	2	1	3	4	1	1
TEMIS-190	155	157	2	1	4	4	1	1
TEMIS-191	155	157	2	1	3	1	0	1
TEMIS-191	155	157	2	1	4	1	1	1
TEMIS-191	155	169	14	1	4	3	2	4
TEMIS-191	156	165	9	1	3	3	2	0
TEMIS-191	156	165	9	1	4	3	2	0
TEMIS-191	156	169	13	1	2	1	2	0
TEMIS-191	157	477	320	0	3	4	1	1
TEMIS-191	157	170	13	1	2	2	1	0
TEMIS-191	158	242	84	1	4	3	2	0
TEMIS-191	158	267	109	1	3	1	2	1
TEMIS-192	158	169	11	1	1	1	2	0
TEMIS-192	161	477	316	0	3	1	0	0
TEMIS-192	161	162	1	1	3	1	1	0
TEMIS-192	161	169	8	1	3	1	2	0
TEMIS-192	161	170	9	1	2	1	2	1
TEMIS-192	162	477	315	0	3	4	0	0
TEMIS-192	162	169	7	1	3	3	1	0
TEMIS-192	162	170	8	1	2	1	2	1
TEMIS-192	163	173	10	1	2	1	2	0
TEMIS-192	163	318	155	1	3	1	2	0
TEMIS-193	163	172	9	1	3	1	1	0
TEMIS-193	163	169	6	1	2	3	1	0
TEMIS-193	164	477	313	0	3	1	0	1
TEMIS-193	164	477	313	0	3	1	0	0
TEMIS-193	164	168	4	1	2	1	2	0
TEMIS-193	164	165	1	1	3	1	2	1
TEMIS-193	165	169	4	1	2	1	2	0
TEMIS-193	165	477	312	0	3	1	0	0
TEMIS-193	165	236	71	1	4	3	1	1
TEMIS-193	166	168	2	1	3	1	2	0
TEMIS-194	168	169	1	1	1	1	2	2
TEMIS-194	168	233	65	1	3	1	1	1
TEMIS-194	168	169	1	1	2	1	2	2
TEMIS-194	168	169	1	1	3	1	2	0
TEMIS-194	170	171	1	1	5	1	2	0
TEMIS-194	170	171	1	1	5	1	1	0
TEMIS-194	170	477	307	0	3	1	0	0
TEMIS-194	170	171	1	1	2	4	2	1
TEMIS-194	170	437	267	1	3	3	1	0
TEMIS-194	171	346	175	1	4	1	1	0
TEMIS-195	171	218	47	1	3	3	1	0
TEMIS-195	171	172	1	1	3	1	1	1
TEMIS-195	172	437	265	1	3	1	1	0
TEMIS-195	172	477	305	0	1	4	1	0
TEMIS-195	176	295	119	1	3	3	1	0
TEMIS-195	177	178	1	1	3	1	0	0
TEMIS-195	177	212	35	1	3	3	1	0
TEMIS-195	177	189	12	1	4	3	1	0
TEMIS-195	178	197	19	1	3	1	2	0
TEMIS-195	178	191	13	1	4	1	1	0
TEMIS-196	178	477	299	0	4	1	0	0
TEMIS-196	178	284	106	1	3	4	2	1
TEMIS-196	178	477	299	0	4	1	0	0
TEMIS-196	179	477	298	0	4	1	0	0
TEMIS-196	179	477	298	0	3	3	0	0
TEMIS-196	185	477	292	0	3	1	0	0
TEMIS-196	185	192	7	1	3	1	2	0
TEMIS-196	185	477	292	0	3	2	0	0
TEMIS-196	185	477	292	0	3	2	0	0
TEMIS-196	185	477	292	0	3	3	0	0
TEMIS-197	186	242	56	1	3	1	2	0
TEMIS-197	186	249	63	1	3	4	2	0
TEMIS-197	188	477	289	0	3	1	0	0
TEMIS-197	189	192	3	1	1	1	0	0
TEMIS-197	189	242	53	1	3	3	2	0
TEMIS-197	189	477	288	0	1	1	1	0
TEMIS-197	190	191	1	1	3	1	0	1
TEMIS-197	191	429	238	1	4	4	2	0
TEMIS-197	192	219	27	1	2	1	2	2
TEMIS-197	192	206	14	1	4	1	1	0
TEMIS-198	192	321	129	1	5	4	1	0
TEMIS-198	192	256	64	1	5	4	1	0
TEMIS-198	199	477	278	0	3	1	0	0
TEMIS-198	200	477	277	0	3	1	0	0
TEMIS-198	200	234	34	1	3	1	0	1
TEMIS-198	201	228	27	1	2	1	1	0
TEMIS-198	203	228	25	1	3	1	1	0
TEMIS-198	204	211	7	1	3	4	1	1
TEMIS-198	204	228	24	1	3	1	1	0
TEMIS-198	204	228	24	1	3	1	1	0
TEMIS-199	205	228	23	1	3	1	1	0
TEMIS-199	205	260	55	1	1	3	1	1
TEMIS-199	206	228	22	1	3	1	1	0
TEMIS-199	207	477	270	0	3	1	0	0
TEMIS-199	210	228	18	1	4	4	1	0
TEMIS-199	210	228	18	1	3	1	1	0
TEMIS-199	210	299	89	1	4	1	2	0
TEMIS-199	210	228	18	1	3	1	1	0
TEMIS-199	211	477	266	0	4	1	0	0
TEMIS-199	211	221	10	1	3	4	1	0
TEMIS-200	211	299	88	1	3	1	2	0
TEMIS-200	211	228	17	1	3	1	1	0
TEMIS-200	211	477	266	0	3	1	0	0
TEMIS-200	212	437	225	1	3	4	1	0
TEMIS-200	212	477	265	0	3	4	0	0
TEMIS-200	212	477	265	0	4	1	0	1
TEMIS-200	212	242	30	1	3	3	1	0
TEMIS-200	212	298	86	1	2	1	0	0
TEMIS-200	213	226	13	1	4	2	1	0
TEMIS-200	213	214	1	1	3	3	0	0
TEMIS-201	214	226	12	1	3	1	2	0
TEMIS-201	214	228	14	1	3	1	1	1
TEMIS-201	217	451	234	1	3	1	0	0
TEMIS-201	218	228	10	1	3	1	1	0
TEMIS-201	218	219	1	1	3	1	2	0
TEMIS-201	218	221	3	1	4	4	0	0
TEMIS-201	219	242	23	1	4	5	1	0
TEMIS-201	219	221	2	1	3	1	2	0
TEMIS-201	219	242	23	1	3	4	1	0
TEMIS-201	220	295	75	1	3	1	1	0
TEMIS-202	220	224	4	1	3	1	2	0
TEMIS-202	220	228	8	1	3	1	1	0
TEMIS-202	221	437	216	1	3	2	1	0
TEMIS-202	221	224	3	1	3	1	2	0
TEMIS-202	223	228	5	1	2	4	1	1
TEMIS-202	223	228	5	1	2	1	1	0
TEMIS-202	224	477	253	0	3	4	0	0
TEMIS-202	224	225	1	1	3	1	2	0
TEMIS-202	224	477	253	0	3	2	1	4
TEMIS-202	224	228	4	1	3	1	1	0
TEMIS-203	225	228	3	1	3	1	1	1
TEMIS-203	225	295	70	1	4	1	0	1
TEMIS-203	225	231	6	1	3	1	2	1
TEMIS-203	225	226	1	1	4	1	1	0
TEMIS-203	227	477	250	0	3	1	0	0
TEMIS-203	227	477	250	0	3	1	0	0
TEMIS-203	228	229	1	1	3	3	2	0
TEMIS-203	228	242	14	1	3	3	1	0
TEMIS-203	228	477	249	0	3	1	0	0
TEMIS-203	228	477	249	0	3	1	0	0
TEMIS-204	228	477	249	0	3	1	0	0
TEMIS-204	228	477	249	0	3	1	0	0
TEMIS-204	228	477	249	0	3	1	0	0
TEMIS-204	228	231	3	1	3	1	0	0
TEMIS-204	231	281	50	1	3	4	1	1
TEMIS-204	231	350	119	1	3	4	1	1
TEMIS-204	231	242	11	1	3	1	1	0
TEMIS-204	232	242	10	1	3	4	1	0
TEMIS-204	233	477	244	0	3	1	2	1
TEMIS-204	233	477	244	0	3	4	0	0
TEMIS-205	234	348	114	1	3	1	3	0
TEMIS-205	234	295	61	1	3	4	2	0
TEMIS-205	235	242	7	1	3	1	1	1
TEMIS-205	237	242	5	1	3	1	1	0
TEMIS-205	238	259	21	1	3	4	0	1
TEMIS-205	238	242	4	1	1	1	1	0
TEMIS-205	238	242	4	1	3	1	1	0
TEMIS-205	238	239	1	1	1	4	1	0
TEMIS-205	239	246	7	1	3	4	1	1
TEMIS-205	239	477	238	0	4	1	1	0
TEMIS-206	239	240	1	1	3	1	1	1
TEMIS-206	239	477	238	0	4	1	0	0
TEMIS-206	239	242	3	1	4	4	2	0
TEMIS-206	240	241	1	1	3	4	2	0
TEMIS-206	240	241	1	1	3	4	2	0
TEMIS-206	240	241	1	1	3	1	2	1
TEMIS-206	241	242	1	1	3	1	1	0
TEMIS-206	241	254	13	1	4	4	1	0
TEMIS-206	245	256	11	1	3	4	1	0
TEMIS-206	245	477	232	0	3	1	0	0
TEMIS-207	245	256	11	1	3	4	0	0
TEMIS-207	245	246	1	1	3	1	0	0
TEMIS-207	246	247	1	1	3	1	2	0
TEMIS-207	246	247	1	1	3	1	1	0
TEMIS-207	246	299	53	1	3	1	2	0
TEMIS-207	247	255	8	1	3	4	2	0
TEMIS-207	247	295	48	1	3	1	1	1
TEMIS-207	248	477	229	0	3	1	1	0
TEMIS-207	249	256	7	1	3	1	2	0
TEMIS-207	249	477	228	0	3	1	0	0
TEMIS-208	249	250	1	1	3	1	0	0
TEMIS-208	250	295	45	1	3	1	1	0
TEMIS-208	253	254	1	1	3	4	1	0
TEMIS-208	254	255	1	1	3	4	1	0
TEMIS-208	254	255	1	1	3	1	2	1
TEMIS-208	255	346	91	1	4	4	2	0
TEMIS-208	255	256	1	1	3	3	2	0
TEMIS-208	255	295	40	1	3	4	2	0
TEMIS-208	256	437	181	1	3	1	1	0
TEMIS-208	256	257	1	1	3	1	2	0
TEMIS-209	256	257	1	1	3	1	0	0
TEMIS-209	260	477	217	0	4	4	0	0
TEMIS-209	261	299	38	1	3	1	2	0
TEMIS-209	263	266	3	1	4	1	2	0
TEMIS-209	263	295	32	1	3	1	1	0
TEMIS-209	267	269	2	1	3	1	2	0
TEMIS-209	267	268	1	1	3	1	1	0
TEMIS-209	268	477	209	0	3	2	1	0
TEMIS-209	268	269	1	1	3	1	2	0
TEMIS-209	268	269	1	1	3	1	2	0
TEMIS-210	269	382	113	1	3	1	2	0
TEMIS-210	270	477	207	0	3	1	2	0
TEMIS-210	274	299	25	1	3	1	2	0
TEMIS-210	274	283	9	1	3	1	1	0
TEMIS-210	275	382	107	1	3	5	2	0
TEMIS-210	275	299	24	1	3	1	2	0
TEMIS-210	275	295	20	1	3	1	2	0
TEMIS-210	275	295	20	1	3	1	2	1
TEMIS-210	276	294	18	1	3	1	2	0
TEMIS-210	276	477	201	0	3	1	0	1
TEMIS-211	276	299	23	1	4	1	2	0
TEMIS-211	277	287	10	1	3	1	2	1
TEMIS-211	277	294	17	1	3	1	2	0
TEMIS-211	280	477	197	0	3	1	0	0
TEMIS-211	280	382	102	1	3	1	2	0
TEMIS-211	281	477	196	0	4	1	0	0
TEMIS-211	281	283	2	1	4	2	2	0
TEMIS-211	282	295	13	1	3	1	1	0
TEMIS-211	282	437	155	1	3	1	1	0
TEMIS-211	282	477	195	0	3	1	0	0
TEMIS-212	282	477	195	0	3	1	0	0
TEMIS-212	282	283	1	1	3	2	2	0
TEMIS-212	283	477	194	0	4	5	0	0
TEMIS-212	284	382	98	1	3	1	2	0
TEMIS-212	284	285	1	1	3	1	0	0
TEMIS-212	287	382	95	1	3	4	2	0
TEMIS-212	287	437	150	1	3	1	1	1
TEMIS-212	288	382	94	1	4	4	2	0
TEMIS-212	289	477	188	0	3	1	0	0
TEMIS-212	289	477	188	0	3	1	0	0
TEMIS-213	289	382	93	1	3	1	2	0
TEMIS-213	289	299	10	1	3	1	2	0
TEMIS-213	289	477	188	0	3	1	0	1
TEMIS-213	289	382	93	1	3	1	2	0
TEMIS-213	289	477	188	0	3	4	0	0
TEMIS-213	289	290	1	1	3	3	1	0
TEMIS-213	290	294	4	1	3	1	2	0
TEMIS-213	291	350	59	1	3	1	2	0
TEMIS-213	291	292	1	1	3	1	0	0
TEMIS-213	291	347	56	1	3	1	2	0
TEMIS-214	291	318	27	1	3	1	2	0
TEMIS-214	294	437	143	1	5	2	1	1
TEMIS-214	295	437	142	1	3	4	1	0
TEMIS-214	295	298	3	1	3	1	0	0
TEMIS-214	295	382	87	1	3	1	2	0
TEMIS-214	296	477	181	0	4	1	0	0
TEMIS-214	296	297	1	1	3	1	2	0
TEMIS-214	296	477	181	0	3	1	0	0
TEMIS-214	297	298	1	1	3	3	2	0
TEMIS-214	298	299	1	1	3	1	2	0
TEMIS-215	298	437	139	1	4	2	1	0
TEMIS-215	301	371	70	1	3	1	1	0
TEMIS-215	301	302	1	1	3	1	0	0
TEMIS-215	301	302	1	1	3	1	0	0
TEMIS-215	301	477	176	0	3	1	0	0
TEMIS-215	302	303	1	1	3	1	2	0
TEMIS-215	302	437	135	1	3	1	1	0
TEMIS-215	302	382	80	1	3	4	2	0
TEMIS-215	303	382	79	1	3	1	2	0
TEMIS-215	303	382	79	1	3	1	2	0
TEMIS-216	303	382	79	1	3	1	2	0
TEMIS-216	304	477	173	0	3	1	0	1
TEMIS-216	305	346	41	1	4	1	1	1
TEMIS-216	305	382	77	1	3	4	2	0
TEMIS-216	308	477	169	0	2	1	0	0
TEMIS-216	310	477	167	0	3	1	0	0
TEMIS-216	311	346	35	1	3	1	1	0
TEMIS-216	311	477	166	0	3	1	0	0
TEMIS-216	311	477	166	0	3	1	0	0
TEMIS-216	312	313	1	1	3	4	1	0
TEMIS-217	314	437	123	1	4	4	1	0
TEMIS-217	315	477	162	0	3	1	0	0
TEMIS-217	315	329	14	1	3	1	0	0
TEMIS-217	315	477	162	0	2	1	0	0
TEMIS-217	316	329	13	1	3	1	2	0
TEMIS-217	316	382	66	1	3	1	2	0
TEMIS-217	317	477	160	0	3	1	0	0
TEMIS-217	321	477	156	0	3	4	0	0
TEMIS-217	323	382	59	1	3	4	1	0
TEMIS-217	323	382	59	1	3	4	1	0
TEMIS-218	325	477	152	0	2	1	0	0
TEMIS-218	327	346	19	1	3	1	0	0
TEMIS-218	328	477	149	0	2	1	0	0
TEMIS-218	328	437	109	1	5	1	1	0
TEMIS-218	329	477	148	0	5	1	0	0
TEMIS-218	330	477	147	0	4	4	0	0
TEMIS-218	330	437	107	1	3	1	1	0
TEMIS-218	332	382	50	1	3	1	2	0
TEMIS-218	332	382	50	1	3	1	2	0
TEMIS-218	336	372	36	1	3	1	1	0
TEMIS-219	337	382	45	1	3	1	2	0
TEMIS-219	337	477	140	0	4	4	0	0
TEMIS-219	337	387	50	1	3	1	2	0
TEMIS-219	338	477	139	0	2	1	0	1
TEMIS-219	340	346	6	1	5	1	1	0
TEMIS-219	340	477	137	0	2	1	0	0
TEMIS-219	341	347	6	1	4	4	1	0
TEMIS-219	343	345	2	1	3	1	1	0
TEMIS-219	343	347	4	1	4	4	1	0
TEMIS-219	343	344	1	1	3	1	1	0
TEMIS-220	344	382	38	1	4	1	2	1
TEMIS-220	344	382	38	1	3	5	2	0
TEMIS-220	344	346	2	1	3	1	2	0
TEMIS-220	345	477	132	0	3	2	0	0
TEMIS-220	345	477	132	0	3	1	0	0
TEMIS-220	350	437	87	1	3	4	1	0
TEMIS-220	351	437	86	1	3	1	1	0
TEMIS-220	351	352	1	1	3	1	2	0
TEMIS-220	352	437	85	1	3	4	1	0
TEMIS-220	354	355	1	1	2	1	0	0
TEMIS-221	357	382	25	1	3	1	2	0
TEMIS-221	357	437	80	1	4	4	1	0
TEMIS-221	357	437	80	1	4	4	1	0
TEMIS-221	358	477	119	0	2	1	0	0
TEMIS-221	359	437	78	1	3	1	1	0
TEMIS-221	362	437	75	1	3	1	1	0
TEMIS-221	362	437	75	1	3	4	1	1
TEMIS-221	362	382	20	1	3	1	1	0
TEMIS-221	362	477	115	0	1	1	0	0
FSITE-	80	86	6	1	3	1	0	1
FSITE-	107	108	1	1	3	1	0	0
TERIXDB-221	1	477	476	0	3	1	1	0
TERIXDB-221	1	477	476	0	3	1	1	0
TERIXDB-221	2	3	1	1	3	1	0	0
TERIXDB-222	2	477	475	0	3	1	1	0
TERIXDB-222	2	477	475	0	3	4	1	0
TERIXDB-222	3	72	69	1	3	4	0	0
TERIXDB-222	3	144	141	1	3	4	0	0
TERIXDB-222	3	477	474	0	3	4	0	0
TERIXDB-222	3	477	474	0	3	4	0	0
TERIXDB-222	3	477	474	0	3	4	0	0
TERIXDB-222	3	72	69	1	3	1	0	0
TERIXDB-222	4	6	2	1	3	4	0	0
TERIXDB-222	4	72	68	1	3	4	0	0
TERIXDB-223	4	27	23	1	3	1	0	0
TERIXDB-223	5	50	45	1	3	4	0	0
TERIXDB-223	6	33	27	1	3	1	0	0
TERIXDB-223	6	477	471	0	3	4	0	0
TERIXDB-223	7	11	4	1	3	1	0	0
TERIXDB-223	9	477	468	0	3	1	1	0
TERIXDB-223	11	16	5	1	3	1	0	0
TERIXDB-223	11	12	1	1	3	1	0	0
TERIXDB-223	11	477	466	0	3	1	0	0
TERIXDB-223	11	22	11	1	3	1	0	0
TERIXDB-224	11	477	466	0	3	1	0	0
TERIXDB-224	11	477	466	0	3	1	0	0
TERIXDB-224	11	477	466	0	4	4	0	0
TERIXDB-224	14	16	2	1	3	1	0	0
TERIXDB-224	14	31	17	1	4	1	0	0
TERIXDB-224	14	15	1	1	4	4	0	0
TERIXDB-224	14	16	2	1	3	1	0	0
TERIXDB-224	14	16	2	1	4	4	0	0
TERIXDB-224	15	18	3	1	4	1	0	0
TERIXDB-224	16	17	1	1	3	4	0	0
TERIXDB-225	16	33	17	1	3	1	0	0
TERIXDB-225	16	465	449	1	3	1	0	0
TERIXDB-225	17	477	460	0	3	4	0	0
TERIXDB-225	17	477	460	0	3	4	0	0
TERIXDB-225	17	477	460	0	3	4	0	0
TERIXDB-225	17	466	449	1	3	1	0	0
TERIXDB-225	19	29	10	1	3	4	0	0
TERIXDB-225	20	477	457	0	4	1	0	1
TERIXDB-225	21	477	456	0	3	4	0	0
TERIXDB-225	21	477	456	0	3	4	0	0
TERIXDB-226	22	23	1	1	3	1	0	0
TERIXDB-226	23	38	15	1	3	4	0	0
TERIXDB-226	23	477	454	0	3	1	0	0
TERIXDB-226	23	42	19	1	3	4	0	0
TERIXDB-226	24	477	453	0	3	4	0	0
TERIXDB-226	24	477	453	0	3	4	0	0
TERIXDB-226	24	27	3	1	3	1	0	0
TERIXDB-226	25	477	452	0	3	4	0	0
TERIXDB-226	25	27	2	1	4	4	0	0
TERIXDB-226	26	30	4	1	3	1	0	0
TERIXDB-227	27	66	39	1	3	1	0	0
TERIXDB-227	28	44	16	1	3	1	0	0
TERIXDB-227	29	37	8	1	4	4	0	0
TERIXDB-227	30	326	296	1	3	1	1	1
TERIXDB-227	31	477	446	0	2	1	0	0
TERIXDB-227	32	477	445	0	3	1	0	0
TERIXDB-227	35	38	3	1	3	4	0	0
TERIXDB-227	35	466	431	1	3	4	0	0
TERIXDB-227	36	477	441	0	3	1	0	0
TERIXDB-227	37	38	1	1	3	1	0	0
TERIXDB-228	37	87	50	1	3	1	0	0
TERIXDB-228	37	38	1	1	3	1	0	0
TERIXDB-228	41	66	25	1	3	1	0	0
TERIXDB-228	43	477	434	0	3	1	0	0
TERIXDB-228	44	46	2	1	3	4	0	0
TERIXDB-228	45	73	28	1	3	1	0	0
TERIXDB-228	45	466	421	1	3	4	1	0
TERIXDB-228	45	52	7	1	4	4	0	0
TERIXDB-228	45	477	432	0	3	1	1	0
TERIXDB-228	45	477	432	0	3	1	1	0
TERIXDB-229	47	73	26	1	3	1	0	0
TERIXDB-229	49	53	4	1	4	4	0	0
TERIXDB-229	50	477	427	0	3	4	1	0
TERIXDB-229	51	70	19	1	4	1	0	0
TERIXDB-229	51	52	1	1	4	4	0	0
TERIXDB-229	52	477	425	0	4	1	1	0
TERIXDB-229	52	53	1	1	3	1	0	0
TERIXDB-229	53	477	424	0	3	1	0	1
TERIXDB-229	55	465	410	1	2	1	0	0
TERIXDB-229	55	56	1	1	2	1	0	0
TERIXDB-230	56	477	421	0	2	1	0	0
TERIXDB-230	56	60	4	1	2	1	0	0
TERIXDB-230	57	58	1	1	3	1	0	0
TERIXDB-230	57	60	3	1	3	1	0	0
TERIXDB-230	58	66	8	1	3	1	0	0
TERIXDB-230	58	65	7	1	4	4	0	0
TERIXDB-230	58	477	419	0	2	1	0	0
TERIXDB-230	59	60	1	1	4	1	0	0
TERIXDB-230	60	477	417	0	2	1	1	0
TERIXDB-230	60	62	2	1	3	1	0	0
TERIXDB-231	62	477	415	0	3	4	0	0
TERIXDB-231	63	477	414	0	2	1	0	0
TERIXDB-231	63	214	151	1	4	1	0	0
TERIXDB-231	64	65	1	1	4	4	0	0
TERIXDB-231	64	283	219	1	4	1	1	0
TERIXDB-231	65	477	412	0	4	1	0	0
TERIXDB-231	66	68	2	1	2	1	0	0
TERIXDB-231	66	73	7	1	4	1	0	0
TERIXDB-231	67	144	77	1	1	1	1	0
TERIXDB-231	67	74	7	1	4	1	0	0
TERIXDB-232	67	71	4	1	3	1	0	0
TERIXDB-232	67	477	410	0	2	1	0	0
TERIXDB-232	67	477	410	0	3	1	0	0
TERIXDB-232	68	73	5	1	3	1	0	0
TERIXDB-232	69	477	408	0	4	1	1	0
TERIXDB-232	70	477	407	0	3	1	0	0
TERIXDB-232	70	99	29	1	3	1	1	0
TERIXDB-232	71	477	406	0	3	1	1	0
TERIXDB-232	71	477	406	0	3	1	0	0
TERIXDB-232	71	72	1	1	2	1	0	0
TERIXDB-233	71	72	1	1	3	4	0	0
TERIXDB-233	72	73	1	1	3	1	0	0
TERIXDB-233	73	77	4	1	3	1	0	2
TERIXDB-233	78	87	9	1	3	1	0	0
TERIXDB-233	78	214	136	1	2	1	0	0
TERIXDB-233	79	477	398	0	4	4	0	0
TERIXDB-233	80	83	3	1	3	1	0	0
TERIXDB-233	80	477	397	0	4	1	0	0
TERIXDB-233	81	464	383	1	3	1	0	0
TERIXDB-233	81	88	7	1	3	4	0	0
TERIXDB-234	81	85	4	1	4	4	0	0
TERIXDB-234	83	84	1	1	4	1	0	0
TERIXDB-234	85	86	1	1	3	1	0	0
TERIXDB-234	85	88	3	1	4	4	0	0
TERIXDB-234	86	214	128	1	3	4	0	0
TERIXDB-234	86	87	1	1	4	1	0	0
TERIXDB-234	86	88	2	1	4	1	0	0
TERIXDB-234	86	104	18	1	3	1	1	0
TERIXDB-234	87	88	1	1	4	1	0	0
TERIXDB-234	87	266	179	1	3	1	1	0
TERIXDB-235	88	477	389	0	4	4	1	0
TERIXDB-235	88	89	1	1	4	4	0	0
TERIXDB-235	91	92	1	1	4	1	0	0
TERIXDB-235	92	93	1	1	3	1	1	0
TERIXDB-235	93	109	16	1	4	1	0	0
TERIXDB-235	94	108	14	1	4	1	0	0
TERIXDB-235	94	109	15	1	4	1	0	0
TERIXDB-235	95	103	8	1	4	4	0	0
TERIXDB-235	95	157	62	1	1	1	1	0
TERIXDB-235	95	464	369	1	3	3	0	0
TERIXDB-236	96	477	381	0	3	1	1	0
TERIXDB-236	99	464	365	1	3	1	1	0
TERIXDB-236	100	464	364	1	3	1	0	0
TERIXDB-236	101	477	376	0	3	1	0	0
TERIXDB-236	102	464	362	1	4	1	0	0
TERIXDB-236	102	477	375	0	3	4	0	0
TERIXDB-236	102	477	375	0	3	1	0	0
TERIXDB-236	106	214	108	1	3	4	0	0
TERIXDB-236	108	477	369	0	4	1	0	0
TERIXDB-236	109	477	368	0	3	1	0	0
TERIXDB-237	111	316	205	1	3	4	0	0
TERIXDB-237	113	115	2	1	4	4	0	0
TERIXDB-237	115	477	362	0	2	1	1	0
TERIXDB-237	115	206	91	1	3	4	0	0
TERIXDB-237	115	248	133	1	2	1	0	0
TERIXDB-237	116	464	348	1	3	1	1	0
TERIXDB-237	117	121	4	1	4	4	0	0
TERIXDB-237	117	127	10	1	3	1	1	0
TERIXDB-237	120	121	1	1	3	4	0	0
TERIXDB-237	120	121	1	1	3	4	0	0
TERIXDB-238	121	193	72	1	3	1	0	0
TERIXDB-238	121	284	163	1	3	1	1	0
TERIXDB-238	121	477	356	0	3	1	1	0
TERIXDB-238	123	477	354	0	3	4	0	0
TERIXDB-238	123	477	354	0	4	1	0	0
TERIXDB-238	127	477	350	0	3	1	0	0
TERIXDB-238	128	135	7	1	3	4	0	0
TERIXDB-238	135	136	1	1	3	1	1	0
TERIXDB-238	137	465	328	1	3	4	1	0
TERIXDB-238	138	477	339	0	3	4	1	0
TERIXDB-239	140	141	1	1	3	1	0	0
TERIXDB-239	143	155	12	1	3	4	0	0
TERIXDB-239	144	477	333	0	4	4	0	0
TERIXDB-239	144	149	5	1	3	4	0	0
TERIXDB-239	150	477	327	0	3	1	0	0
TERIXDB-239	150	151	1	1	4	4	0	0
TERIXDB-239	151	153	2	1	1	1	1	0
TERIXDB-239	153	477	324	0	3	4	1	0
TERIXDB-239	156	465	309	1	3	1	1	0
TERIXDB-239	156	162	6	1	3	1	1	0
TERIXDB-240	158	161	3	1	3	4	0	0
TERIXDB-240	163	165	2	1	3	4	0	0
TERIXDB-240	175	206	31	1	3	4	0	0
TERIXDB-240	176	477	301	0	3	1	1	0
TERIXDB-240	179	477	298	0	3	4	0	0
TERIXDB-240	179	206	27	1	3	4	0	0
TERIXDB-240	182	186	4	1	4	4	0	0
TERIXDB-240	187	477	290	0	3	1	0	0
TERIXDB-240	189	190	1	1	4	1	0	0
TERIXDB-240	189	190	1	1	3	1	0	0
TERIXDB-241	189	477	288	0	3	1	0	0
TERIXDB-241	193	194	1	1	4	1	0	0
TERIXDB-241	194	477	283	0	3	1	1	0
TERIXDB-241	194	197	3	1	4	1	0	0
TERIXDB-241	196	465	269	1	3	1	1	0
TERIXDB-241	196	477	281	0	3	1	0	0
TERIXDB-241	198	199	1	1	4	1	0	0
TERIXDB-241	199	201	2	1	4	1	0	0
TERIXDB-241	199	200	1	1	4	1	0	0
TERIXDB-241	201	204	3	1	4	4	0	0
TERIXDB-242	203	204	1	1	4	1	0	0
TERIXDB-242	204	205	1	1	3	1	0	0
TERIXDB-242	204	310	106	1	3	4	0	0
TERIXDB-242	205	208	3	1	4	1	0	0
TERIXDB-242	206	207	1	1	4	1	0	0
TERIXDB-242	206	477	271	0	3	1	0	0
TERIXDB-242	206	207	1	1	3	1	0	0
TERIXDB-242	206	477	271	0	3	1	1	0
TERIXDB-242	207	208	1	1	4	1	0	0
TERIXDB-242	207	214	7	1	3	1	0	0
TERIXDB-243	208	477	269	0	3	1	0	0
TERIXDB-243	209	465	256	1	3	1	0	0
TERIXDB-243	210	477	267	0	3	1	0	0
TERIXDB-243	212	221	9	1	4	4	0	0
TERIXDB-243	215	218	3	1	4	1	0	0
TERIXDB-243	218	477	259	0	3	1	1	0
TERIXDB-243	218	477	259	0	3	1	1	0
TERIXDB-243	218	266	48	1	3	1	0	0
TERIXDB-243	219	220	1	1	4	4	0	0
TERIXDB-243	219	221	2	1	4	4	0	0
TERIXDB-244	224	225	1	1	3	1	0	0
TERIXDB-244	225	226	1	1	4	4	0	0
TERIXDB-244	226	227	1	1	4	4	0	0
TERIXDB-244	227	477	250	0	3	4	0	0
TERIXDB-244	237	291	54	1	3	1	1	0
TERIXDB-244	238	239	1	1	3	1	0	0
TERIXDB-244	238	246	8	1	4	4	0	0
TERIXDB-244	239	242	3	1	4	1	0	0
TERIXDB-244	241	242	1	1	3	1	0	0
TERIXDB-244	242	243	1	1	3	1	0	0
TERIXDB-245	247	477	230	0	5	1	0	0
TERIXDB-245	248	330	82	1	4	3	0	0
TERIXDB-245	255	269	14	1	3	1	0	0
TERIXDB-245	256	269	13	1	3	1	0	0
TERIXDB-245	266	289	23	1	3	4	0	0
TERIXDB-245	266	267	1	1	3	4	0	0
TERIXDB-245	270	477	207	0	2	1	1	0
TERIXDB-245	272	477	205	0	2	3	1	0
TERIXDB-245	273	477	204	0	3	1	1	0
TERIXDB-245	277	436	159	1	4	4	0	0
TERIXDB-246	282	309	27	1	3	1	0	1
TERIXDB-246	282	285	3	1	4	1	0	0
TERIXDB-246	283	284	1	1	2	1	1	0
TERIXDB-246	283	326	43	1	3	1	1	1
TERIXDB-246	286	310	24	1	3	1	0	0
TERIXDB-246	287	477	190	0	3	4	0	0
TERIXDB-246	291	304	13	1	3	3	0	0
TERIXDB-246	295	296	1	1	3	1	0	0
TERIXDB-246	297	324	27	1	3	1	0	0
TERIXDB-246	300	308	8	1	3	1	1	0
TERIXDB-247	301	477	176	0	3	1	0	0
TERIXDB-247	302	477	175	0	3	1	1	0
TERIXDB-247	304	305	1	1	3	1	1	0
TERIXDB-247	305	441	136	1	4	1	1	0
TERIXDB-247	308	310	2	1	3	1	1	0
TERIXDB-247	308	312	4	1	3	1	1	0
TERIXDB-247	309	350	41	1	3	4	0	2
TERIXDB-247	311	477	166	0	3	1	0	0
TERIXDB-247	314	342	28	1	3	1	1	0
TERIXDB-247	315	316	1	1	3	4	1	0
TERIXDB-248	315	465	150	1	3	1	1	0
TERIXDB-248	317	477	160	0	2	1	1	1
TERIXDB-248	320	477	157	0	3	1	1	0
TERIXDB-248	321	452	131	1	2	1	0	1
TERIXDB-248	325	336	11	1	4	4	1	0
TERIXDB-248	327	431	104	1	3	1	0	0
TERIXDB-248	329	477	148	0	3	1	0	0
TERIXDB-248	330	331	1	1	3	1	0	0
TERIXDB-248	336	367	31	1	3	4	0	0
TERIXDB-248	336	337	1	1	3	1	1	0
TERIXDB-249	337	477	140	0	3	4	1	0
TERIXDB-249	339	430	91	1	2	1	1	2
TERIXDB-249	342	465	123	1	3	1	1	0
TERIXDB-249	343	477	134	0	2	1	0	0
TERIXDB-249	344	382	38	1	3	1	1	0
TERIXDB-249	344	477	133	0	4	1	0	0
TERIXDB-249	345	477	132	0	3	1	1	0
TERIXDB-249	346	350	4	1	3	1	1	0
TERIXDB-249	350	352	2	1	4	4	0	2
TERIXDB-249	351	477	126	0	3	4	0	0
TERIXDB-250	351	477	126	0	3	1	0	0
TERIXDB-250	352	430	78	1	2	1	0	1
TERIXDB-250	358	477	119	0	3	1	0	0
TERIXDB-250	360	382	22	1	3	1	1	0
TERIXDB-250	361	477	116	0	3	1	0	0
LAS-232	1	2	1	1	3	1	2	1
LAS-233	1	135	134	1	3	1	1	0
LAS-233	2	3	1	1	3	5	1	0
LAS-233	2	3	1	1	3	1	2	0
LAS-233	4	15	11	1	3	1	1	0
LAS-233	4	15	11	1	3	1	1	0
LAS-233	4	477	473	0	3	1	0	1
LAS-233	4	15	11	1	3	1	0	0
LAS-233	4	199	195	1	3	1	0	0
LAS-233	4	477	473	0	3	1	0	0
LAS-233	4	7	3	1	3	1	2	0
LAS-234	4	10	6	1	3	1	1	0
LAS-234	4	477	473	0	3	1	0	0
LAS-234	4	29	25	1	3	1	1	0
LAS-234	4	135	131	1	3	1	1	0
LAS-234	4	5	1	1	3	1	1	0
LAS-234	4	5	1	1	3	1	1	0
LAS-234	5	7	2	1	3	1	1	0
LAS-234	8	9	1	1	2	1	1	0
LAS-234	8	9	1	1	3	5	1	0
LAS-234	9	10	1	1	3	5	1	0
LAS-235	9	10	1	1	3	1	2	0
LAS-235	9	10	1	1	3	1	1	0
LAS-235	10	25	15	1	3	1	2	0
LAS-235	10	11	1	1	3	1	1	0
LAS-235	10	25	15	1	3	1	1	0
LAS-235	10	11	1	1	3	5	1	0
LAS-235	10	12	2	1	3	4	1	0
LAS-235	11	12	1	1	3	5	1	0
LAS-235	11	477	466	0	3	1	0	0
LAS-235	11	12	1	1	3	1	1	0
LAS-236	11	12	1	1	3	4	1	0
LAS-236	11	12	1	1	3	1	1	0
LAS-236	11	12	1	1	3	5	1	0
LAS-236	13	14	1	1	3	1	1	0
LAS-236	14	15	1	1	3	4	1	0
LAS-236	15	40	25	1	3	1	1	0
LAS-236	15	24	9	1	3	5	1	0
LAS-236	15	40	25	1	3	5	1	0
LAS-236	15	16	1	1	3	5	1	0
LAS-236	15	16	1	1	3	4	1	0
LAS-237	15	17	2	1	3	1	1	0
LAS-237	16	22	6	1	3	4	1	0
LAS-237	16	18	2	1	3	1	1	0
LAS-237	17	18	1	1	3	1	1	0
LAS-237	17	18	1	1	3	1	1	0
LAS-237	17	25	8	1	3	1	1	0
LAS-237	17	18	1	1	3	1	1	0
LAS-237	17	26	9	1	3	1	1	0
LAS-237	18	25	7	1	3	1	1	0
LAS-237	21	120	99	1	1	1	1	0
LAS-238	21	120	99	1	1	1	1	0
LAS-238	21	135	114	1	1	1	1	2
LAS-238	21	135	114	1	1	1	1	2
LAS-238	21	477	456	0	1	1	1	0
LAS-238	21	135	114	1	1	1	1	2
LAS-238	21	135	114	1	1	1	1	2
LAS-238	21	477	456	0	1	1	1	1
LAS-238	21	135	114	1	1	1	1	1
LAS-238	21	477	456	0	1	1	1	3
LAS-238	21	135	114	1	1	1	1	1
LAS-239	21	135	114	1	1	1	1	1
LAS-239	21	135	114	1	1	1	1	1
LAS-239	21	477	456	0	1	1	1	0
LAS-239	21	477	456	0	1	1	1	0
LAS-239	21	135	114	1	1	1	1	0
LAS-239	21	477	456	0	1	1	1	0
LAS-239	21	477	456	0	1	1	1	0
LAS-239	21	66	45	1	1	1	1	0
LAS-239	21	121	100	1	1	1	1	0
LAS-239	21	121	100	1	1	1	1	0
LAS-240	21	477	456	0	1	1	1	0
LAS-240	21	120	99	1	1	1	1	0
LAS-240	21	120	99	1	1	1	1	0
LAS-240	21	120	99	1	1	1	1	0
LAS-240	21	120	99	1	1	1	1	0
LAS-240	21	135	114	1	1	1	1	0
LAS-240	21	477	456	0	1	1	1	0
LAS-240	21	135	114	1	1	1	1	0
LAS-240	21	135	114	1	1	1	1	0
LAS-240	21	477	456	0	1	1	1	0
LAS-241	21	477	456	0	1	1	1	0
LAS-241	21	477	456	0	1	1	1	0
LAS-241	21	120	99	1	1	1	1	0
LAS-241	21	120	99	1	1	1	1	0
LAS-241	21	120	99	1	1	1	1	0
LAS-241	21	120	99	1	1	1	1	0
LAS-241	21	120	99	1	1	1	1	0
LAS-241	21	120	99	1	1	1	1	0
LAS-241	22	25	3	1	3	1	1	0
LAS-241	22	25	3	1	3	1	1	0
LAS-242	24	27	3	1	3	4	1	0
LAS-242	26	29	3	1	3	4	2	0
LAS-242	28	44	16	1	4	4	2	0
LAS-242	29	30	1	1	3	1	2	0
LAS-242	29	30	1	1	3	1	1	0
LAS-242	30	35	5	1	3	3	1	0
LAS-242	30	31	1	1	3	5	1	0
LAS-242	30	35	5	1	3	5	1	0
LAS-242	30	31	1	1	3	5	1	0
LAS-242	30	135	105	1	3	1	1	0
LAS-243	30	31	1	1	3	1	1	0
LAS-243	31	32	1	1	3	1	1	0
LAS-243	35	38	3	1	3	3	1	0
LAS-243	36	37	1	1	3	1	1	0
LAS-243	37	38	1	1	3	1	1	0
LAS-243	40	43	3	1	3	1	1	0
LAS-243	42	200	158	1	5	4	0	1
LAS-243	42	477	435	0	3	1	1	0
LAS-243	43	44	1	1	3	1	1	0
LAS-243	43	44	1	1	3	1	2	0
LAS-244	43	44	1	1	3	1	2	0
LAS-244	43	44	1	1	3	1	2	0
LAS-244	43	45	2	1	3	1	2	0
LAS-244	44	47	3	1	3	1	1	0
LAS-244	44	156	112	1	3	1	1	4
LAS-244	44	45	1	1	3	1	2	0
LAS-244	44	45	1	1	3	1	2	0
LAS-244	44	45	1	1	3	1	1	0
LAS-244	44	45	1	1	3	1	1	0
LAS-244	45	477	432	0	3	1	0	0
LAS-245	45	46	1	1	3	1	0	0
LAS-245	46	52	6	1	3	4	2	0
LAS-245	46	47	1	1	3	1	1	0
LAS-245	46	47	1	1	3	1	1	0
LAS-245	46	47	1	1	2	1	2	0
LAS-245	47	48	1	1	3	1	2	0
LAS-245	47	51	4	1	3	5	1	1
LAS-245	51	101	50	1	3	2	1	0
LAS-245	52	463	411	1	3	1	2	0
LAS-245	53	135	82	1	3	4	1	4
LAS-246	53	100	47	1	3	4	1	0
LAS-246	53	66	13	1	3	4	2	0
LAS-246	57	81	24	1	4	1	2	0
LAS-246	57	134	77	1	3	1	1	1
LAS-246	57	477	420	0	3	5	0	0
LAS-246	58	477	419	0	4	4	0	0
LAS-246	58	477	419	0	4	4	0	0
LAS-246	59	60	1	1	3	1	2	0
LAS-246	59	60	1	1	3	1	2	0
LAS-246	59	63	4	1	1	2	1	0
LAS-247	59	94	35	1	3	5	1	2
LAS-247	59	477	418	0	3	5	0	1
LAS-247	59	78	19	1	3	5	1	1
LAS-247	59	98	39	1	3	5	1	0
LAS-247	60	61	1	1	3	1	2	0
LAS-247	61	66	5	1	3	1	1	0
LAS-247	61	140	79	1	3	1	1	1
LAS-247	63	64	1	1	3	1	1	0
LAS-247	63	136	73	1	3	1	1	0
LAS-247	64	282	218	1	3	1	1	0
LAS-248	64	66	2	1	3	1	1	0
LAS-248	64	68	4	1	3	4	1	0
LAS-248	65	66	1	1	3	1	1	0
LAS-248	65	74	9	1	4	1	2	0
LAS-248	65	74	9	1	3	1	1	0
LAS-248	65	66	1	1	3	1	2	0
LAS-248	65	66	1	1	3	1	1	1
LAS-248	65	70	5	1	3	4	1	1
LAS-248	66	75	9	1	3	2	1	0
LAS-248	67	69	2	1	3	4	1	0
LAS-249	67	144	77	1	3	4	1	0
LAS-249	67	79	12	1	2	1	2	4
LAS-249	67	69	2	1	3	4	1	0
LAS-249	68	69	1	1	3	4	1	0
LAS-249	69	71	2	1	3	1	1	0
LAS-249	70	72	2	1	3	4	1	0
LAS-249	70	71	1	1	1	1	1	0
LAS-249	71	72	1	1	3	4	1	1
LAS-249	71	477	406	0	3	4	0	1
LAS-249	72	101	29	1	3	4	1	0
LAS-250	72	75	3	1	3	1	2	0
LAS-250	73	74	1	1	3	1	1	0
LAS-250	73	74	1	1	3	1	2	0
LAS-250	73	75	2	1	3	1	1	1
LAS-250	77	79	2	1	3	1	1	0
LAS-250	77	83	6	1	3	1	1	1
LAS-250	77	79	2	1	3	1	1	0
LAS-250	77	84	7	1	2	1	2	0
LAS-250	79	84	5	1	3	1	1	0
LAS-250	79	80	1	1	3	4	2	0
LAS-251	79	85	6	1	3	3	1	0
LAS-251	80	84	4	1	3	1	2	0
LAS-251	81	105	24	1	3	1	1	0
LAS-251	81	84	3	1	3	1	1	0
LAS-251	81	84	3	1	3	1	1	0
LAS-251	82	86	4	1	2	1	1	1
LAS-251	84	86	2	1	2	1	1	0
LAS-251	84	136	52	1	3	1	0	0
LAS-251	85	477	392	0	4	4	0	0
LAS-251	85	477	392	0	4	1	0	0
LAS-252	85	308	223	1	3	4	1	2
LAS-252	86	122	36	1	3	3	1	1
LAS-252	86	101	15	1	3	1	2	0
LAS-252	87	150	63	1	3	1	1	1
LAS-252	87	101	14	1	3	1	2	0
LAS-252	88	101	13	1	3	1	2	1
LAS-252	88	101	13	1	3	1	1	0
LAS-252	88	101	13	1	2	4	1	0
LAS-252	92	95	3	1	3	1	1	0
LAS-252	92	101	9	1	3	1	1	1
LAS-253	93	94	1	1	3	1	2	0
LAS-253	93	98	5	1	3	1	2	2
LAS-253	94	101	7	1	3	1	1	0
LAS-253	94	95	1	1	3	1	1	0
LAS-253	94	107	13	1	3	2	1	1
LAS-253	94	101	7	1	2	1	1	0
LAS-253	94	95	1	1	3	1	2	0
LAS-253	95	477	382	0	3	4	0	0
LAS-253	95	101	6	1	3	1	1	0
LAS-253	95	105	10	1	3	1	1	0
LAS-254	97	98	1	1	3	1	0	1
LAS-254	97	245	148	1	3	1	0	2
LAS-254	98	101	3	1	3	1	1	0
LAS-254	98	101	3	1	3	1	1	1
LAS-254	98	101	3	1	3	1	1	1
LAS-254	98	101	3	1	3	1	1	0
LAS-254	98	477	379	0	3	1	1	0
LAS-254	98	102	4	1	3	5	1	0
LAS-254	98	477	379	0	3	1	0	0
LAS-254	98	99	1	1	3	1	1	0
LAS-255	98	135	37	1	3	1	1	1
LAS-255	98	101	3	1	3	4	1	0
LAS-255	99	101	2	1	3	4	1	0
LAS-255	100	101	1	1	3	1	1	0
LAS-255	100	107	7	1	3	1	1	0
LAS-255	100	107	7	1	3	4	1	0
LAS-255	100	101	1	1	3	1	1	0
LAS-255	101	102	1	1	3	1	2	0
LAS-255	102	105	3	1	3	3	1	0
LAS-255	102	113	11	1	3	1	1	0
LAS-256	102	105	3	1	3	1	1	0
LAS-256	102	135	33	1	2	4	1	0
LAS-256	102	122	20	1	3	4	1	3
LAS-256	102	477	375	0	4	2	1	0
LAS-256	102	112	10	1	3	1	1	0
LAS-256	102	126	24	1	3	3	1	0
LAS-256	105	135	30	1	3	4	1	1
LAS-256	105	107	2	1	3	1	1	0
LAS-256	105	477	372	0	3	4	0	0
LAS-256	105	120	15	1	3	4	1	0
LAS-257	105	106	1	1	5	4	1	1
LAS-257	105	120	15	1	4	4	1	0
LAS-257	105	234	129	1	3	4	1	0
LAS-257	105	234	129	1	3	4	1	0
LAS-257	105	234	129	1	3	4	1	0
LAS-257	105	234	129	1	3	4	1	0
LAS-257	105	234	129	1	3	4	1	0
LAS-257	105	234	129	1	3	4	1	0
LAS-257	106	107	1	1	3	4	1	0
LAS-257	106	122	16	1	3	1	1	1
LAS-258	106	107	1	1	3	3	1	0
LAS-258	106	107	1	1	3	1	2	0
LAS-258	106	135	29	1	3	4	1	0
LAS-258	107	108	1	1	3	1	1	0
LAS-258	107	108	1	1	3	1	1	0
LAS-258	107	119	12	1	3	1	1	0
LAS-258	107	109	2	1	3	1	1	0
LAS-258	108	109	1	1	3	1	2	0
LAS-258	108	121	13	1	3	1	1	0
LAS-258	109	115	6	1	3	1	1	0
LAS-259	109	110	1	1	3	1	1	0
LAS-259	109	110	1	1	3	1	1	0
LAS-259	112	113	1	1	1	1	1	0
LAS-259	112	191	79	1	3	5	0	0
LAS-259	112	113	1	1	3	1	1	0
LAS-259	112	477	365	0	3	4	0	0
LAS-259	112	113	1	1	3	4	1	0
LAS-259	112	119	7	1	3	4	1	0
LAS-259	113	477	364	0	3	4	0	0
LAS-259	113	122	9	1	3	1	1	1
LAS-260	113	122	9	1	3	4	1	2
LAS-260	113	477	364	0	3	4	0	0
LAS-260	113	114	1	1	3	1	1	0
LAS-260	113	114	1	1	3	1	1	0
LAS-260	113	120	7	1	3	1	1	0
LAS-260	113	120	7	1	3	4	1	1
LAS-260	113	135	22	1	4	1	1	0
LAS-260	114	477	363	0	2	4	0	0
LAS-260	114	122	8	1	3	1	1	1
LAS-260	114	115	1	1	3	1	1	1
LAS-261	114	115	1	1	3	1	1	1
LAS-261	115	117	2	1	3	1	2	0
LAS-261	115	120	5	1	3	1	1	0
LAS-261	115	120	5	1	3	1	1	0
LAS-261	115	120	5	1	2	1	1	0
LAS-261	115	477	362	0	3	4	0	0
LAS-261	115	120	5	1	3	4	1	0
LAS-261	115	234	119	1	3	4	1	0
LAS-261	115	477	362	0	3	5	0	0
LAS-261	115	116	1	1	3	3	1	0
LAS-262	115	116	1	1	3	1	2	0
LAS-262	117	234	117	1	3	4	1	0
LAS-262	118	477	359	0	3	4	0	0
LAS-262	119	136	17	1	4	1	1	0
LAS-262	119	120	1	1	3	1	1	0
LAS-262	119	120	1	1	3	1	1	0
LAS-262	119	120	1	1	3	1	1	0
LAS-262	119	120	1	1	3	1	1	0
LAS-262	119	120	1	1	3	1	1	0
LAS-262	119	120	1	1	3	1	1	0
LAS-263	119	120	1	1	3	3	1	0
LAS-263	119	120	1	1	3	3	1	1
LAS-263	119	134	15	1	3	1	1	0
LAS-263	120	121	1	1	3	1	1	0
LAS-263	120	135	15	1	3	1	2	0
LAS-263	121	122	1	1	3	1	2	0
LAS-263	121	135	14	1	3	1	1	0
LAS-263	121	142	21	1	3	4	1	0
LAS-263	121	134	13	1	3	1	1	0
LAS-263	122	123	1	1	2	1	1	2
LAS-264	122	124	2	1	3	1	1	2
LAS-264	122	123	1	1	3	1	1	0
LAS-264	122	477	355	0	3	1	0	0
LAS-264	122	123	1	1	3	3	1	0
LAS-264	123	125	2	1	3	1	1	1
LAS-264	123	136	13	1	3	1	1	1
LAS-264	124	125	1	1	3	4	1	1
LAS-264	125	127	2	1	3	4	1	0
LAS-264	125	126	1	1	3	1	1	0
LAS-264	126	130	4	1	3	1	1	1
LAS-265	126	135	9	1	2	1	1	0
LAS-265	126	127	1	1	3	1	1	0
LAS-265	126	135	9	1	3	1	1	0
LAS-265	126	127	1	1	3	1	1	0
LAS-265	126	127	1	1	3	1	1	0
LAS-265	126	127	1	1	3	1	1	0
LAS-265	127	128	1	1	3	4	1	0
LAS-265	127	444	317	1	4	5	0	1
LAS-265	127	136	9	1	3	1	1	1
LAS-265	127	135	8	1	3	1	1	0
LAS-266	127	477	350	0	3	1	1	0
LAS-266	128	477	349	0	3	1	0	0
LAS-266	128	129	1	1	3	4	1	0
LAS-266	128	129	1	1	3	4	1	2
LAS-266	128	129	1	1	3	1	1	1
LAS-266	128	477	349	0	3	4	0	0
LAS-266	128	136	8	1	4	1	1	0
LAS-266	128	135	7	1	3	4	1	0
LAS-266	129	133	4	1	3	4	1	0
LAS-266	129	130	1	1	3	4	1	0
LAS-267	129	135	6	1	3	4	1	0
LAS-267	129	135	6	1	3	4	1	1
LAS-267	130	133	3	1	3	4	1	0
LAS-267	130	136	6	1	3	1	1	0
LAS-267	130	477	347	0	3	4	0	0
LAS-267	133	134	1	1	3	5	1	1
LAS-267	133	134	1	1	3	5	1	4
LAS-267	133	134	1	1	3	5	1	1
LAS-267	133	134	1	1	3	1	1	0
LAS-267	133	135	2	1	3	4	1	0
LAS-268	134	135	1	1	3	1	2	0
LAS-268	134	477	343	0	3	1	0	0
LAS-268	134	477	343	0	3	1	0	0
LAS-268	134	136	2	1	3	1	1	1
LAS-268	134	136	2	1	3	1	1	1
LAS-268	134	135	1	1	3	4	1	0
LAS-268	134	135	1	1	3	4	1	0
LAS-268	134	135	1	1	3	3	1	0
LAS-268	135	153	18	1	3	3	1	0
LAS-268	135	136	1	1	3	5	1	0
LAS-269	135	152	17	1	3	5	1	0
LAS-269	135	153	18	1	3	5	1	0
LAS-269	135	136	1	1	3	1	1	0
LAS-269	135	136	1	1	3	4	1	0
LAS-269	135	144	9	1	2	2	1	0
LAS-269	135	136	1	1	3	1	1	0
LAS-269	135	145	10	1	2	4	1	0
LAS-269	136	137	1	1	3	1	1	0
LAS-269	136	141	5	1	3	4	1	0
LAS-269	137	138	1	1	3	4	1	1
LAS-270	137	138	1	1	3	1	1	0
LAS-270	137	138	1	1	3	1	1	0
LAS-270	137	138	1	1	3	1	1	0
LAS-270	137	138	1	1	3	1	1	0
LAS-270	137	144	7	1	3	4	1	0
LAS-270	137	138	1	1	3	1	1	0
LAS-270	140	141	1	1	3	4	1	0
LAS-270	140	141	1	1	3	1	1	0
LAS-270	140	169	29	1	2	2	2	1
LAS-270	140	145	5	1	2	2	1	0
LAS-271	140	141	1	1	1	1	1	0
LAS-271	141	142	1	1	3	1	1	0
LAS-271	142	143	1	1	3	1	1	0
LAS-271	142	143	1	1	3	1	1	0
LAS-271	142	143	1	1	3	1	1	0
LAS-271	142	143	1	1	3	3	1	0
LAS-271	143	144	1	1	2	1	1	0
LAS-271	143	145	2	1	3	1	1	0
LAS-271	143	144	1	1	3	2	1	0
LAS-271	143	144	1	1	3	3	1	0
LAS-272	143	144	1	1	3	4	1	0
LAS-272	144	145	1	1	3	4	1	0
LAS-272	144	145	1	1	2	1	1	0
LAS-272	147	148	1	1	2	1	1	0
LAS-272	148	238	90	1	2	2	3	0
LAS-272	148	149	1	1	3	1	1	0
LAS-272	149	150	1	1	1	1	1	0
LAS-272	150	151	1	1	2	1	1	0
LAS-272	150	151	1	1	3	1	0	0
LAS-272	150	155	5	1	2	1	2	0
LAS-273	151	158	7	1	3	1	2	0
LAS-273	151	155	4	1	3	1	2	0
LAS-273	152	155	3	1	3	1	3	0
LAS-273	153	154	1	1	3	1	1	0
LAS-273	153	154	1	1	3	1	1	0
LAS-273	154	155	1	1	3	5	1	0
LAS-273	154	155	1	1	3	1	1	0
LAS-273	154	477	323	0	3	1	1	0
LAS-273	154	227	73	1	3	4	1	0
LAS-273	155	156	1	1	3	5	1	0
LAS-274	155	477	322	0	3	1	1	0
LAS-274	155	156	1	1	3	1	2	0
LAS-274	156	157	1	1	3	1	2	0
LAS-274	157	288	131	1	3	1	2	0
LAS-274	157	164	7	1	3	1	2	0
LAS-274	157	160	3	1	4	1	3	0
LAS-274	157	282	125	1	3	4	2	0
LAS-274	158	162	4	1	3	1	2	0
LAS-274	158	159	1	1	3	1	1	0
LAS-274	158	159	1	1	3	1	1	0
LAS-275	158	159	1	1	3	1	1	0
LAS-275	158	160	2	1	3	1	2	0
LAS-275	161	477	316	0	3	1	0	0
LAS-275	161	477	316	0	3	1	1	0
LAS-275	162	163	1	1	2	1	2	0
LAS-275	162	477	315	0	3	1	0	0
LAS-275	163	171	8	1	3	1	2	1
LAS-275	164	165	1	1	3	1	3	0
LAS-275	165	171	6	1	3	1	2	1
LAS-275	165	477	312	0	3	1	0	0
LAS-276	169	170	1	1	3	1	2	0
LAS-276	169	231	62	1	3	1	2	0
LAS-276	170	171	1	1	3	1	2	2
LAS-276	170	477	307	0	3	1	0	0
LAS-276	172	173	1	1	3	1	2	0
LAS-276	174	176	2	1	3	1	2	0
LAS-276	176	177	1	1	3	1	2	0
LAS-276	177	182	5	1	3	1	2	1
LAS-276	177	203	26	1	3	1	2	1
LAS-276	178	179	1	1	3	1	2	0
LAS-277	181	182	1	1	2	1	2	0
LAS-277	182	183	1	1	3	4	2	0
LAS-277	183	477	294	0	3	1	0	0
LAS-277	183	184	1	1	3	1	2	0
LAS-277	183	318	135	1	3	2	3	0
LAS-277	183	184	1	1	3	4	2	1
LAS-277	183	477	294	0	3	1	0	0
LAS-277	185	186	1	1	3	4	2	1
LAS-277	185	186	1	1	3	1	2	0
LAS-277	185	477	292	0	3	4	1	0
LAS-278	185	186	1	1	3	4	2	0
LAS-278	186	477	291	0	2	1	1	0
LAS-278	189	477	288	0	3	4	0	0
LAS-278	189	477	288	0	3	4	0	0
LAS-278	189	477	288	0	3	4	0	0
LAS-278	190	191	1	1	3	1	2	0
LAS-278	190	197	7	1	2	1	3	0
LAS-278	192	219	27	1	4	4	1	0
LAS-278	196	203	7	1	3	1	3	0
LAS-278	197	477	280	0	3	2	0	0
LAS-279	197	477	280	0	2	2	0	0
LAS-279	200	477	277	0	3	1	0	0
LAS-279	205	477	272	0	3	1	0	0
LAS-279	206	210	4	1	3	4	3	0
LAS-279	207	208	1	1	3	1	3	0
LAS-279	207	212	5	1	3	1	1	0
LAS-279	207	477	270	0	3	4	0	0
LAS-279	210	213	3	1	3	4	1	0
LAS-279	210	213	3	1	3	4	1	0
LAS-279	211	213	2	1	4	4	1	0
LAS-280	212	477	265	0	3	1	3	0
LAS-280	212	217	5	1	3	1	2	0
LAS-280	213	214	1	1	3	4	1	0
LAS-280	213	214	1	1	4	4	1	0
LAS-280	213	214	1	1	3	4	1	0
LAS-280	213	217	4	1	4	1	1	0
LAS-280	213	218	5	1	3	4	1	0
LAS-280	214	221	7	1	3	4	1	0
LAS-280	214	228	14	1	3	4	1	0
LAS-280	214	242	28	1	3	1	2	0
LAS-281	214	420	206	1	3	4	0	0
LAS-281	214	218	4	1	3	4	1	0
LAS-281	217	221	4	1	3	4	3	0
LAS-281	217	228	11	1	3	4	1	0
LAS-281	217	228	11	1	3	4	1	1
LAS-281	218	219	1	1	3	4	3	0
LAS-281	219	227	8	1	3	1	2	0
LAS-281	219	225	6	1	3	4	2	0
LAS-281	219	238	19	1	3	4	1	0
LAS-281	224	225	1	1	3	1	1	0
LAS-282	225	234	9	1	3	4	3	1
LAS-282	225	227	2	1	3	1	2	0
LAS-282	225	242	17	1	3	2	2	1
LAS-282	226	242	16	1	2	1	2	0
LAS-282	226	317	91	1	3	1	3	0
LAS-282	227	228	1	1	3	4	2	1
LAS-282	227	228	1	1	3	1	2	0
LAS-282	227	228	1	1	3	4	2	0
LAS-282	228	235	7	1	5	4	0	0
LAS-282	229	268	39	1	3	4	0	0
LAS-283	232	233	1	1	3	1	1	1
LAS-283	232	233	1	1	3	1	1	1
LAS-283	232	233	1	1	4	3	2	0
LAS-283	232	233	1	1	3	1	1	0
LAS-283	233	234	1	1	3	1	1	0
LAS-283	233	242	9	1	3	1	1	0
LAS-283	234	242	8	1	3	4	1	0
LAS-283	235	297	62	1	3	4	2	0
LAS-283	236	238	2	1	3	4	3	0
LAS-283	238	305	67	1	3	1	1	0
LAS-284	238	242	4	1	3	1	1	0
LAS-284	238	477	239	0	3	1	1	0
LAS-284	238	477	239	0	3	1	1	0
LAS-284	238	241	3	1	3	1	1	0
LAS-284	239	242	3	1	4	4	2	0
LAS-284	240	241	1	1	3	4	1	0
LAS-284	240	241	1	1	3	1	1	0
LAS-284	240	241	1	1	3	4	3	0
LAS-284	240	241	1	1	3	1	1	0
LAS-284	240	242	2	1	3	1	1	0
LAS-285	241	477	236	0	3	1	1	0
LAS-285	241	477	236	0	3	1	1	1
LAS-285	241	242	1	1	3	4	1	0
LAS-285	242	243	1	1	2	1	2	0
LAS-285	242	477	235	0	3	1	0	0
LAS-285	242	477	235	0	3	1	1	0
LAS-285	242	243	1	1	3	4	1	0
LAS-285	246	247	1	1	3	1	3	0
LAS-285	246	260	14	1	3	1	1	1
LAS-285	246	477	231	0	3	1	2	0
LAS-286	246	259	13	1	3	1	3	0
LAS-286	248	249	1	1	3	4	1	0
LAS-286	249	254	5	1	3	1	1	0
LAS-286	251	477	226	0	3	1	1	0
LAS-286	252	256	4	1	3	4	1	0
LAS-286	253	260	7	1	3	1	1	0
LAS-286	253	260	7	1	3	5	1	0
LAS-286	253	260	7	1	3	5	1	0
LAS-286	253	260	7	1	3	5	0	1
LAS-286	253	254	1	1	3	4	1	0
LAS-287	254	255	1	1	3	4	1	0
LAS-287	254	256	2	1	2	1	1	0
LAS-287	257	406	149	1	3	4	3	0
LAS-287	258	259	1	1	3	3	1	1
LAS-287	259	260	1	1	3	4	1	1
LAS-287	260	262	2	1	3	4	1	0
LAS-287	260	261	1	1	3	5	1	0
LAS-287	260	261	1	1	3	1	3	0
LAS-287	260	406	146	1	2	1	3	0
LAS-287	261	477	216	0	3	1	1	0
LAS-288	261	477	216	0	3	1	1	0
LAS-288	261	477	216	0	3	2	1	0
LAS-288	261	264	3	1	3	4	1	0
LAS-288	262	263	1	1	3	1	1	0
LAS-288	263	477	214	0	3	1	1	0
LAS-288	263	268	5	1	3	3	1	0
LAS-288	264	266	2	1	3	4	1	0
LAS-288	265	297	32	1	3	4	1	0
LAS-288	266	267	1	1	3	1	0	0
LAS-288	267	477	210	0	3	2	0	1
LAS-289	267	294	27	1	3	3	2	0
LAS-289	267	298	31	1	2	1	3	1
LAS-289	267	270	3	1	3	4	2	1
LAS-289	268	477	209	0	3	4	1	0
LAS-289	268	280	12	1	3	1	1	1
LAS-289	268	269	1	1	4	1	0	1
LAS-289	268	477	209	0	3	2	1	0
LAS-289	269	270	1	1	3	4	0	0
LAS-289	269	477	208	0	3	1	0	0
LAS-289	269	270	1	1	3	1	0	1
LAS-290	269	301	32	1	3	1	3	0
LAS-290	270	477	207	0	3	1	0	0
LAS-290	270	477	207	0	3	1	0	0
LAS-290	271	477	206	0	3	5	0	0
LAS-290	273	477	204	0	3	1	1	0
LAS-290	274	275	1	1	3	3	2	0
LAS-290	276	280	4	1	3	1	0	0
LAS-290	276	301	25	1	3	1	1	0
LAS-290	277	477	200	0	3	4	0	0
LAS-290	279	288	9	1	3	1	2	0
LAS-291	280	304	24	1	3	3	1	0
LAS-291	280	303	23	1	3	5	0	0
LAS-291	280	303	23	1	3	5	0	0
LAS-291	280	304	24	1	3	5	0	0
LAS-291	280	303	23	1	3	5	0	0
LAS-291	280	477	197	0	3	2	0	0
LAS-291	281	477	196	0	4	4	0	0
LAS-291	282	288	6	1	3	5	3	0
LAS-291	283	294	11	1	3	3	1	0
LAS-291	284	477	193	0	3	1	0	1
LAS-292	285	294	9	1	3	3	1	0
LAS-292	287	289	2	1	4	1	0	0
LAS-292	287	288	1	1	3	1	1	0
LAS-292	287	288	1	1	3	1	1	0
LAS-292	288	289	1	1	3	3	3	0
LAS-292	290	293	3	1	4	1	2	0
LAS-292	291	294	3	1	3	1	3	0
LAS-292	292	477	185	0	3	3	1	0
LAS-292	293	477	184	0	2	1	2	0
LAS-292	293	294	1	1	3	1	2	1
LAS-293	294	296	2	1	3	1	3	0
LAS-293	294	297	3	1	3	1	0	0
LAS-293	295	477	182	0	3	1	1	1
LAS-293	295	457	162	1	3	1	0	0
LAS-293	296	303	7	1	3	4	2	0
LAS-293	297	298	1	1	3	4	3	0
LAS-293	298	304	6	1	3	4	1	0
LAS-293	298	301	3	1	3	5	3	0
LAS-293	298	304	6	1	3	4	1	0
LAS-293	298	477	179	0	3	4	0	0
LAS-294	301	477	176	0	4	1	0	0
LAS-294	302	304	2	1	3	4	2	0
LAS-294	302	477	175	0	3	1	2	0
LAS-294	302	303	1	1	3	1	2	0
LAS-294	303	477	174	0	3	4	2	0
LAS-294	303	445	142	1	3	1	2	0
LAS-294	303	359	56	1	3	1	1	0
LAS-294	303	304	1	1	3	4	3	0
LAS-294	303	477	174	0	3	4	0	0
LAS-294	304	416	112	1	3	4	2	0
LAS-295	304	305	1	1	3	1	3	0
LAS-295	304	477	173	0	3	4	3	1
LAS-295	304	422	118	1	3	5	3	2
LAS-295	304	389	85	1	3	5	3	0
LAS-295	308	309	1	1	3	1	3	0
LAS-295	308	477	169	0	4	5	0	0
LAS-295	309	310	1	1	3	1	1	0
LAS-295	309	310	1	1	3	3	2	0
LAS-295	310	311	1	1	4	1	3	0
LAS-295	312	313	1	1	3	3	2	0
LAS-296	312	458	146	1	3	5	0	0
LAS-296	312	313	1	1	3	1	3	2
LAS-296	312	477	165	0	3	1	0	0
LAS-296	313	477	164	0	3	1	0	0
LAS-296	315	477	162	0	3	1	1	0
LAS-296	317	327	10	1	3	1	3	0
LAS-296	317	477	160	0	3	1	0	0
LAS-296	317	322	5	1	3	4	1	0
LAS-296	318	477	159	0	3	4	1	0
LAS-296	319	477	158	0	3	4	2	0
LAS-297	319	324	5	1	3	4	1	0
LAS-297	319	320	1	1	3	1	0	0
LAS-297	322	477	155	0	3	2	0	0
LAS-297	322	477	155	0	4	2	0	0
LAS-297	322	477	155	0	3	1	0	0
LAS-297	322	323	1	1	3	1	3	0
LAS-297	325	336	11	1	3	5	3	2
LAS-297	326	477	151	0	2	1	0	0
LAS-297	326	477	151	0	2	1	0	0
LAS-297	326	354	28	1	3	4	1	0
LAS-298	329	330	1	1	3	1	2	0
LAS-298	330	331	1	1	3	1	3	0
LAS-298	332	333	1	1	2	1	2	0
LAS-298	332	477	145	0	3	1	0	0
LAS-298	333	406	73	1	3	1	2	0
LAS-298	333	477	144	0	2	1	0	0
LAS-298	333	336	3	1	3	1	3	0
LAS-298	334	436	102	1	3	3	1	0
LAS-298	336	422	86	1	3	1	3	1
LAS-298	337	477	140	0	1	1	0	0
LAS-299	338	477	139	0	1	1	0	0
LAS-299	340	477	137	0	4	1	0	0
LAS-299	340	447	107	1	4	1	2	1
LAS-299	345	477	132	0	2	1	0	0
LAS-299	346	438	92	1	3	1	3	0
LAS-299	346	353	7	1	3	1	2	0
LAS-299	347	387	40	1	3	4	1	0
LAS-299	348	477	129	0	1	1	0	0
LAS-299	350	357	7	1	3	5	3	1
LAS-299	350	448	98	1	3	5	3	2
LAS-300	350	477	127	0	3	4	0	0
LAS-300	350	456	106	1	3	1	2	0
LAS-300	351	352	1	1	3	1	3	0
LAS-300	354	477	123	0	1	1	0	0
LAS-300	357	366	9	1	3	4	1	3
LAS-300	357	367	10	1	4	4	2	0
LAS-300	357	368	11	1	3	4	3	1
LAS-300	359	367	8	1	3	4	3	0
LAS-300	359	477	118	0	3	4	0	0
LAS-300	359	367	8	1	3	5	3	0
LAS-301	359	375	16	1	3	5	3	0
LAS-301	359	477	118	0	1	1	0	0
LAS-301	360	477	117	0	3	1	1	0
LAS-301	361	477	116	0	3	1	0	0
LAS-301	362	477	115	0	3	1	0	0
TIC-16	25	36	11	1	3	1	0	1
TIC-16	81	191	110	1	4	3	0	0
TIC-16	160	190	30	1	3	3	0	4
TIC-17	168	477	309	0	3	1	0	1
TIC-17	185	477	292	0	3	3	0	1
TIC-17	353	477	124	0	3	3	0	1
TIC-17	356	464	108	1	3	3	0	2
RORA-196	2	17	15	1	4	1	1	0
RORA-196	17	51	34	1	3	3	1	0
RORA-196	23	24	1	1	4	1	1	0
RORA-196	23	477	454	0	3	1	0	0
RORA-196	28	29	1	1	4	3	1	0
RORA-196	29	477	448	0	3	5	0	0
RORA-196	29	477	448	0	3	5	0	0
RORA-197	29	477	448	0	3	5	0	0
RORA-197	37	477	440	0	4	5	0	0
RORA-197	39	477	438	0	3	1	0	0
RORA-197	45	477	432	0	5	1	0	0
RORA-197	64	85	21	1	5	3	1	0
RORA-197	66	170	104	1	3	1	1	0
RORA-197	67	155	88	1	3	5	0	0
RORA-197	67	140	73	1	3	5	0	0
RORA-197	67	155	88	1	3	5	0	0
RORA-197	67	155	88	1	3	5	0	0
RORA-198	71	477	406	0	3	1	0	0
RORA-198	77	79	2	1	3	5	1	0
RORA-198	77	477	400	0	3	5	0	0
RORA-198	91	477	386	0	4	5	0	0
RORA-198	98	477	379	0	4	3	0	0
RORA-198	144	477	333	0	4	1	0	0
RORA-198	144	477	333	0	3	1	0	0
RORA-198	149	477	328	0	3	3	0	0
RORA-198	155	302	147	1	1	1	0	0
RORA-198	164	477	313	0	3	1	0	0
RORA-199	165	166	1	1	3	1	0	0
RORA-199	176	259	83	1	4	1	1	0
RORA-199	183	477	294	0	4	1	0	0
RORA-199	200	201	1	1	3	1	1	0
RORA-199	241	477	236	0	5	3	0	0
RORA-199	241	477	236	0	4	3	0	0
RORA-199	272	477	205	0	3	1	0	0
TOTAG-2	16	477	461	0	4	4	0	0
RO-212	2	22	20	1	3	1	3	0
RO-212	2	477	475	0	2	1	0	0
RO-212	3	477	474	0	4	1	0	0
RO-212	3	15	12	1	3	1	0	0
RO-212	3	477	474	0	3	1	0	0
RO-212	8	311	303	1	4	4	1	0
RO-212	10	477	467	0	3	1	0	1
RO-212	11	332	321	1	4	4	1	0
RO-213	15	16	1	1	3	3	1	0
RO-213	16	332	316	1	3	1	1	0
RO-213	17	52	35	1	3	4	1	0
RO-213	17	18	1	1	4	4	1	0
RO-213	18	477	459	0	3	1	0	0
RO-213	26	477	451	0	3	1	0	0
RO-213	27	477	450	0	2	1	0	0
RO-213	28	477	449	0	3	1	0	0
RO-213	29	477	448	0	3	1	0	0
RO-213	31	477	446	0	2	1	0	0
RO-214	32	477	445	0	4	4	0	0
RO-214	39	477	438	0	4	2	0	0
RO-214	42	330	288	1	5	4	1	0
RO-214	42	52	10	1	3	4	1	0
RO-214	43	451	408	1	4	1	1	0
RO-214	44	477	433	0	3	1	0	0
RO-214	46	477	431	0	3	1	0	0
RO-214	47	60	13	1	3	4	1	0
RO-214	51	477	426	0	2	4	0	0
RO-214	52	477	425	0	3	4	0	0
RO-215	52	477	425	0	4	4	0	0
RO-215	58	477	419	0	4	1	0	0
RO-215	60	63	3	1	5	1	0	0
RO-215	61	274	213	1	4	1	0	0
RO-215	63	477	414	0	3	1	0	0
RO-215	65	338	273	1	4	2	1	0
RO-215	65	338	273	1	3	2	1	0
RO-215	67	72	5	1	5	1	1	0
RO-215	69	477	408	0	4	2	0	0
RO-215	73	477	404	0	3	2	0	0
RO-216	73	477	404	0	2	1	0	0
RO-216	75	376	301	1	3	4	1	2
RO-216	80	444	364	1	3	4	1	0
RO-216	80	477	397	0	3	3	1	2
RO-216	81	477	396	0	3	4	0	2
RO-216	90	209	119	1	4	4	1	0
RO-216	93	113	20	1	3	1	0	0
RO-216	93	113	20	1	3	1	1	0
RO-216	94	113	19	1	3	1	0	0
RO-216	95	113	18	1	3	4	1	0
RO-217	106	477	371	0	4	4	0	0
RO-217	106	477	371	0	3	4	0	0
RO-217	116	121	5	1	3	2	1	0
RO-217	123	188	65	1	3	4	0	0
RO-217	123	477	354	0	3	1	0	1
RO-217	126	477	351	0	2	3	0	0
RO-217	126	477	351	0	3	1	0	0
RO-217	128	477	349	0	3	1	0	0
RO-217	129	322	193	1	3	4	0	0
RO-217	136	311	175	1	2	1	1	0
RO-218	142	477	335	0	3	4	0	0
RO-218	147	330	183	1	3	1	1	1
RO-218	148	455	307	1	3	1	1	1
RO-218	149	313	164	1	3	1	1	0
RO-218	151	344	193	1	3	1	1	0
RO-218	151	477	326	0	4	4	0	0
RO-218	155	277	122	1	2	1	1	0
RO-218	158	477	319	0	3	2	0	0
RO-218	162	477	315	0	4	1	0	0
RO-218	163	165	2	1	5	1	1	0
RO-219	171	477	306	0	3	1	0	0
RO-219	171	477	306	0	2	1	0	0
RO-219	171	338	167	1	4	4	1	0
RO-219	172	338	166	1	4	4	0	1
RO-219	176	477	301	0	3	1	0	0
RO-219	179	210	31	1	3	2	1	0
RO-219	179	272	93	1	3	1	1	0
RO-219	186	477	291	0	3	4	0	0
RO-219	192	477	285	0	3	1	1	0
RO-219	196	454	258	1	4	4	1	0
RO-220	196	457	261	1	4	4	1	0
RO-220	205	477	272	0	3	4	0	0
RO-220	206	459	253	1	3	1	1	0
RO-220	209	315	106	1	1	1	0	0
RO-220	210	477	267	0	3	2	0	0
RO-220	210	477	267	0	3	4	0	0
RO-220	210	477	267	0	3	2	0	0
RO-220	217	304	87	1	3	1	1	1
RO-220	220	304	84	1	3	1	1	0
RO-220	223	276	53	1	3	1	1	0
RO-221	223	232	9	1	3	5	0	0
RO-221	227	477	250	0	3	5	0	0
RO-221	231	427	196	1	2	1	1	3
RO-221	231	274	43	1	4	1	1	0
RO-221	231	274	43	1	4	4	1	1
RO-221	231	477	246	0	3	4	0	0
RO-221	233	311	78	1	3	1	1	0
RO-221	233	315	82	1	2	1	1	1
RO-221	253	401	148	1	3	4	1	0
RO-221	253	274	21	1	3	1	0	1
RO-222	253	274	21	1	3	1	1	1
RO-222	254	477	223	0	3	1	0	0
RO-222	254	274	20	1	3	1	1	0
RO-222	254	477	223	0	4	4	0	0
RO-222	255	274	19	1	3	4	0	0
RO-222	255	477	222	0	3	1	0	0
RO-222	256	477	221	0	3	1	0	0
RO-222	261	477	216	0	3	1	1	1
RO-222	266	315	49	1	3	4	1	1
RO-222	267	277	10	1	3	4	1	0
RO-223	269	277	8	1	3	1	0	0
RO-223	269	477	208	0	3	1	0	0
RO-223	270	477	207	0	3	1	0	0
RO-223	270	277	7	1	3	4	0	1
RO-223	274	310	36	1	3	4	1	0
RO-223	275	289	14	1	3	1	0	1
RO-223	276	477	201	0	3	1	0	0
RO-223	276	477	201	0	3	1	0	0
RO-223	277	385	108	1	3	4	1	0
RO-223	277	321	44	1	3	4	1	0
RO-224	280	310	30	1	3	1	1	0
RO-224	283	323	40	1	3	4	1	1
RO-224	287	477	190	0	4	1	0	0
RO-224	288	477	189	0	4	4	0	0
RO-224	289	323	34	1	3	1	1	1
RO-224	290	311	21	1	4	4	1	0
RO-224	292	295	3	1	3	3	0	0
RO-224	296	477	181	0	3	4	1	0
RO-224	297	477	180	0	3	4	0	0
RO-224	298	300	2	1	3	3	1	0
RO-225	301	477	176	0	3	3	0	0
RO-225	302	455	153	1	3	5	1	1
RO-225	304	477	173	0	3	5	0	0
RO-225	308	477	169	0	4	1	0	0
RO-225	311	477	166	0	3	1	0	0
RO-225	312	477	165	0	3	4	0	0
RO-225	312	321	9	1	2	1	1	0
RO-225	312	477	165	0	3	1	0	0
RO-225	312	477	165	0	3	2	0	0
RO-225	314	315	1	1	3	4	1	0
RO-226	314	477	163	0	4	1	0	0
RO-226	315	316	1	1	3	3	1	0
RO-226	315	316	1	1	3	3	1	0
RO-226	315	316	1	1	3	3	1	0
RO-226	315	316	1	1	3	3	1	0
RO-226	315	316	1	1	3	3	1	1
RO-226	318	321	3	1	4	4	2	0
RO-226	318	323	5	1	3	4	1	0
RO-226	318	320	2	1	3	5	0	1
RO-226	319	450	131	1	3	5	1	1
RO-227	319	320	1	1	5	1	0	0
RO-227	323	477	154	0	3	4	0	0
RO-227	324	477	153	0	3	1	0	0
RO-227	327	477	150	0	3	3	1	0
RO-227	329	331	2	1	3	4	0	0
RO-227	329	477	148	0	3	4	0	0
RO-227	330	332	2	1	4	1	1	0
RO-227	330	399	69	1	4	4	1	0
RO-227	330	477	147	0	3	1	0	0
RO-227	332	333	1	1	4	4	1	0
RO-228	336	358	22	1	3	1	1	0
RO-228	339	340	1	1	4	4	1	0
RO-228	340	477	137	0	3	4	1	0
RO-228	345	477	132	0	5	1	0	0
RO-228	346	477	131	0	4	1	0	0
RO-228	352	353	1	1	3	1	1	0
RO-228	352	477	125	0	4	1	0	0
RO-228	353	359	6	1	4	5	1	0
RO-228	353	386	33	1	4	4	1	1
RO-229	353	367	14	1	4	5	1	0
RO-229	354	450	96	1	4	4	1	0
RO-229	355	356	1	1	3	3	1	0
RO-229	358	477	119	0	4	1	0	0
RO-229	360	477	117	0	3	1	0	0
RO-229	362	373	11	1	3	4	0	0
IOM-48	129	147	18	1	4	1	0	0
IOM-49	248	322	74	1	3	1	0	0
IOM-49	255	477	222	0	4	1	0	0
IOM-49	314	316	2	1	3	1	1	0
IOM-49	318	319	1	1	3	1	1	1
IS-292	188	189	1	1	3	1	0	0
IS-292	253	477	224	0	3	1	0	0
IS-292	295	477	182	0	3	1	1	0
IS-292	321	477	156	0	2	1	1	0
IS-292	321	477	156	0	3	1	1	0
IS2-590	3	477	474	0	2	1	0	0
IS2-590	22	23	1	1	3	1	0	0
IS2-590	29	30	1	1	3	1	0	0
IS2-590	38	151	113	1	3	1	0	0
IS2-590	52	477	425	0	3	1	0	0
IS2-590	72	477	405	0	3	1	0	0
IS2-591	72	477	405	0	3	1	0	0
IS2-591	73	477	404	0	3	4	0	0
IS2-591	86	151	65	1	3	1	0	0
IS2-591	127	128	1	1	1	1	0	1
IS2-591	127	138	11	1	3	1	1	1
IS2-591	141	143	2	1	2	1	0	0
IS2-591	142	143	1	1	3	1	0	0
IS2-591	151	253	102	1	3	1	0	0
IS2-591	151	253	102	1	3	1	0	0
IS2-591	158	229	71	1	3	1	1	1
IS2-592	163	253	90	1	3	1	0	0
IS2-592	178	253	75	1	3	1	0	0
IS2-592	188	195	7	1	3	1	0	0
IS2-592	192	203	11	1	4	1	1	0
IS2-592	193	477	284	0	3	1	0	0
IS2-592	195	477	282	0	2	2	0	0
IS2-592	204	477	273	0	2	1	0	0
IS2-592	211	477	266	0	4	1	0	0
IS2-592	221	477	256	0	3	4	0	0
IS2-592	221	477	256	0	4	4	0	0
IS2-593	241	243	2	1	3	1	1	2
IS2-593	253	477	224	0	3	4	0	0
IS2-593	253	275	22	1	3	1	0	0
IS2-593	254	477	223	0	3	4	0	0
IS2-593	260	477	217	0	1	1	0	0
IS2-593	287	477	190	0	1	1	0	0
IS2-593	291	371	80	1	3	1	0	0
IS2-593	311	312	1	1	3	4	0	2
IS2-593	311	312	1	1	2	4	0	2
IS2-593	316	477	161	0	2	1	0	0
IS2-594	317	477	160	0	3	1	0	0
IS2-594	324	477	153	0	3	1	0	0
IS2-594	326	477	151	0	3	4	0	0
IS2-594	351	477	126	0	3	1	0	0
IS2-594	353	477	124	0	2	1	0	0
IS2C-169	6	120	114	1	3	1	1	0
IS2C-169	20	477	457	0	3	1	1	0
IS2C-169	118	119	1	1	3	1	1	0
IS2C-169	136	393	257	1	4	3	0	0
HIR-15	31	32	1	1	4	1	1	0
HIR-15	39	477	438	0	3	2	0	0
HIR-15	42	43	1	1	3	1	2	0
HIR-16	53	477	424	0	3	4	1	0
HIR-16	84	477	393	0	3	5	0	0
HIR-16	114	115	1	1	3	3	1	0
HIR-16	114	115	1	1	3	4	1	0
HIR-16	115	311	196	1	1	5	1	0
HIR-16	128	311	183	1	3	1	1	0
HIR-16	130	311	181	1	3	5	1	0
HIR-16	130	477	347	0	3	4	0	0
HIR-16	144	477	333	0	3	2	0	0
HIR-16	169	477	308	0	3	4	0	0
HIR-17	177	178	1	1	2	1	1	0
HIR-17	178	179	1	1	3	1	1	0
HIR-17	184	477	293	0	4	1	0	0
HIR-17	193	206	13	1	3	4	1	0
HIR-17	201	217	16	1	2	4	1	0
HIR-17	205	374	169	1	3	1	1	0
HIR-17	221	256	35	1	3	4	1	0
HIR-17	241	477	236	0	1	1	0	0
HIR-17	260	310	50	1	3	4	1	0
HIR-17	262	379	117	1	4	5	1	0
HIR-18	263	430	167	1	3	4	1	0
HIR-18	304	311	7	1	4	4	1	0
HIR-18	322	333	11	1	3	2	1	0
HIR-18	335	348	13	1	3	4	1	0
HIR-18	338	406	68	1	3	1	1	0
HIR-18	338	477	139	0	3	1	0	0
HIR-18	338	345	7	1	3	2	1	0
HIR-18	344	457	113	1	4	4	1	0
HIR-18	344	345	1	1	3	3	1	0
TCHEE-13	78	477	399	0	3	1	1	1
TCHEE-13	83	84	1	1	3	2	1	1
TCHEE-13	183	184	1	1	3	1	1	0
TCHEE-13	211	212	1	1	3	1	1	0
TCHEE-13	331	333	2	1	2	1	1	0
TIK-121	22	477	455	0	5	1	0	0
TIK-121	28	477	449	0	5	4	0	0
TIK-121	38	477	439	0	3	1	0	0
TIK-121	55	119	64	1	1	1	0	0
TIK-121	56	477	421	0	4	1	0	0
TIK-121	59	477	418	0	3	1	0	0
TIK-121	66	477	411	0	3	1	0	0
TIK-122	78	477	399	0	4	1	0	0
TIK-122	110	477	367	0	3	4	0	0
TIK-122	128	129	1	1	3	1	0	0
TIK-122	134	477	343	0	3	1	0	0
TIK-122	143	477	334	0	4	1	0	0
TIK-122	147	477	330	0	4	1	0	0
TIK-122	148	477	329	0	3	1	0	0
TIK-122	149	477	328	0	3	1	0	0
TIK-122	151	477	326	0	2	1	0	0
TIK-122	151	247	96	1	3	1	0	0
TIK-123	151	164	13	1	1	1	0	0
TIK-123	155	477	322	0	1	1	0	0
TIK-123	164	168	4	1	4	1	0	0
TIK-123	168	246	78	1	3	1	0	0
TIK-123	168	169	1	1	3	1	0	0
TIK-123	179	180	1	1	4	1	0	0
TIK-123	183	184	1	1	3	1	0	0
TIK-123	210	477	267	0	3	1	0	0
TIK-123	220	477	257	0	3	1	0	0
TIK-123	240	241	1	1	3	1	0	0
TIK-124	245	246	1	1	3	1	0	0
TIK-124	283	477	194	0	3	1	0	0
TIK-124	289	477	188	0	3	1	0	0
TIK-124	302	477	175	0	4	1	0	0
TIK-124	304	477	173	0	3	1	0	0
TIK-124	322	323	1	1	3	1	0	0
TIK-124	344	477	133	0	2	1	0	0
TIK-124	354	477	123	0	4	1	0	0
TIK-124	361	362	1	1	3	1	0	0
TIK-124	361	379	18	1	3	1	0	0
TIK-125	362	379	17	1	3	1	0	0
EL-30	45	477	432	0	5	1	0	0
EL-30	176	477	301	0	3	1	0	0
EL-30	197	208	11	1	3	1	1	1
EL-30	208	209	1	1	3	2	1	1
EL-30	230	477	247	0	5	1	0	0
EL-30	233	477	244	0	3	1	0	0
EL-30	234	477	243	0	3	1	0	0
EL-30	234	477	243	0	3	1	0	0
EL-31	234	477	243	0	3	1	0	0
EL-31	234	477	243	0	3	1	0	0
EL-31	234	477	243	0	3	1	0	0
EL-31	234	477	243	0	3	1	0	0
EL-31	337	477	140	0	3	4	0	0
AM-340	1	477	476	0	4	1	0	0
AM-340	1	477	476	0	4	4	0	0
AM-340	1	477	476	0	4	4	0	0
AM-340	2	477	475	0	3	1	0	0
AM-340	2	6	4	1	4	4	1	0
AM-340	2	11	9	1	4	4	1	0
AM-340	2	8	6	1	3	1	1	0
AM-340	2	477	475	0	3	1	0	2
AM-340	2	477	475	0	3	1	0	0
AM-340	3	59	56	1	1	1	1	1
AM-341	3	477	474	0	3	1	0	0
AM-341	3	23	20	1	3	1	1	0
AM-341	4	206	202	1	3	4	1	0
AM-341	4	477	473	0	3	4	0	0
AM-341	4	344	340	1	3	1	1	1
AM-341	4	477	473	0	3	2	0	0
AM-341	4	24	20	1	4	1	1	0
AM-341	4	128	124	1	3	3	1	0
AM-341	4	186	182	1	3	4	1	0
AM-341	4	477	473	0	3	4	0	0
AM-342	4	45	41	1	3	1	1	0
AM-342	5	477	472	0	4	4	0	0
AM-342	5	8	3	1	3	5	1	1
AM-342	5	42	37	1	3	1	1	0
AM-342	5	116	111	1	3	1	1	0
AM-342	5	116	111	1	3	1	1	0
AM-342	7	27	20	1	3	3	1	1
AM-342	7	21	14	1	3	5	1	1
AM-342	7	24	17	1	3	5	1	0
AM-342	7	477	470	0	3	1	0	0
AM-343	7	27	20	1	3	5	1	1
AM-343	7	11	4	1	3	5	1	0
AM-343	7	24	17	1	3	5	1	0
AM-343	7	158	151	1	4	1	1	0
AM-343	7	477	470	0	4	4	0	0
AM-343	7	428	421	1	4	1	1	0
AM-343	8	12	4	1	3	1	1	0
AM-343	8	373	365	1	3	5	1	0
AM-343	8	15	7	1	3	1	1	0
AM-343	8	9	1	1	3	1	1	0
AM-344	8	162	154	1	3	4	1	1
AM-344	8	58	50	1	3	4	1	1
AM-344	8	266	258	1	4	1	1	0
AM-344	8	186	178	1	4	4	1	1
AM-344	8	183	175	1	3	5	1	0
AM-344	8	100	92	1	3	1	1	0
AM-344	9	261	252	1	3	2	1	0
AM-344	9	477	468	0	3	4	0	0
AM-344	9	116	107	1	3	5	1	0
AM-344	9	112	103	1	3	3	1	1
AM-345	9	17	8	1	3	1	1	0
AM-345	9	10	1	1	3	1	1	0
AM-345	10	12	2	1	3	1	1	0
AM-345	10	477	467	0	3	2	0	0
AM-345	10	14	4	1	4	4	1	1
AM-345	10	477	467	0	3	1	0	0
AM-345	10	113	103	1	3	1	1	1
AM-345	10	67	57	1	3	5	1	1
AM-345	10	17	7	1	3	1	1	0
AM-345	10	100	90	1	3	5	1	1
AM-346	10	32	22	1	3	5	1	1
AM-346	11	17	6	1	5	5	1	0
AM-346	11	477	466	0	4	5	0	0
AM-346	11	477	466	0	3	3	0	0
AM-346	11	18	7	1	5	1	1	0
AM-346	11	24	13	1	3	5	1	1
AM-346	11	24	13	1	3	5	1	0
AM-346	11	12	1	1	3	5	1	0
AM-346	11	12	1	1	3	5	1	1
AM-346	11	108	97	1	4	4	1	0
AM-347	11	42	31	1	3	4	1	0
AM-347	11	477	466	0	3	4	0	0
AM-347	11	477	466	0	3	4	0	0
AM-347	11	56	45	1	3	1	1	0
AM-347	11	56	45	1	4	1	1	0
AM-347	11	477	466	0	3	2	0	0
AM-347	11	66	55	1	3	5	1	0
AM-347	11	477	466	0	3	4	0	0
AM-347	12	13	1	1	3	1	1	0
AM-347	13	477	464	0	3	3	0	0
AM-348	14	477	463	0	3	1	0	0
AM-348	14	477	463	0	3	1	0	0
AM-348	15	200	185	1	3	1	1	0
AM-348	15	477	462	0	3	4	0	0
AM-348	15	108	93	1	4	1	1	0
AM-348	15	116	101	1	3	1	1	0
AM-348	16	23	7	1	5	1	1	0
AM-348	16	477	461	0	3	1	0	0
AM-348	16	477	461	0	4	4	0	0
AM-348	16	477	461	0	4	2	0	0
AM-349	17	477	460	0	3	1	0	0
AM-349	17	477	460	0	5	1	0	0
AM-349	17	21	4	1	1	1	1	0
AM-349	17	477	460	0	4	1	0	0
AM-349	17	374	357	1	3	1	1	0
AM-349	17	477	460	0	3	1	0	0
AM-349	17	18	1	1	2	1	1	0
AM-349	17	477	460	0	3	1	0	0
AM-349	17	18	1	1	3	1	1	0
AM-349	18	36	18	1	3	1	1	0
AM-350	18	81	63	1	3	4	1	0
AM-350	18	477	459	0	3	1	0	0
AM-350	18	19	1	1	4	4	1	0
AM-350	18	477	459	0	4	2	0	0
AM-350	19	200	181	1	4	1	1	0
AM-350	19	56	37	1	4	4	1	0
AM-350	20	29	9	1	4	4	1	0
AM-350	20	21	1	1	3	4	1	1
AM-350	21	374	353	1	3	1	1	0
AM-350	21	477	456	0	3	2	0	0
AM-351	21	22	1	1	3	1	1	0
AM-351	21	435	414	1	3	1	1	0
AM-351	21	177	156	1	3	1	1	0
AM-351	21	212	191	1	3	5	1	2
AM-351	21	477	456	0	4	3	0	2
AM-351	21	132	111	1	3	5	1	1
AM-351	22	298	276	1	3	1	1	0
AM-351	22	477	455	0	3	3	0	0
AM-351	22	226	204	1	3	5	1	0
AM-351	22	477	455	0	3	1	0	4
AM-352	22	106	84	1	3	5	1	0
AM-352	22	107	85	1	3	5	1	1
AM-352	22	109	87	1	3	5	1	0
AM-352	22	477	455	0	4	4	0	0
AM-352	23	477	454	0	3	5	0	0
AM-352	23	24	1	1	4	1	1	0
AM-352	23	36	13	1	3	1	1	0
AM-352	23	64	41	1	4	1	1	0
AM-352	23	477	454	0	3	1	0	0
AM-352	23	477	454	0	3	1	0	0
AM-353	24	477	453	0	3	4	0	0
AM-353	24	30	6	1	3	1	1	0
AM-353	24	477	453	0	4	4	0	0
AM-353	24	25	1	1	5	4	1	0
AM-353	24	25	1	1	3	5	1	0
AM-353	24	477	453	0	4	1	0	0
AM-353	24	477	453	0	3	1	0	0
AM-353	24	177	153	1	3	1	1	0
AM-353	25	52	27	1	4	4	1	0
AM-353	25	28	3	1	5	4	1	0
AM-354	25	179	154	1	3	1	1	0
AM-354	25	179	154	1	3	1	1	0
AM-354	25	477	452	0	4	1	0	0
AM-354	25	477	452	0	3	5	0	0
AM-354	25	477	452	0	3	5	0	0
AM-354	25	477	452	0	3	5	0	0
AM-354	25	114	89	1	3	5	1	0
AM-354	25	102	77	1	3	1	1	0
AM-354	25	477	452	0	3	2	0	0
AM-354	26	477	451	0	4	4	0	1
AM-355	26	28	2	1	4	4	1	0
AM-355	27	32	5	1	3	5	1	0
AM-355	27	50	23	1	3	4	1	1
AM-355	27	50	23	1	3	5	1	0
AM-355	27	50	23	1	3	5	1	0
AM-355	27	50	23	1	3	5	1	0
AM-355	27	50	23	1	3	5	1	0
AM-355	28	477	449	0	3	1	0	0
AM-355	28	477	449	0	3	5	0	0
AM-355	28	31	3	1	4	1	1	0
AM-356	28	29	1	1	5	4	1	0
AM-356	28	477	449	0	3	3	0	0
AM-356	28	37	9	1	3	3	1	0
AM-356	28	78	50	1	3	5	1	0
AM-356	28	35	7	1	3	1	1	0
AM-356	28	50	22	1	3	1	1	0
AM-356	28	477	449	0	3	4	1	0
AM-356	29	477	448	0	3	1	0	0
AM-356	29	477	448	0	3	1	0	0
AM-356	29	58	29	1	3	1	1	0
AM-357	29	78	49	1	3	1	1	0
AM-357	29	477	448	0	3	3	0	0
AM-357	29	37	8	1	4	4	1	0
AM-357	30	477	447	0	3	1	0	0
AM-357	30	477	447	0	3	1	0	0
AM-357	30	72	42	1	3	4	1	0
AM-357	30	477	447	0	3	5	0	0
AM-357	30	477	447	0	3	5	0	0
AM-357	30	31	1	1	2	1	1	0
AM-357	30	39	9	1	3	1	1	1
AM-358	30	382	352	1	3	1	1	0
AM-358	30	66	36	1	3	1	1	0
AM-358	30	37	7	1	3	1	1	0
AM-358	30	477	447	0	3	1	0	0
AM-358	30	33	3	1	1	1	1	0
AM-358	30	31	1	1	1	1	1	0
AM-358	31	32	1	1	3	1	1	0
AM-358	31	187	156	1	4	1	1	0
AM-358	31	477	446	0	3	4	0	0
AM-358	31	36	5	1	1	1	1	1
AM-359	31	193	162	1	4	1	1	0
AM-359	31	32	1	1	4	1	1	0
AM-359	31	38	7	1	3	1	1	0
AM-359	31	32	1	1	5	4	1	0
AM-359	31	477	446	0	4	4	0	0
AM-359	31	182	151	1	3	1	1	0
AM-359	31	477	446	0	3	1	0	0
AM-359	31	32	1	1	4	4	1	0
AM-359	31	44	13	1	2	1	1	0
AM-359	31	44	13	1	2	1	1	0
AM-360	31	64	33	1	3	1	1	2
AM-360	31	42	11	1	3	5	1	0
AM-360	31	35	4	1	5	4	1	0
AM-360	32	33	1	1	3	4	1	0
AM-360	32	477	445	0	2	1	1	1
AM-360	32	44	12	1	2	1	1	0
AM-360	32	477	445	0	3	4	0	0
AM-360	32	477	445	0	3	5	0	0
AM-360	32	417	385	1	3	5	1	3
AM-360	32	477	445	0	3	2	0	0
AM-361	32	33	1	1	3	1	1	0
AM-361	32	59	27	1	4	4	1	0
AM-361	32	386	354	1	3	4	1	0
AM-361	33	39	6	1	4	1	1	0
AM-361	33	477	444	0	3	4	0	0
AM-361	33	34	1	1	2	2	1	1
AM-361	35	477	442	0	3	4	1	0
AM-361	35	477	442	0	4	1	0	0
AM-361	35	36	1	1	5	4	1	0
AM-361	35	177	142	1	3	4	1	0
AM-362	36	40	4	1	3	4	1	0
AM-362	36	65	29	1	2	1	1	0
AM-362	36	477	441	0	3	1	0	0
AM-362	36	477	441	0	3	1	0	0
AM-362	36	37	1	1	5	4	1	0
AM-362	36	477	441	0	3	1	0	0
AM-362	36	43	7	1	3	5	1	1
AM-362	36	42	6	1	1	1	1	0
AM-362	36	78	42	1	1	1	1	0
AM-362	36	42	6	1	3	5	1	1
AM-363	36	42	6	1	3	5	1	1
AM-363	36	54	18	1	3	5	1	1
AM-363	36	52	16	1	3	1	1	0
AM-363	37	477	440	0	3	4	0	0
AM-363	37	190	153	1	3	4	1	0
AM-363	37	38	1	1	3	4	1	0
AM-363	37	477	440	0	2	1	0	0
AM-363	37	43	6	1	4	1	1	0
AM-363	37	38	1	1	2	1	1	0
AM-363	37	38	1	1	3	3	1	0
AM-364	37	477	440	0	3	3	0	0
AM-364	37	477	440	0	4	4	0	0
AM-364	37	477	440	0	3	4	0	0
AM-364	37	477	440	0	4	1	0	0
AM-364	37	177	140	1	3	4	1	0
AM-364	37	477	440	0	3	4	0	0
AM-364	38	43	5	1	2	1	1	0
AM-364	38	477	439	0	3	2	0	2
AM-364	38	477	439	0	3	2	0	0
AM-364	38	56	18	1	4	1	1	0
AM-365	38	477	439	0	3	4	0	0
AM-365	38	274	236	1	3	5	1	0
AM-365	38	274	236	1	3	5	1	0
AM-365	38	477	439	0	3	5	0	0
AM-365	38	234	196	1	3	5	1	0
AM-365	38	281	243	1	3	5	1	0
AM-365	38	477	439	0	3	5	0	0
AM-365	38	344	306	1	3	5	1	0
AM-365	38	477	439	0	3	5	0	0
AM-365	38	333	295	1	3	5	1	0
AM-366	38	477	439	0	3	5	0	0
AM-366	38	333	295	1	3	5	1	0
AM-366	38	51	13	1	3	5	1	0
AM-366	38	477	439	0	3	5	0	0
AM-366	38	477	439	0	3	5	0	0
AM-366	38	477	439	0	3	5	0	0
AM-366	38	45	7	1	3	5	1	0
AM-366	38	394	356	1	3	1	1	0
AM-366	38	40	2	1	1	1	1	1
AM-366	38	154	116	1	3	1	1	0
AM-367	38	177	139	1	3	1	1	0
AM-367	38	64	26	1	3	2	1	2
AM-367	38	477	439	0	4	4	0	0
AM-367	38	233	195	1	3	5	1	0
AM-367	38	477	439	0	4	5	0	0
AM-367	38	262	224	1	3	5	1	0
AM-367	38	280	242	1	3	5	1	0
AM-367	39	477	438	0	4	1	0	0
AM-367	39	477	438	0	4	2	0	0
AM-367	39	77	38	1	4	4	1	0
AM-368	39	477	438	0	3	1	0	0
AM-368	39	58	19	1	3	1	1	0
AM-368	39	477	438	0	4	2	0	0
AM-368	40	50	10	1	3	1	1	0
AM-368	40	44	4	1	3	1	1	0
AM-368	40	477	437	0	3	1	0	0
AM-368	41	477	436	0	3	2	0	1
AM-368	41	175	134	1	3	1	1	1
AM-368	41	56	15	1	3	4	1	0
AM-368	42	59	17	1	3	4	1	0
AM-369	42	53	11	1	4	1	1	0
AM-369	42	477	435	0	4	4	0	0
AM-369	42	43	1	1	3	1	1	0
AM-369	42	43	1	1	3	1	1	1
AM-369	42	477	435	0	3	4	0	0
AM-369	43	86	43	1	2	1	1	0
AM-369	43	477	434	0	3	1	0	0
AM-369	43	119	76	1	3	5	1	0
AM-369	43	53	10	1	3	1	1	1
AM-369	43	56	13	1	3	1	1	0
AM-370	44	477	433	0	3	3	0	0
AM-370	44	51	7	1	3	3	1	0
AM-370	44	477	433	0	3	3	0	0
AM-370	44	73	29	1	3	1	1	0
AM-370	44	477	433	0	3	1	0	0
AM-370	44	63	19	1	3	1	1	0
AM-370	44	178	134	1	4	5	1	0
AM-370	44	107	63	1	3	5	1	0
AM-370	45	212	167	1	3	5	1	0
AM-370	45	477	432	0	3	5	0	0
AM-371	45	121	76	1	3	5	1	0
AM-371	45	333	288	1	3	5	1	0
AM-371	45	477	432	0	3	4	0	0
AM-371	45	477	432	0	4	5	0	0
AM-371	46	109	63	1	3	1	1	0
AM-371	46	114	68	1	3	1	1	0
AM-371	48	477	429	0	3	4	0	0
AM-371	49	477	428	0	3	1	0	0
AM-371	50	477	427	0	5	1	0	0
AM-371	51	477	426	0	3	4	0	0
AM-372	51	52	1	1	3	1	1	0
AM-372	51	477	426	0	3	4	0	0
AM-372	51	477	426	0	3	4	0	0
AM-372	51	477	426	0	4	1	0	0
AM-372	51	53	2	1	3	5	1	0
AM-372	51	130	79	1	4	4	1	0
AM-372	51	94	43	1	3	1	1	1
AM-372	52	282	230	1	3	1	1	0
AM-372	52	53	1	1	1	1	1	0
AM-372	52	53	1	1	1	1	1	0
AM-373	52	477	425	0	3	1	0	1
AM-373	52	92	40	1	3	5	1	0
AM-373	52	55	3	1	3	1	1	1
AM-373	52	140	88	1	3	4	1	0
AM-373	52	113	61	1	3	5	1	0
AM-373	52	59	7	1	3	1	1	0
AM-373	53	477	424	0	3	4	0	0
AM-373	53	477	424	0	3	2	0	0
AM-373	53	150	97	1	3	1	1	1
AM-373	53	57	4	1	3	1	1	0
AM-374	53	477	424	0	3	4	0	0
AM-374	53	176	123	1	3	5	1	0
AM-374	53	477	424	0	3	5	0	0
AM-374	53	477	424	0	3	5	1	0
AM-374	54	206	152	1	2	1	1	0
AM-374	54	477	423	0	3	4	0	0
AM-374	56	296	240	1	3	1	1	0
AM-374	56	347	291	1	3	5	1	0
AM-374	56	477	421	0	3	1	0	0
AM-374	56	80	24	1	3	4	1	0
AM-375	57	66	9	1	4	1	1	0
AM-375	57	477	420	0	3	1	0	0
AM-375	57	477	420	0	3	1	0	0
AM-375	57	65	8	1	3	1	1	0
AM-375	57	63	6	1	4	1	1	0
AM-375	57	477	420	0	3	1	0	0
AM-375	57	276	219	1	2	4	1	0
AM-375	57	73	16	1	3	1	1	0
AM-375	57	477	420	0	3	5	0	0
AM-375	57	477	420	0	3	4	0	0
AM-376	58	59	1	1	1	1	1	0
AM-376	58	477	419	0	3	4	0	2
AM-376	58	59	1	1	4	4	1	0
AM-376	58	477	419	0	4	3	0	0
AM-376	59	477	418	0	4	4	0	0
AM-376	59	421	362	1	4	1	1	0
AM-376	59	477	418	0	4	1	0	0
AM-376	59	477	418	0	4	2	0	0
AM-376	59	64	5	1	1	1	1	0
AM-376	59	198	139	1	4	1	1	0
AM-377	60	61	1	1	3	4	1	0
AM-377	60	64	4	1	3	1	1	0
AM-377	60	477	417	0	3	1	0	0
AM-377	60	168	108	1	3	4	1	0
AM-377	60	93	33	1	3	4	1	0
AM-377	60	148	88	1	3	1	1	1
AM-377	61	137	76	1	2	1	1	0
AM-377	63	64	1	1	3	1	1	0
AM-377	63	477	414	0	3	1	0	0
AM-377	63	100	37	1	3	1	1	0
AM-378	63	66	3	1	3	1	1	0
AM-378	63	477	414	0	4	3	0	1
AM-378	64	95	31	1	3	1	1	1
AM-378	64	477	413	0	3	2	0	0
AM-378	64	477	413	0	4	2	0	0
AM-378	64	142	78	1	3	4	1	0
AM-378	64	477	413	0	3	3	0	0
AM-378	64	477	413	0	3	4	0	0
AM-378	64	477	413	0	3	2	0	0
AM-378	64	142	78	1	3	4	1	0
AM-379	64	65	1	1	2	1	1	0
AM-379	65	100	35	1	3	1	1	0
AM-379	65	108	43	1	3	1	1	2
AM-379	65	68	3	1	4	1	1	0
AM-379	65	66	1	1	3	3	1	0
AM-379	65	70	5	1	3	4	1	0
AM-379	65	70	5	1	3	4	1	0
AM-379	65	477	412	0	4	3	0	0
AM-379	65	87	22	1	3	5	1	0
AM-379	65	66	1	1	3	1	1	0
AM-380	65	84	19	1	3	4	1	0
AM-380	65	66	1	1	4	1	1	0
AM-380	65	91	26	1	3	1	1	0
AM-380	65	77	12	1	3	1	1	0
AM-380	65	67	2	1	4	5	1	0
AM-380	66	477	411	0	5	1	0	0
AM-380	66	68	2	1	3	1	1	0
AM-380	66	477	411	0	3	1	0	0
AM-380	66	477	411	0	3	4	0	0
AM-380	66	217	151	1	3	1	1	0
AM-381	66	477	411	0	3	5	0	0
AM-381	66	477	411	0	3	1	0	0
AM-381	66	477	411	0	4	1	0	0
AM-381	66	133	67	1	4	4	1	0
AM-381	66	477	411	0	3	1	0	0
AM-381	66	78	12	1	1	1	1	0
AM-381	67	477	410	0	3	1	0	0
AM-381	67	78	11	1	3	1	1	0
AM-381	67	103	36	1	4	2	1	0
AM-381	67	86	19	1	3	4	1	0
AM-382	67	245	178	1	5	4	1	0
AM-382	67	477	410	0	3	4	0	1
AM-382	67	477	410	0	3	5	0	0
AM-382	67	373	306	1	4	1	1	1
AM-382	67	81	14	1	4	1	1	0
AM-382	68	477	409	0	4	1	0	0
AM-382	68	137	69	1	3	3	1	1
AM-382	68	140	72	1	3	3	1	2
AM-382	68	477	409	0	3	5	0	0
AM-382	69	70	1	1	3	1	1	0
AM-383	70	477	407	0	3	5	0	0
AM-383	70	392	322	1	4	5	1	0
AM-383	70	477	407	0	3	5	0	0
AM-383	70	176	106	1	3	5	1	0
AM-383	70	477	407	0	3	5	0	0
AM-383	70	477	407	0	3	5	0	0
AM-383	70	477	407	0	3	5	0	0
AM-383	70	477	407	0	3	5	0	0
AM-383	70	380	310	1	3	3	1	0
AM-383	70	380	310	1	3	5	1	0
AM-384	70	78	8	1	3	5	1	0
AM-384	70	73	3	1	3	1	1	0
AM-384	70	71	1	1	4	4	1	0
AM-384	70	71	1	1	4	4	1	0
AM-384	71	477	406	0	4	1	0	0
AM-384	71	477	406	0	4	3	0	0
AM-384	71	72	1	1	3	4	1	0
AM-384	72	84	12	1	3	1	1	0
AM-384	72	99	27	1	4	4	1	0
AM-384	72	477	405	0	4	4	0	0
AM-385	72	477	405	0	3	2	0	0
AM-385	72	119	47	1	3	4	1	0
AM-385	72	459	387	1	4	2	1	0
AM-385	72	193	121	1	3	1	1	0
AM-385	72	106	34	1	3	4	1	0
AM-385	72	91	19	1	3	4	1	0
AM-385	72	106	34	1	3	4	1	0
AM-385	73	477	404	0	3	2	0	0
AM-385	73	477	404	0	3	1	0	0
AM-385	73	477	404	0	3	1	0	0
AM-386	73	477	404	0	4	4	0	1
AM-386	73	477	404	0	3	3	0	0
AM-386	74	477	403	0	5	4	0	0
AM-386	74	477	403	0	3	1	0	1
AM-386	74	477	403	0	3	4	0	0
AM-386	74	477	403	0	3	1	0	0
AM-386	74	78	4	1	3	1	1	0
AM-386	74	477	403	0	3	2	0	0
AM-386	74	477	403	0	4	4	0	0
AM-386	74	75	1	1	2	1	1	0
AM-387	75	477	402	0	4	1	0	0
AM-387	75	477	402	0	4	1	0	0
AM-387	75	477	402	0	4	1	0	0
AM-387	76	79	3	1	3	1	1	0
AM-387	76	391	315	1	4	4	1	0
AM-387	77	93	16	1	4	4	1	0
AM-387	77	157	80	1	3	1	1	0
AM-387	77	179	102	1	3	1	1	0
AM-387	77	477	400	0	4	4	0	0
AM-387	77	477	400	0	3	4	0	0
AM-388	77	477	400	0	4	1	0	0
AM-388	77	82	5	1	3	1	1	0
AM-388	77	477	400	0	4	4	0	0
AM-388	77	178	101	1	3	5	1	2
AM-388	77	477	400	0	3	5	0	0
AM-388	77	477	400	0	3	5	0	0
AM-388	77	477	400	0	4	5	0	0
AM-388	77	477	400	0	3	5	0	0
AM-388	77	477	400	0	3	5	0	0
AM-388	78	80	2	1	3	1	1	1
AM-389	78	477	399	0	3	1	0	0
AM-389	78	80	2	1	3	1	1	0
AM-389	78	87	9	1	3	4	1	0
AM-389	78	79	1	1	4	1	1	0
AM-389	78	79	1	1	4	4	1	0
AM-389	78	81	3	1	3	1	1	0
AM-389	78	477	399	0	4	4	0	0
AM-389	78	477	399	0	4	1	0	0
AM-389	78	477	399	0	3	4	0	0
AM-389	79	477	398	0	4	4	0	0
AM-390	79	347	268	1	3	2	1	1
AM-390	79	134	55	1	3	5	1	0
AM-390	79	141	62	1	3	5	1	0
AM-390	79	80	1	1	4	5	1	0
AM-390	79	276	197	1	4	3	1	0
AM-390	79	160	81	1	3	4	1	1
AM-390	79	214	135	1	3	5	1	0
AM-390	79	182	103	1	3	4	1	0
AM-390	80	100	20	1	2	1	1	0
AM-390	80	119	39	1	3	4	1	0
AM-391	80	97	17	1	3	2	1	0
AM-391	80	477	397	0	3	1	0	0
AM-391	80	339	259	1	4	5	1	1
AM-391	80	91	11	1	3	4	1	0
AM-391	80	119	39	1	3	4	1	2
AM-391	80	477	397	0	4	1	0	0
AM-391	80	477	397	0	3	2	0	0
AM-391	80	213	133	1	4	1	1	0
AM-391	80	114	34	1	3	1	1	0
AM-391	81	344	263	1	2	1	1	0
AM-392	81	477	396	0	3	1	0	0
AM-392	81	477	396	0	4	2	0	0
AM-392	81	477	396	0	3	1	0	0
AM-392	81	477	396	0	3	2	0	0
AM-392	84	477	393	0	3	1	0	1
AM-392	84	477	393	0	3	4	0	1
AM-392	84	477	393	0	3	5	0	1
AM-392	84	112	28	1	3	5	1	0
AM-392	84	112	28	1	3	5	1	0
AM-392	84	477	393	0	3	5	0	0
AM-393	84	477	393	0	3	5	0	0
AM-393	84	85	1	1	5	4	1	0
AM-393	84	86	2	1	3	1	1	0
AM-393	84	108	24	1	3	1	1	0
AM-393	84	477	393	0	4	1	0	0
AM-393	84	477	393	0	4	1	0	0
AM-393	84	374	290	1	4	1	1	0
AM-393	84	477	393	0	3	3	0	0
AM-393	84	106	22	1	3	5	1	0
AM-393	84	106	22	1	3	5	1	2
AM-394	84	120	36	1	3	5	1	1
AM-394	84	106	22	1	3	5	1	0
AM-394	84	121	37	1	3	5	1	3
AM-394	84	121	37	1	3	5	1	1
AM-394	84	477	393	0	3	5	0	1
AM-394	85	477	392	0	4	1	0	0
AM-394	85	93	8	1	3	1	1	0
AM-394	85	477	392	0	4	4	0	0
AM-394	85	86	1	1	3	1	1	0
AM-394	85	347	262	1	3	5	1	0
AM-395	85	190	105	1	3	4	1	0
AM-395	85	86	1	1	3	5	1	0
AM-395	85	102	17	1	4	1	1	0
AM-395	85	477	392	0	3	4	0	0
AM-395	85	477	392	0	3	5	0	1
AM-395	85	477	392	0	3	1	0	0
AM-395	85	477	392	0	3	1	0	0
AM-395	86	477	391	0	3	5	0	0
AM-395	86	116	30	1	3	1	1	0
AM-395	86	477	391	0	4	1	0	0
AM-396	86	87	1	1	3	5	1	0
AM-396	86	477	391	0	3	5	0	0
AM-396	86	477	391	0	4	4	0	0
AM-396	86	91	5	1	1	1	1	1
AM-396	86	91	5	1	3	1	1	2
AM-396	86	95	9	1	3	1	1	0
AM-396	86	477	391	0	4	1	0	0
AM-396	87	136	49	1	3	5	1	1
AM-396	87	477	390	0	3	5	0	0
AM-396	87	477	390	0	3	1	0	0
AM-397	87	133	46	1	3	1	1	3
AM-397	87	477	390	0	3	1	0	1
AM-397	87	126	39	1	3	1	1	4
AM-397	87	136	49	1	1	1	1	0
AM-397	88	179	91	1	3	5	1	0
AM-397	88	92	4	1	3	1	1	0
AM-397	88	89	1	1	3	1	1	1
AM-397	88	477	389	0	4	4	0	0
AM-397	89	119	30	1	3	1	1	0
AM-397	91	155	64	1	3	1	1	0
AM-398	91	92	1	1	3	1	1	0
AM-398	91	130	39	1	3	5	1	1
AM-398	91	94	3	1	4	1	1	0
AM-398	91	168	77	1	3	2	1	1
AM-398	91	477	386	0	4	3	0	0
AM-398	91	106	15	1	4	3	1	0
AM-398	91	119	28	1	5	4	1	0
AM-398	91	92	1	1	3	5	1	0
AM-398	91	102	11	1	3	1	1	0
AM-398	92	100	8	1	3	5	1	0
AM-399	92	477	385	0	3	1	0	0
AM-399	92	109	17	1	1	4	1	0
AM-399	92	477	385	0	3	4	0	0
AM-399	92	93	1	1	3	5	1	0
AM-399	92	107	15	1	4	1	1	1
AM-399	92	136	44	1	3	5	1	1
AM-399	93	477	384	0	3	1	0	0
AM-399	93	116	23	1	3	5	1	0
AM-399	93	170	77	1	3	5	1	1
AM-399	93	175	82	1	3	5	1	0
AM-400	93	213	120	1	3	5	1	1
AM-400	93	141	48	1	3	5	1	1
AM-400	93	142	49	1	3	5	1	1
AM-400	93	190	97	1	3	5	1	1
AM-400	93	163	70	1	3	5	1	1
AM-400	93	163	70	1	3	5	1	1
AM-400	93	216	123	1	3	5	1	1
AM-400	93	184	91	1	3	5	1	0
AM-400	93	175	82	1	3	5	1	0
AM-400	93	163	70	1	3	5	1	1
AM-401	93	477	384	0	4	5	0	0
AM-401	93	106	13	1	3	1	1	0
AM-401	93	477	384	0	3	1	0	0
AM-401	93	100	7	1	3	1	1	0
AM-401	94	98	4	1	3	5	1	0
AM-401	94	100	6	1	1	1	1	0
AM-401	94	191	97	1	3	1	1	0
AM-401	94	477	383	0	4	4	0	0
AM-401	94	113	19	1	4	2	1	2
AM-401	94	107	13	1	4	4	1	1
AM-402	94	192	98	1	4	2	1	2
AM-402	94	95	1	1	3	5	1	1
AM-402	94	95	1	1	3	1	1	1
AM-402	94	186	92	1	3	1	1	0
AM-402	94	477	383	0	3	4	0	0
AM-402	94	477	383	0	3	1	0	0
AM-402	95	99	4	1	4	1	1	0
AM-402	95	109	14	1	3	1	1	0
AM-402	95	477	382	0	3	1	0	0
AM-402	95	477	382	0	3	4	0	0
AM-403	96	395	299	1	3	1	1	0
AM-403	96	196	100	1	4	4	1	0
AM-403	98	477	379	0	3	4	0	0
AM-403	98	477	379	0	4	5	0	0
AM-403	98	99	1	1	3	1	1	0
AM-403	98	100	2	1	3	1	1	0
AM-403	98	477	379	0	3	1	0	0
AM-403	98	477	379	0	3	4	0	0
AM-403	99	273	174	1	3	2	1	1
AM-403	99	477	378	0	3	4	0	0
AM-404	99	477	378	0	3	1	0	2
AM-404	99	477	378	0	3	1	0	0
AM-404	99	296	197	1	4	5	1	0
AM-404	99	477	378	0	4	5	0	1
AM-404	99	129	30	1	3	2	1	0
AM-404	99	477	378	0	3	1	0	2
AM-404	99	477	378	0	3	5	0	0
AM-404	100	477	377	0	5	4	0	0
AM-404	100	130	30	1	3	4	1	1
AM-404	100	112	12	1	3	4	1	2
AM-405	100	477	377	0	4	5	0	0
AM-405	100	101	1	1	3	1	1	0
AM-405	100	477	377	0	3	4	0	0
AM-405	100	113	13	1	3	2	1	1
AM-405	100	477	377	0	4	3	0	0
AM-405	100	386	286	1	3	4	1	0
AM-405	101	107	6	1	4	2	1	2
AM-405	101	477	376	0	3	5	0	1
AM-405	101	477	376	0	3	3	0	1
AM-405	101	143	42	1	3	5	1	0
AM-406	101	141	40	1	1	5	1	0
AM-406	101	191	90	1	3	1	1	0
AM-406	101	130	29	1	1	1	1	0
AM-406	102	477	375	0	4	2	0	2
AM-406	102	477	375	0	3	1	0	0
AM-406	102	477	375	0	3	4	0	0
AM-406	102	113	11	1	4	1	1	0
AM-406	102	212	110	1	4	2	1	4
AM-406	102	477	375	0	4	2	0	1
AM-406	102	107	5	1	4	1	1	1
AM-407	102	477	375	0	3	3	0	0
AM-407	102	115	13	1	4	2	1	2
AM-407	102	137	35	1	3	1	1	0
AM-407	102	151	49	1	3	1	1	4
AM-407	102	477	375	0	3	3	0	0
AM-407	102	107	5	1	3	5	1	0
AM-407	103	477	374	0	3	4	0	0
AM-407	103	149	46	1	3	5	1	0
AM-407	103	477	374	0	3	5	0	0
AM-407	103	477	374	0	3	5	0	0
AM-408	103	477	374	0	3	5	0	0
AM-408	104	477	373	0	3	5	0	0
AM-408	104	149	45	1	3	5	1	0
AM-408	104	477	373	0	3	5	0	0
AM-408	104	149	45	1	3	5	1	0
AM-408	104	477	373	0	3	5	0	0
AM-408	105	374	269	1	3	1	2	0
AM-408	105	477	372	0	3	5	0	1
AM-408	105	477	372	0	3	5	1	0
AM-408	105	136	31	1	3	2	1	0
AM-409	105	151	46	1	3	1	1	0
AM-409	105	477	372	0	3	1	0	0
AM-409	105	106	1	1	3	2	1	1
AM-409	105	477	372	0	3	2	0	1
AM-409	105	213	108	1	3	5	1	0
AM-409	105	477	372	0	4	4	0	0
AM-409	106	477	371	0	4	4	0	0
AM-409	106	382	276	1	3	3	1	1
AM-409	106	108	2	1	3	3	1	2
AM-409	106	162	56	1	3	3	1	0
AM-410	106	477	371	0	3	1	0	0
AM-410	106	120	14	1	4	1	1	0
AM-410	106	404	298	1	3	5	1	0
AM-410	106	477	371	0	3	5	0	0
AM-410	106	477	371	0	4	1	0	0
AM-410	106	107	1	1	3	4	1	0
AM-410	106	477	371	0	5	4	0	0
AM-410	106	477	371	0	2	5	0	0
AM-410	106	107	1	1	3	5	1	0
AM-410	106	477	371	0	4	1	0	1
AM-411	106	368	262	1	3	1	1	1
AM-411	106	477	371	0	3	3	0	0
AM-411	107	477	370	0	4	1	0	0
AM-411	107	477	370	0	3	4	0	0
AM-411	107	477	370	0	3	4	0	0
AM-411	107	477	370	0	3	4	0	0
AM-411	107	477	370	0	5	4	0	0
AM-411	107	247	140	1	4	3	1	3
AM-411	107	212	105	1	3	3	1	0
AM-411	107	121	14	1	4	5	1	1
AM-412	107	113	6	1	3	5	1	0
AM-412	107	108	1	1	3	1	1	0
AM-412	107	113	6	1	3	5	1	2
AM-412	107	477	370	0	3	2	0	0
AM-412	107	308	201	1	3	1	1	0
AM-412	107	122	15	1	3	2	1	0
AM-412	107	190	83	1	4	5	1	1
AM-412	107	135	28	1	3	2	1	2
AM-412	107	353	246	1	3	2	1	1
AM-412	107	477	370	0	4	5	0	0
AM-413	107	235	128	1	4	2	1	2
AM-413	107	120	13	1	4	2	1	1
AM-413	108	477	369	0	3	1	0	0
AM-413	108	477	369	0	3	4	0	0
AM-413	108	477	369	0	4	1	0	0
AM-413	108	151	43	1	3	2	1	0
AM-413	108	477	369	0	3	1	0	0
AM-413	108	255	147	1	4	4	1	0
AM-413	108	136	28	1	3	4	1	0
AM-413	108	477	369	0	3	5	0	0
AM-414	108	162	54	1	4	1	1	1
AM-414	108	137	29	1	3	1	1	0
AM-414	108	387	279	1	3	1	1	3
AM-414	108	368	260	1	3	1	1	2
AM-414	108	120	12	1	3	1	1	1
AM-414	108	171	63	1	4	2	1	2
AM-414	108	115	7	1	4	1	1	2
AM-414	108	212	104	1	3	2	1	1
AM-414	109	477	368	0	4	4	0	1
AM-414	109	169	60	1	4	1	1	2
AM-415	109	477	368	0	3	3	1	0
AM-415	109	477	368	0	4	1	0	0
AM-415	110	477	367	0	3	4	0	0
AM-415	112	115	3	1	3	1	1	0
AM-415	112	162	50	1	3	1	1	0
AM-415	112	477	365	0	3	4	0	0
AM-415	112	477	365	0	3	4	0	0
AM-415	112	137	25	1	3	5	1	0
AM-415	112	477	365	0	4	5	0	0
AM-415	112	477	365	0	3	5	0	0
AM-416	112	114	2	1	3	2	1	0
AM-416	112	477	365	0	3	1	0	0
AM-416	113	142	29	1	3	2	1	0
AM-416	113	477	364	0	3	1	0	0
AM-416	113	450	337	1	3	5	1	0
AM-416	113	114	1	1	3	1	1	0
AM-416	113	182	69	1	3	1	1	0
AM-416	113	148	35	1	3	2	1	0
AM-416	113	477	364	0	3	2	0	0
AM-416	113	114	1	1	3	1	1	0
AM-417	113	121	8	1	3	5	1	0
AM-417	114	477	363	0	3	1	0	0
AM-417	114	137	23	1	3	4	1	0
AM-417	114	168	54	1	3	2	1	0
AM-417	114	168	54	1	3	2	1	0
AM-417	114	119	5	1	3	1	1	0
AM-417	115	477	362	0	3	1	0	4
AM-417	115	120	5	1	5	4	1	0
AM-417	115	267	152	1	4	1	1	0
AM-417	116	477	361	0	4	4	0	0
AM-418	116	477	361	0	5	5	0	0
AM-418	116	477	361	0	3	4	0	0
AM-418	116	117	1	1	3	1	1	0
AM-418	116	477	361	0	3	2	0	0
AM-418	116	386	270	1	3	1	1	2
AM-418	116	135	19	1	3	4	1	1
AM-418	118	124	6	1	4	2	1	0
AM-418	119	477	358	0	3	4	0	0
AM-418	119	354	235	1	4	1	1	0
AM-418	119	133	14	1	3	4	1	0
AM-419	119	477	358	0	3	2	0	0
AM-419	119	477	358	0	3	1	0	1
AM-419	119	477	358	0	3	4	0	0
AM-419	119	477	358	0	3	2	0	0
AM-419	119	171	52	1	3	2	1	0
AM-419	119	477	358	0	3	2	0	0
AM-419	119	129	10	1	3	5	1	1
AM-419	119	477	358	0	3	4	0	0
AM-419	119	477	358	0	3	4	0	0
AM-419	119	142	23	1	3	4	1	0
AM-420	119	129	10	1	3	4	1	0
AM-420	119	134	15	1	3	4	1	0
AM-420	119	477	358	0	3	2	0	0
AM-420	119	477	358	0	3	2	0	0
AM-420	119	182	63	1	3	2	1	2
AM-420	119	192	73	1	3	2	1	0
AM-420	119	192	73	1	3	2	1	0
AM-420	119	477	358	0	3	2	0	0
AM-420	119	477	358	0	3	2	0	0
AM-420	119	477	358	0	3	2	0	0
AM-421	119	477	358	0	3	2	0	0
AM-421	119	477	358	0	3	2	0	0
AM-421	119	477	358	0	3	2	0	0
AM-421	120	477	357	0	3	1	0	1
AM-421	120	477	357	0	3	5	0	0
AM-421	120	477	357	0	3	4	0	0
AM-421	120	165	45	1	3	2	1	0
AM-421	120	121	1	1	3	2	1	0
AM-421	120	127	7	1	3	1	1	0
AM-421	120	477	357	0	3	1	0	0
AM-422	120	477	357	0	3	1	0	0
AM-422	120	477	357	0	3	1	0	0
AM-422	120	477	357	0	4	1	0	0
AM-422	120	167	47	1	4	1	1	1
AM-422	121	477	356	0	4	4	0	0
AM-422	121	191	70	1	3	4	1	0
AM-422	121	477	356	0	3	3	0	0
AM-422	121	477	356	0	4	1	0	0
AM-422	121	477	356	0	3	2	0	0
AM-422	121	126	5	1	1	1	1	3
AM-423	122	477	355	0	4	1	0	0
AM-423	122	171	49	1	4	1	1	2
AM-423	122	477	355	0	4	1	0	0
AM-423	122	126	4	1	3	1	1	0
AM-423	123	148	25	1	3	1	1	0
AM-423	123	477	354	0	4	4	0	0
AM-423	123	135	12	1	1	5	1	1
AM-423	123	477	354	0	4	2	0	0
AM-423	123	477	354	0	3	2	0	1
AM-423	123	477	354	0	3	2	0	1
AM-424	123	179	56	1	3	2	1	2
AM-424	123	477	354	0	3	2	0	1
AM-424	124	128	4	1	3	1	1	0
AM-424	125	477	352	0	3	1	0	0
AM-424	125	477	352	0	3	2	0	0
AM-424	126	477	351	0	4	4	0	0
AM-424	126	127	1	1	3	3	1	0
AM-424	126	477	351	0	3	2	1	0
AM-424	126	477	351	0	3	2	0	2
AM-424	126	150	24	1	3	1	1	0
AM-425	126	477	351	0	3	4	0	0
AM-425	126	129	3	1	3	1	1	0
AM-425	126	477	351	0	3	1	0	0
AM-425	126	152	26	1	4	1	1	1
AM-425	126	477	351	0	4	4	0	0
AM-425	127	477	350	0	3	1	1	0
AM-425	127	303	176	1	2	1	1	0
AM-425	127	205	78	1	4	4	1	0
AM-425	127	179	52	1	3	2	1	1
AM-425	127	179	52	1	3	2	1	2
AM-426	127	214	87	1	4	4	1	0
AM-426	128	477	349	0	4	1	0	0
AM-426	128	206	78	1	3	1	1	0
AM-426	128	477	349	0	4	1	0	0
AM-426	128	136	8	1	1	1	1	1
AM-426	128	434	306	1	3	2	1	0
AM-426	128	477	349	0	3	1	0	0
AM-426	128	176	48	1	3	4	1	1
AM-426	129	130	1	1	1	1	1	0
AM-426	129	130	1	1	3	2	1	2
AM-427	129	477	348	0	3	2	0	0
AM-427	129	477	348	0	3	1	0	2
AM-427	129	477	348	0	3	2	0	0
AM-427	129	154	25	1	3	1	1	0
AM-427	130	477	347	0	3	1	0	0
AM-427	130	477	347	0	3	1	0	0
AM-427	130	217	87	1	3	5	1	0
AM-427	130	157	27	1	4	4	1	0
AM-427	130	477	347	0	3	1	0	0
AM-427	130	133	3	1	3	1	1	0
AM-428	130	134	4	1	3	1	1	0
AM-428	130	165	35	1	3	1	1	0
AM-428	132	150	18	1	3	1	1	0
AM-428	133	168	35	1	3	5	1	0
AM-428	133	477	344	0	4	1	0	0
AM-428	133	262	129	1	3	1	1	3
AM-428	133	477	344	0	4	1	0	1
AM-428	134	477	343	0	3	1	0	2
AM-428	134	477	343	0	3	1	0	1
AM-428	134	477	343	0	3	4	0	1
AM-429	134	163	29	1	3	5	1	0
AM-429	134	165	31	1	3	5	1	0
AM-429	134	477	343	0	3	4	0	0
AM-429	134	477	343	0	3	4	0	0
AM-429	134	142	8	1	3	5	1	0
AM-429	134	477	343	0	4	1	0	0
AM-429	134	443	309	1	3	3	1	2
AM-429	135	148	13	1	3	3	1	1
AM-429	135	477	342	0	3	1	0	1
AM-429	135	163	28	1	3	5	1	0
AM-430	135	154	19	1	3	1	1	0
AM-430	135	477	342	0	3	1	0	0
AM-430	135	176	41	1	3	2	1	0
AM-430	135	151	16	1	4	4	1	1
AM-430	135	136	1	1	4	4	1	2
AM-430	135	136	1	1	4	4	1	1
AM-430	135	147	12	1	4	4	1	0
AM-430	135	144	9	1	4	4	1	0
AM-430	135	144	9	1	4	4	1	0
AM-430	135	165	30	1	4	4	1	2
AM-431	135	155	20	1	4	4	1	0
AM-431	135	158	23	1	4	4	1	0
AM-431	135	144	9	1	4	4	1	0
AM-431	135	163	28	1	4	4	1	0
AM-431	135	170	35	1	4	4	1	1
AM-431	135	154	19	1	4	4	1	0
AM-431	135	149	14	1	4	4	1	0
AM-431	135	145	10	1	4	4	1	0
AM-431	135	161	26	1	4	4	1	0
AM-431	135	149	14	1	4	4	1	0
AM-432	135	154	19	1	4	4	1	0
AM-432	135	148	13	1	4	4	1	0
AM-432	135	149	14	1	4	4	1	0
AM-432	135	150	15	1	4	4	1	0
AM-432	135	154	19	1	4	4	1	0
AM-432	135	171	36	1	4	4	1	1
AM-432	135	157	22	1	4	4	1	2
AM-432	135	170	35	1	4	4	1	0
AM-432	135	151	16	1	3	1	1	0
AM-432	136	477	341	0	4	5	0	0
AM-433	136	197	61	1	3	5	1	1
AM-433	136	162	26	1	3	1	1	0
AM-433	136	477	341	0	2	1	0	1
AM-433	136	176	40	1	4	2	1	0
AM-433	136	477	341	0	4	1	0	0
AM-433	136	137	1	1	4	4	1	0
AM-433	136	137	1	1	4	4	1	0
AM-433	136	137	1	1	4	4	1	0
AM-433	136	137	1	1	4	4	1	0
AM-433	136	137	1	1	4	4	1	0
AM-434	136	137	1	1	4	4	1	0
AM-434	136	143	7	1	4	4	1	0
AM-434	136	143	7	1	4	4	1	0
AM-434	136	141	5	1	4	4	1	0
AM-434	136	141	5	1	4	4	1	0
AM-434	136	137	1	1	4	4	1	0
AM-434	136	137	1	1	4	4	1	0
AM-434	136	142	6	1	4	4	1	0
AM-434	136	141	5	1	4	4	1	0
AM-434	136	141	5	1	4	4	1	2
AM-435	136	137	1	1	4	4	1	3
AM-435	136	141	5	1	4	4	1	1
AM-435	136	137	1	1	4	4	1	0
AM-435	136	137	1	1	4	4	1	0
AM-435	136	142	6	1	4	4	1	0
AM-435	136	137	1	1	4	4	1	0
AM-435	136	150	14	1	4	4	1	0
AM-435	136	144	8	1	1	1	1	0
AM-435	136	477	341	0	3	4	0	0
AM-435	137	276	139	1	3	1	1	0
AM-436	137	142	5	1	3	5	1	0
AM-436	137	144	7	1	5	3	1	0
AM-436	137	477	340	0	3	4	0	0
AM-436	139	477	338	0	4	1	0	0
AM-436	139	477	338	0	4	1	0	0
AM-436	140	477	337	0	3	1	0	0
AM-436	140	165	25	1	3	5	1	0
AM-436	140	477	337	0	3	1	0	0
AM-436	140	154	14	1	4	5	1	0
AM-436	140	477	337	0	4	1	0	0
AM-437	140	144	4	1	3	1	1	0
AM-437	140	361	221	1	3	1	1	0
AM-437	140	477	337	0	3	1	0	0
AM-437	140	477	337	0	3	1	0	0
AM-437	140	477	337	0	3	2	0	0
AM-437	140	143	3	1	1	1	1	0
AM-437	140	477	337	0	4	4	0	0
AM-437	140	477	337	0	3	4	0	0
AM-437	141	477	336	0	3	4	0	0
AM-437	141	477	336	0	3	4	0	1
AM-438	141	477	336	0	5	1	0	0
AM-438	141	477	336	0	3	2	0	0
AM-438	141	477	336	0	4	4	0	1
AM-438	141	477	336	0	4	4	0	1
AM-438	142	477	335	0	4	4	0	0
AM-438	142	162	20	1	3	2	1	1
AM-438	142	143	1	1	3	4	1	0
AM-438	142	477	335	0	3	4	0	0
AM-438	142	477	335	0	3	2	0	1
AM-438	142	150	8	1	3	2	1	0
AM-439	142	143	1	1	3	4	1	0
AM-439	142	477	335	0	4	2	0	0
AM-439	142	143	1	1	3	1	1	0
AM-439	142	143	1	1	3	4	1	0
AM-439	142	178	36	1	3	2	1	0
AM-439	142	477	335	0	4	4	0	0
AM-439	143	477	334	0	4	5	0	0
AM-439	143	477	334	0	4	4	0	0
AM-439	143	477	334	0	4	5	0	2
AM-439	143	168	25	1	4	5	1	1
AM-440	143	477	334	0	4	4	0	0
AM-440	143	144	1	1	3	1	1	0
AM-440	143	477	334	0	3	2	0	0
AM-440	143	477	334	0	3	2	0	0
AM-440	143	151	8	1	2	1	1	1
AM-440	143	477	334	0	3	4	0	0
AM-440	143	157	14	1	4	1	1	0
AM-440	143	477	334	0	4	4	0	1
AM-440	144	477	333	0	4	4	0	1
AM-440	144	477	333	0	3	1	0	0
AM-441	144	477	333	0	3	2	0	0
AM-441	144	145	1	1	4	4	1	0
AM-441	145	477	332	0	3	5	0	0
AM-441	147	477	330	0	3	5	0	0
AM-441	147	361	214	1	3	1	1	0
AM-441	147	162	15	1	3	2	1	0
AM-441	147	477	330	0	3	5	0	0
AM-441	147	260	113	1	2	4	1	0
AM-441	148	198	50	1	3	5	1	0
AM-441	148	165	17	1	3	5	1	0
AM-442	148	477	329	0	4	5	0	0
AM-442	148	151	3	1	3	1	1	0
AM-442	148	477	329	0	3	3	0	1
AM-442	148	477	329	0	4	4	0	1
AM-442	148	477	329	0	4	4	0	0
AM-442	148	477	329	0	3	1	0	0
AM-442	148	149	1	1	3	1	1	0
AM-442	149	477	328	0	3	5	0	0
AM-442	149	172	23	1	3	5	1	0
AM-442	149	172	23	1	3	5	1	0
AM-443	149	197	48	1	2	5	1	0
AM-443	149	296	147	1	4	2	1	0
AM-443	149	254	105	1	4	4	1	0
AM-443	150	477	327	0	4	4	0	0
AM-443	150	477	327	0	3	5	0	1
AM-443	150	477	327	0	3	5	0	1
AM-443	150	477	327	0	3	5	0	1
AM-443	150	477	327	0	3	1	0	0
AM-443	150	477	327	0	3	4	0	0
AM-443	150	477	327	0	3	5	0	0
AM-444	150	477	327	0	3	1	0	0
AM-444	151	477	326	0	4	4	0	0
AM-444	151	477	326	0	3	4	0	0
AM-444	151	162	11	1	3	5	1	0
AM-444	151	344	193	1	3	2	1	2
AM-444	151	176	25	1	4	5	1	2
AM-444	151	152	1	1	4	4	1	0
AM-444	151	247	96	1	3	1	1	0
AM-444	151	157	6	1	3	1	1	0
AM-444	152	168	16	1	3	4	1	0
AM-445	153	477	324	0	3	5	0	0
AM-445	153	183	30	1	3	5	1	0
AM-445	153	212	59	1	3	5	1	0
AM-445	153	212	59	1	3	5	1	0
AM-445	153	409	256	1	3	5	1	1
AM-445	153	477	324	0	3	5	0	0
AM-445	153	477	324	0	3	5	0	0
AM-445	153	477	324	0	3	5	0	0
AM-445	153	477	324	0	3	5	0	0
AM-445	153	477	324	0	3	5	0	0
AM-446	153	477	324	0	3	5	0	0
AM-446	153	477	324	0	3	5	0	0
AM-446	153	154	1	1	3	2	1	0
AM-446	154	477	323	0	4	4	0	0
AM-446	154	477	323	0	3	2	0	0
AM-446	154	345	191	1	3	2	1	1
AM-446	154	477	323	0	4	4	0	0
AM-446	154	477	323	0	4	4	0	0
AM-446	154	477	323	0	4	4	0	0
AM-446	154	199	45	1	4	4	1	0
AM-447	154	477	323	0	3	1	0	0
AM-447	154	233	79	1	3	2	1	0
AM-447	154	387	233	1	3	1	1	0
AM-447	155	165	10	1	3	1	1	1
AM-447	155	161	6	1	3	1	1	0
AM-447	155	193	38	1	4	3	1	0
AM-447	155	477	322	0	3	3	0	4
AM-447	155	157	2	1	3	5	1	0
AM-447	155	168	13	1	3	5	1	0
AM-447	155	477	322	0	4	4	1	0
AM-448	155	157	2	1	4	4	1	0
AM-448	155	190	35	1	3	1	1	0
AM-448	155	477	322	0	3	4	0	0
AM-448	155	172	17	1	3	1	1	0
AM-448	155	190	35	1	3	1	1	1
AM-448	155	156	1	1	4	4	1	0
AM-448	155	477	322	0	3	1	0	0
AM-448	155	477	322	0	3	4	0	0
AM-448	155	477	322	0	3	4	0	0
AM-448	155	477	322	0	3	4	0	0
AM-449	155	477	322	0	3	4	0	0
AM-449	155	477	322	0	4	1	0	0
AM-449	155	288	133	1	3	3	1	2
AM-449	155	289	134	1	3	4	1	1
AM-449	155	171	16	1	3	5	1	0
AM-449	155	242	87	1	3	5	1	0
AM-449	155	269	114	1	3	5	1	0
AM-449	155	477	322	0	3	2	0	0
AM-449	155	276	121	1	3	5	1	0
AM-449	155	277	122	1	3	5	1	0
AM-450	155	172	17	1	3	5	1	0
AM-450	155	277	122	1	3	5	1	1
AM-450	155	277	122	1	3	5	1	0
AM-450	155	288	133	1	3	5	1	0
AM-450	155	289	134	1	3	5	1	0
AM-450	155	289	134	1	3	5	1	1
AM-450	155	477	322	0	3	1	0	0
AM-450	156	157	1	1	3	4	1	0
AM-450	156	477	321	0	4	4	0	0
AM-450	156	477	321	0	3	5	0	1
AM-451	156	477	321	0	3	4	0	0
AM-451	156	247	91	1	3	5	1	2
AM-451	156	196	40	1	3	5	1	0
AM-451	156	477	321	0	3	1	0	0
AM-451	157	477	320	0	3	4	0	0
AM-451	157	477	320	0	3	4	0	0
AM-451	157	477	320	0	3	4	0	0
AM-451	157	158	1	1	4	4	1	0
AM-451	157	477	320	0	2	1	0	1
AM-451	157	477	320	0	4	1	0	0
AM-452	158	395	237	1	3	1	1	1
AM-452	158	477	319	0	4	1	0	0
AM-452	158	401	243	1	3	4	1	1
AM-452	158	171	13	1	3	1	1	1
AM-452	158	324	166	1	3	3	1	0
AM-452	159	477	318	0	4	1	0	0
AM-452	159	161	2	1	1	1	1	0
AM-452	159	428	269	1	2	1	1	0
AM-452	159	163	4	1	2	1	1	1
AM-452	161	172	11	1	3	5	1	0
AM-453	161	172	11	1	3	5	1	0
AM-453	161	477	316	0	3	4	0	0
AM-453	161	477	316	0	4	2	0	0
AM-453	161	168	7	1	3	1	1	0
AM-453	162	169	7	1	3	4	1	0
AM-453	162	164	2	1	3	1	1	0
AM-453	162	164	2	1	1	1	1	0
AM-453	162	163	1	1	3	5	1	0
AM-453	162	477	315	0	3	5	0	0
AM-453	162	294	132	1	3	1	1	0
AM-454	162	163	1	1	3	1	1	0
AM-454	162	477	315	0	5	3	0	0
AM-454	162	266	104	1	4	4	1	0
AM-454	162	477	315	0	4	4	0	2
AM-454	162	477	315	0	3	5	0	1
AM-454	162	276	114	1	3	1	1	0
AM-454	162	477	315	0	3	2	0	0
AM-454	162	183	21	1	3	5	1	1
AM-454	162	477	315	0	3	1	0	0
AM-454	162	165	3	1	1	1	1	0
AM-455	163	477	314	0	3	2	0	0
AM-455	163	164	1	1	4	4	2	0
AM-455	163	477	314	0	4	4	0	0
AM-455	163	288	125	1	3	5	1	0
AM-455	163	164	1	1	3	4	1	0
AM-455	163	164	1	1	3	1	1	1
AM-455	163	177	14	1	4	4	1	1
AM-455	163	477	314	0	3	1	0	0
AM-455	163	164	1	1	1	1	1	0
AM-455	163	295	132	1	3	4	1	0
AM-456	164	172	8	1	3	5	1	0
AM-456	164	477	313	0	3	5	0	0
AM-456	164	197	33	1	3	4	1	0
AM-456	164	477	313	0	4	1	0	1
AM-456	164	477	313	0	3	4	0	0
AM-456	164	477	313	0	3	3	0	0
AM-456	165	477	312	0	3	2	0	0
AM-456	165	450	285	1	3	1	1	1
AM-456	165	178	13	1	3	5	1	0
AM-456	165	373	208	1	3	4	1	0
AM-457	166	170	4	1	3	1	1	0
AM-457	168	224	56	1	4	4	1	0
AM-457	168	477	309	0	4	4	0	0
AM-457	168	462	294	1	3	4	1	1
AM-457	168	477	309	0	3	1	0	0
AM-457	168	178	10	1	3	2	1	0
AM-457	168	169	1	1	3	1	1	0
AM-457	168	191	23	1	3	4	1	0
AM-457	168	477	309	0	3	3	0	0
AM-457	168	191	23	1	3	5	1	0
AM-458	168	477	309	0	3	4	0	0
AM-458	168	477	309	0	3	1	0	0
AM-458	168	477	309	0	3	1	0	0
AM-458	169	191	22	1	3	5	1	0
AM-458	169	171	2	1	3	4	1	0
AM-458	169	232	63	1	3	5	1	0
AM-458	169	477	308	0	4	4	0	0
AM-458	169	179	10	1	4	3	1	0
AM-458	169	477	308	0	3	3	0	0
AM-458	169	477	308	0	3	4	0	0
AM-459	169	190	21	1	3	4	1	0
AM-459	169	170	1	1	3	1	1	0
AM-459	169	171	2	1	3	1	1	0
AM-459	170	477	307	0	4	1	0	0
AM-459	170	410	240	1	3	2	1	4
AM-459	170	177	7	1	3	1	1	0
AM-459	170	477	307	0	4	4	0	0
AM-459	170	373	203	1	3	1	1	1
AM-459	170	218	48	1	3	5	1	1
AM-459	170	191	21	1	3	5	1	0
AM-460	170	175	5	1	3	5	1	0
AM-460	170	182	12	1	3	2	1	2
AM-460	170	177	7	1	3	5	1	1
AM-460	170	477	307	0	3	1	0	0
AM-460	170	172	2	1	3	4	1	0
AM-460	170	477	307	0	3	3	0	0
AM-460	170	247	77	1	3	4	1	0
AM-460	171	477	306	0	3	5	0	0
AM-460	171	477	306	0	4	4	0	0
AM-460	171	172	1	1	3	5	1	0
AM-461	171	455	284	1	4	4	1	0
AM-461	171	172	1	1	3	1	1	0
AM-461	171	477	306	0	3	1	0	0
AM-461	171	477	306	0	3	5	0	0
AM-461	171	177	6	1	3	1	1	0
AM-461	171	477	306	0	3	2	0	1
AM-461	171	176	5	1	3	1	1	0
AM-461	172	173	1	1	3	4	1	0
AM-461	172	173	1	1	1	1	1	0
AM-461	172	175	3	1	3	1	1	0
AM-462	172	388	216	1	4	1	1	0
AM-462	172	477	305	0	3	1	0	0
AM-462	172	197	25	1	3	1	1	0
AM-462	172	477	305	0	3	1	0	0
AM-462	172	175	3	1	3	5	1	0
AM-462	172	477	305	0	3	5	0	0
AM-462	172	182	10	1	3	2	1	0
AM-462	172	179	7	1	3	1	1	0
AM-462	172	477	305	0	3	5	0	0
AM-462	173	206	33	1	3	4	1	0
AM-463	173	174	1	1	3	1	1	0
AM-463	173	175	2	1	3	1	1	0
AM-463	173	221	48	1	3	1	1	0
AM-463	175	477	302	0	3	1	0	0
AM-463	175	477	302	0	4	4	0	0
AM-463	175	178	3	1	4	1	1	0
AM-463	175	220	45	1	4	4	1	0
AM-463	175	206	31	1	2	5	1	1
AM-463	175	380	205	1	3	5	1	0
AM-463	175	179	4	1	3	5	1	0
AM-464	175	179	4	1	3	2	1	0
AM-464	175	179	4	1	3	2	1	0
AM-464	176	183	7	1	3	4	1	0
AM-464	176	400	224	1	4	4	1	0
AM-464	176	187	11	1	4	1	1	0
AM-464	176	477	301	0	4	1	0	0
AM-464	176	178	2	1	3	4	1	1
AM-464	176	190	14	1	3	4	1	0
AM-464	176	477	301	0	3	4	0	0
AM-464	177	193	16	1	3	1	1	0
AM-465	177	477	300	0	3	2	0	0
AM-465	177	178	1	1	3	2	1	0
AM-465	177	180	3	1	2	2	1	0
AM-465	177	199	22	1	3	5	1	0
AM-465	177	187	10	1	3	5	1	0
AM-465	177	477	300	0	3	5	0	1
AM-465	177	477	300	0	3	5	0	1
AM-465	177	220	43	1	3	5	1	0
AM-465	177	178	1	1	3	5	1	1
AM-466	177	477	300	0	3	5	0	1
AM-466	177	178	1	1	3	5	1	2
AM-466	177	477	300	0	3	4	0	0
AM-466	177	477	300	0	3	5	0	0
AM-466	177	183	6	1	3	1	1	0
AM-466	177	477	300	0	4	1	0	0
AM-466	178	179	1	1	3	1	1	0
AM-466	178	477	299	0	4	1	0	0
AM-466	178	477	299	0	4	4	0	0
AM-466	178	477	299	0	4	4	0	0
AM-467	178	477	299	0	4	4	0	0
AM-467	178	186	8	1	3	5	1	0
AM-467	178	477	299	0	3	1	0	0
AM-467	178	477	299	0	3	5	0	0
AM-467	178	179	1	1	3	5	1	1
AM-467	178	179	1	1	3	4	1	0
AM-467	178	477	299	0	3	2	0	0
AM-467	178	179	1	1	3	2	1	0
AM-467	178	477	299	0	3	5	0	0
AM-467	178	477	299	0	3	5	0	0
AM-468	178	477	299	0	3	5	0	0
AM-468	178	322	144	1	3	5	1	0
AM-468	178	477	299	0	3	5	0	0
AM-468	178	233	55	1	3	5	1	0
AM-468	178	477	299	0	3	2	0	1
AM-468	178	477	299	0	3	4	0	0
AM-468	178	213	35	1	3	1	1	0
AM-468	179	214	35	1	3	2	1	0
AM-468	179	477	298	0	3	2	0	0
AM-468	179	180	1	1	1	2	1	0
AM-469	179	191	12	1	3	5	1	0
AM-469	179	347	168	1	4	3	1	0
AM-469	179	373	194	1	3	1	1	0
AM-469	179	180	1	1	3	1	1	0
AM-469	179	226	47	1	3	1	1	0
AM-469	180	477	297	0	3	2	0	0
AM-469	180	247	67	1	3	4	1	1
AM-469	180	183	3	1	3	1	1	0
AM-469	180	477	297	0	3	2	0	0
AM-469	180	220	40	1	3	1	1	1
AM-470	181	197	16	1	3	1	1	0
AM-470	181	183	2	1	3	2	1	0
AM-470	181	477	296	0	3	2	0	0
AM-470	181	477	296	0	3	2	0	0
AM-470	182	477	295	0	3	1	0	0
AM-470	182	232	50	1	3	5	1	0
AM-470	182	184	2	1	3	1	1	0
AM-470	182	192	10	1	3	4	1	0
AM-470	182	183	1	1	1	1	1	0
AM-470	182	477	295	0	3	1	0	0
AM-471	182	477	295	0	3	5	0	1
AM-471	182	260	78	1	4	3	1	0
AM-471	182	183	1	1	3	1	1	0
AM-471	182	186	4	1	3	2	1	0
AM-471	182	183	1	1	3	2	1	0
AM-471	182	477	295	0	3	4	0	1
AM-471	182	183	1	1	3	5	1	0
AM-471	182	477	295	0	3	4	0	1
AM-471	182	193	11	1	3	1	1	0
AM-471	182	477	295	0	3	2	0	0
AM-472	182	477	295	0	3	2	0	0
AM-472	182	477	295	0	3	2	0	0
AM-472	182	183	1	1	3	4	1	0
AM-472	183	235	52	1	3	1	1	0
AM-472	183	190	7	1	3	1	1	0
AM-472	183	477	294	0	3	4	0	0
AM-472	183	387	204	1	3	5	1	0
AM-472	183	217	34	1	3	5	1	0
AM-472	183	213	30	1	3	5	1	0
AM-472	183	477	294	0	3	3	0	0
AM-473	184	217	33	1	3	5	1	0
AM-473	184	227	43	1	3	1	1	0
AM-473	184	477	293	0	2	1	0	0
AM-473	184	192	8	1	3	1	1	0
AM-473	185	477	292	0	3	1	0	0
AM-473	186	477	291	0	4	4	0	1
AM-473	186	477	291	0	3	1	0	0
AM-473	186	477	291	0	3	1	0	0
AM-473	186	187	1	1	3	1	1	0
AM-473	186	187	1	1	3	1	1	0
AM-474	186	213	27	1	3	1	1	0
AM-474	187	322	135	1	3	4	1	1
AM-474	189	190	1	1	4	4	1	0
AM-474	189	190	1	1	3	1	1	0
AM-474	189	192	3	1	1	1	1	0
AM-474	189	191	2	1	2	1	1	0
AM-474	189	477	288	0	3	2	0	0
AM-474	189	477	288	0	4	4	0	0
AM-474	189	210	21	1	3	1	1	1
AM-474	190	289	99	1	3	4	1	0
AM-475	190	477	287	0	2	1	0	0
AM-475	190	213	23	1	3	5	1	0
AM-475	190	191	1	1	3	1	1	0
AM-475	190	477	287	0	4	1	0	1
AM-475	190	477	287	0	3	4	0	1
AM-475	190	224	34	1	4	1	1	0
AM-475	190	191	1	1	3	1	1	0
AM-475	191	219	28	1	3	5	1	0
AM-475	191	477	286	0	4	5	0	0
AM-475	191	192	1	1	3	1	1	0
AM-476	191	477	286	0	3	5	0	0
AM-476	191	218	27	1	3	5	1	1
AM-476	191	477	286	0	3	5	0	1
AM-476	191	477	286	0	3	5	0	0
AM-476	191	192	1	1	1	1	1	0
AM-476	191	346	155	1	3	5	1	0
AM-476	191	477	286	0	3	1	0	0
AM-476	191	477	286	0	3	1	0	0
AM-476	191	192	1	1	1	1	1	0
AM-476	192	200	8	1	4	1	1	0
AM-477	192	477	285	0	3	1	0	0
AM-477	192	197	5	1	4	1	1	0
AM-477	192	231	39	1	3	1	1	0
AM-477	192	193	1	1	3	1	1	0
AM-477	192	218	26	1	3	2	1	0
AM-477	192	477	285	0	3	1	0	1
AM-477	192	477	285	0	3	1	0	3
AM-477	192	477	285	0	3	1	0	2
AM-477	192	477	285	0	3	1	0	1
AM-477	192	477	285	0	3	1	0	0
AM-478	192	477	285	0	3	1	0	0
AM-478	192	477	285	0	3	3	0	0
AM-478	192	477	285	0	3	3	0	0
AM-478	193	403	210	1	3	4	1	0
AM-478	193	477	284	0	3	1	0	0
AM-478	193	477	284	0	3	4	0	0
AM-478	193	477	284	0	3	1	0	0
AM-478	193	194	1	1	3	1	1	0
AM-478	193	257	64	1	3	5	1	0
AM-478	194	477	283	0	4	4	0	0
AM-479	194	477	283	0	3	4	0	1
AM-479	194	198	4	1	3	3	1	1
AM-479	194	220	26	1	3	2	1	0
AM-479	194	477	283	0	3	5	0	0
AM-479	194	211	17	1	3	5	1	0
AM-479	196	200	4	1	4	1	1	0
AM-479	196	298	102	1	3	1	1	0
AM-479	196	477	281	0	3	2	0	0
AM-479	196	221	25	1	3	1	1	0
AM-479	196	197	1	1	3	1	1	0
AM-480	196	198	2	1	4	1	1	0
AM-480	197	198	1	1	3	1	1	0
AM-480	197	206	9	1	3	1	2	0
AM-480	197	477	280	0	3	1	0	0
AM-480	197	214	17	1	3	1	1	0
AM-480	197	477	280	0	3	1	0	0
AM-480	197	204	7	1	3	4	1	0
AM-480	197	220	23	1	3	2	1	0
AM-480	197	218	21	1	3	4	1	0
AM-480	197	232	35	1	3	1	1	0
AM-481	198	199	1	1	3	1	1	2
AM-481	198	477	279	0	3	1	0	0
AM-481	198	477	279	0	3	1	0	1
AM-481	198	213	15	1	3	4	1	0
AM-481	198	199	1	1	3	4	1	0
AM-481	198	477	279	0	3	4	0	0
AM-481	198	199	1	1	3	1	1	0
AM-481	198	199	1	1	1	1	1	0
AM-481	198	206	8	1	4	1	1	0
AM-481	198	477	279	0	3	4	0	3
AM-482	198	204	6	1	3	1	1	0
AM-482	198	477	279	0	3	4	0	0
AM-482	198	477	279	0	3	2	0	0
AM-482	199	234	35	1	4	2	1	0
AM-482	199	477	278	0	4	4	0	0
AM-482	199	477	278	0	3	1	0	0
AM-482	199	275	76	1	3	1	1	0
AM-482	199	203	4	1	3	4	1	0
AM-482	199	233	34	1	3	2	1	0
AM-482	199	477	278	0	3	4	0	0
AM-483	199	477	278	0	3	1	0	0
AM-483	199	477	278	0	3	1	0	1
AM-483	199	204	5	1	3	1	1	0
AM-483	199	477	278	0	4	4	0	0
AM-483	200	477	277	0	3	1	0	0
AM-483	200	219	19	1	4	4	1	1
AM-483	200	361	161	1	3	1	1	0
AM-483	200	276	76	1	3	1	1	0
AM-483	200	213	13	1	3	4	1	0
AM-483	200	231	31	1	4	1	1	0
AM-484	200	201	1	1	3	5	1	0
AM-484	200	206	6	1	3	5	1	0
AM-484	202	212	10	1	3	1	1	1
AM-484	202	260	58	1	4	1	1	0
AM-484	203	217	14	1	3	5	1	0
AM-484	203	283	80	1	3	1	1	0
AM-484	203	221	18	1	3	1	1	1
AM-484	203	477	274	0	3	1	0	0
AM-484	203	204	1	1	3	1	1	0
AM-484	203	221	18	1	3	4	1	0
AM-485	203	477	274	0	3	4	0	2
AM-485	204	233	29	1	3	5	1	0
AM-485	204	387	183	1	3	4	1	0
AM-485	204	206	2	1	3	1	1	0
AM-485	204	205	1	1	3	1	1	0
AM-485	204	477	273	0	3	3	0	0
AM-485	204	205	1	1	3	1	1	0
AM-485	204	206	2	1	3	5	1	0
AM-485	204	282	78	1	4	1	1	0
AM-485	204	206	2	1	3	5	1	0
AM-486	205	206	1	1	3	1	1	0
AM-486	205	261	56	1	3	1	1	0
AM-486	205	402	197	1	4	1	1	0
AM-486	205	477	272	0	3	4	0	0
AM-486	205	477	272	0	5	1	0	0
AM-486	205	206	1	1	5	4	1	0
AM-486	205	206	1	1	3	1	1	0
AM-486	205	206	1	1	3	4	1	1
AM-486	205	477	272	0	3	1	1	0
AM-486	205	274	69	1	3	5	1	0
AM-487	205	274	69	1	3	5	1	0
AM-487	205	477	272	0	3	1	0	0
AM-487	205	267	62	1	3	5	1	0
AM-487	205	477	272	0	3	1	0	0
AM-487	205	274	69	1	3	5	1	0
AM-487	205	274	69	1	3	1	1	0
AM-487	205	274	69	1	3	5	1	0
AM-487	205	274	69	1	3	1	1	0
AM-487	205	274	69	1	3	5	1	0
AM-487	205	274	69	1	3	5	1	0
AM-488	205	274	69	1	3	5	1	0
AM-488	205	274	69	1	3	5	1	0
AM-488	205	274	69	1	3	5	1	0
AM-488	205	477	272	0	3	1	0	0
AM-488	205	274	69	1	3	5	1	0
AM-488	205	477	272	0	3	1	0	0
AM-488	205	274	69	1	3	5	1	0
AM-488	205	217	12	1	3	1	1	0
AM-488	205	217	12	1	3	5	1	0
AM-488	205	217	12	1	3	5	1	0
AM-489	205	459	254	1	3	1	1	0
AM-489	205	274	69	1	3	5	1	0
AM-489	205	274	69	1	3	1	1	0
AM-489	205	274	69	1	3	5	1	0
AM-489	205	274	69	1	3	5	1	0
AM-489	205	477	272	0	3	1	0	0
AM-489	205	274	69	1	3	5	1	0
AM-489	205	477	272	0	3	1	0	0
AM-489	205	274	69	1	3	5	1	0
AM-489	205	477	272	0	3	1	0	0
AM-490	205	274	69	1	3	5	1	0
AM-490	205	477	272	0	3	1	0	0
AM-490	205	274	69	1	3	5	1	0
AM-490	205	477	272	0	3	1	0	0
AM-490	205	392	187	1	3	5	1	0
AM-490	205	274	69	1	3	5	1	0
AM-490	205	477	272	0	3	1	0	0
AM-490	205	214	9	1	3	5	1	0
AM-490	205	214	9	1	3	5	1	0
AM-490	205	214	9	1	3	5	1	0
AM-491	205	477	272	0	3	1	0	0
AM-491	205	252	47	1	3	5	1	0
AM-491	205	274	69	1	3	5	1	1
AM-491	205	477	272	0	3	1	0	0
AM-491	205	252	47	1	3	5	1	0
AM-491	205	477	272	0	3	1	1	0
AM-491	205	274	69	1	3	5	1	0
AM-491	205	477	272	0	3	1	0	0
AM-491	205	274	69	1	3	5	1	0
AM-491	205	477	272	0	3	1	0	0
AM-492	205	252	47	1	3	5	1	0
AM-492	205	477	272	0	3	1	0	0
AM-492	205	227	22	1	3	5	1	0
AM-492	205	477	272	0	3	1	0	0
AM-492	205	274	69	1	3	5	1	0
AM-492	205	477	272	0	3	1	0	0
AM-492	205	274	69	1	3	5	1	0
AM-492	205	477	272	0	3	1	0	0
AM-492	205	228	23	1	3	5	1	0
AM-492	205	274	69	1	3	5	1	0
AM-493	205	477	272	0	3	1	1	0
AM-493	205	274	69	1	3	5	1	0
AM-493	205	477	272	0	3	1	1	0
AM-493	205	274	69	1	3	5	1	0
AM-493	205	477	272	0	3	1	1	0
AM-493	205	213	8	1	3	5	1	0
AM-493	205	477	272	0	3	1	0	0
AM-493	205	234	29	1	3	5	1	0
AM-493	205	477	272	0	3	1	1	0
AM-493	205	274	69	1	3	5	1	0
AM-494	205	274	69	1	3	5	1	0
AM-494	205	274	69	1	3	5	1	0
AM-494	205	274	69	1	3	5	1	0
AM-494	205	274	69	1	3	5	1	0
AM-494	205	274	69	1	3	5	1	0
AM-494	205	274	69	1	3	5	1	0
AM-494	205	477	272	0	3	1	0	0
AM-494	205	274	69	1	3	5	1	0
AM-494	205	477	272	0	3	1	0	0
AM-494	205	274	69	1	3	5	1	0
AM-495	205	477	272	0	3	1	0	0
AM-495	205	274	69	1	3	5	1	0
AM-495	205	274	69	1	3	5	1	0
AM-495	205	274	69	1	3	5	1	0
AM-495	205	274	69	1	3	5	1	0
AM-495	205	274	69	1	3	5	1	0
AM-495	205	274	69	1	3	5	1	0
AM-495	205	477	272	0	3	1	0	0
AM-495	205	274	69	1	3	5	1	0
AM-495	205	274	69	1	3	5	1	0
AM-496	205	274	69	1	3	5	1	0
AM-496	205	477	272	0	3	1	0	0
AM-496	205	274	69	1	3	5	1	0
AM-496	205	274	69	1	3	1	1	0
AM-496	205	214	9	1	3	5	1	0
AM-496	205	214	9	1	3	5	1	0
AM-496	205	214	9	1	3	5	1	0
AM-496	205	214	9	1	3	5	1	0
AM-496	205	477	272	0	3	1	0	0
AM-496	205	274	69	1	3	5	1	0
AM-497	205	477	272	0	3	1	0	0
AM-497	205	217	12	1	3	5	1	0
AM-497	205	477	272	0	3	1	0	0
AM-497	205	274	69	1	3	5	1	0
AM-497	205	477	272	0	3	1	0	0
AM-497	205	274	69	1	3	5	1	0
AM-497	205	477	272	0	3	1	0	0
AM-497	205	274	69	1	3	5	1	0
AM-497	205	477	272	0	3	1	0	0
AM-497	205	274	69	1	3	5	1	0
AM-498	205	477	272	0	3	1	0	0
AM-498	205	274	69	1	3	5	1	0
AM-498	205	238	33	1	3	5	1	0
AM-498	205	477	272	0	3	1	0	0
AM-498	205	274	69	1	3	5	1	0
AM-498	205	274	69	1	3	5	1	0
AM-498	205	274	69	1	3	1	1	0
AM-498	205	274	69	1	3	5	1	0
AM-498	205	274	69	1	3	5	1	0
AM-498	205	274	69	1	3	5	1	0
AM-499	205	274	69	1	3	1	1	0
AM-499	205	274	69	1	3	5	1	0
AM-499	205	477	272	0	3	1	0	0
AM-499	205	274	69	1	3	5	1	0
AM-499	205	274	69	1	3	5	1	0
AM-499	205	274	69	1	3	5	1	0
AM-499	205	477	272	0	3	1	0	0
AM-499	205	274	69	1	3	5	1	0
AM-499	205	477	272	0	3	1	0	0
AM-499	205	274	69	1	3	5	1	0
AM-500	205	477	272	0	3	1	0	0
AM-500	205	274	69	1	3	5	1	0
AM-500	205	477	272	0	3	1	0	0
AM-500	205	273	68	1	3	5	1	0
AM-500	205	273	68	1	3	5	1	0
AM-500	205	477	272	0	3	1	0	0
AM-500	205	274	69	1	3	5	1	0
AM-500	205	274	69	1	3	5	1	0
AM-500	205	274	69	1	3	5	1	0
AM-500	205	477	272	0	3	1	0	0
AM-501	205	274	69	1	3	5	1	0
AM-501	205	477	272	0	3	1	1	0
AM-501	205	210	5	1	3	5	1	0
AM-501	205	477	272	0	3	1	0	0
AM-501	205	274	69	1	3	5	1	0
AM-501	205	252	47	1	3	5	1	0
AM-501	205	477	272	0	3	1	0	0
AM-501	205	252	47	1	3	5	1	0
AM-501	205	274	69	1	3	1	1	0
AM-501	205	217	12	1	3	5	1	0
AM-502	205	477	272	0	3	1	0	0
AM-502	205	274	69	1	3	5	1	0
AM-502	205	275	70	1	3	4	1	0
AM-502	205	211	6	1	3	4	1	0
AM-502	205	477	272	0	3	4	0	0
AM-502	206	477	271	0	3	1	0	0
AM-502	206	304	98	1	4	1	1	2
AM-502	206	240	34	1	3	5	1	0
AM-502	206	304	98	1	3	1	1	0
AM-502	206	477	271	0	4	4	0	0
AM-503	206	217	11	1	3	5	1	0
AM-503	206	207	1	1	3	1	1	0
AM-503	206	207	1	1	3	5	1	0
AM-503	206	226	20	1	3	3	1	0
AM-503	206	477	271	0	3	1	0	0
AM-503	206	238	32	1	2	4	1	3
AM-503	207	302	95	1	3	4	1	0
AM-503	207	347	140	1	3	1	1	0
AM-503	207	477	270	0	3	1	0	0
AM-503	207	211	4	1	3	1	1	0
AM-504	207	477	270	0	3	1	0	0
AM-504	210	219	9	1	3	1	1	0
AM-504	210	477	267	0	3	4	0	0
AM-504	210	477	267	0	2	5	0	0
AM-504	210	249	39	1	2	4	1	0
AM-504	210	402	192	1	4	1	1	0
AM-504	210	477	267	0	3	3	0	3
AM-504	210	211	1	1	5	4	1	0
AM-504	210	477	267	0	5	4	0	0
AM-504	211	477	266	0	3	1	0	0
AM-505	211	214	3	1	3	1	1	1
AM-505	211	477	266	0	3	2	0	0
AM-505	211	477	266	0	3	1	0	0
AM-505	211	225	14	1	4	1	1	0
AM-505	211	462	251	1	3	4	1	0
AM-505	212	213	1	1	3	3	1	0
AM-505	212	214	2	1	3	1	1	1
AM-505	212	289	77	1	3	1	1	0
AM-505	213	347	134	1	3	3	1	0
AM-505	213	477	264	0	3	4	0	0
AM-506	213	234	21	1	2	1	1	0
AM-506	213	477	264	0	3	5	0	1
AM-506	213	282	69	1	4	4	1	0
AM-506	213	224	11	1	3	1	1	0
AM-506	213	375	162	1	3	5	1	4
AM-506	213	214	1	1	3	5	1	1
AM-506	213	218	5	1	2	1	1	0
AM-506	214	462	248	1	3	1	1	0
AM-506	214	217	3	1	3	5	1	0
AM-506	214	477	263	0	3	1	0	0
AM-507	214	477	263	0	2	1	0	0
AM-507	214	225	11	1	3	1	1	0
AM-507	214	217	3	1	3	1	1	1
AM-507	214	462	248	1	3	5	1	0
AM-507	215	218	3	1	3	4	1	1
AM-507	216	477	261	0	3	2	0	0
AM-507	217	477	260	0	5	4	0	0
AM-507	217	233	16	1	3	5	1	1
AM-507	217	218	1	1	3	5	1	1
AM-507	217	274	57	1	3	1	1	1
AM-508	217	219	2	1	3	1	1	0
AM-508	217	219	2	1	3	1	1	0
AM-508	217	226	9	1	3	1	1	0
AM-508	217	274	57	1	3	5	1	0
AM-508	217	221	4	1	3	5	1	0
AM-508	217	274	57	1	3	5	1	0
AM-508	217	477	260	0	3	1	0	0
AM-508	217	274	57	1	3	5	1	0
AM-508	217	274	57	1	3	5	1	0
AM-508	217	400	183	1	3	5	1	0
AM-509	217	477	260	0	3	4	0	0
AM-509	217	402	185	1	3	5	1	1
AM-509	217	477	260	0	2	2	0	0
AM-509	217	477	260	0	3	2	0	2
AM-509	217	218	1	1	5	4	1	0
AM-509	217	477	260	0	4	5	0	0
AM-509	217	224	7	1	3	1	1	0
AM-509	217	477	260	0	5	4	0	0
AM-509	218	408	190	1	2	1	1	0
AM-509	218	233	15	1	3	5	1	0
AM-510	218	220	2	1	3	5	1	0
AM-510	218	227	9	1	3	5	1	0
AM-510	218	462	244	1	3	5	1	0
AM-510	218	221	3	1	3	5	1	0
AM-510	218	477	259	0	3	1	0	0
AM-510	219	337	118	1	3	4	1	0
AM-510	219	221	2	1	3	5	1	0
AM-510	219	248	29	1	3	4	1	0
AM-510	219	477	258	0	3	3	0	0
AM-510	219	225	6	1	3	1	1	0
AM-511	219	262	43	1	3	1	1	2
AM-511	219	477	258	0	3	5	0	2
AM-511	219	458	239	1	3	5	1	0
AM-511	219	220	1	1	3	5	1	0
AM-511	219	477	258	0	3	2	0	0
AM-511	220	441	221	1	3	4	1	0
AM-511	220	238	18	1	3	1	1	2
AM-511	220	462	242	1	3	5	1	0
AM-511	220	477	257	0	3	4	0	0
AM-511	220	477	257	0	3	3	0	0
AM-512	220	477	257	0	3	3	0	1
AM-512	220	239	19	1	3	5	1	0
AM-512	220	477	257	0	3	1	0	1
AM-512	221	233	12	1	3	5	1	0
AM-512	221	281	60	1	3	5	1	0
AM-512	221	281	60	1	3	1	1	0
AM-512	221	477	256	0	4	1	0	1
AM-512	221	477	256	0	3	1	0	0
AM-512	221	477	256	0	3	5	0	0
AM-512	221	477	256	0	3	5	0	1
AM-513	221	477	256	0	3	5	0	0
AM-513	221	477	256	0	3	5	0	0
AM-513	223	477	254	0	3	1	0	0
AM-513	224	274	50	1	3	1	1	0
AM-513	224	274	50	1	3	5	1	0
AM-513	224	274	50	1	3	5	1	0
AM-513	224	274	50	1	3	5	1	0
AM-513	224	274	50	1	3	5	1	0
AM-513	224	274	50	1	3	5	1	0
AM-513	224	249	25	1	3	1	1	0
AM-514	224	227	3	1	3	4	1	0
AM-514	224	227	3	1	3	4	1	0
AM-514	224	225	1	1	3	4	1	0
AM-514	224	239	15	1	3	1	1	0
AM-514	224	266	42	1	3	1	1	0
AM-514	224	226	2	1	5	1	1	0
AM-514	225	409	184	1	3	1	1	0
AM-514	225	226	1	1	4	4	1	0
AM-514	225	477	252	0	3	2	1	0
AM-514	225	457	232	1	3	5	1	0
AM-515	225	477	252	0	3	1	0	0
AM-515	225	266	41	1	3	4	1	0
AM-515	226	274	48	1	3	1	1	0
AM-515	226	274	48	1	3	5	1	0
AM-515	226	267	41	1	3	1	1	0
AM-515	226	228	2	1	3	1	1	0
AM-515	226	477	251	0	3	1	2	0
AM-515	226	477	251	0	3	5	0	0
AM-515	226	477	251	0	3	4	0	0
AM-515	226	477	251	0	3	5	0	0
AM-516	227	233	6	1	3	5	1	0
AM-516	228	229	1	1	3	5	1	0
AM-516	228	477	249	0	3	3	0	0
AM-516	228	477	249	0	4	1	0	0
AM-516	228	477	249	0	4	1	0	0
AM-516	228	477	249	0	4	1	0	0
AM-516	229	477	248	0	3	2	0	1
AM-516	229	477	248	0	3	2	0	2
AM-516	229	231	2	1	3	4	1	0
AM-516	230	231	1	1	3	4	1	0
AM-517	230	477	247	0	3	1	0	0
AM-517	231	477	246	0	3	1	0	0
AM-517	231	323	92	1	3	1	1	0
AM-517	231	477	246	0	3	1	0	0
AM-517	231	465	234	1	4	1	1	0
AM-517	231	281	50	1	3	5	1	1
AM-517	231	297	66	1	3	5	1	0
AM-517	231	477	246	0	3	5	0	0
AM-517	231	477	246	0	3	5	0	0
AM-517	231	262	31	1	3	5	1	0
AM-518	231	235	4	1	1	1	1	0
AM-518	231	274	43	1	3	1	1	0
AM-518	231	274	43	1	3	5	1	0
AM-518	231	274	43	1	3	5	1	0
AM-518	231	235	4	1	3	1	1	1
AM-518	231	275	44	1	3	1	1	1
AM-518	231	254	23	1	3	1	1	0
AM-518	232	275	43	1	4	2	1	3
AM-518	232	477	245	0	3	1	0	0
AM-518	232	477	245	0	3	5	0	2
AM-519	233	275	42	1	3	1	1	0
AM-519	233	477	244	0	4	4	0	0
AM-519	233	477	244	0	3	4	0	0
AM-519	233	234	1	1	3	1	1	0
AM-519	233	275	42	1	3	1	1	0
AM-519	233	240	7	1	3	5	1	0
AM-519	233	234	1	1	4	4	1	1
AM-519	233	331	98	1	2	4	1	1
AM-519	233	477	244	0	4	3	0	0
AM-519	233	477	244	0	4	4	0	0
AM-520	233	477	244	0	3	1	0	0
AM-520	233	477	244	0	3	1	0	0
AM-520	234	282	48	1	3	4	1	0
AM-520	234	434	200	1	3	4	1	0
AM-520	234	477	243	0	3	4	0	0
AM-520	234	262	28	1	3	5	1	0
AM-520	234	477	243	0	4	1	0	0
AM-520	234	238	4	1	3	2	1	1
AM-520	234	235	1	1	3	4	1	0
AM-520	234	268	34	1	4	4	1	0
AM-521	234	242	8	1	3	1	1	0
AM-521	234	235	1	1	3	1	1	0
AM-521	235	477	242	0	3	4	0	0
AM-521	235	477	242	0	3	1	0	0
AM-521	235	477	242	0	3	1	0	0
AM-521	235	416	181	1	3	1	1	2
AM-521	235	477	242	0	3	1	0	0
AM-521	236	477	241	0	3	4	0	1
AM-521	237	406	169	1	5	4	1	0
AM-521	237	260	23	1	4	4	1	0
AM-522	238	262	24	1	3	5	1	0
AM-522	238	457	219	1	3	1	1	0
AM-522	238	477	239	0	4	1	0	0
AM-522	238	274	36	1	3	1	1	0
AM-522	238	274	36	1	3	5	1	0
AM-522	238	252	14	1	3	5	1	0
AM-522	238	274	36	1	3	5	1	0
AM-522	238	252	14	1	3	5	1	0
AM-522	238	252	14	1	3	5	1	0
AM-522	238	274	36	1	3	5	1	0
AM-523	238	274	36	1	3	5	1	0
AM-523	238	274	36	1	3	5	1	0
AM-523	238	274	36	1	3	5	1	0
AM-523	238	274	36	1	3	5	1	0
AM-523	238	274	36	1	3	5	1	0
AM-523	238	274	36	1	3	5	1	0
AM-523	238	274	36	1	3	5	1	0
AM-523	238	252	14	1	3	5	1	0
AM-523	238	252	14	1	3	5	1	0
AM-523	238	253	15	1	3	2	1	0
AM-524	238	295	57	1	3	5	1	0
AM-524	238	477	239	0	3	1	0	0
AM-524	238	477	239	0	3	1	0	0
AM-524	238	368	130	1	3	1	1	0
AM-524	238	477	239	0	3	1	0	1
AM-524	239	262	23	1	3	5	1	0
AM-524	239	256	17	1	3	1	1	0
AM-524	239	245	6	1	4	4	1	0
AM-524	239	262	23	1	3	5	1	0
AM-524	239	319	80	1	3	1	1	0
AM-525	239	247	8	1	3	4	1	2
AM-525	239	477	238	0	3	4	0	0
AM-525	239	240	1	1	2	5	1	0
AM-525	239	247	8	1	2	1	1	0
AM-525	240	477	237	0	3	4	0	0
AM-525	240	268	28	1	3	1	1	1
AM-525	240	241	1	1	4	4	1	0
AM-525	240	477	237	0	4	4	0	0
AM-525	240	259	19	1	3	5	1	1
AM-525	240	477	237	0	3	5	0	0
AM-526	240	242	2	1	3	5	1	3
AM-526	240	242	2	1	3	1	1	0
AM-526	240	260	20	1	4	1	1	0
AM-526	241	262	21	1	3	5	1	0
AM-526	241	477	236	0	3	4	0	1
AM-526	241	477	236	0	3	1	0	0
AM-526	241	477	236	0	3	1	0	0
AM-526	241	345	104	1	3	4	1	1
AM-526	241	242	1	1	3	1	1	0
AM-526	241	246	5	1	3	1	1	0
AM-527	241	252	11	1	3	5	1	0
AM-527	241	477	236	0	3	4	0	0
AM-527	241	402	161	1	4	4	1	0
AM-527	241	477	236	0	3	1	0	1
AM-527	241	246	5	1	3	4	1	0
AM-527	241	477	236	0	3	1	0	0
AM-527	242	262	20	1	3	5	1	0
AM-527	242	246	4	1	3	1	1	1
AM-527	242	477	235	0	2	1	0	0
AM-527	242	249	7	1	3	1	1	0
AM-528	242	368	126	1	3	1	1	0
AM-528	242	281	39	1	3	1	1	1
AM-528	242	243	1	1	3	5	1	1
AM-528	243	255	12	1	3	5	1	2
AM-528	243	323	80	1	3	5	1	3
AM-528	243	246	3	1	3	1	1	1
AM-528	243	477	234	0	3	1	1	1
AM-528	245	477	232	0	3	5	0	0
AM-528	245	275	30	1	3	2	1	2
AM-528	245	477	232	0	3	5	0	0
AM-529	245	274	29	1	3	5	1	0
AM-529	245	274	29	1	3	5	1	0
AM-529	245	274	29	1	3	5	1	0
AM-529	245	255	10	1	3	1	1	0
AM-529	246	281	35	1	3	1	1	0
AM-529	246	477	231	0	3	4	0	0
AM-529	246	249	3	1	3	1	1	0
AM-529	246	477	231	0	4	1	0	0
AM-529	246	477	231	0	3	1	0	0
AM-529	246	312	66	1	4	4	1	2
AM-530	246	477	231	0	3	3	0	0
AM-530	246	249	3	1	3	1	1	0
AM-530	246	477	231	0	3	4	0	0
AM-530	246	477	231	0	3	5	0	1
AM-530	246	333	87	1	3	5	1	2
AM-530	247	477	230	0	2	1	0	0
AM-530	247	249	2	1	3	5	1	0
AM-530	247	295	48	1	3	4	1	1
AM-530	247	248	1	1	3	3	1	0
AM-530	247	339	92	1	4	5	1	2
AM-531	247	441	194	1	4	4	1	0
AM-531	247	477	230	0	5	4	0	2
AM-531	247	477	230	0	4	2	0	0
AM-531	247	395	148	1	3	5	1	0
AM-531	247	258	11	1	3	5	1	0
AM-531	247	477	230	0	3	5	0	4
AM-531	247	258	11	1	3	5	1	0
AM-531	247	259	12	1	3	5	1	0
AM-531	247	258	11	1	3	5	1	0
AM-531	247	385	138	1	3	5	1	0
AM-532	247	352	105	1	3	5	1	0
AM-532	247	345	98	1	3	5	1	0
AM-532	247	411	164	1	3	5	1	0
AM-532	247	256	9	1	3	5	1	0
AM-532	247	373	126	1	3	5	1	0
AM-532	247	477	230	0	4	2	0	0
AM-532	247	302	55	1	3	4	1	0
AM-532	247	248	1	1	3	5	1	0
AM-532	247	477	230	0	3	1	0	0
AM-532	247	477	230	0	3	5	0	0
AM-533	248	477	229	0	3	4	0	0
AM-533	248	249	1	1	3	3	1	0
AM-533	248	249	1	1	3	1	1	0
AM-533	248	249	1	1	3	1	1	0
AM-533	248	263	15	1	3	1	1	0
AM-533	248	477	229	0	3	1	0	0
AM-533	248	477	229	0	5	5	0	0
AM-533	249	258	9	1	2	1	1	1
AM-533	249	477	228	0	4	4	0	0
AM-533	249	273	24	1	3	1	1	0
AM-534	249	366	117	1	3	1	1	1
AM-534	249	254	5	1	3	1	1	0
AM-534	250	273	23	1	3	4	1	0
AM-534	252	262	10	1	3	5	1	0
AM-534	252	274	22	1	3	5	1	0
AM-534	252	274	22	1	3	5	1	0
AM-534	252	274	22	1	3	5	1	0
AM-534	252	274	22	1	3	5	1	0
AM-534	252	274	22	1	3	5	1	0
AM-534	252	274	22	1	3	5	1	0
AM-535	252	477	225	0	3	1	0	0
AM-535	252	259	7	1	3	1	1	0
AM-535	253	477	224	0	3	1	0	0
AM-535	253	477	224	0	4	1	0	0
AM-535	253	477	224	0	3	1	0	0
AM-535	253	309	56	1	4	5	1	1
AM-535	253	309	56	1	4	5	1	0
AM-535	253	477	224	0	3	1	0	0
AM-535	253	477	224	0	4	2	0	1
AM-535	253	441	188	1	4	2	1	2
AM-536	253	477	224	0	4	2	0	1
AM-536	253	477	224	0	4	2	0	1
AM-536	253	477	224	0	4	2	0	1
AM-536	253	477	224	0	4	2	0	1
AM-536	253	477	224	0	4	1	0	0
AM-536	253	257	4	1	3	1	1	0
AM-536	253	290	37	1	4	4	1	0
AM-536	253	281	28	1	3	1	1	0
AM-536	253	277	24	1	3	5	1	0
AM-536	253	277	24	1	3	5	1	1
AM-537	254	477	223	0	4	4	0	0
AM-537	254	281	27	1	3	5	1	0
AM-537	254	256	2	1	5	4	1	1
AM-537	254	262	8	1	3	5	1	0
AM-537	254	373	119	1	3	1	1	0
AM-537	254	408	154	1	3	1	1	0
AM-537	254	282	28	1	3	4	1	0
AM-537	254	477	223	0	3	1	0	0
AM-537	255	477	222	0	3	1	0	0
AM-537	255	477	222	0	3	4	0	0
AM-538	255	262	7	1	3	1	1	0
AM-538	255	462	207	1	3	4	1	0
AM-538	255	261	6	1	3	4	1	0
AM-538	255	257	2	1	3	1	1	0
AM-538	255	296	41	1	3	1	1	0
AM-538	256	259	3	1	3	1	1	0
AM-538	256	363	107	1	3	1	1	1
AM-538	256	477	221	0	3	1	0	0
AM-538	256	257	1	1	3	1	1	0
AM-538	256	257	1	1	3	1	1	0
AM-539	256	477	221	0	3	1	0	0
AM-539	256	477	221	0	3	5	0	0
AM-539	259	408	149	1	3	1	1	1
AM-539	259	477	218	0	4	4	0	1
AM-539	259	477	218	0	3	1	0	0
AM-539	259	260	1	1	3	1	1	0
AM-539	259	385	126	1	3	4	2	2
AM-539	259	477	218	0	3	4	0	0
AM-539	259	274	15	1	3	1	1	0
AM-539	259	477	218	0	3	5	0	0
AM-540	259	267	8	1	3	5	1	0
AM-540	259	274	15	1	3	5	1	0
AM-540	259	274	15	1	3	5	1	0
AM-540	259	260	1	1	4	4	1	1
AM-540	259	263	4	1	3	1	1	0
AM-540	259	260	1	1	4	4	1	0
AM-540	259	260	1	1	3	1	1	0
AM-540	259	288	29	1	3	1	1	0
AM-540	259	263	4	1	3	1	1	0
AM-540	259	260	1	1	3	1	2	0
AM-541	259	339	80	1	3	4	1	0
AM-541	259	477	218	0	3	4	0	0
AM-541	259	263	4	1	3	1	1	0
AM-541	259	269	10	1	4	4	1	0
AM-541	259	477	218	0	3	4	0	0
AM-541	259	477	218	0	3	1	0	0
AM-541	259	477	218	0	3	4	0	0
AM-541	260	477	217	0	3	1	0	0
AM-541	260	261	1	1	3	4	1	1
AM-541	260	345	85	1	3	2	1	4
AM-542	260	477	217	0	4	1	0	0
AM-542	260	477	217	0	3	1	0	0
AM-542	260	477	217	0	3	4	0	0
AM-542	260	274	14	1	3	1	1	0
AM-542	260	261	1	1	3	5	1	0
AM-542	260	477	217	0	3	4	0	0
AM-542	260	477	217	0	3	4	0	0
AM-542	261	281	20	1	4	4	1	0
AM-542	261	477	216	0	3	4	0	0
AM-542	261	477	216	0	3	4	0	0
AM-543	261	323	62	1	3	1	1	0
AM-543	262	477	215	0	3	2	0	0
AM-543	262	263	1	1	3	1	1	0
AM-543	262	462	200	1	3	3	1	0
AM-543	262	374	112	1	3	1	1	0
AM-543	262	263	1	1	3	5	1	0
AM-543	262	477	215	0	5	4	1	0
AM-543	262	281	19	1	3	5	1	0
AM-543	262	477	215	0	4	5	0	0
AM-543	262	296	34	1	3	1	1	0
AM-544	262	477	215	0	3	2	0	2
AM-544	262	274	12	1	3	2	1	1
AM-544	262	393	131	1	3	1	1	3
AM-544	262	271	9	1	3	4	1	1
AM-544	262	263	1	1	3	1	1	0
AM-544	262	298	36	1	3	4	1	0
AM-544	262	388	126	1	4	4	1	1
AM-544	262	333	71	1	3	5	1	1
AM-544	262	347	85	1	3	5	0	1
AM-544	262	477	215	0	3	5	0	2
AM-545	262	333	71	1	4	5	1	3
AM-545	262	263	1	1	4	5	1	1
AM-545	262	477	215	0	4	5	0	0
AM-545	262	477	215	0	4	5	0	0
AM-545	262	477	215	0	4	4	0	0
AM-545	263	267	4	1	4	4	1	1
AM-545	263	322	59	1	1	4	1	0
AM-545	263	280	17	1	3	1	1	1
AM-545	263	265	2	1	2	5	1	0
AM-545	263	477	214	0	4	5	0	0
AM-546	263	270	7	1	3	4	1	0
AM-546	263	264	1	1	4	4	1	0
AM-546	263	338	75	1	4	1	1	0
AM-546	263	477	214	0	3	1	0	0
AM-546	263	477	214	0	3	1	0	2
AM-546	263	477	214	0	3	1	0	0
AM-546	264	477	213	0	3	1	0	0
AM-546	264	363	99	1	2	4	1	2
AM-546	266	477	211	0	3	4	0	2
AM-546	266	274	8	1	3	1	1	0
AM-547	266	274	8	1	3	5	1	0
AM-547	266	274	8	1	3	5	1	0
AM-547	266	274	8	1	3	5	1	0
AM-547	266	274	8	1	3	5	1	0
AM-547	266	274	8	1	3	5	1	0
AM-547	266	274	8	1	3	5	1	0
AM-547	266	274	8	1	3	5	1	0
AM-547	266	274	8	1	3	5	1	0
AM-547	266	274	8	1	3	5	1	0
AM-547	266	274	8	1	3	5	1	0
AM-548	266	274	8	1	3	5	1	0
AM-548	266	274	8	1	3	5	1	0
AM-548	266	274	8	1	3	5	1	0
AM-548	266	274	8	1	3	5	1	0
AM-548	266	274	8	1	3	5	1	0
AM-548	266	477	211	0	4	1	0	0
AM-548	266	267	1	1	3	1	1	0
AM-548	266	273	7	1	3	1	1	1
AM-548	266	477	211	0	3	1	0	0
AM-548	266	267	1	1	3	1	1	0
AM-549	266	477	211	0	3	1	0	0
AM-549	266	458	192	1	3	1	1	0
AM-549	267	477	210	0	3	2	0	0
AM-549	267	274	7	1	3	1	1	0
AM-549	267	268	1	1	3	5	0	0
AM-549	267	477	210	0	3	1	0	1
AM-549	267	297	30	1	3	1	1	0
AM-549	267	477	210	0	3	4	0	0
AM-549	267	477	210	0	3	1	0	0
AM-549	267	301	34	1	3	5	1	0
AM-550	267	275	8	1	3	1	1	0
AM-550	267	477	210	0	5	1	0	0
AM-550	267	477	210	0	3	1	0	0
AM-550	267	477	210	0	4	1	0	0
AM-550	267	477	210	0	3	2	0	0
AM-550	267	477	210	0	3	5	0	0
AM-550	267	269	2	1	3	5	1	0
AM-550	267	269	2	1	3	1	1	0
AM-550	268	477	209	0	4	3	0	0
AM-550	268	271	3	1	3	1	1	0
AM-551	268	477	209	0	3	1	0	0
AM-551	268	477	209	0	5	4	0	0
AM-551	268	477	209	0	3	4	0	0
AM-551	268	280	12	1	3	1	1	0
AM-551	268	344	76	1	3	1	1	1
AM-551	268	274	6	1	3	1	1	1
AM-551	268	274	6	1	3	1	1	0
AM-551	269	477	208	0	3	4	0	0
AM-551	269	270	1	1	3	1	1	0
AM-551	269	477	208	0	3	1	1	0
AM-552	270	274	4	1	3	4	1	0
AM-552	270	477	207	0	3	4	0	1
AM-552	270	281	11	1	3	1	1	0
AM-552	270	477	207	0	4	4	0	0
AM-552	270	477	207	0	4	1	0	0
AM-552	271	477	206	0	3	4	0	1
AM-552	272	477	205	0	1	4	0	0
AM-552	272	273	1	1	3	1	1	1
AM-552	272	277	5	1	2	1	1	2
AM-552	273	344	71	1	3	1	1	0
AM-553	273	477	204	0	3	4	1	0
AM-553	273	274	1	1	3	4	1	0
AM-553	273	277	4	1	4	4	1	0
AM-553	273	274	1	1	3	1	1	0
AM-553	273	281	8	1	3	1	1	0
AM-553	273	373	100	1	3	4	1	0
AM-553	273	368	95	1	3	1	1	0
AM-553	273	296	23	1	3	1	1	2
AM-553	273	477	204	0	3	1	0	0
AM-553	273	354	81	1	3	1	1	0
AM-554	273	477	204	0	3	1	0	0
AM-554	273	477	204	0	3	5	0	0
AM-554	273	284	11	1	3	5	1	0
AM-554	273	477	204	0	3	5	0	0
AM-554	273	284	11	1	3	5	1	0
AM-554	273	284	11	1	3	5	1	0
AM-554	273	284	11	1	3	5	1	0
AM-554	273	284	11	1	3	5	1	0
AM-554	273	284	11	1	3	5	1	0
AM-554	273	274	1	1	3	5	1	0
AM-555	273	284	11	1	3	5	1	0
AM-555	273	477	204	0	3	5	0	0
AM-555	273	284	11	1	3	5	1	0
AM-555	273	274	1	1	3	5	1	0
AM-555	273	284	11	1	3	5	1	0
AM-555	273	274	1	1	3	5	1	0
AM-555	273	284	11	1	3	5	1	0
AM-555	273	284	11	1	3	5	1	0
AM-555	273	477	204	0	3	5	0	0
AM-555	273	284	11	1	3	5	1	0
AM-556	273	477	204	0	3	5	0	0
AM-556	273	477	204	0	3	5	0	0
AM-556	273	477	204	0	3	5	0	0
AM-556	273	477	204	0	3	5	0	0
AM-556	273	477	204	0	3	5	0	0
AM-556	273	284	11	1	3	5	1	0
AM-556	273	477	204	0	3	5	0	0
AM-556	273	477	204	0	3	5	0	0
AM-556	273	477	204	0	3	5	0	0
AM-556	273	477	204	0	3	5	0	0
AM-557	273	477	204	0	3	5	0	0
AM-557	273	284	11	1	3	5	1	0
AM-557	273	274	1	1	3	5	1	0
AM-557	273	477	204	0	3	5	0	0
AM-557	273	477	204	0	3	5	0	0
AM-557	273	477	204	0	3	5	0	0
AM-557	273	448	175	1	3	5	1	0
AM-557	273	477	204	0	3	5	0	0
AM-557	273	284	11	1	3	5	1	0
AM-557	273	284	11	1	3	5	1	0
AM-558	273	284	11	1	3	5	1	0
AM-558	273	284	11	1	3	5	1	0
AM-558	273	477	204	0	3	5	0	0
AM-558	273	284	11	1	3	5	1	0
AM-558	273	284	11	1	3	5	1	0
AM-558	273	477	204	0	3	1	0	0
AM-558	273	284	11	1	3	5	1	0
AM-558	273	284	11	1	3	5	1	0
AM-558	273	284	11	1	3	5	1	0
AM-558	273	477	204	0	3	5	0	0
AM-559	273	477	204	0	3	5	0	0
AM-559	273	477	204	0	3	5	0	0
AM-559	273	477	204	0	3	5	0	0
AM-559	273	276	3	1	3	5	1	0
AM-559	273	284	11	1	3	5	1	0
AM-559	273	477	204	0	3	5	0	0
AM-559	273	274	1	1	3	2	1	0
AM-559	273	477	204	0	3	4	0	0
AM-559	273	274	1	1	3	1	1	1
AM-559	273	477	204	0	3	2	0	1
AM-560	273	477	204	0	3	2	0	1
AM-560	273	477	204	0	3	2	0	1
AM-560	273	477	204	0	3	2	0	1
AM-560	273	274	1	1	3	1	1	0
AM-560	273	477	204	0	3	2	0	1
AM-560	273	477	204	0	3	2	0	4
AM-560	274	477	203	0	3	4	0	0
AM-560	274	477	203	0	4	5	0	1
AM-560	274	276	2	1	3	1	1	0
AM-560	274	288	14	1	3	1	1	0
AM-561	274	275	1	1	3	4	1	0
AM-561	274	477	203	0	3	1	0	0
AM-561	274	413	139	1	3	5	1	0
AM-561	274	477	203	0	3	4	0	0
AM-561	275	477	202	0	3	1	0	0
AM-561	275	400	125	1	3	5	1	0
AM-561	275	373	98	1	3	5	1	0
AM-561	275	395	120	1	3	5	1	0
AM-561	275	297	22	1	3	5	1	0
AM-561	275	276	1	1	5	1	1	0
AM-562	275	281	6	1	3	5	1	0
AM-562	275	322	47	1	3	5	1	1
AM-562	275	400	125	1	3	5	2	0
AM-562	275	352	77	1	3	5	1	1
AM-562	275	284	9	1	3	5	1	1
AM-562	275	276	1	1	3	1	1	0
AM-562	275	280	5	1	3	5	1	1
AM-562	275	477	202	0	4	5	1	1
AM-562	275	477	202	0	4	5	0	1
AM-562	275	373	98	1	3	5	1	0
AM-563	275	368	93	1	3	1	1	0
AM-563	275	409	134	1	3	1	1	0
AM-563	275	477	202	0	2	1	0	0
AM-563	275	283	8	1	3	1	1	0
AM-563	275	280	5	1	3	3	1	0
AM-563	275	477	202	0	3	2	0	0
AM-563	275	287	12	1	3	5	1	0
AM-563	275	296	21	1	3	5	1	1
AM-563	275	477	202	0	4	4	0	0
AM-563	275	477	202	0	4	4	0	0
AM-564	276	477	201	0	3	1	0	0
AM-564	276	277	1	1	3	4	1	0
AM-564	276	477	201	0	2	1	0	0
AM-564	276	277	1	1	3	1	1	0
AM-564	276	477	201	0	3	2	0	0
AM-564	276	477	201	0	3	1	0	0
AM-564	276	297	21	1	3	1	1	0
AM-564	276	277	1	1	3	5	1	1
AM-564	276	277	1	1	3	5	1	2
AM-564	276	442	166	1	4	4	1	1
AM-565	276	477	201	0	3	1	0	0
AM-565	276	277	1	1	3	1	1	0
AM-565	276	277	1	1	3	1	1	0
AM-565	276	281	5	1	1	5	1	0
AM-565	276	477	201	0	3	2	0	0
AM-565	276	277	1	1	3	1	1	1
AM-565	276	277	1	1	3	1	1	1
AM-565	276	477	201	0	4	3	0	0
AM-565	276	477	201	0	2	5	0	1
AM-565	276	477	201	0	4	3	0	0
AM-566	276	281	5	1	3	3	1	0
AM-566	276	367	91	1	3	1	1	0
AM-566	276	371	95	1	3	1	1	0
AM-566	277	477	200	0	3	5	0	2
AM-566	277	477	200	0	3	4	0	0
AM-566	277	368	91	1	3	1	1	0
AM-566	277	282	5	1	3	4	1	0
AM-566	277	281	4	1	3	1	1	0
AM-566	277	278	1	1	3	1	1	0
AM-566	277	283	6	1	3	1	1	0
AM-567	277	477	200	0	3	5	0	0
AM-567	277	477	200	0	3	5	0	1
AM-567	277	409	132	1	3	5	1	0
AM-567	280	304	24	1	3	1	1	0
AM-567	280	372	92	1	3	1	1	0
AM-567	280	302	22	1	3	1	1	0
AM-567	280	477	197	0	3	4	0	0
AM-567	280	477	197	0	4	1	0	0
AM-567	280	282	2	1	4	5	1	0
AM-567	280	477	197	0	3	1	0	0
AM-568	280	281	1	1	3	1	1	1
AM-568	280	290	10	1	3	1	1	2
AM-568	280	477	197	0	3	1	0	0
AM-568	280	368	88	1	3	1	1	3
AM-568	280	288	8	1	3	1	1	0
AM-568	281	288	7	1	3	1	1	0
AM-568	281	477	196	0	4	3	0	0
AM-568	281	282	1	1	3	1	1	0
AM-568	281	282	1	1	3	1	1	0
AM-568	281	477	196	0	4	3	0	0
AM-569	281	477	196	0	3	3	0	0
AM-569	281	282	1	1	3	1	1	1
AM-569	281	415	134	1	3	1	1	0
AM-569	281	288	7	1	3	1	1	0
AM-569	281	477	196	0	3	1	0	0
AM-569	281	284	3	1	3	1	1	0
AM-569	281	309	28	1	3	4	1	0
AM-569	281	282	1	1	3	1	1	0
AM-569	281	477	196	0	3	3	0	0
AM-569	281	282	1	1	3	5	1	0
AM-570	282	368	86	1	3	1	1	0
AM-570	282	368	86	1	3	1	1	0
AM-570	282	289	7	1	3	4	1	0
AM-570	282	298	16	1	3	5	1	1
AM-570	282	283	1	1	3	1	1	1
AM-570	282	322	40	1	1	4	1	0
AM-570	282	287	5	1	1	1	1	0
AM-570	282	289	7	1	4	4	1	0
AM-570	282	304	22	1	3	4	1	1
AM-570	282	477	195	0	4	1	1	0
AM-571	282	366	84	1	3	1	1	0
AM-571	282	287	5	1	3	1	1	0
AM-571	282	288	6	1	3	1	1	0
AM-571	283	477	194	0	3	1	0	1
AM-571	283	330	47	1	3	1	1	0
AM-571	283	477	194	0	4	4	0	0
AM-571	283	298	15	1	3	3	1	0
AM-571	283	284	1	1	3	1	1	0
AM-571	283	373	90	1	3	1	1	0
AM-571	283	284	1	1	3	5	1	0
AM-572	283	289	6	1	4	5	1	1
AM-572	283	477	194	0	3	1	0	0
AM-572	283	477	194	0	3	1	0	0
AM-572	283	456	173	1	3	1	1	3
AM-572	283	303	20	1	3	4	1	0
AM-572	284	310	26	1	3	1	1	0
AM-572	284	311	27	1	3	1	1	1
AM-572	284	372	88	1	3	1	1	1
AM-572	284	477	193	0	3	4	0	0
AM-572	284	318	34	1	3	4	1	0
AM-573	284	289	5	1	3	5	1	0
AM-573	284	410	126	1	4	5	1	0
AM-573	284	456	172	1	3	4	1	0
AM-573	284	477	193	0	3	5	0	0
AM-573	284	329	45	1	3	1	1	0
AM-573	284	477	193	0	3	4	0	0
AM-573	284	477	193	0	3	5	0	0
AM-573	284	477	193	0	3	5	0	0
AM-573	284	477	193	0	3	5	0	0
AM-573	284	477	193	0	3	5	0	0
AM-574	284	477	193	0	3	5	0	0
AM-574	284	409	125	1	3	5	1	0
AM-574	284	477	193	0	3	5	0	0
AM-574	284	299	15	1	3	5	1	0
AM-574	285	477	192	0	3	1	0	1
AM-574	286	298	12	1	4	5	1	0
AM-574	287	477	190	0	3	1	0	0
AM-574	287	477	190	0	3	1	0	0
AM-574	287	477	190	0	3	5	0	0
AM-574	287	477	190	0	3	1	0	0
AM-575	287	477	190	0	3	5	0	0
AM-575	287	477	190	0	3	1	0	0
AM-575	287	477	190	0	3	5	0	0
AM-575	287	477	190	0	3	5	0	0
AM-575	287	288	1	1	4	5	1	0
AM-575	287	477	190	0	3	5	0	0
AM-575	287	409	122	1	3	5	1	0
AM-575	288	477	189	0	3	2	0	0
AM-575	288	477	189	0	3	5	0	1
AM-576	288	292	4	1	3	4	1	1
AM-576	288	373	85	1	3	1	1	0
AM-576	288	409	121	1	3	1	1	1
AM-576	288	289	1	1	3	5	1	0
AM-576	288	409	121	1	3	5	1	0
AM-576	288	289	1	1	3	5	1	0
AM-576	288	289	1	1	3	5	1	0
AM-576	288	308	20	1	3	5	1	0
AM-576	288	477	189	0	3	5	0	0
AM-576	288	477	189	0	3	5	0	0
AM-577	288	308	20	1	3	5	1	0
AM-577	288	477	189	0	3	1	0	0
AM-577	288	477	189	0	3	1	0	0
AM-577	288	303	15	1	3	1	1	0
AM-577	288	367	79	1	2	1	1	0
AM-577	289	466	177	1	4	4	1	0
AM-577	289	397	108	1	3	5	1	0
AM-577	289	477	188	0	3	1	0	1
AM-577	289	361	72	1	3	4	1	1
AM-577	289	354	65	1	3	1	1	0
AM-578	289	290	1	1	3	1	1	0
AM-578	289	302	13	1	3	5	1	0
AM-578	289	290	1	1	4	1	1	0
AM-578	289	295	6	1	3	1	1	0
AM-578	289	442	153	1	4	3	1	0
AM-578	289	435	146	1	3	5	1	0
AM-578	290	477	187	0	3	4	0	0
AM-578	290	477	187	0	3	1	0	0
AM-578	290	368	78	1	3	5	1	1
AM-578	290	477	187	0	3	1	0	0
AM-579	291	319	28	1	3	5	1	0
AM-579	291	477	186	0	3	4	0	0
AM-579	291	295	4	1	3	4	1	0
AM-579	291	295	4	1	4	4	1	0
AM-579	291	477	186	0	3	1	0	0
AM-579	291	477	186	0	3	4	0	0
AM-579	291	294	3	1	3	4	1	0
AM-579	291	295	4	1	3	1	1	1
AM-579	291	372	81	1	3	2	1	1
AM-579	291	295	4	1	3	1	1	1
AM-580	291	301	10	1	3	5	1	0
AM-580	291	301	10	1	3	5	1	0
AM-580	291	302	11	1	3	5	1	0
AM-580	292	293	1	1	3	1	1	0
AM-580	292	405	113	1	4	4	1	0
AM-580	293	477	184	0	3	1	0	0
AM-580	293	477	184	0	4	2	0	0
AM-580	294	409	115	1	3	4	1	0
AM-580	294	477	183	0	3	1	0	0
AM-580	294	477	183	0	3	5	0	0
AM-581	294	303	9	1	4	4	1	0
AM-581	294	477	183	0	2	1	0	0
AM-581	294	318	24	1	2	1	1	0
AM-581	294	323	29	1	2	1	1	0
AM-581	294	477	183	0	2	1	0	0
AM-581	294	301	7	1	3	5	1	0
AM-581	294	408	114	1	3	1	1	1
AM-581	294	330	36	1	3	2	1	0
AM-581	294	477	183	0	3	4	0	0
AM-581	295	477	182	0	3	2	0	0
AM-582	295	477	182	0	3	5	0	1
AM-582	295	477	182	0	3	5	0	0
AM-582	295	477	182	0	3	5	0	0
AM-582	295	477	182	0	3	5	0	0
AM-582	295	477	182	0	3	5	0	0
AM-582	295	477	182	0	3	5	0	0
AM-582	295	477	182	0	3	5	0	0
AM-582	295	447	152	1	3	5	1	1
AM-582	295	477	182	0	3	5	0	1
AM-582	295	477	182	0	3	1	0	1
AM-583	295	296	1	1	3	1	1	0
AM-583	295	296	1	1	4	1	1	0
AM-583	295	296	1	1	3	1	1	1
AM-583	295	296	1	1	1	1	1	0
AM-583	295	477	182	0	3	5	0	0
AM-583	295	409	114	1	3	3	1	1
AM-583	295	333	38	1	3	5	1	0
AM-583	295	298	3	1	3	5	1	0
AM-583	295	298	3	1	3	5	1	0
AM-583	295	298	3	1	3	5	1	0
AM-584	295	477	182	0	3	5	0	0
AM-584	295	298	3	1	3	5	1	0
AM-584	295	298	3	1	3	5	1	0
AM-584	295	477	182	0	3	1	0	2
AM-584	295	477	182	0	4	3	0	0
AM-584	295	303	8	1	3	4	1	0
AM-584	295	409	114	1	3	1	1	0
AM-584	296	477	181	0	4	4	0	0
AM-584	296	297	1	1	4	1	1	0
AM-584	296	477	181	0	3	5	0	0
AM-585	296	477	181	0	3	2	0	0
AM-585	296	477	181	0	3	2	0	0
AM-585	296	462	166	1	3	2	1	0
AM-585	296	298	2	1	3	1	1	0
AM-585	296	477	181	0	3	4	0	0
AM-585	296	297	1	1	3	4	1	0
AM-585	297	477	180	0	4	5	0	0
AM-585	297	309	12	1	3	1	1	0
AM-585	297	477	180	0	3	1	0	0
AM-585	297	477	180	0	3	4	0	0
AM-586	297	304	7	1	3	5	1	0
AM-586	297	304	7	1	3	5	1	0
AM-586	298	477	179	0	4	5	0	1
AM-586	298	477	179	0	4	5	0	0
AM-586	298	477	179	0	4	5	0	0
AM-586	298	477	179	0	3	4	0	2
AM-586	298	374	76	1	3	1	1	0
AM-586	298	319	21	1	3	5	1	0
AM-586	298	477	179	0	3	1	0	0
AM-586	298	477	179	0	3	3	0	0
AM-587	298	352	54	1	3	1	1	0
AM-587	298	462	164	1	3	3	1	0
AM-587	298	477	179	0	3	5	0	0
AM-587	298	477	179	0	3	1	0	3
AM-587	298	477	179	0	3	1	0	0
AM-587	298	303	5	1	2	1	1	0
AM-587	298	477	179	0	3	5	0	0
AM-587	298	477	179	0	3	1	0	0
AM-587	298	477	179	0	4	5	0	0
AM-587	298	386	88	1	3	5	1	0
AM-588	299	477	178	0	3	1	0	0
AM-588	299	302	3	1	3	1	1	0
AM-588	300	462	162	1	3	5	1	0
AM-588	300	309	9	1	3	1	1	0
AM-588	300	309	9	1	3	1	1	0
AM-588	300	311	11	1	3	5	1	0
AM-588	300	301	1	1	3	3	1	0
AM-588	300	302	2	1	3	1	1	0
AM-588	301	311	10	1	3	5	1	0
AM-588	301	311	10	1	3	5	1	0
AM-589	301	304	3	1	3	5	1	0
AM-589	301	308	7	1	4	4	1	1
AM-589	301	309	8	1	3	4	1	0
AM-589	301	477	176	0	3	1	0	0
AM-589	301	477	176	0	3	1	0	0
AM-589	301	477	176	0	3	5	0	0
AM-589	301	477	176	0	3	5	0	0
AM-589	301	477	176	0	3	5	0	0
AM-589	301	477	176	0	3	5	0	0
AM-589	301	477	176	0	3	5	0	0
AM-590	301	477	176	0	3	5	0	0
AM-590	301	477	176	0	3	5	0	0
AM-590	301	477	176	0	3	5	0	0
AM-590	301	477	176	0	3	5	0	0
AM-590	301	477	176	0	3	5	0	0
AM-590	301	477	176	0	3	5	0	0
AM-590	301	382	81	1	4	4	1	0
AM-590	301	477	176	0	4	1	0	0
AM-590	301	302	1	1	2	1	1	0
AM-590	301	302	1	1	4	1	1	0
AM-591	301	382	81	1	4	4	1	0
AM-591	301	449	148	1	3	1	1	0
AM-591	301	303	2	1	3	1	1	0
AM-591	302	303	1	1	2	4	1	0
AM-591	302	477	175	0	3	1	0	0
AM-591	302	311	9	1	3	1	1	0
AM-591	302	305	3	1	3	1	1	1
AM-591	302	308	6	1	4	4	1	1
AM-591	302	477	175	0	3	4	0	0
AM-591	302	303	1	1	4	1	1	1
AM-592	302	339	37	1	4	5	1	0
AM-592	302	304	2	1	3	1	1	0
AM-592	302	477	175	0	4	4	0	0
AM-592	302	477	175	0	3	5	0	0
AM-592	302	477	175	0	4	5	0	0
AM-592	302	380	78	1	2	1	1	0
AM-592	302	477	175	0	3	1	0	0
AM-592	302	374	72	1	3	1	1	1
AM-592	303	477	174	0	3	1	0	0
AM-592	303	477	174	0	4	4	0	0
AM-593	303	304	1	1	3	1	1	0
AM-593	303	312	9	1	3	3	1	1
AM-593	304	308	4	1	1	1	1	0
AM-593	304	388	84	1	5	4	1	2
AM-593	304	477	173	0	3	1	0	1
AM-593	304	477	173	0	4	4	0	0
AM-593	304	361	57	1	4	1	1	0
AM-593	304	333	29	1	2	1	1	1
AM-593	304	305	1	1	4	1	1	0
AM-593	305	477	172	0	4	1	0	0
AM-594	305	311	6	1	3	5	1	0
AM-594	305	462	157	1	3	5	1	0
AM-594	305	462	157	1	3	5	1	0
AM-594	305	311	6	1	3	5	1	0
AM-594	305	306	1	1	3	5	1	0
AM-594	305	311	6	1	3	5	1	0
AM-594	305	308	3	1	3	3	1	1
AM-594	305	477	172	0	3	2	0	0
AM-594	305	344	39	1	3	5	1	1
AM-594	305	477	172	0	3	1	0	0
AM-595	305	367	62	1	4	1	1	0
AM-595	305	372	67	1	3	1	1	0
AM-595	305	311	6	1	3	5	1	0
AM-595	305	400	95	1	3	5	1	4
AM-595	305	368	63	1	4	1	1	0
AM-595	305	367	62	1	4	1	1	1
AM-595	305	311	6	1	3	5	1	0
AM-595	305	309	4	1	3	1	1	0
AM-595	305	367	62	1	4	1	1	0
AM-595	306	409	103	1	3	1	1	1
AM-596	306	307	1	1	2	1	1	0
AM-596	306	309	3	1	3	1	1	0
AM-596	306	311	5	1	3	5	1	0
AM-596	306	311	5	1	3	5	1	0
AM-596	306	477	171	0	3	2	0	0
AM-596	307	311	4	1	3	5	1	0
AM-596	307	402	95	1	3	1	1	0
AM-596	308	477	169	0	3	4	0	0
AM-596	308	477	169	0	3	1	0	0
AM-596	308	477	169	0	3	5	0	0
AM-597	308	309	1	1	3	5	1	0
AM-597	308	309	1	1	3	1	1	1
AM-597	308	477	169	0	3	2	0	0
AM-597	308	477	169	0	4	1	0	0
AM-597	308	310	2	1	3	1	1	0
AM-597	308	371	63	1	3	1	1	0
AM-597	308	434	126	1	4	4	1	0
AM-597	308	386	78	1	3	4	1	0
AM-597	309	333	24	1	3	1	1	0
AM-597	309	310	1	1	3	1	1	0
AM-598	309	477	168	0	3	2	0	1
AM-598	309	311	2	1	4	5	1	2
AM-598	309	477	168	0	4	5	0	2
AM-598	309	322	13	1	4	5	1	1
AM-598	309	336	27	1	3	5	0	0
AM-598	309	477	168	0	3	5	0	2
AM-598	309	477	168	0	3	4	0	0
AM-598	309	310	1	1	3	1	1	0
AM-598	309	477	168	0	3	1	0	0
AM-598	309	310	1	1	3	5	1	0
AM-599	309	310	1	1	3	5	1	0
AM-599	309	310	1	1	3	5	1	0
AM-599	309	310	1	1	3	5	1	0
AM-599	309	361	52	1	3	5	1	0
AM-599	309	361	52	1	3	5	1	0
AM-599	309	477	168	0	3	5	0	1
AM-599	309	323	14	1	3	4	1	0
AM-599	309	477	168	0	2	1	0	0
AM-599	309	477	168	0	3	5	0	0
AM-599	309	318	9	1	3	1	1	0
AM-600	309	477	168	0	3	2	0	0
AM-600	309	310	1	1	3	5	1	0
AM-600	309	368	59	1	2	1	1	0
AM-600	309	368	59	1	3	5	1	0
AM-600	309	477	168	0	3	1	0	0
AM-600	309	477	168	0	3	1	0	0
AM-600	310	311	1	1	3	5	1	0
AM-600	310	477	167	0	4	4	0	0
AM-600	310	477	167	0	3	4	0	0
AM-600	310	326	16	1	3	5	1	1
AM-601	310	311	1	1	3	1	1	0
AM-601	310	318	8	1	2	1	1	1
AM-601	310	477	167	0	3	1	0	1
AM-601	310	311	1	1	4	4	1	0
AM-601	310	311	1	1	3	1	1	0
AM-601	310	477	167	0	3	3	0	4
AM-601	310	312	2	1	3	1	1	1
AM-601	311	462	151	1	3	2	1	0
AM-601	311	317	6	1	3	1	1	0
AM-601	311	399	88	1	3	4	1	0
AM-602	311	477	166	0	4	4	0	0
AM-602	311	372	61	1	4	4	1	0
AM-602	311	312	1	1	3	1	1	0
AM-602	311	373	62	1	4	4	1	0
AM-602	311	393	82	1	3	5	1	1
AM-602	311	372	61	1	3	1	1	2
AM-602	311	315	4	1	4	4	1	0
AM-602	311	477	166	0	4	1	0	0
AM-602	311	409	98	1	2	1	1	0
AM-602	312	477	165	0	3	1	0	1
AM-603	312	368	56	1	2	4	1	0
AM-603	312	477	165	0	3	1	0	0
AM-603	312	336	24	1	4	5	1	0
AM-603	313	344	31	1	3	1	1	0
AM-603	313	317	4	1	4	4	1	0
AM-603	314	477	163	0	4	4	0	0
AM-603	315	318	3	1	1	1	1	0
AM-603	315	373	58	1	4	4	1	0
AM-603	315	477	162	0	3	1	0	0
AM-603	315	448	133	1	3	5	1	0
AM-604	315	477	162	0	3	1	0	0
AM-604	315	477	162	0	3	5	0	0
AM-604	315	477	162	0	3	5	0	0
AM-604	315	477	162	0	3	5	0	0
AM-604	315	477	162	0	3	5	0	0
AM-604	315	477	162	0	3	5	0	0
AM-604	315	477	162	0	3	5	0	0
AM-604	315	317	2	1	2	1	1	1
AM-604	315	449	134	1	3	1	1	0
AM-604	315	477	162	0	3	4	0	0
AM-605	315	383	68	1	2	1	1	0
AM-605	316	477	161	0	3	1	1	1
AM-605	316	441	125	1	4	1	1	0
AM-605	316	326	10	1	3	4	1	0
AM-605	316	319	3	1	3	5	1	0
AM-605	316	323	7	1	2	1	1	1
AM-605	316	373	57	1	4	5	1	1
AM-605	316	317	1	1	3	1	1	1
AM-605	317	331	14	1	3	1	1	0
AM-605	317	477	160	0	3	1	0	2
AM-606	317	477	160	0	3	1	0	1
AM-606	317	477	160	0	3	1	0	0
AM-606	317	318	1	1	3	1	1	0
AM-606	317	325	8	1	3	4	1	2
AM-606	317	477	160	0	3	1	0	0
AM-606	317	477	160	0	4	5	0	0
AM-606	317	329	12	1	3	1	1	2
AM-606	317	477	160	0	3	4	0	0
AM-606	317	318	1	1	3	1	1	0
AM-606	318	477	159	0	4	1	0	0
AM-607	318	477	159	0	3	1	0	0
AM-607	318	477	159	0	4	2	0	0
AM-607	318	333	15	1	3	3	1	0
AM-607	318	477	159	0	4	1	0	0
AM-607	319	368	49	1	3	1	1	0
AM-607	319	367	48	1	3	1	1	0
AM-607	319	347	28	1	3	1	1	0
AM-607	319	337	18	1	3	4	1	0
AM-607	319	320	1	1	4	4	1	0
AM-607	319	343	24	1	4	4	1	0
AM-608	319	320	1	1	3	1	1	0
AM-608	319	477	158	0	4	2	0	0
AM-608	319	330	11	1	1	1	1	0
AM-608	319	323	4	1	3	4	1	0
AM-608	319	352	33	1	3	1	1	0
AM-608	319	325	6	1	1	1	1	0
AM-608	321	477	156	0	2	1	0	0
AM-608	321	323	2	1	2	1	1	0
AM-608	322	477	155	0	4	1	0	0
AM-608	322	477	155	0	3	1	0	0
AM-609	322	477	155	0	3	5	0	0
AM-609	322	477	155	0	3	5	0	0
AM-609	322	477	155	0	3	5	0	0
AM-609	322	477	155	0	3	5	0	0
AM-609	322	477	155	0	3	4	0	0
AM-609	322	477	155	0	3	2	0	0
AM-609	323	389	66	1	3	5	1	0
AM-609	323	373	50	1	3	2	1	0
AM-609	323	330	7	1	3	4	1	0
AM-609	323	324	1	1	4	4	1	0
AM-610	323	336	13	1	3	5	1	0
AM-610	316	331	15	1	3	1	1	1
AM-610	323	332	9	1	1	1	1	0
AM-610	323	477	154	0	3	1	0	0
AM-610	324	372	48	1	3	1	1	2
AM-610	324	477	153	0	4	4	0	0
AM-610	324	366	42	1	3	1	1	0
AM-610	324	477	153	0	4	1	0	0
AM-610	324	477	153	0	3	1	0	0
AM-610	324	330	6	1	3	2	1	0
AM-611	324	372	48	1	3	1	1	0
AM-611	324	336	12	1	3	1	2	3
AM-611	324	477	153	0	3	2	0	0
AM-611	325	477	152	0	4	4	0	0
AM-611	325	477	152	0	3	4	0	0
AM-611	325	361	36	1	4	1	1	0
AM-611	325	326	1	1	2	1	1	0
AM-611	326	327	1	1	3	1	1	0
AM-611	326	477	151	0	3	1	0	0
AM-611	326	477	151	0	3	2	0	0
AM-612	326	477	151	0	3	4	0	0
AM-612	327	477	150	0	4	1	0	0
AM-612	329	337	8	1	3	3	1	0
AM-612	329	330	1	1	4	4	1	0
AM-612	329	448	119	1	3	1	1	0
AM-612	329	448	119	1	3	5	1	0
AM-612	329	477	148	0	3	1	0	0
AM-612	329	477	148	0	3	5	0	0
AM-612	329	477	148	0	3	2	0	0
AM-612	330	336	6	1	2	1	1	1
AM-613	330	373	43	1	2	1	1	0
AM-613	330	367	37	1	2	1	1	0
AM-613	330	359	29	1	2	1	1	1
AM-613	330	367	37	1	3	2	1	0
AM-613	330	331	1	1	3	4	1	1
AM-613	330	393	63	1	3	5	1	0
AM-613	330	477	147	0	4	1	0	0
AM-613	330	477	147	0	4	1	0	0
AM-613	330	477	147	0	3	2	0	0
AM-613	330	477	147	0	3	1	0	0
AM-614	330	477	147	0	4	1	0	0
AM-614	330	477	147	0	4	1	0	0
AM-614	331	477	146	0	3	4	0	0
AM-614	331	336	5	1	3	3	1	0
AM-614	331	477	146	0	4	4	0	0
AM-614	332	333	1	1	1	1	1	0
AM-614	332	333	1	1	3	1	1	1
AM-614	332	477	145	0	3	3	0	2
AM-614	332	477	145	0	3	2	0	0
AM-614	332	477	145	0	4	1	0	0
AM-615	332	368	36	1	4	4	1	0
AM-615	332	338	6	1	3	4	1	0
AM-615	332	333	1	1	1	1	1	0
AM-615	332	477	145	0	3	1	0	0
AM-615	333	389	56	1	3	5	1	2
AM-615	333	370	37	1	3	4	1	0
AM-615	333	336	3	1	3	1	1	0
AM-615	333	477	144	0	3	1	0	0
AM-615	333	477	144	0	3	5	0	1
AM-615	333	346	13	1	3	3	1	0
AM-616	333	337	4	1	3	5	1	0
AM-616	333	477	144	0	3	2	0	0
AM-616	333	337	4	1	1	1	1	0
AM-616	334	335	1	1	3	2	1	0
AM-616	335	370	35	1	4	1	1	0
AM-616	336	353	17	1	3	4	1	0
AM-616	336	477	141	0	3	4	0	1
AM-616	336	396	60	1	4	4	1	0
AM-616	336	477	141	0	3	4	0	0
AM-616	336	477	141	0	4	1	0	0
AM-617	336	386	50	1	5	1	1	0
AM-617	337	477	140	0	3	1	0	0
AM-617	337	344	7	1	4	4	1	0
AM-617	337	339	2	1	1	1	1	0
AM-617	337	338	1	1	3	5	1	0
AM-617	337	477	140	0	4	4	0	1
AM-617	337	344	7	1	3	1	1	0
AM-617	337	477	140	0	3	1	0	0
AM-617	337	458	121	1	2	4	1	0
AM-617	337	359	22	1	3	1	1	1
AM-618	337	338	1	1	3	5	1	0
AM-618	337	437	100	1	3	1	1	0
AM-618	338	434	96	1	1	1	1	1
AM-618	338	344	6	1	3	4	1	0
AM-618	338	374	36	1	4	4	1	0
AM-618	339	438	99	1	3	4	1	0
AM-618	339	477	138	0	4	4	0	0
AM-618	339	347	8	1	3	4	1	0
AM-618	339	374	35	1	3	5	1	1
AM-618	339	477	138	0	3	1	0	0
AM-619	339	393	54	1	4	4	1	0
AM-619	339	347	8	1	4	2	1	0
AM-619	340	477	137	0	3	4	0	0
AM-619	340	477	137	0	3	4	0	0
AM-619	340	341	1	1	3	5	1	0
AM-619	340	341	1	1	3	5	1	0
AM-619	340	341	1	1	3	1	1	0
AM-619	341	477	136	0	4	4	0	0
AM-619	342	477	135	0	4	1	0	0
AM-619	343	477	134	0	4	5	0	0
AM-620	343	350	7	1	3	5	1	0
AM-620	343	344	1	1	5	5	1	3
AM-620	343	477	134	0	3	4	0	0
AM-620	343	477	134	0	3	1	0	0
AM-620	343	345	2	1	3	3	1	0
AM-620	343	345	2	1	3	5	1	0
AM-620	344	374	30	1	3	1	1	0
AM-620	344	395	51	1	5	5	1	1
AM-620	344	477	133	0	3	1	0	0
AM-620	344	477	133	0	3	4	0	0
AM-621	344	477	133	0	3	1	0	1
AM-621	344	477	133	0	4	4	0	1
AM-621	344	354	10	1	3	4	1	0
AM-621	345	346	1	1	4	1	1	0
AM-621	345	375	30	1	3	4	1	1
AM-621	345	477	132	0	3	1	0	0
AM-621	345	346	1	1	3	1	1	0
AM-621	345	477	132	0	4	1	0	0
AM-621	345	477	132	0	3	1	0	0
AM-621	345	477	132	0	4	1	0	0
AM-622	345	477	132	0	4	1	0	0
AM-622	345	477	132	0	4	1	0	0
AM-622	345	477	132	0	4	1	0	0
AM-622	345	477	132	0	4	5	0	0
AM-622	345	346	1	1	3	1	1	0
AM-622	346	347	1	1	3	3	1	0
AM-622	346	477	131	0	3	2	0	0
AM-622	346	347	1	1	3	1	1	0
AM-622	346	477	131	0	4	2	0	0
AM-622	346	372	26	1	3	1	1	0
AM-623	346	394	48	1	3	4	1	1
AM-623	346	477	131	0	3	5	0	0
AM-623	346	477	131	0	3	3	0	0
AM-623	346	409	63	1	3	3	1	0
AM-623	347	378	31	1	5	4	1	1
AM-623	347	350	3	1	4	4	1	0
AM-623	347	477	130	0	3	3	0	0
AM-623	347	389	42	1	3	1	1	1
AM-623	347	477	130	0	4	1	0	0
AM-623	348	372	24	1	3	2	1	0
AM-624	348	477	129	0	3	5	0	0
AM-624	349	450	101	1	3	4	1	2
AM-624	350	352	2	1	3	5	1	1
AM-624	350	477	127	0	3	1	0	2
AM-624	350	359	9	1	3	1	1	0
AM-624	350	352	2	1	4	5	1	0
AM-624	350	441	91	1	3	5	1	0
AM-624	350	477	127	0	4	3	0	0
AM-624	350	374	24	1	3	4	1	1
AM-624	350	477	127	0	3	1	0	0
AM-625	350	352	2	1	3	1	1	0
AM-625	350	477	127	0	3	1	0	0
AM-625	350	477	127	0	3	4	0	0
AM-625	350	477	127	0	3	4	0	0
AM-625	350	372	22	1	4	4	1	0
AM-625	351	477	126	0	3	2	0	0
AM-625	351	477	126	0	2	1	0	0
AM-625	351	477	126	0	3	4	0	0
AM-625	351	477	126	0	3	1	0	1
AM-625	351	477	126	0	3	1	0	0
AM-626	351	477	126	0	3	2	0	0
AM-626	351	477	126	0	3	2	0	0
AM-626	351	353	2	1	4	1	1	0
AM-626	351	352	1	1	3	5	1	0
AM-626	351	477	126	0	3	4	0	0
AM-626	351	477	126	0	3	2	0	0
AM-626	351	448	97	1	3	1	1	0
AM-626	352	477	125	0	3	1	0	0
AM-626	352	416	64	1	3	5	1	1
AM-626	352	372	20	1	3	2	1	0
AM-627	352	396	44	1	4	1	1	0
AM-627	352	477	125	0	3	3	0	0
AM-627	352	353	1	1	2	1	1	1
AM-627	352	354	2	1	4	1	1	0
AM-627	353	477	124	0	3	4	0	0
AM-627	353	477	124	0	3	1	0	0
AM-627	353	374	21	1	3	1	1	0
AM-627	353	477	124	0	4	1	0	0
AM-627	353	477	124	0	3	4	0	0
AM-627	353	380	27	1	2	1	1	0
AM-628	353	477	124	0	2	1	0	0
AM-628	353	354	1	1	2	1	1	0
AM-628	353	372	19	1	2	1	1	0
AM-628	353	354	1	1	4	5	1	0
AM-628	353	477	124	0	3	1	0	3
AM-628	353	394	41	1	3	4	1	0
AM-628	353	477	124	0	3	4	0	0
AM-628	354	372	18	1	3	1	1	0
AM-628	354	372	18	1	4	4	1	0
AM-628	354	368	14	1	2	1	1	0
AM-629	354	382	28	1	3	5	1	0
AM-629	354	407	53	1	3	5	1	0
AM-629	354	444	90	1	4	4	1	0
AM-629	354	409	55	1	3	5	1	0
AM-629	354	376	22	1	3	2	1	1
AM-629	354	367	13	1	4	1	1	0
AM-629	354	360	6	1	3	2	1	1
AM-629	355	477	122	0	3	1	0	0
AM-629	355	477	122	0	3	1	0	0
AM-629	355	477	122	0	3	1	0	0
AM-630	355	409	54	1	3	5	1	0
AM-630	355	368	13	1	3	1	1	0
AM-630	356	393	37	1	2	4	1	0
AM-630	356	477	121	0	3	4	0	0
AM-630	359	477	118	0	3	2	0	0
AM-630	359	393	34	1	5	4	1	0
AM-630	359	360	1	1	4	4	1	0
AM-630	359	428	69	1	3	1	1	0
AM-630	359	477	118	0	3	1	0	0
AM-630	359	477	118	0	3	1	0	0
AM-631	359	477	118	0	3	1	0	0
AM-631	359	373	14	1	3	1	1	0
AM-631	359	373	14	1	3	1	1	0
AM-631	359	477	118	0	3	1	0	0
AM-631	359	360	1	1	3	1	1	0
AM-631	360	477	117	0	4	1	0	0
AM-631	360	361	1	1	3	1	1	0
AM-631	360	366	6	1	3	1	1	0
AM-631	360	380	20	1	3	1	1	0
AM-631	360	373	13	1	3	1	1	0
AM-632	360	477	117	0	3	1	0	0
AM-632	360	378	18	1	3	1	1	0
AM-632	360	366	6	1	3	1	1	1
AM-632	360	477	117	0	3	1	0	0
AM-632	361	450	89	1	3	4	1	0
AM-632	361	362	1	1	4	1	1	0
AM-632	361	374	13	1	3	5	1	1
AM-632	361	477	116	0	3	2	0	0
AM-632	361	477	116	0	4	4	0	0
AM-632	362	363	1	1	2	1	1	1
ANUTILS-50	52	53	1	1	3	4	0	1
ANUTILS-50	77	477	400	0	3	1	0	0
ANUTILS-50	150	477	327	0	3	1	0	2
ANUTILS-51	191	477	286	0	3	1	0	0
ANUTILS-51	210	211	1	1	3	2	0	1
ANUTILS-51	277	278	1	1	3	2	1	0
ANUTILS-51	280	477	197	0	3	1	0	0
ANUTILS-51	280	284	4	1	3	2	1	0
ANUTILS-51	303	304	1	1	3	4	1	0
ANUTILS-51	343	477	134	0	5	1	0	0
GTOP-297	0	1	1	1	3	1	1	0
GTOP-298	1	9	8	1	3	1	1	0
GTOP-298	3	4	1	1	3	1	1	0
GTOP-298	4	477	473	0	3	1	0	0
GTOP-298	24	477	453	0	3	1	0	0
GTOP-298	30	34	4	1	3	1	1	0
GTOP-298	30	441	411	1	4	5	0	0
GTOP-298	31	338	307	1	1	1	1	2
GTOP-298	31	226	195	1	1	1	1	1
GTOP-298	32	36	4	1	3	1	0	0
GTOP-298	32	36	4	1	3	4	1	1
GTOP-299	33	34	1	1	3	1	1	2
GTOP-299	33	115	82	1	3	1	1	0
GTOP-299	33	40	7	1	3	4	1	0
GTOP-299	35	441	406	1	3	5	1	0
GTOP-299	35	449	414	1	3	5	1	0
GTOP-299	35	453	418	1	3	5	1	0
GTOP-299	35	449	414	1	3	5	1	0
GTOP-299	35	441	406	1	3	5	0	0
GTOP-299	35	441	406	1	3	5	0	0
GTOP-299	40	477	437	0	3	4	0	0
GTOP-300	40	477	437	0	3	4	0	0
GTOP-300	43	58	15	1	3	1	1	0
GTOP-300	53	54	1	1	5	4	1	0
GTOP-300	56	63	7	1	3	1	1	0
GTOP-300	56	58	2	1	3	1	1	0
GTOP-300	56	65	9	1	4	4	1	0
GTOP-300	57	58	1	1	5	3	1	0
GTOP-300	57	65	8	1	3	2	1	0
GTOP-300	58	398	340	1	3	5	0	0
GTOP-300	58	398	340	1	3	5	1	1
GTOP-301	59	65	6	1	3	4	1	0
GTOP-301	64	218	154	1	3	4	1	1
GTOP-301	66	477	411	0	3	1	0	0
GTOP-301	67	83	16	1	3	1	1	0
GTOP-301	70	85	15	1	3	1	1	1
GTOP-301	79	477	398	0	3	1	0	0
GTOP-301	87	477	390	0	3	3	0	0
GTOP-301	87	477	390	0	3	3	0	0
GTOP-301	88	89	1	1	4	1	1	1
GTOP-301	89	477	388	0	3	4	0	0
GTOP-302	91	477	386	0	3	1	0	0
GTOP-302	99	117	18	1	3	1	0	0
GTOP-302	106	108	2	1	3	4	0	0
GTOP-302	113	118	5	1	3	1	1	1
GTOP-302	122	127	5	1	3	1	1	0
GTOP-302	122	123	1	1	2	1	1	0
GTOP-302	128	129	1	1	3	1	1	0
GTOP-302	128	156	28	1	3	1	1	0
GTOP-302	128	477	349	0	3	4	0	0
GTOP-302	129	477	348	0	3	1	0	0
GTOP-303	129	136	7	1	3	1	1	0
GTOP-303	133	134	1	1	3	4	1	0
GTOP-303	135	477	342	0	3	1	0	0
GTOP-303	137	144	7	1	3	1	1	0
GTOP-303	141	151	10	1	3	1	0	0
GTOP-303	149	163	14	1	3	1	1	0
GTOP-303	149	150	1	1	3	1	1	0
GTOP-303	150	156	6	1	3	1	1	0
GTOP-303	150	155	5	1	4	4	1	0
GTOP-303	152	237	85	1	4	4	1	0
GTOP-304	155	161	6	1	3	1	1	0
GTOP-304	155	156	1	1	3	1	1	0
GTOP-304	156	162	6	1	3	1	1	0
GTOP-304	158	159	1	1	3	4	0	0
GTOP-304	159	232	73	1	3	1	1	0
GTOP-304	159	163	4	1	3	1	1	0
GTOP-304	176	178	2	1	3	1	1	0
GTOP-304	176	218	42	1	4	4	1	0
GTOP-304	182	189	7	1	3	1	1	0
GTOP-304	182	477	295	0	3	4	0	0
GTOP-305	185	186	1	1	3	1	1	0
GTOP-305	185	477	292	0	2	1	0	0
GTOP-305	188	189	1	1	3	1	1	0
GTOP-305	199	200	1	1	3	1	1	0
GTOP-305	212	215	3	1	3	1	1	0
GTOP-305	218	246	28	1	3	4	1	1
GTOP-305	218	477	259	0	3	4	1	0
GTOP-305	218	477	259	0	3	4	1	0
GTOP-305	218	281	63	1	3	4	1	1
GTOP-305	218	231	13	1	3	4	1	1
GTOP-306	218	219	1	1	4	4	1	0
GTOP-306	219	225	6	1	3	1	1	2
GTOP-306	220	256	36	1	3	4	1	1
GTOP-306	220	265	45	1	1	3	1	4
GTOP-306	221	239	18	1	3	4	1	1
GTOP-306	226	238	12	1	3	4	1	1
GTOP-306	226	239	13	1	3	4	1	1
GTOP-306	226	246	20	1	3	4	1	1
GTOP-306	226	246	20	1	3	4	1	1
GTOP-306	226	238	12	1	3	4	1	1
GTOP-307	231	477	246	0	4	4	0	0
GTOP-307	231	477	246	0	4	4	0	0
GTOP-307	234	253	19	1	2	1	0	0
GTOP-307	239	477	238	0	4	4	0	0
GTOP-307	240	259	19	1	3	3	1	1
GTOP-307	240	260	20	1	3	3	1	1
GTOP-307	243	253	10	1	3	1	1	0
GTOP-307	246	255	9	1	3	1	1	0
GTOP-307	250	252	2	1	3	1	1	1
GTOP-307	252	261	9	1	3	1	0	0
GTOP-308	253	477	224	0	3	2	0	0
GTOP-308	260	261	1	1	3	1	1	0
GTOP-308	261	262	1	1	3	1	1	2
GTOP-308	262	263	1	1	3	1	1	0
GTOP-308	262	477	215	0	4	5	0	0
GTOP-308	262	404	142	1	4	4	1	0
GTOP-308	271	343	72	1	3	3	0	0
GTOP-308	271	275	4	1	3	3	0	0
GTOP-308	275	276	1	1	3	1	1	0
GTOP-308	275	277	2	1	3	1	1	0
GTOP-309	275	276	1	1	3	1	1	0
GTOP-309	275	276	1	1	3	1	1	0
GTOP-309	275	477	202	0	4	4	1	0
GTOP-309	278	477	199	0	3	4	0	0
GTOP-309	281	282	1	1	4	1	0	0
GTOP-309	281	477	196	0	4	1	0	0
GTOP-309	296	477	181	0	4	1	0	0
GTOP-309	305	477	172	0	4	4	0	0
GTOP-309	309	359	50	1	3	3	1	0
GTOP-309	318	321	3	1	3	1	1	1
GTOP-310	320	477	157	0	3	3	0	0
GTOP-310	325	477	152	0	3	1	0	0
GTOP-310	326	327	1	1	3	1	1	0
GTOP-310	328	329	1	1	3	4	1	0
GTOP-310	329	330	1	1	3	3	0	0
GTOP-310	329	330	1	1	3	3	1	0
GTOP-310	330	331	1	1	3	3	2	0
GTOP-310	336	338	2	1	3	1	1	0
GTOP-310	344	354	10	1	4	3	1	0
GTOP-310	346	385	39	1	3	3	1	0
GTOP-311	346	354	8	1	3	5	1	0
GTOP-311	346	365	19	1	3	5	0	0
GTOP-311	346	354	8	1	3	1	1	1
GTOP-311	347	354	7	1	3	1	1	0
GTOP-311	347	357	10	1	3	5	1	0
GTOP-311	357	366	9	1	3	5	1	0
GTOP-311	357	361	4	1	3	5	0	1
GTOP-311	357	359	2	1	3	5	1	0
GTOP-311	358	367	9	1	3	5	1	0
GTOP-311	359	477	118	0	3	1	0	1
GTOP-312	360	361	1	1	4	5	1	0
GTOP-312	361	366	5	1	3	5	1	0
OOKLYN-57	7	11	4	1	3	1	1	0
OOKLYN-57	21	29	8	1	3	1	1	0
OOKLYN-57	21	29	8	1	3	1	1	0
OOKLYN-57	22	477	455	0	3	4	0	0
OOKLYN-57	22	144	122	1	3	1	0	0
OOKLYN-57	22	477	455	0	3	4	0	0
OOKLYN-57	29	477	448	0	3	1	0	0
OOKLYN-57	30	150	120	1	3	1	0	0
OOKLYN-58	39	144	105	1	3	1	1	0
OOKLYN-58	42	477	435	0	3	1	1	0
OOKLYN-58	51	477	426	0	3	1	0	0
OOKLYN-58	52	53	1	1	3	4	1	0
OOKLYN-58	53	477	424	0	3	4	1	0
OOKLYN-58	67	477	410	0	3	1	0	0
OOKLYN-58	81	155	74	1	4	4	0	0
OOKLYN-58	135	477	342	0	4	1	0	0
OOKLYN-58	144	155	11	1	3	1	0	0
OOKLYN-58	144	172	28	1	3	1	0	0
OOKLYN-59	144	172	28	1	3	1	0	0
OOKLYN-59	157	477	320	0	4	4	0	0
OOKLYN-59	165	477	312	0	3	1	0	0
OOKLYN-59	169	198	29	1	4	5	1	0
OOKLYN-59	170	176	6	1	3	1	1	0
OOKLYN-59	176	477	301	0	3	1	0	0
OOKLYN-59	176	477	301	0	3	1	0	0
OOKLYN-59	226	477	251	0	3	4	0	0
OOKLYN-59	233	477	244	0	3	1	0	0
OOKLYN-59	248	274	26	1	3	1	1	0
OOKLYN-60	248	274	26	1	3	1	1	0
OOKLYN-60	255	477	222	0	3	1	0	0
OOKLYN-60	273	274	1	1	4	1	1	0
OOKLYN-60	274	477	203	0	3	1	0	0
OOKLYN-60	280	394	114	1	3	5	1	0
OOKLYN-60	282	477	195	0	3	5	0	0
ILDR-73	172	477	305	0	3	1	0	0
ILDR-73	175	477	302	0	3	1	0	0
ILDR-73	252	477	225	0	1	1	0	0
AL-15	97	290	193	1	3	4	0	0
AL-15	159	160	1	1	3	1	1	0
AL-15	171	289	118	1	3	1	1	0
AL-15	279	280	1	1	3	4	1	0
AL-16	290	291	1	1	3	4	1	2
AL-16	290	291	1	1	3	3	1	2
AL-16	290	291	1	1	3	3	1	0
AL-16	290	291	1	1	3	3	1	2
AL-16	290	291	1	1	3	3	1	0
AL-16	302	303	1	1	3	1	1	0
AL-16	302	303	1	1	3	3	1	0
AL-16	307	421	114	1	3	1	1	2
AL-16	310	311	1	1	3	1	1	0
AL-16	331	477	146	0	3	1	0	1
LCITE-211	3	477	474	0	3	1	0	0
LCITE-211	3	17	14	1	4	1	1	0
LCITE-211	3	107	104	1	3	1	1	1
LCITE-212	4	5	1	1	3	2	1	0
LCITE-212	4	477	473	0	3	1	0	0
LCITE-212	4	8	4	1	3	1	1	1
LCITE-212	5	477	472	0	3	1	0	0
LCITE-212	5	10	5	1	3	1	1	0
LCITE-212	6	8	2	1	3	1	0	0
LCITE-212	8	477	469	0	3	4	0	1
LCITE-212	9	10	1	1	3	1	1	1
LCITE-212	9	46	37	1	3	4	1	1
LCITE-212	9	477	468	0	3	1	0	2
LCITE-213	9	477	468	0	3	1	0	2
LCITE-213	9	477	468	0	3	4	0	2
LCITE-213	9	477	468	0	3	1	0	2
LCITE-213	12	17	5	1	3	4	1	1
LCITE-213	12	477	465	0	3	1	0	0
LCITE-213	12	22	10	1	3	1	1	0
LCITE-213	15	477	462	0	3	1	0	0
LCITE-213	16	17	1	1	3	1	1	0
LCITE-213	16	477	461	0	3	1	0	2
LCITE-213	16	17	1	1	3	1	1	3
LCITE-214	17	59	42	1	4	4	1	0
LCITE-214	17	477	460	0	4	2	0	0
LCITE-214	17	477	460	0	4	1	0	1
LCITE-214	17	22	5	1	3	1	1	0
LCITE-214	18	477	459	0	4	4	0	0
LCITE-214	20	23	3	1	3	1	1	1
LCITE-214	21	372	351	1	3	1	0	1
LCITE-214	21	25	4	1	3	1	1	0
LCITE-214	22	23	1	1	3	5	1	0
LCITE-214	24	25	1	1	1	1	1	1
LCITE-215	24	477	453	0	3	1	0	0
LCITE-215	26	477	451	0	3	4	0	0
LCITE-215	28	477	449	0	3	1	0	1
LCITE-215	28	29	1	1	3	1	1	1
LCITE-215	29	67	38	1	3	1	2	3
LCITE-215	29	477	448	0	3	4	0	0
LCITE-215	29	35	6	1	3	1	1	0
LCITE-215	29	477	448	0	3	2	0	0
LCITE-215	29	297	268	1	3	1	1	0
LCITE-215	29	120	91	1	3	1	1	0
LCITE-216	29	477	448	0	3	1	0	1
LCITE-216	30	111	81	1	3	3	1	1
LCITE-216	31	35	4	1	3	1	1	0
LCITE-216	34	477	443	0	3	1	0	0
LCITE-216	34	111	77	1	3	4	1	0
LCITE-216	35	477	442	0	3	1	0	0
LCITE-216	35	477	442	0	2	1	0	1
LCITE-216	36	239	203	1	3	1	0	0
LCITE-216	36	477	441	0	4	5	0	0
LCITE-216	36	477	441	0	4	3	0	0
LCITE-217	36	47	11	1	3	2	1	4
LCITE-217	37	38	1	1	3	1	0	0
LCITE-217	38	55	17	1	5	4	0	0
LCITE-217	38	477	439	0	4	4	0	0
LCITE-217	38	477	439	0	5	3	0	0
LCITE-217	42	477	435	0	3	3	0	0
LCITE-217	43	44	1	1	3	5	0	0
LCITE-217	44	45	1	1	3	1	1	1
LCITE-217	44	45	1	1	3	4	1	0
LCITE-217	44	51	7	1	3	4	1	1
LCITE-218	45	46	1	1	3	1	1	0
LCITE-218	46	93	47	1	3	3	1	4
LCITE-218	46	67	21	1	3	1	1	4
LCITE-218	46	53	7	1	4	1	1	1
LCITE-218	46	477	431	0	4	1	0	1
LCITE-218	46	53	7	1	3	5	1	0
LCITE-218	47	477	430	0	4	2	0	0
LCITE-218	47	48	1	1	3	1	1	0
LCITE-218	51	83	32	1	3	1	1	2
LCITE-218	52	53	1	1	3	1	1	1
LCITE-219	53	54	1	1	3	4	1	0
LCITE-219	54	71	17	1	3	3	1	3
LCITE-219	54	55	1	1	3	1	1	1
LCITE-219	56	57	1	1	3	4	1	1
LCITE-219	56	477	421	0	4	2	0	0
LCITE-219	57	60	3	1	3	1	1	0
LCITE-219	58	59	1	1	5	1	1	0
LCITE-219	59	70	11	1	3	1	1	1
LCITE-219	59	477	418	0	3	1	0	0
LCITE-219	60	63	3	1	5	4	1	0
LCITE-220	60	62	2	1	3	1	1	2
LCITE-220	61	85	24	1	3	3	1	1
LCITE-220	62	477	415	0	3	4	1	0
LCITE-220	62	66	4	1	4	1	1	1
LCITE-220	63	477	414	0	3	1	0	0
LCITE-220	64	83	19	1	3	1	1	3
LCITE-220	65	100	35	1	3	1	1	1
LCITE-220	65	71	6	1	2	3	1	3
LCITE-220	66	477	411	0	3	1	0	0
LCITE-220	68	477	409	0	3	2	0	0
LCITE-221	69	72	3	1	3	4	1	3
LCITE-221	71	477	406	0	3	1	0	0
LCITE-221	71	72	1	1	2	3	1	3
LCITE-221	72	73	1	1	3	1	1	0
LCITE-221	72	477	405	0	3	2	0	0
LCITE-221	74	75	1	1	4	3	1	1
LCITE-221	74	98	24	1	4	4	1	1
LCITE-221	74	75	1	1	3	3	0	0
LCITE-221	76	117	41	1	3	4	1	0
LCITE-221	77	164	87	1	3	1	1	0
LCITE-222	80	86	6	1	3	3	1	0
LCITE-222	80	477	397	0	3	3	0	0
LCITE-222	81	92	11	1	3	1	1	0
LCITE-222	83	477	394	0	2	1	0	4
LCITE-222	85	311	226	1	3	1	1	1
LCITE-222	85	86	1	1	3	1	1	3
LCITE-222	86	92	6	1	3	1	1	1
LCITE-222	86	112	26	1	3	1	1	1
LCITE-222	86	141	55	1	3	1	0	1
LCITE-222	86	87	1	1	3	1	1	0
LCITE-223	87	477	390	0	3	1	0	0
LCITE-223	87	477	390	0	3	1	0	0
LCITE-223	88	89	1	1	3	1	1	0
LCITE-223	90	477	387	0	3	1	0	0
LCITE-223	91	477	386	0	3	1	0	0
LCITE-223	91	207	116	1	3	1	0	0
LCITE-223	92	95	3	1	3	1	1	1
LCITE-223	92	100	8	1	3	1	1	4
LCITE-223	92	102	10	1	3	1	1	2
LCITE-223	92	102	10	1	3	1	1	2
LCITE-224	94	95	1	1	3	4	1	0
LCITE-224	94	477	383	0	3	4	0	3
LCITE-224	95	98	3	1	3	1	1	2
LCITE-224	98	477	379	0	3	1	0	0
LCITE-224	98	477	379	0	3	1	0	0
LCITE-224	98	477	379	0	3	5	0	0
LCITE-224	99	477	378	0	4	1	0	0
LCITE-224	99	145	46	1	3	4	1	4
LCITE-224	99	100	1	1	3	2	0	0
LCITE-224	100	372	272	1	3	1	1	1
LCITE-225	101	477	376	0	3	1	0	1
LCITE-225	101	477	376	0	3	2	0	1
LCITE-225	103	477	374	0	4	4	0	0
LCITE-225	103	105	2	1	3	1	1	1
LCITE-225	103	477	374	0	3	4	0	1
LCITE-225	103	185	82	1	3	4	2	2
LCITE-225	104	477	373	0	3	1	0	0
LCITE-225	104	424	320	1	3	4	1	4
LCITE-225	104	105	1	1	3	4	1	2
LCITE-225	105	189	84	1	3	1	1	1
LCITE-226	105	477	372	0	3	1	0	0
LCITE-226	106	109	3	1	3	4	1	1
LCITE-226	106	127	21	1	3	1	1	0
LCITE-226	107	477	370	0	3	1	0	0
LCITE-226	107	115	8	1	3	1	1	0
LCITE-226	107	141	34	1	3	1	1	0
LCITE-226	108	312	204	1	3	5	1	1
LCITE-226	108	109	1	1	3	1	1	0
LCITE-226	109	117	8	1	5	4	1	1
LCITE-226	109	451	342	1	3	4	1	1
LCITE-227	109	477	368	0	3	1	0	0
LCITE-227	109	239	130	1	3	1	1	1
LCITE-227	110	118	8	1	3	4	1	4
LCITE-227	111	477	366	0	3	1	0	0
LCITE-227	112	477	365	0	3	4	1	2
LCITE-227	112	115	3	1	3	1	1	2
LCITE-227	112	128	16	1	3	1	1	0
LCITE-227	113	114	1	1	3	1	1	0
LCITE-227	113	140	27	1	3	1	1	0
LCITE-227	114	477	363	0	3	1	0	0
LCITE-228	114	189	75	1	3	1	1	3
LCITE-228	115	179	64	1	3	1	1	1
LCITE-228	115	477	362	0	3	1	0	0
LCITE-228	115	477	362	0	3	1	0	0
LCITE-228	115	135	20	1	2	4	1	0
LCITE-228	115	165	50	1	3	4	1	0
LCITE-228	115	172	57	1	3	4	1	0
LCITE-228	116	120	4	1	3	1	1	0
LCITE-228	117	422	305	1	3	1	1	0
LCITE-228	118	371	253	1	4	4	1	2
LCITE-229	119	422	303	1	3	1	1	0
LCITE-229	120	177	57	1	3	1	1	0
LCITE-229	120	477	357	0	3	1	0	0
LCITE-229	120	121	1	1	3	1	1	1
LCITE-229	121	149	28	1	3	4	1	0
LCITE-229	121	477	356	0	2	1	0	0
LCITE-229	121	477	356	0	3	4	1	2
LCITE-229	121	477	356	0	3	1	0	0
LCITE-229	121	477	356	0	3	1	0	0
LCITE-229	122	189	67	1	4	1	2	1
LCITE-230	122	477	355	0	3	4	0	0
LCITE-230	124	401	277	1	4	1	1	1
LCITE-230	126	477	351	0	3	4	0	1
LCITE-230	127	179	52	1	3	1	2	3
LCITE-230	127	189	62	1	3	1	1	1
LCITE-230	128	130	2	1	3	1	1	0
LCITE-230	129	130	1	1	3	1	1	0
LCITE-230	129	477	348	0	3	4	0	0
LCITE-230	130	477	347	0	3	1	0	0
LCITE-230	133	134	1	1	3	1	1	0
LCITE-231	134	477	343	0	4	4	0	1
LCITE-231	134	159	25	1	3	1	1	2
LCITE-231	135	477	342	0	3	2	0	0
LCITE-231	135	477	342	0	3	1	0	0
LCITE-231	135	148	13	1	3	1	1	2
LCITE-231	136	477	341	0	3	1	0	0
LCITE-231	137	140	3	1	3	1	1	0
LCITE-231	137	477	340	0	3	1	0	0
LCITE-231	137	151	14	1	4	1	1	0
LCITE-231	140	163	23	1	3	1	1	0
LCITE-232	140	142	2	1	3	1	1	0
LCITE-232	140	158	18	1	3	2	1	1
LCITE-232	141	477	336	0	3	4	0	0
LCITE-232	142	173	31	1	3	1	1	0
LCITE-232	143	162	19	1	3	1	1	1
LCITE-232	143	477	334	0	3	1	0	1
LCITE-232	144	477	333	0	3	4	0	4
LCITE-232	144	239	95	1	3	1	1	0
LCITE-232	144	356	212	1	4	1	1	0
LCITE-232	144	163	19	1	3	4	1	0
LCITE-233	144	176	32	1	3	1	1	4
LCITE-233	148	195	47	1	2	1	1	2
LCITE-233	148	149	1	1	3	1	1	2
LCITE-233	148	149	1	1	5	3	2	0
LCITE-233	148	149	1	1	4	4	1	1
LCITE-233	149	239	90	1	3	3	1	0
LCITE-233	149	477	328	0	3	1	0	0
LCITE-233	149	200	51	1	3	3	1	3
LCITE-233	149	424	275	1	3	1	1	2
LCITE-233	149	477	328	0	3	1	0	3
LCITE-234	150	428	278	1	3	1	1	1
LCITE-234	150	163	13	1	4	1	2	0
LCITE-234	150	185	35	1	3	1	1	0
LCITE-234	150	477	327	0	3	1	0	0
LCITE-234	150	373	223	1	3	1	1	0
LCITE-234	150	151	1	1	3	4	1	1
LCITE-234	150	477	327	0	4	1	0	0
LCITE-234	151	171	20	1	3	4	1	1
LCITE-234	151	477	326	0	3	1	0	0
LCITE-234	151	356	205	1	4	1	1	0
LCITE-235	151	152	1	1	3	1	1	0
LCITE-235	152	477	325	0	3	1	0	0
LCITE-235	155	159	4	1	3	1	1	0
LCITE-235	155	158	3	1	3	1	1	0
LCITE-235	156	477	321	0	2	1	0	0
LCITE-235	157	163	6	1	3	1	1	0
LCITE-235	158	477	319	0	3	1	0	0
LCITE-235	161	163	2	1	4	1	1	0
LCITE-235	162	164	2	1	3	1	1	0
LCITE-235	162	179	17	1	3	1	1	1
LCITE-236	163	477	314	0	4	1	0	0
LCITE-236	164	165	1	1	5	4	1	1
LCITE-236	164	477	313	0	3	1	0	0
LCITE-236	165	477	312	0	3	4	0	0
LCITE-236	165	178	13	1	4	5	1	0
LCITE-236	165	179	14	1	3	1	1	2
LCITE-236	166	193	27	1	3	2	1	0
LCITE-236	166	167	1	1	4	4	1	0
LCITE-236	166	173	7	1	3	1	1	0
LCITE-236	168	173	5	1	3	1	1	0
LCITE-237	169	173	4	1	3	1	1	0
LCITE-237	170	477	307	0	3	3	0	0
LCITE-237	172	173	1	1	3	3	1	0
LCITE-237	172	477	305	0	4	1	0	0
LCITE-237	172	191	19	1	5	4	0	0
LCITE-237	172	372	200	1	3	1	1	0
LCITE-237	172	189	17	1	3	4	1	2
LCITE-237	175	477	302	0	4	1	0	0
LCITE-237	175	477	302	0	3	4	0	0
LCITE-237	175	182	7	1	3	1	1	0
LCITE-238	175	176	1	1	3	1	1	0
LCITE-238	176	189	13	1	5	4	2	0
LCITE-238	176	179	3	1	2	1	1	0
LCITE-238	176	189	13	1	3	1	1	0
LCITE-238	176	190	14	1	3	1	1	0
LCITE-238	177	318	141	1	3	1	1	0
LCITE-238	177	178	1	1	3	4	1	0
LCITE-238	178	179	1	1	3	1	1	0
LCITE-238	179	180	1	1	3	1	1	0
LCITE-239	180	186	6	1	3	1	1	1
LCITE-239	181	182	1	1	3	1	1	0
LCITE-239	182	185	3	1	3	1	1	1
LCITE-239	182	183	1	1	3	1	1	0
LCITE-239	182	477	295	0	3	1	0	0
LCITE-239	183	477	294	0	3	2	0	0
LCITE-239	183	189	6	1	3	1	1	0
LCITE-239	183	477	294	0	3	4	0	0
LCITE-239	183	189	6	1	3	1	1	0
LCITE-239	183	477	294	0	3	1	0	0
LCITE-240	184	477	293	0	3	1	0	2
LCITE-240	185	477	292	0	3	1	0	1
LCITE-240	185	224	39	1	3	1	1	0
LCITE-240	185	189	4	1	3	1	1	1
LCITE-240	186	296	110	1	1	1	1	1
LCITE-240	189	305	116	1	3	2	1	2
LCITE-240	189	477	288	0	3	2	0	1
LCITE-240	189	477	288	0	4	4	0	0
LCITE-240	189	337	148	1	3	1	1	2
LCITE-240	191	194	3	1	3	1	1	0
LCITE-241	191	192	1	1	3	4	1	1
LCITE-241	191	477	286	0	3	1	0	0
LCITE-241	191	331	140	1	3	4	1	1
LCITE-241	193	265	72	1	2	1	1	0
LCITE-241	193	477	284	0	3	2	0	0
LCITE-241	195	477	282	0	2	1	0	1
LCITE-241	196	212	16	1	3	1	1	2
LCITE-241	197	205	8	1	3	1	1	0
LCITE-241	197	247	50	1	3	1	1	1
LCITE-241	198	208	10	1	3	4	1	1
LCITE-242	198	203	5	1	3	1	1	0
LCITE-242	199	477	278	0	4	1	0	2
LCITE-242	200	210	10	1	3	1	1	0
LCITE-242	200	477	277	0	3	1	0	1
LCITE-242	203	217	14	1	3	1	0	0
LCITE-242	203	337	134	1	3	1	1	0
LCITE-242	204	477	273	0	2	1	0	0
LCITE-242	204	477	273	0	3	1	0	1
LCITE-242	210	355	145	1	3	1	1	1
LCITE-242	210	211	1	1	3	1	1	0
LCITE-243	210	211	1	1	3	1	1	0
LCITE-243	210	211	1	1	3	1	1	0
LCITE-243	211	477	266	0	3	1	0	0
LCITE-243	211	247	36	1	3	1	1	2
LCITE-243	211	247	36	1	3	1	1	0
LCITE-243	212	213	1	1	3	1	1	2
LCITE-243	212	477	265	0	3	4	0	0
LCITE-243	212	372	160	1	3	1	1	0
LCITE-243	213	278	65	1	2	1	1	2
LCITE-243	213	477	264	0	3	1	0	0
LCITE-244	214	232	18	1	3	1	0	0
LCITE-244	214	304	90	1	3	1	1	0
LCITE-244	214	477	263	0	3	1	0	2
LCITE-244	214	317	103	1	3	4	1	0
LCITE-244	214	259	45	1	3	1	1	1
LCITE-244	214	215	1	1	3	4	0	0
LCITE-244	214	224	10	1	3	1	1	0
LCITE-244	214	224	10	1	3	1	1	0
LCITE-244	217	477	260	0	3	1	0	0
LCITE-244	218	477	259	0	3	4	0	2
LCITE-245	218	477	259	0	3	5	0	0
LCITE-245	218	477	259	0	3	5	0	2
LCITE-245	218	477	259	0	3	5	0	0
LCITE-245	218	477	259	0	5	4	0	1
LCITE-245	219	401	182	1	3	1	1	1
LCITE-245	219	477	258	0	3	1	0	0
LCITE-245	219	463	244	1	3	1	1	1
LCITE-245	219	477	258	0	3	4	0	1
LCITE-245	219	266	47	1	3	4	1	1
LCITE-245	220	477	257	0	4	4	0	0
LCITE-246	220	477	257	0	4	4	0	0
LCITE-246	220	477	257	0	3	4	0	0
LCITE-246	221	231	10	1	3	5	1	0
LCITE-246	221	357	136	1	3	1	1	0
LCITE-246	222	417	195	1	3	1	1	1
LCITE-246	225	226	1	1	3	4	1	0
LCITE-246	225	227	2	1	3	1	1	0
LCITE-246	226	238	12	1	4	4	2	2
LCITE-246	227	339	112	1	3	1	1	1
LCITE-246	227	246	19	1	2	1	1	2
LCITE-247	227	242	15	1	3	1	1	0
LCITE-247	227	368	141	1	3	1	1	2
LCITE-247	228	477	249	0	3	1	0	0
LCITE-247	229	247	18	1	3	1	1	0
LCITE-247	230	247	17	1	3	1	1	0
LCITE-247	230	247	17	1	3	1	1	0
LCITE-247	230	247	17	1	3	1	1	0
LCITE-247	230	247	17	1	3	1	1	0
LCITE-247	230	247	17	1	3	1	1	0
LCITE-247	230	247	17	1	3	1	1	0
LCITE-248	230	231	1	1	3	1	1	0
LCITE-248	231	238	7	1	3	1	1	1
LCITE-248	233	477	244	0	3	1	0	0
LCITE-248	233	477	244	0	3	1	0	0
LCITE-248	234	247	13	1	3	1	1	1
LCITE-248	234	477	243	0	3	1	0	0
LCITE-248	234	262	28	1	3	4	2	2
LCITE-248	234	235	1	1	3	1	1	0
LCITE-248	234	235	1	1	3	1	0	0
LCITE-248	238	477	239	0	3	1	0	0
LCITE-249	238	477	239	0	3	1	0	0
LCITE-249	238	243	5	1	3	1	1	1
LCITE-249	239	477	238	0	3	2	0	0
LCITE-249	239	240	1	1	5	3	1	0
LCITE-249	239	240	1	1	3	1	1	0
LCITE-249	239	240	1	1	3	1	1	0
LCITE-249	239	477	238	0	3	1	0	0
LCITE-249	239	240	1	1	4	3	1	1
LCITE-249	239	243	4	1	3	1	1	0
LCITE-249	239	477	238	0	4	3	1	0
LCITE-250	240	241	1	1	3	4	1	0
LCITE-250	240	252	12	1	3	3	1	0
LCITE-250	240	477	237	0	3	1	0	0
LCITE-250	240	249	9	1	3	4	1	0
LCITE-250	240	260	20	1	3	5	1	0
LCITE-250	240	254	14	1	3	1	1	0
LCITE-250	240	273	33	1	3	1	1	1
LCITE-250	240	477	237	0	4	4	0	0
LCITE-250	241	477	236	0	3	1	0	0
LCITE-250	241	477	236	0	3	1	0	0
LCITE-251	241	477	236	0	3	3	1	1
LCITE-251	241	275	34	1	3	1	1	1
LCITE-251	241	243	2	1	3	1	1	0
LCITE-251	241	242	1	1	4	3	1	0
LCITE-251	242	245	3	1	3	1	1	0
LCITE-251	242	477	235	0	3	1	0	1
LCITE-251	242	477	235	0	3	1	0	1
LCITE-251	242	477	235	0	3	1	0	1
LCITE-251	242	265	23	1	3	4	1	0
LCITE-251	242	243	1	1	3	4	1	0
LCITE-252	242	243	1	1	3	1	1	0
LCITE-252	243	247	4	1	3	1	1	0
LCITE-252	243	244	1	1	3	1	1	0
LCITE-252	243	247	4	1	3	1	1	0
LCITE-252	243	257	14	1	3	1	1	0
LCITE-252	246	262	16	1	3	1	1	1
LCITE-252	246	265	19	1	3	4	1	0
LCITE-252	246	262	16	1	3	1	1	0
LCITE-252	246	262	16	1	3	1	1	4
LCITE-252	246	337	91	1	3	4	1	1
LCITE-253	247	477	230	0	4	1	0	0
LCITE-253	247	248	1	1	3	3	1	0
LCITE-253	247	248	1	1	4	3	1	0
LCITE-253	247	248	1	1	4	3	1	0
LCITE-253	247	248	1	1	3	3	1	0
LCITE-253	247	259	12	1	3	1	1	2
LCITE-253	247	252	5	1	4	3	1	0
LCITE-253	247	259	12	1	4	4	1	0
LCITE-253	247	248	1	1	3	1	1	1
LCITE-253	248	477	229	0	3	1	0	1
LCITE-254	248	477	229	0	3	1	0	1
LCITE-254	248	477	229	0	3	1	0	0
LCITE-254	250	335	85	1	3	1	1	3
LCITE-254	251	252	1	1	3	1	1	0
LCITE-254	252	253	1	1	4	3	1	0
LCITE-254	252	253	1	1	3	1	1	0
LCITE-254	252	259	7	1	3	1	1	1
LCITE-254	252	253	1	1	4	3	1	1
LCITE-254	252	253	1	1	3	3	1	1
LCITE-254	252	260	8	1	3	3	1	0
LCITE-255	253	254	1	1	4	3	1	0
LCITE-255	253	255	2	1	2	1	1	0
LCITE-255	253	477	224	0	3	1	0	0
LCITE-255	254	477	223	0	3	1	0	0
LCITE-255	254	372	118	1	4	4	1	0
LCITE-255	255	261	6	1	3	4	1	1
LCITE-255	255	264	9	1	3	4	1	1
LCITE-255	256	477	221	0	3	1	0	0
LCITE-255	257	258	1	1	3	5	1	1
LCITE-255	258	259	1	1	3	1	1	1
LCITE-256	258	477	219	0	3	4	0	0
LCITE-256	258	477	219	0	4	1	0	0
LCITE-256	258	263	5	1	3	1	1	0
LCITE-256	258	259	1	1	3	1	1	0
LCITE-256	258	477	219	0	3	1	0	0
LCITE-256	258	477	219	0	3	1	0	0
LCITE-256	258	477	219	0	2	1	0	0
LCITE-256	259	261	2	1	3	1	1	0
LCITE-256	259	260	1	1	3	4	1	1
LCITE-256	260	477	217	0	3	1	0	0
LCITE-257	261	262	1	1	4	4	2	0
LCITE-257	261	266	5	1	3	1	1	0
LCITE-257	261	262	1	1	3	1	1	0
LCITE-257	261	262	1	1	3	1	1	0
LCITE-257	261	262	1	1	4	3	3	0
LCITE-257	261	355	94	1	3	1	1	4
LCITE-257	261	336	75	1	3	3	1	2
LCITE-257	261	262	1	1	3	3	2	0
LCITE-257	262	264	2	1	3	4	1	0
LCITE-257	262	370	108	1	3	3	1	0
LCITE-258	262	267	5	1	3	1	1	2
LCITE-258	262	263	1	1	3	1	1	0
LCITE-258	262	416	154	1	4	4	1	0
LCITE-258	262	263	1	1	3	4	1	0
LCITE-258	263	264	1	1	3	5	1	0
LCITE-258	263	264	1	1	3	4	1	0
LCITE-258	263	266	3	1	3	1	1	0
LCITE-258	265	266	1	1	3	4	1	0
LCITE-258	265	267	2	1	3	4	1	0
LCITE-258	265	477	212	0	3	4	0	1
LCITE-259	265	266	1	1	3	4	1	2
LCITE-259	265	266	1	1	2	1	1	0
LCITE-259	265	477	212	0	3	1	0	2
LCITE-259	267	477	210	0	3	1	0	2
LCITE-259	267	268	1	1	3	1	2	0
LCITE-259	267	268	1	1	3	4	1	1
LCITE-259	268	337	69	1	1	1	1	1
LCITE-259	270	477	207	0	4	1	0	0
LCITE-259	270	477	207	0	3	3	0	0
LCITE-259	271	434	163	1	3	4	1	0
LCITE-260	271	477	206	0	3	4	0	0
LCITE-260	271	477	206	0	3	4	0	0
LCITE-260	271	477	206	0	3	1	0	0
LCITE-260	272	477	205	0	3	1	0	0
LCITE-260	275	280	5	1	3	3	1	4
LCITE-260	275	308	33	1	3	1	1	2
LCITE-260	275	477	202	0	3	1	0	0
LCITE-260	275	477	202	0	3	4	0	0
LCITE-260	276	477	201	0	3	4	0	0
LCITE-260	276	323	47	1	3	1	0	1
LCITE-261	276	477	201	0	3	1	0	0
LCITE-261	276	281	5	1	3	1	1	1
LCITE-261	276	477	201	0	3	1	0	0
LCITE-261	277	323	46	1	3	1	1	0
LCITE-261	277	477	200	0	3	1	0	0
LCITE-261	280	289	9	1	3	3	1	0
LCITE-261	281	477	196	0	3	1	0	1
LCITE-261	282	301	19	1	3	4	1	1
LCITE-261	282	477	195	0	3	1	0	1
LCITE-261	283	335	52	1	3	4	1	1
LCITE-262	283	289	6	1	3	4	1	0
LCITE-262	283	428	145	1	3	4	1	1
LCITE-262	283	284	1	1	4	1	1	0
LCITE-262	284	371	87	1	4	4	1	0
LCITE-262	284	477	193	0	3	4	0	0
LCITE-262	284	368	84	1	3	1	1	0
LCITE-262	284	477	193	0	3	1	0	0
LCITE-262	288	477	189	0	3	4	0	0
LCITE-262	289	297	8	1	3	1	1	0
LCITE-262	289	372	83	1	4	1	1	0
LCITE-263	290	477	187	0	3	4	0	4
LCITE-263	290	297	7	1	3	1	1	1
LCITE-263	290	335	45	1	3	1	1	1
LCITE-263	291	477	186	0	3	1	0	0
LCITE-263	291	477	186	0	3	4	0	1
LCITE-263	292	373	81	1	3	4	1	0
LCITE-263	295	477	182	0	3	1	0	0
LCITE-263	295	335	40	1	3	1	1	0
LCITE-263	296	301	5	1	3	1	1	1
LCITE-263	296	297	1	1	1	1	1	1
LCITE-264	297	477	180	0	3	2	0	0
LCITE-264	297	477	180	0	3	1	0	0
LCITE-264	297	298	1	1	3	1	1	0
LCITE-264	298	309	11	1	3	1	0	1
LCITE-264	301	302	1	1	3	1	0	1
LCITE-264	301	477	176	0	3	1	0	1
LCITE-264	301	302	1	1	3	1	1	1
LCITE-264	301	304	3	1	3	1	1	0
LCITE-264	302	477	175	0	3	1	0	0
LCITE-264	303	477	174	0	4	4	0	1
LCITE-265	303	304	1	1	4	4	1	1
LCITE-265	303	319	16	1	3	4	1	0
LCITE-265	304	311	7	1	3	1	1	0
LCITE-265	305	308	3	1	4	4	0	0
LCITE-265	307	311	4	1	3	1	1	0
LCITE-265	309	310	1	1	4	4	2	3
LCITE-265	309	477	168	0	3	1	0	1
LCITE-265	310	311	1	1	3	1	1	0
LCITE-265	310	451	141	1	3	1	1	1
LCITE-265	310	477	167	0	3	1	0	0
LCITE-266	310	316	6	1	4	5	1	1
LCITE-266	311	316	5	1	3	1	1	0
LCITE-266	311	337	26	1	3	4	1	0
LCITE-266	312	351	39	1	4	4	1	0
LCITE-266	312	477	165	0	3	1	0	0
LCITE-266	314	477	163	0	3	1	0	0
LCITE-266	315	477	162	0	3	1	0	0
LCITE-266	316	477	161	0	3	1	0	0
LCITE-266	316	317	1	1	3	4	1	0
LCITE-266	316	317	1	1	3	1	1	0
LCITE-267	317	339	22	1	3	5	1	1
LCITE-267	317	477	160	0	3	4	0	0
LCITE-267	317	477	160	0	3	1	0	0
LCITE-267	317	331	14	1	3	4	1	0
LCITE-267	318	431	113	1	3	1	1	1
LCITE-267	318	322	4	1	3	1	1	2
LCITE-267	318	319	1	1	3	4	1	0
LCITE-267	319	433	114	1	3	1	1	1
LCITE-267	319	322	3	1	3	1	1	0
LCITE-267	320	335	15	1	3	1	1	0
LCITE-268	320	321	1	1	3	1	1	0
LCITE-268	321	322	1	1	3	1	1	0
LCITE-268	321	322	1	1	4	4	1	0
LCITE-268	321	477	156	0	3	1	0	1
LCITE-268	322	337	15	1	4	1	1	0
LCITE-268	323	325	2	1	3	1	1	0
LCITE-268	323	331	8	1	3	1	1	1
LCITE-268	323	336	13	1	3	4	1	0
LCITE-268	323	335	12	1	3	4	1	0
LCITE-269	324	477	153	0	3	4	0	1
LCITE-269	325	477	152	0	3	4	0	0
LCITE-269	325	477	152	0	3	5	0	0
LCITE-269	325	477	152	0	3	5	0	0
LCITE-269	325	477	152	0	3	5	0	0
LCITE-269	325	331	6	1	3	4	1	2
LCITE-269	325	477	152	0	3	1	0	1
LCITE-269	325	477	152	0	3	1	0	0
LCITE-269	325	331	6	1	3	4	1	1
LCITE-269	326	335	9	1	3	1	1	0
LCITE-270	326	477	151	0	4	4	0	0
LCITE-270	326	335	9	1	3	4	1	2
LCITE-270	326	477	151	0	3	1	0	0
LCITE-270	326	423	97	1	3	4	1	2
LCITE-270	329	477	148	0	1	1	1	0
LCITE-270	329	335	6	1	5	1	1	0
LCITE-270	329	330	1	1	3	1	0	1
LCITE-270	329	477	148	0	3	1	0	0
LCITE-270	329	477	148	0	3	1	0	0
LCITE-270	329	337	8	1	3	4	1	0
LCITE-271	329	330	1	1	3	1	0	0
LCITE-271	330	331	1	1	3	1	1	0
LCITE-271	330	477	147	0	3	1	0	0
LCITE-271	331	337	6	1	3	1	1	1
LCITE-271	331	335	4	1	5	4	1	0
LCITE-271	331	335	4	1	3	1	1	0
LCITE-271	331	337	6	1	3	1	1	2
LCITE-271	332	335	3	1	3	1	1	0
LCITE-271	332	333	1	1	3	1	1	0
LCITE-271	332	337	5	1	3	1	1	0
LCITE-272	333	335	2	1	3	1	1	0
LCITE-272	335	477	142	0	3	4	0	2
LCITE-272	336	420	84	1	3	1	1	0
LCITE-272	337	338	1	1	3	4	1	0
LCITE-272	337	338	1	1	3	4	1	0
LCITE-272	338	477	139	0	3	1	1	0
LCITE-272	338	339	1	1	3	1	1	0
LCITE-272	339	367	28	1	3	1	1	0
LCITE-272	339	406	67	1	4	4	1	0
LCITE-272	340	451	111	1	3	1	1	1
LCITE-273	340	346	6	1	3	1	1	0
LCITE-273	340	346	6	1	3	1	1	0
LCITE-273	340	367	27	1	3	5	1	0
LCITE-273	340	367	27	1	3	4	1	1
LCITE-273	344	477	133	0	3	4	0	0
LCITE-273	345	356	11	1	4	4	1	0
LCITE-273	345	477	132	0	3	4	1	0
LCITE-273	345	348	3	1	3	1	0	0
LCITE-273	345	477	132	0	4	4	0	0
LCITE-273	345	477	132	0	3	1	0	0
LCITE-274	347	477	130	0	3	5	0	0
LCITE-274	347	477	130	0	4	2	0	0
LCITE-274	348	477	129	0	3	4	0	0
LCITE-274	350	477	127	0	3	1	0	0
LCITE-274	350	452	102	1	3	1	0	0
LCITE-274	350	477	127	0	3	1	0	1
LCITE-274	351	477	126	0	3	1	0	0
LCITE-274	351	477	126	0	3	1	0	1
LCITE-274	351	477	126	0	3	1	0	0
LCITE-274	353	354	1	1	3	1	0	0
LCITE-275	354	421	67	1	3	1	1	0
LCITE-275	354	477	123	0	3	1	0	0
LCITE-275	356	477	121	0	3	1	0	0
LCITE-275	356	477	121	0	3	1	0	0
LCITE-275	359	459	100	1	3	2	1	1
LCITE-275	359	366	7	1	3	4	1	0
LCITE-275	359	360	1	1	3	1	0	0
LCITE-275	361	477	116	0	3	1	0	0
LCITE-275	362	477	115	0	4	4	0	0
LCITE-275	362	363	1	1	3	5	1	1
MEL-1210	1	239	238	1	4	2	1	0
MEL-1211	1	2	1	1	3	4	2	0
MEL-1211	1	5	4	1	3	1	2	0
MEL-1211	2	10	8	1	4	1	2	0
MEL-1211	2	3	1	1	3	4	2	0
MEL-1211	2	228	226	1	4	4	2	2
MEL-1211	2	65	63	1	3	3	1	0
MEL-1211	2	3	1	1	3	1	0	0
MEL-1211	2	8	6	1	4	4	0	0
MEL-1211	2	3	1	1	3	2	1	0
MEL-1211	2	8	6	1	4	4	0	0
MEL-1212	2	3	1	1	3	1	1	1
MEL-1212	3	4	1	1	3	1	0	0
MEL-1212	3	4	1	1	3	2	1	0
MEL-1212	3	57	54	1	3	1	1	0
MEL-1212	3	4	1	1	4	4	1	0
MEL-1212	3	9	6	1	4	4	1	0
MEL-1212	4	8	4	1	3	2	1	1
MEL-1212	5	8	3	1	3	2	1	0
MEL-1212	6	7	1	1	4	4	0	0
MEL-1212	6	7	1	1	4	5	2	0
MEL-1213	7	8	1	1	3	3	1	0
MEL-1213	8	9	1	1	4	1	3	0
MEL-1213	8	477	469	0	4	4	0	0
MEL-1213	8	21	13	1	4	3	1	0
MEL-1213	9	10	1	1	3	1	2	0
MEL-1213	11	12	1	1	4	4	1	0
MEL-1213	11	12	1	1	4	1	1	0
MEL-1213	11	15	4	1	3	2	1	0
MEL-1213	11	171	160	1	3	2	1	0
MEL-1213	11	12	1	1	3	4	1	0
MEL-1214	11	477	466	0	3	4	1	0
MEL-1214	13	18	5	1	4	1	1	0
MEL-1214	13	14	1	1	3	5	1	0
MEL-1214	14	18	4	1	3	4	1	0
MEL-1214	14	18	4	1	3	4	1	0
MEL-1214	14	15	1	1	3	4	1	0
MEL-1214	15	16	1	1	3	4	1	0
MEL-1214	15	16	1	1	4	4	1	0
MEL-1214	15	16	1	1	3	4	1	1
MEL-1214	16	17	1	1	3	1	3	0
MEL-1215	16	17	1	1	3	4	1	0
MEL-1215	16	17	1	1	3	4	1	0
MEL-1215	16	18	2	1	3	4	1	0
MEL-1215	16	17	1	1	3	3	1	0
MEL-1215	17	21	4	1	4	4	3	0
MEL-1215	17	21	4	1	3	3	1	0
MEL-1215	17	18	1	1	3	4	1	0
MEL-1215	17	18	1	1	3	1	1	0
MEL-1215	17	18	1	1	3	4	1	0
MEL-1215	18	19	1	1	3	4	1	0
MEL-1216	18	19	1	1	3	4	1	0
MEL-1216	18	19	1	1	3	4	1	0
MEL-1216	18	19	1	1	3	4	1	0
MEL-1216	18	19	1	1	3	4	1	0
MEL-1216	18	19	1	1	3	4	1	0
MEL-1216	18	19	1	1	4	4	1	0
MEL-1216	18	19	1	1	3	1	1	0
MEL-1216	21	39	18	1	3	2	1	0
MEL-1216	21	39	18	1	3	2	1	0
MEL-1216	21	477	456	0	3	2	0	0
MEL-1217	21	317	296	1	3	2	1	0
MEL-1217	21	22	1	1	3	4	1	0
MEL-1217	21	22	1	1	3	4	1	0
MEL-1217	21	22	1	1	3	4	1	0
MEL-1217	21	22	1	1	3	4	1	0
MEL-1217	21	22	1	1	3	4	1	0
MEL-1217	21	32	11	1	3	1	2	0
MEL-1217	21	22	1	1	3	2	1	0
MEL-1217	21	31	10	1	5	4	1	0
MEL-1217	22	477	455	0	3	2	0	0
MEL-1218	22	36	14	1	3	3	1	0
MEL-1218	22	31	9	1	3	1	3	0
MEL-1218	22	23	1	1	4	4	1	0
MEL-1218	22	25	3	1	3	2	1	0
MEL-1218	22	25	3	1	4	1	2	0
MEL-1218	22	25	3	1	3	2	1	1
MEL-1218	23	24	1	1	3	2	1	0
MEL-1218	23	24	1	1	3	2	1	0
MEL-1218	23	24	1	1	3	2	1	0
MEL-1218	23	24	1	1	3	2	1	0
MEL-1219	23	24	1	1	3	4	1	0
MEL-1219	23	477	454	0	3	3	1	0
MEL-1219	24	31	7	1	3	4	1	0
MEL-1219	24	25	1	1	3	1	3	0
MEL-1219	24	25	1	1	3	4	1	0
MEL-1219	25	31	6	1	3	1	1	0
MEL-1219	25	26	1	1	3	1	3	0
MEL-1219	25	26	1	1	4	4	1	0
MEL-1219	25	29	4	1	4	4	1	0
MEL-1219	25	27	2	1	3	1	0	0
MEL-1220	25	28	3	1	4	1	1	0
MEL-1220	25	477	452	0	3	2	1	0
MEL-1220	26	477	451	0	4	4	1	0
MEL-1220	27	28	1	1	3	3	3	0
MEL-1220	28	29	1	1	3	3	1	0
MEL-1220	28	29	1	1	3	4	1	0
MEL-1220	28	29	1	1	4	4	1	0
MEL-1220	28	29	1	1	4	4	0	0
MEL-1220	28	29	1	1	3	4	1	0
MEL-1220	28	30	2	1	4	5	1	0
MEL-1221	28	29	1	1	4	1	1	0
MEL-1221	28	29	1	1	3	1	1	0
MEL-1221	29	39	10	1	3	2	1	0
MEL-1221	29	387	358	1	4	4	2	3
MEL-1221	29	176	147	1	3	3	1	1
MEL-1221	29	30	1	1	4	4	1	0
MEL-1221	30	142	112	1	3	1	0	0
MEL-1221	30	31	1	1	3	1	1	0
MEL-1221	30	31	1	1	4	4	1	0
MEL-1221	31	477	446	0	3	4	0	0
MEL-1222	31	32	1	1	4	2	1	0
MEL-1222	31	64	33	1	3	2	1	0
MEL-1222	32	43	11	1	4	1	3	0
MEL-1222	32	33	1	1	5	3	1	0
MEL-1222	32	35	3	1	3	3	1	0
MEL-1222	32	33	1	1	3	3	1	0
MEL-1222	32	33	1	1	4	4	1	0
MEL-1222	34	38	4	1	3	3	1	0
MEL-1222	35	36	1	1	3	1	3	0
MEL-1222	35	234	199	1	4	1	1	0
MEL-1223	36	43	7	1	4	3	0	0
MEL-1223	36	37	1	1	3	3	1	0
MEL-1223	36	37	1	1	1	1	1	0
MEL-1223	36	40	4	1	4	4	1	0
MEL-1223	36	37	1	1	3	3	1	0
MEL-1223	36	37	1	1	4	4	1	0
MEL-1223	37	38	1	1	3	1	1	0
MEL-1223	37	39	2	1	3	2	1	0
MEL-1223	37	204	167	1	3	2	1	0
MEL-1223	37	38	1	1	3	3	1	0
MEL-1224	37	43	6	1	4	5	1	0
MEL-1224	38	39	1	1	3	3	1	0
MEL-1224	38	44	6	1	3	3	1	0
MEL-1224	38	41	3	1	3	3	0	0
MEL-1224	38	44	6	1	3	1	1	0
MEL-1224	38	39	1	1	3	1	0	0
MEL-1224	38	39	1	1	3	1	1	0
MEL-1224	38	39	1	1	3	1	1	0
MEL-1224	39	40	1	1	4	3	1	0
MEL-1224	39	43	4	1	3	1	1	0
MEL-1225	39	43	4	1	3	1	0	0
MEL-1225	39	40	1	1	3	4	4	2
MEL-1225	40	76	36	1	3	1	3	0
MEL-1225	40	41	1	1	3	4	1	1
MEL-1225	41	43	2	1	3	4	1	1
MEL-1225	41	42	1	1	3	1	2	0
MEL-1225	42	43	1	1	4	1	3	0
MEL-1225	42	43	1	1	3	4	0	0
MEL-1225	42	43	1	1	3	1	1	0
MEL-1225	42	43	1	1	3	1	0	0
MEL-1226	43	46	3	1	4	1	1	0
MEL-1226	43	44	1	1	3	3	1	0
MEL-1226	43	50	7	1	4	3	1	1
MEL-1226	43	477	434	0	4	1	0	1
MEL-1226	43	217	174	1	4	1	0	0
MEL-1226	43	46	3	1	4	4	1	0
MEL-1226	43	51	8	1	3	2	1	0
MEL-1226	45	46	1	1	3	4	1	0
MEL-1226	45	46	1	1	3	4	1	0
MEL-1226	45	46	1	1	3	2	1	0
MEL-1227	45	63	18	1	3	4	1	0
MEL-1227	46	477	431	0	4	1	0	0
MEL-1227	46	47	1	1	4	4	1	0
MEL-1227	46	56	10	1	3	3	1	0
MEL-1227	46	99	53	1	4	5	2	0
MEL-1227	46	47	1	1	3	2	1	0
MEL-1227	47	176	129	1	3	4	1	1
MEL-1227	49	50	1	1	3	1	0	0
MEL-1227	49	50	1	1	3	1	2	0
MEL-1227	49	50	1	1	4	1	1	0
MEL-1228	50	51	1	1	3	2	1	0
MEL-1228	50	477	427	0	3	4	1	1
MEL-1228	51	52	1	1	3	1	1	0
MEL-1228	51	52	1	1	3	4	1	0
MEL-1228	51	52	1	1	4	1	3	0
MEL-1228	52	86	34	1	3	2	1	0
MEL-1228	52	53	1	1	3	1	1	0
MEL-1228	53	56	3	1	4	1	1	0
MEL-1228	53	81	28	1	3	2	1	0
MEL-1228	53	56	3	1	3	1	3	1
MEL-1229	53	477	424	0	4	3	0	0
MEL-1229	53	63	10	1	3	1	3	3
MEL-1229	55	61	6	1	3	1	3	0
MEL-1229	56	57	1	1	4	4	3	0
MEL-1229	56	57	1	1	3	1	0	1
MEL-1229	56	61	5	1	4	2	1	0
MEL-1229	57	58	1	1	3	4	1	1
MEL-1229	57	60	3	1	3	3	1	0
MEL-1229	57	58	1	1	3	5	1	0
MEL-1229	57	58	1	1	4	3	1	0
MEL-1230	57	58	1	1	3	5	1	1
MEL-1230	57	58	1	1	3	5	1	0
MEL-1230	57	63	6	1	3	2	1	0
MEL-1230	58	59	1	1	3	3	1	0
MEL-1230	58	59	1	1	3	3	1	0
MEL-1230	58	59	1	1	3	4	3	0
MEL-1230	58	60	2	1	4	1	1	0
MEL-1230	59	477	418	0	4	3	0	0
MEL-1230	59	60	1	1	3	4	1	0
MEL-1230	59	63	4	1	3	4	1	0
MEL-1231	60	61	1	1	4	3	1	0
MEL-1231	60	61	1	1	3	4	1	0
MEL-1231	61	63	2	1	3	3	1	0
MEL-1231	61	62	1	1	3	3	1	0
MEL-1231	61	62	1	1	3	4	1	0
MEL-1231	61	62	1	1	4	1	1	0
MEL-1231	61	63	2	1	3	2	1	0
MEL-1231	61	477	416	0	3	2	1	0
MEL-1231	63	67	4	1	3	1	1	0
MEL-1231	63	477	414	0	3	2	1	1
MEL-1232	63	248	185	1	3	4	1	0
MEL-1232	63	64	1	1	4	4	1	0
MEL-1232	64	65	1	1	3	1	0	0
MEL-1232	64	455	391	1	3	4	2	0
MEL-1232	64	65	1	1	3	1	1	1
MEL-1232	64	81	17	1	3	1	2	0
MEL-1232	65	66	1	1	3	4	1	0
MEL-1232	65	66	1	1	3	4	1	0
MEL-1232	65	66	1	1	3	1	2	0
MEL-1232	65	66	1	1	3	4	1	1
MEL-1233	65	68	3	1	3	4	1	0
MEL-1233	65	477	412	0	3	2	1	0
MEL-1233	65	66	1	1	3	2	1	0
MEL-1233	65	66	1	1	3	1	1	0
MEL-1233	66	81	15	1	3	4	1	0
MEL-1233	66	67	1	1	3	1	3	0
MEL-1233	66	477	411	0	4	3	0	0
MEL-1233	67	80	13	1	4	4	3	0
MEL-1233	67	68	1	1	4	3	1	0
MEL-1233	67	68	1	1	4	4	1	0
MEL-1234	67	68	1	1	3	1	1	0
MEL-1234	67	68	1	1	3	4	1	0
MEL-1234	68	69	1	1	3	1	3	0
MEL-1234	70	71	1	1	3	1	0	0
MEL-1234	70	79	9	1	4	3	1	0
MEL-1234	70	81	11	1	3	1	2	0
MEL-1234	70	79	9	1	4	3	1	0
MEL-1234	70	148	78	1	3	3	1	0
MEL-1234	70	75	5	1	3	1	4	0
MEL-1234	71	72	1	1	3	1	0	0
MEL-1235	72	184	112	1	4	5	0	0
MEL-1235	72	73	1	1	4	3	1	0
MEL-1235	72	74	2	1	3	4	4	0
MEL-1235	73	74	1	1	4	4	1	0
MEL-1235	73	74	1	1	3	4	1	0
MEL-1235	74	75	1	1	4	1	3	0
MEL-1235	74	75	1	1	3	1	2	0
MEL-1235	74	75	1	1	3	4	2	0
MEL-1235	74	75	1	1	3	4	4	0
MEL-1235	74	79	5	1	3	1	3	1
MEL-1236	74	149	75	1	4	2	3	0
MEL-1236	75	76	1	1	3	1	0	0
MEL-1236	75	99	24	1	3	5	1	1
MEL-1236	75	76	1	1	4	4	1	2
MEL-1236	77	78	1	1	3	1	3	0
MEL-1236	77	148	71	1	4	3	1	0
MEL-1236	77	78	1	1	3	3	1	1
MEL-1236	77	81	4	1	3	1	1	0
MEL-1236	77	78	1	1	3	4	1	0
MEL-1236	77	78	1	1	3	4	1	0
MEL-1237	77	78	1	1	3	1	2	0
MEL-1237	77	78	1	1	3	1	0	0
MEL-1237	77	78	1	1	3	5	1	0
MEL-1237	77	80	3	1	3	5	1	0
MEL-1237	77	99	22	1	3	5	1	0
MEL-1237	77	176	99	1	3	5	1	0
MEL-1237	77	99	22	1	3	5	1	1
MEL-1237	77	80	3	1	3	5	1	0
MEL-1237	77	86	9	1	3	5	1	0
MEL-1237	77	78	1	1	3	1	2	0
MEL-1238	77	80	3	1	4	5	0	0
MEL-1238	78	79	1	1	3	3	1	0
MEL-1238	78	87	9	1	3	4	1	0
MEL-1238	78	122	44	1	3	5	1	0
MEL-1238	78	79	1	1	3	1	2	0
MEL-1238	78	79	1	1	3	5	1	0
MEL-1238	78	79	1	1	4	1	1	0
MEL-1238	79	92	13	1	3	5	1	0
MEL-1238	79	80	1	1	4	4	1	0
MEL-1238	79	80	1	1	3	4	1	0
MEL-1239	79	80	1	1	3	1	2	1
MEL-1239	80	81	1	1	3	2	1	0
MEL-1239	80	81	1	1	3	2	1	0
MEL-1239	80	85	5	1	3	4	1	0
MEL-1239	80	81	1	1	3	4	3	0
MEL-1239	80	102	22	1	4	1	3	0
MEL-1239	80	87	7	1	3	5	1	0
MEL-1239	81	82	1	1	3	2	1	0
MEL-1239	81	477	396	0	3	4	2	1
MEL-1239	81	85	4	1	3	1	2	1
MEL-1240	81	82	1	1	3	2	1	0
MEL-1240	81	82	1	1	3	4	1	0
MEL-1240	81	82	1	1	3	2	1	0
MEL-1240	83	86	3	1	3	4	1	0
MEL-1240	83	142	59	1	4	4	2	0
MEL-1240	84	85	1	1	3	3	1	0
MEL-1240	84	85	1	1	3	1	3	0
MEL-1240	84	85	1	1	3	1	2	0
MEL-1240	84	85	1	1	3	4	1	0
MEL-1240	84	164	80	1	3	3	0	1
MEL-1241	85	225	140	1	4	1	3	1
MEL-1241	86	477	391	0	4	2	0	0
MEL-1241	86	87	1	1	3	1	3	0
MEL-1241	86	477	391	0	3	4	1	0
MEL-1241	86	233	147	1	3	1	1	0
MEL-1241	87	96	9	1	4	1	2	0
MEL-1241	88	477	389	0	5	4	0	0
MEL-1241	91	107	16	1	3	4	0	0
MEL-1241	93	107	14	1	3	1	2	0
MEL-1241	93	94	1	1	3	4	2	0
MEL-1242	93	94	1	1	4	1	1	0
MEL-1242	93	94	1	1	3	4	1	0
MEL-1242	93	94	1	1	3	1	2	0
MEL-1242	94	99	5	1	3	5	1	0
MEL-1242	94	102	8	1	3	1	3	0
MEL-1242	94	95	1	1	3	1	3	0
MEL-1242	98	99	1	1	3	5	0	0
MEL-1242	98	99	1	1	3	4	2	0
MEL-1242	98	477	379	0	4	1	0	0
MEL-1242	99	100	1	1	4	4	2	0
MEL-1243	99	100	1	1	3	5	1	1
MEL-1243	99	100	1	1	3	3	1	0
MEL-1243	100	101	1	1	3	5	0	0
MEL-1243	100	105	5	1	4	1	1	0
MEL-1243	101	102	1	1	3	1	2	0
MEL-1243	101	102	1	1	3	1	3	0
MEL-1243	101	102	1	1	3	4	1	0
MEL-1243	101	102	1	1	3	4	2	0
MEL-1243	101	102	1	1	3	4	3	0
MEL-1244	101	102	1	1	3	4	1	0
MEL-1244	102	105	3	1	3	1	3	0
MEL-1244	102	122	20	1	3	4	1	0
MEL-1244	103	256	153	1	3	4	0	0
MEL-1244	105	106	1	1	3	4	3	1
MEL-1244	105	106	1	1	3	1	1	0
MEL-1244	105	106	1	1	3	4	2	0
MEL-1244	105	106	1	1	3	3	2	1
MEL-1244	105	108	3	1	3	1	2	0
MEL-1244	105	106	1	1	3	1	3	0
MEL-1245	105	431	326	1	4	2	1	0
MEL-1245	106	109	3	1	4	1	3	0
MEL-1245	106	477	371	0	4	4	0	0
MEL-1245	106	144	38	1	3	1	0	0
MEL-1245	107	108	1	1	3	1	3	0
MEL-1245	107	148	41	1	4	4	1	1
MEL-1245	107	112	5	1	4	1	0	0
MEL-1245	108	109	1	1	3	1	2	0
MEL-1245	108	109	1	1	3	4	2	0
MEL-1245	108	126	18	1	3	4	1	0
MEL-1246	108	115	7	1	3	5	1	0
MEL-1246	109	175	66	1	4	2	1	0
MEL-1246	109	115	6	1	3	4	1	0
MEL-1246	110	134	24	1	4	2	1	0
MEL-1246	110	477	367	0	3	4	0	0
MEL-1246	112	113	1	1	3	1	2	0
MEL-1246	112	113	1	1	4	4	1	0
MEL-1246	112	113	1	1	3	1	0	0
MEL-1246	113	114	1	1	3	3	2	0
MEL-1246	114	115	1	1	3	1	0	0
MEL-1247	114	477	363	0	4	3	1	0
MEL-1247	115	477	362	0	4	1	0	1
MEL-1247	116	477	361	0	3	1	0	0
MEL-1247	119	161	42	1	3	4	1	0
MEL-1247	120	121	1	1	3	1	1	0
MEL-1247	120	122	2	1	3	1	3	0
MEL-1247	120	133	13	1	3	4	1	0
MEL-1247	120	121	1	1	3	1	0	0
MEL-1247	120	128	8	1	3	2	1	0
MEL-1247	121	186	65	1	4	3	1	0
MEL-1248	122	125	3	1	4	1	3	0
MEL-1248	122	477	355	0	3	2	0	0
MEL-1248	123	124	1	1	3	4	1	0
MEL-1248	123	125	2	1	4	1	2	0
MEL-1248	123	277	154	1	3	1	3	0
MEL-1248	124	149	25	1	4	5	1	0
MEL-1248	124	239	115	1	4	5	1	0
MEL-1248	125	127	2	1	3	1	3	0
MEL-1248	125	144	19	1	4	3	1	0
MEL-1248	126	477	351	0	4	2	1	0
MEL-1249	126	135	9	1	3	1	2	1
MEL-1249	126	143	17	1	4	1	2	0
MEL-1249	127	477	350	0	3	4	0	0
MEL-1249	127	133	6	1	3	4	2	0
MEL-1249	128	177	49	1	4	3	1	1
MEL-1249	128	129	1	1	3	2	1	0
MEL-1249	128	136	8	1	3	5	1	0
MEL-1249	128	136	8	1	3	1	1	0
MEL-1249	128	136	8	1	3	1	1	0
MEL-1249	128	155	27	1	3	5	1	0
MEL-1250	128	129	1	1	3	1	1	0
MEL-1250	128	129	1	1	3	2	1	0
MEL-1250	129	149	20	1	4	5	1	0
MEL-1250	129	134	5	1	3	2	1	0
MEL-1250	129	477	348	0	3	5	2	0
MEL-1250	130	149	19	1	4	5	1	0
MEL-1250	130	132	2	1	3	1	3	0
MEL-1250	130	132	2	1	3	4	3	0
MEL-1250	131	132	1	1	3	1	0	0
MEL-1250	133	140	7	1	4	3	1	0
MEL-1251	133	217	84	1	3	1	0	0
MEL-1251	133	134	1	1	3	1	2	0
MEL-1251	133	134	1	1	3	5	1	0
MEL-1251	134	409	275	1	3	4	2	0
MEL-1251	134	135	1	1	3	4	2	0
MEL-1251	134	226	92	1	4	4	0	0
MEL-1251	134	135	1	1	3	3	0	0
MEL-1251	135	136	1	1	3	3	1	0
MEL-1251	135	149	14	1	4	5	1	0
MEL-1251	135	182	47	1	4	4	1	0
MEL-1252	135	227	92	1	4	4	1	0
MEL-1252	136	137	1	1	4	5	1	0
MEL-1252	137	176	39	1	4	3	1	0
MEL-1252	137	144	7	1	3	5	0	0
MEL-1252	138	140	2	1	4	3	1	0
MEL-1252	140	228	88	1	3	1	2	1
MEL-1252	140	141	1	1	4	2	1	0
MEL-1252	140	141	1	1	3	2	1	0
MEL-1252	140	477	337	0	4	3	1	0
MEL-1252	141	158	17	1	4	4	0	0
MEL-1253	141	176	35	1	3	2	1	0
MEL-1253	142	149	7	1	4	5	1	0
MEL-1253	142	143	1	1	3	1	3	0
MEL-1253	142	150	8	1	3	4	1	1
MEL-1253	143	155	12	1	4	2	1	0
MEL-1253	143	144	1	1	3	1	2	1
MEL-1253	143	151	8	1	3	1	3	0
MEL-1253	143	169	26	1	3	3	1	0
MEL-1253	144	148	4	1	3	1	0	0
MEL-1253	144	151	7	1	4	3	1	0
MEL-1254	146	147	1	1	4	1	2	1
MEL-1254	146	150	4	1	3	1	3	0
MEL-1254	148	156	8	1	3	4	1	0
MEL-1254	148	477	329	0	4	2	1	0
MEL-1254	148	149	1	1	3	3	1	0
MEL-1254	148	477	329	0	4	2	1	1
MEL-1254	149	239	90	1	3	4	1	0
MEL-1254	149	156	7	1	3	4	1	0
MEL-1254	150	154	4	1	3	1	3	0
MEL-1254	150	218	68	1	4	3	1	2
MEL-1255	150	151	1	1	3	1	3	0
MEL-1255	150	155	5	1	3	1	1	0
MEL-1255	150	153	3	1	4	3	1	1
MEL-1255	151	152	1	1	3	4	1	0
MEL-1255	154	190	36	1	3	4	1	0
MEL-1255	154	157	3	1	3	1	1	0
MEL-1255	157	158	1	1	4	4	1	1
MEL-1255	157	477	320	0	3	2	0	0
MEL-1255	158	159	1	1	3	1	2	0
MEL-1255	158	177	19	1	4	3	1	0
MEL-1256	158	159	1	1	3	1	2	0
MEL-1256	158	159	1	1	3	1	2	0
MEL-1256	158	160	2	1	3	1	2	0
MEL-1256	158	477	319	0	3	3	0	0
MEL-1256	159	161	2	1	3	3	1	0
MEL-1256	159	217	58	1	3	1	3	0
MEL-1256	159	160	1	1	3	2	1	0
MEL-1256	159	160	1	1	3	2	1	0
MEL-1256	160	192	32	1	4	1	1	0
MEL-1256	160	161	1	1	4	4	1	0
MEL-1257	161	162	1	1	3	1	2	2
MEL-1257	161	185	24	1	5	1	1	0
MEL-1257	161	162	1	1	3	4	1	0
MEL-1257	162	163	1	1	3	1	3	0
MEL-1257	162	163	1	1	3	1	0	0
MEL-1257	162	212	50	1	3	1	3	0
MEL-1257	163	164	1	1	3	3	1	1
MEL-1257	164	165	1	1	3	1	1	0
MEL-1257	164	175	11	1	4	4	1	1
MEL-1257	164	165	1	1	3	3	3	0
MEL-1258	164	175	11	1	4	4	1	0
MEL-1258	165	166	1	1	4	1	1	0
MEL-1258	165	166	1	1	3	3	1	0
MEL-1258	165	189	24	1	3	3	1	0
MEL-1258	165	176	11	1	3	4	1	0
MEL-1258	166	168	2	1	3	3	1	0
MEL-1258	166	170	4	1	3	3	1	0
MEL-1258	168	224	56	1	3	4	2	0
MEL-1258	169	179	10	1	3	4	3	0
MEL-1258	169	185	16	1	3	1	3	0
MEL-1259	169	218	49	1	4	1	1	0
MEL-1259	170	477	307	0	4	2	1	0
MEL-1259	172	477	305	0	4	4	1	0
MEL-1259	172	184	12	1	4	1	1	0
MEL-1259	174	189	15	1	3	1	3	1
MEL-1259	175	477	302	0	3	4	0	0
MEL-1259	175	477	302	0	3	4	0	0
MEL-1259	176	231	55	1	3	4	1	0
MEL-1259	176	477	301	0	3	2	0	0
MEL-1259	176	178	2	1	3	3	1	0
MEL-1260	177	178	1	1	3	4	1	0
MEL-1260	177	178	1	1	4	1	2	0
MEL-1260	177	178	1	1	3	1	2	0
MEL-1260	178	184	6	1	3	1	3	0
MEL-1260	179	477	298	0	3	3	0	0
MEL-1260	179	432	253	1	3	4	0	0
MEL-1260	179	182	3	1	3	1	3	0
MEL-1260	179	185	6	1	4	1	3	0
MEL-1260	179	477	298	0	3	2	0	0
MEL-1260	180	185	5	1	4	4	1	0
MEL-1261	181	235	54	1	4	1	1	0
MEL-1261	182	189	7	1	3	3	1	0
MEL-1261	182	183	1	1	3	3	1	0
MEL-1261	182	183	1	1	3	1	3	1
MEL-1261	183	184	1	1	3	5	1	0
MEL-1261	183	184	1	1	3	5	1	0
MEL-1261	183	184	1	1	3	5	1	0
MEL-1261	183	477	294	0	3	5	0	0
MEL-1261	183	477	294	0	3	5	1	1
MEL-1261	183	477	294	0	3	2	0	0
MEL-1262	183	477	294	0	3	1	0	0
MEL-1262	184	185	1	1	3	1	3	0
MEL-1262	184	185	1	1	4	4	1	0
MEL-1262	184	477	293	0	3	2	0	0
MEL-1262	184	193	9	1	4	1	3	0
MEL-1262	185	189	4	1	3	2	1	0
MEL-1262	185	189	4	1	4	1	3	0
MEL-1262	185	195	10	1	3	4	1	0
MEL-1262	186	189	3	1	3	4	1	0
MEL-1262	189	190	1	1	4	2	1	0
MEL-1263	189	190	1	1	3	1	4	0
MEL-1263	189	319	130	1	4	4	3	0
MEL-1263	190	191	1	1	3	3	3	0
MEL-1263	190	192	2	1	4	4	1	0
MEL-1263	190	191	1	1	4	4	1	0
MEL-1263	190	191	1	1	4	1	2	0
MEL-1263	190	191	1	1	3	4	1	0
MEL-1263	191	192	1	1	3	1	3	0
MEL-1263	191	219	28	1	3	1	3	0
MEL-1263	191	193	2	1	4	4	3	0
MEL-1264	191	196	5	1	4	4	1	0
MEL-1264	191	192	1	1	4	4	1	0
MEL-1264	191	203	12	1	3	2	1	0
MEL-1264	191	193	2	1	4	4	1	0
MEL-1264	192	198	6	1	3	2	1	3
MEL-1264	192	193	1	1	3	4	1	0
MEL-1264	192	195	3	1	3	4	1	0
MEL-1264	192	198	6	1	3	1	3	0
MEL-1264	193	194	1	1	3	1	1	0
MEL-1264	193	200	7	1	4	2	1	0
MEL-1265	193	195	2	1	4	4	1	0
MEL-1265	194	196	2	1	3	2	3	0
MEL-1265	196	477	281	0	3	2	0	0
MEL-1265	196	197	1	1	3	4	3	0
MEL-1265	196	204	8	1	4	1	3	0
MEL-1265	196	477	281	0	4	2	0	0
MEL-1265	196	212	16	1	3	1	3	0
MEL-1265	197	477	280	0	3	5	1	1
MEL-1265	197	198	1	1	3	3	3	0
MEL-1265	197	198	1	1	4	1	4	0
MEL-1266	197	221	24	1	3	4	1	1
MEL-1266	198	199	1	1	3	4	1	2
MEL-1266	198	477	279	0	4	4	1	0
MEL-1266	198	199	1	1	3	5	1	0
MEL-1266	198	199	1	1	3	3	1	0
MEL-1266	198	477	279	0	3	2	3	0
MEL-1266	198	199	1	1	3	2	1	0
MEL-1266	199	200	1	1	3	4	1	1
MEL-1266	199	225	26	1	3	1	0	0
MEL-1266	199	200	1	1	3	4	1	0
MEL-1267	199	203	4	1	3	4	1	0
MEL-1267	200	477	277	0	3	3	2	0
MEL-1267	201	477	276	0	3	4	0	0
MEL-1267	203	204	1	1	3	4	1	0
MEL-1267	203	207	4	1	4	4	1	0
MEL-1267	203	204	1	1	3	4	1	0
MEL-1267	203	204	1	1	4	1	0	0
MEL-1267	203	204	1	1	3	3	1	0
MEL-1267	204	477	273	0	4	1	0	0
MEL-1267	204	205	1	1	3	4	1	0
MEL-1268	204	205	1	1	3	1	2	1
MEL-1268	204	205	1	1	4	1	3	0
MEL-1268	205	206	1	1	4	4	1	0
MEL-1268	205	477	272	0	3	4	0	0
MEL-1268	205	459	254	1	3	4	2	0
MEL-1268	205	206	1	1	3	1	3	0
MEL-1268	205	477	272	0	4	2	1	0
MEL-1268	205	211	6	1	4	4	1	0
MEL-1268	206	207	1	1	3	4	1	0
MEL-1268	206	207	1	1	3	1	1	0
MEL-1269	206	207	1	1	3	1	1	0
MEL-1269	207	212	5	1	3	4	3	0
MEL-1269	207	208	1	1	3	4	2	0
MEL-1269	207	208	1	1	4	4	1	0
MEL-1269	207	477	270	0	4	4	1	0
MEL-1269	208	477	269	0	3	5	0	0
MEL-1269	208	211	3	1	3	4	1	0
MEL-1269	210	211	1	1	4	4	2	0
MEL-1269	210	277	67	1	4	4	1	0
MEL-1269	210	216	6	1	3	4	1	0
MEL-1270	211	217	6	1	3	3	1	0
MEL-1270	211	212	1	1	4	1	2	0
MEL-1270	211	212	1	1	3	4	1	0
MEL-1270	211	212	1	1	3	1	1	0
MEL-1270	212	214	2	1	3	4	1	0
MEL-1270	212	213	1	1	3	1	2	0
MEL-1270	213	231	18	1	3	3	1	0
MEL-1270	213	214	1	1	4	4	2	0
MEL-1270	214	381	167	1	3	4	2	0
MEL-1270	214	218	4	1	3	1	3	0
MEL-1271	214	215	1	1	3	4	1	0
MEL-1271	216	221	5	1	3	4	1	0
MEL-1271	217	263	46	1	3	1	0	0
MEL-1271	218	219	1	1	3	1	3	0
MEL-1271	218	219	1	1	3	4	1	0
MEL-1271	218	224	6	1	4	3	1	2
MEL-1271	219	220	1	1	3	3	1	0
MEL-1271	219	220	1	1	3	4	1	0
MEL-1271	220	221	1	1	3	4	0	0
MEL-1271	220	477	257	0	3	4	1	0
MEL-1272	220	225	5	1	3	1	3	0
MEL-1272	220	242	22	1	3	2	1	0
MEL-1272	220	225	5	1	3	1	0	0
MEL-1272	221	477	256	0	3	4	1	0
MEL-1272	221	222	1	1	3	1	3	0
MEL-1272	221	222	1	1	5	1	3	0
MEL-1272	222	223	1	1	3	1	1	0
MEL-1272	224	238	14	1	3	1	1	1
MEL-1272	225	233	8	1	3	1	1	0
MEL-1272	225	226	1	1	4	4	1	0
MEL-1273	226	227	1	1	3	3	1	0
MEL-1273	226	227	1	1	3	3	1	0
MEL-1273	226	227	1	1	3	1	2	1
MEL-1273	226	254	28	1	4	1	2	0
MEL-1273	226	227	1	1	3	2	1	0
MEL-1273	227	228	1	1	3	4	2	2
MEL-1273	227	231	4	1	3	3	1	0
MEL-1273	227	477	250	0	4	2	0	0
MEL-1273	227	276	49	1	4	4	0	0
MEL-1273	228	229	1	1	3	1	1	0
MEL-1274	228	231	3	1	3	1	3	0
MEL-1274	231	233	2	1	3	1	1	0
MEL-1274	232	234	2	1	3	3	1	0
MEL-1274	232	233	1	1	3	3	1	0
MEL-1274	232	233	1	1	3	1	1	0
MEL-1274	232	233	1	1	3	1	1	0
MEL-1274	232	233	1	1	3	1	3	0
MEL-1274	233	234	1	1	3	2	1	0
MEL-1274	233	234	1	1	3	1	1	0
MEL-1274	233	310	77	1	4	4	1	0
MEL-1275	235	477	242	0	3	2	1	0
MEL-1275	238	248	10	1	3	4	2	0
MEL-1275	238	239	1	1	3	3	1	0
MEL-1275	238	239	1	1	4	1	1	0
MEL-1275	239	240	1	1	3	3	3	0
MEL-1275	239	240	1	1	3	3	1	0
MEL-1275	239	246	7	1	3	4	2	0
MEL-1275	239	240	1	1	3	3	1	0
MEL-1275	239	246	7	1	3	1	3	0
MEL-1275	239	319	80	1	4	3	1	0
MEL-1276	239	240	1	1	3	3	1	0
MEL-1276	240	241	1	1	3	4	1	1
MEL-1276	240	241	1	1	3	1	3	0
MEL-1276	240	245	5	1	3	4	1	0
MEL-1276	240	477	237	0	3	1	1	0
MEL-1276	241	477	236	0	3	4	0	0
MEL-1276	243	477	234	0	4	2	2	0
MEL-1276	243	477	234	0	4	2	1	0
MEL-1276	244	245	1	1	4	4	1	0
MEL-1276	245	246	1	1	3	1	3	0
MEL-1277	245	246	1	1	3	4	1	0
MEL-1277	245	246	1	1	5	4	1	0
MEL-1277	246	477	231	0	3	5	1	0
MEL-1277	246	477	231	0	4	2	0	0
MEL-1277	246	323	77	1	3	1	3	0
MEL-1277	246	247	1	1	3	1	3	0
MEL-1277	246	247	1	1	3	1	0	0
MEL-1277	247	257	10	1	3	3	1	0
MEL-1277	247	248	1	1	3	1	2	0
MEL-1277	247	248	1	1	3	1	3	0
MEL-1278	247	248	1	1	1	1	1	0
MEL-1278	247	249	2	1	4	3	1	0
MEL-1278	248	250	2	1	4	1	2	0
MEL-1278	248	477	229	0	3	2	0	0
MEL-1278	248	256	8	1	3	2	1	0
MEL-1278	248	254	6	1	3	1	3	0
MEL-1278	249	276	27	1	5	1	3	0
MEL-1278	249	252	3	1	3	1	3	0
MEL-1278	249	253	4	1	3	3	0	0
MEL-1278	252	253	1	1	3	5	0	0
MEL-1279	252	253	1	1	3	5	0	0
MEL-1279	252	253	1	1	3	5	0	0
MEL-1279	252	395	143	1	3	3	2	1
MEL-1279	252	253	1	1	3	5	0	0
MEL-1279	252	253	1	1	3	5	0	0
MEL-1279	252	253	1	1	4	5	0	0
MEL-1279	252	253	1	1	4	5	0	0
MEL-1279	252	253	1	1	3	5	0	0
MEL-1279	252	253	1	1	3	5	0	0
MEL-1279	252	253	1	1	3	5	0	0
MEL-1280	252	253	1	1	3	5	0	0
MEL-1280	253	254	1	1	3	1	0	0
MEL-1280	253	254	1	1	3	3	1	0
MEL-1280	253	254	1	1	4	5	0	0
MEL-1280	253	254	1	1	3	1	0	0
MEL-1280	254	266	12	1	3	1	3	0
MEL-1280	255	256	1	1	3	4	1	0
MEL-1280	255	256	1	1	3	1	1	0
MEL-1280	255	477	222	0	3	2	0	0
MEL-1280	256	257	1	1	3	1	1	1
MEL-1281	256	318	62	1	3	2	1	0
MEL-1281	256	395	139	1	3	3	2	1
MEL-1281	256	477	221	0	3	1	0	0
MEL-1281	257	263	6	1	4	4	1	0
MEL-1281	257	395	138	1	3	3	2	1
MEL-1281	258	351	93	1	3	2	2	0
MEL-1281	259	263	4	1	3	3	1	0
MEL-1281	259	395	136	1	3	2	2	0
MEL-1281	259	395	136	1	3	3	2	4
MEL-1281	259	395	136	1	3	3	2	1
MEL-1282	260	261	1	1	3	1	2	0
MEL-1282	260	261	1	1	5	1	3	0
MEL-1282	261	262	1	1	3	2	1	0
MEL-1282	262	477	215	0	4	2	0	0
MEL-1282	262	265	3	1	3	2	1	0
MEL-1282	263	267	4	1	3	1	0	0
MEL-1282	263	266	3	1	3	1	1	0
MEL-1282	263	265	2	1	3	1	2	0
MEL-1282	266	269	3	1	3	2	1	0
MEL-1282	266	267	1	1	3	1	3	0
MEL-1283	266	274	8	1	3	1	2	0
MEL-1283	266	267	1	1	3	1	2	0
MEL-1283	267	268	1	1	3	4	1	0
MEL-1283	267	269	2	1	3	4	1	0
MEL-1283	267	477	210	0	3	5	0	0
MEL-1283	267	305	38	1	3	1	3	0
MEL-1283	268	269	1	1	3	1	2	0
MEL-1283	269	270	1	1	4	1	0	0
MEL-1283	269	270	1	1	3	1	3	0
MEL-1283	269	270	1	1	3	4	0	0
MEL-1284	269	477	208	0	3	2	1	0
MEL-1284	270	274	4	1	3	2	1	0
MEL-1284	270	271	1	1	3	1	1	0
MEL-1284	272	280	8	1	4	1	3	0
MEL-1284	273	274	1	1	3	1	3	0
MEL-1284	273	477	204	0	4	2	1	0
MEL-1284	273	274	1	1	3	2	1	1
MEL-1284	273	274	1	1	3	2	1	0
MEL-1284	274	275	1	1	4	1	1	1
MEL-1284	274	275	1	1	3	3	1	0
MEL-1285	275	276	1	1	3	1	3	0
MEL-1285	275	477	202	0	4	1	1	0
MEL-1285	275	276	1	1	4	1	3	0
MEL-1285	275	277	2	1	4	5	1	0
MEL-1285	275	477	202	0	3	2	0	0
MEL-1285	276	277	1	1	3	2	1	0
MEL-1285	276	477	201	0	3	2	0	0
MEL-1285	276	477	201	0	3	2	0	0
MEL-1285	276	477	201	0	3	2	0	0
MEL-1285	277	278	1	1	3	2	1	0
MEL-1286	277	278	1	1	3	1	1	0
MEL-1286	277	396	119	1	4	1	0	0
MEL-1286	280	281	1	1	3	1	0	0
MEL-1286	280	477	197	0	3	2	0	0
MEL-1286	280	477	197	0	4	4	0	0
MEL-1286	280	319	39	1	3	4	1	0
MEL-1286	280	477	197	0	4	4	0	0
MEL-1286	280	281	1	1	4	1	1	0
MEL-1286	280	477	197	0	3	4	0	1
MEL-1286	280	319	39	1	3	4	1	0
MEL-1287	281	282	1	1	3	1	3	0
MEL-1287	281	477	196	0	3	1	0	0
MEL-1287	281	477	196	0	4	4	0	1
MEL-1287	282	283	1	1	3	1	1	0
MEL-1287	283	284	1	1	3	1	1	0
MEL-1287	283	284	1	1	4	1	0	0
MEL-1287	284	477	193	0	3	4	0	0
MEL-1287	284	477	193	0	3	2	0	0
MEL-1287	284	287	3	1	3	4	1	0
MEL-1287	285	477	192	0	3	2	0	0
MEL-1288	286	287	1	1	3	1	3	0
MEL-1288	287	288	1	1	4	3	1	0
MEL-1288	287	288	1	1	4	1	3	0
MEL-1288	288	305	17	1	3	1	1	0
MEL-1288	288	289	1	1	3	2	1	0
MEL-1288	288	477	189	0	4	1	0	0
MEL-1288	288	319	31	1	3	3	1	0
MEL-1288	288	290	2	1	3	1	0	0
MEL-1288	288	292	4	1	4	1	1	0
MEL-1288	289	292	3	1	4	1	0	0
MEL-1289	290	294	4	1	3	1	3	0
MEL-1289	292	294	2	1	3	1	3	0
MEL-1289	293	294	1	1	3	1	0	0
MEL-1289	294	295	1	1	3	1	1	0
MEL-1289	295	296	1	1	3	4	0	0
MEL-1289	296	297	1	1	1	5	0	0
MEL-1289	296	477	181	0	4	2	1	0
MEL-1289	296	297	1	1	3	1	3	0
MEL-1289	296	477	181	0	4	5	0	0
MEL-1289	297	319	22	1	3	1	2	0
MEL-1290	297	298	1	1	3	1	3	0
MEL-1290	297	302	5	1	3	1	0	0
MEL-1290	298	299	1	1	4	3	1	1
MEL-1290	298	299	1	1	4	4	1	0
MEL-1290	298	477	179	0	3	2	1	0
MEL-1290	298	301	3	1	3	1	1	0
MEL-1290	300	477	177	0	3	1	0	0
MEL-1290	301	459	158	1	3	2	0	0
MEL-1290	303	325	22	1	3	1	1	2
MEL-1290	304	477	173	0	3	4	0	0
MEL-1291	305	477	172	0	3	4	0	0
MEL-1291	305	309	4	1	3	1	3	1
MEL-1291	305	312	7	1	4	1	1	0
MEL-1291	305	306	1	1	2	1	0	0
MEL-1291	309	310	1	1	3	5	1	1
MEL-1291	310	477	167	0	3	4	0	0
MEL-1291	310	311	1	1	4	1	3	0
MEL-1291	311	312	1	1	3	2	1	0
MEL-1291	311	312	1	1	3	5	1	0
MEL-1291	311	338	27	1	3	4	2	0
MEL-1292	311	340	29	1	3	1	0	1
MEL-1292	311	312	1	1	3	4	1	0
MEL-1292	311	312	1	1	4	4	1	0
MEL-1292	311	477	166	0	4	4	0	0
MEL-1292	312	313	1	1	3	4	1	0
MEL-1292	312	315	3	1	3	2	1	0
MEL-1292	312	317	5	1	3	1	1	1
MEL-1292	312	477	165	0	3	4	0	0
MEL-1292	313	477	164	0	3	3	0	0
MEL-1292	314	315	1	1	3	1	1	0
MEL-1293	315	331	16	1	3	2	1	1
MEL-1293	315	316	1	1	3	4	1	0
MEL-1293	315	318	3	1	4	1	3	0
MEL-1293	316	317	1	1	3	1	3	0
MEL-1293	317	318	1	1	3	4	0	0
MEL-1293	317	345	28	1	4	4	3	1
MEL-1293	317	462	145	1	4	4	2	0
MEL-1293	317	344	27	1	5	3	2	0
MEL-1293	318	477	159	0	4	1	0	0
MEL-1293	318	319	1	1	3	1	0	0
MEL-1294	318	319	1	1	3	1	3	0
MEL-1294	318	477	159	0	5	4	0	0
MEL-1294	319	320	1	1	3	1	3	0
MEL-1294	322	325	3	1	3	1	1	2
MEL-1294	322	337	15	1	4	4	2	0
MEL-1294	323	477	154	0	3	4	1	0
MEL-1294	323	477	154	0	3	4	1	0
MEL-1294	324	347	23	1	4	1	2	0
MEL-1294	324	452	128	1	3	1	4	0
MEL-1294	324	363	39	1	4	1	0	0
MEL-1295	325	326	1	1	3	2	1	0
MEL-1295	325	330	5	1	4	1	1	0
MEL-1295	325	330	5	1	4	1	1	0
MEL-1295	325	477	152	0	3	2	2	0
MEL-1295	326	346	20	1	3	2	2	0
MEL-1295	329	417	88	1	3	2	2	0
MEL-1295	329	363	34	1	3	1	0	0
MEL-1295	329	477	148	0	4	4	0	0
MEL-1295	329	330	1	1	3	1	2	1
MEL-1295	329	330	1	1	3	1	0	1
MEL-1296	330	477	147	0	4	2	1	2
MEL-1296	330	477	147	0	4	2	1	1
MEL-1296	330	477	147	0	4	4	0	0
MEL-1296	330	477	147	0	3	1	4	0
MEL-1296	331	333	2	1	3	2	2	0
MEL-1296	331	363	32	1	3	3	2	0
MEL-1296	332	477	145	0	3	4	1	1
MEL-1296	333	334	1	1	3	4	1	0
MEL-1296	333	477	144	0	3	1	0	0
MEL-1296	333	363	30	1	3	1	4	0
MEL-1297	333	363	30	1	4	1	0	0
MEL-1297	333	477	144	0	3	1	0	0
MEL-1297	333	336	3	1	3	1	0	0
MEL-1297	336	337	1	1	3	1	2	0
MEL-1297	336	363	27	1	4	1	4	0
MEL-1297	336	477	141	0	4	1	2	1
MEL-1297	336	339	3	1	3	1	0	0
MEL-1297	337	338	1	1	3	4	0	1
MEL-1297	337	477	140	0	3	4	3	1
MEL-1297	337	338	1	1	3	4	2	0
MEL-1298	339	375	36	1	2	1	4	1
MEL-1298	339	477	138	0	3	3	1	0
MEL-1298	339	382	43	1	3	2	2	0
MEL-1298	340	477	137	0	3	2	0	0
MEL-1298	340	372	32	1	3	3	1	0
MEL-1298	340	343	3	1	3	1	4	0
MEL-1298	341	371	30	1	3	1	1	0
MEL-1298	342	344	2	1	3	1	3	0
MEL-1298	343	344	1	1	3	3	2	0
MEL-1298	343	344	1	1	4	4	0	0
MEL-1299	344	345	1	1	4	2	1	0
MEL-1299	344	345	1	1	4	1	3	0
MEL-1299	344	477	133	0	3	4	0	0
MEL-1299	344	345	1	1	3	4	2	0
MEL-1299	345	350	5	1	4	1	3	0
MEL-1299	345	371	26	1	3	3	1	0
MEL-1299	346	477	131	0	3	5	0	0
MEL-1299	346	477	131	0	3	5	0	0
MEL-1299	346	477	131	0	3	5	0	0
MEL-1299	346	347	1	1	4	1	2	0
MEL-1300	346	477	131	0	4	3	0	0
MEL-1300	347	367	20	1	3	4	2	0
MEL-1300	347	400	53	1	2	3	2	0
MEL-1300	347	477	130	0	3	4	0	0
MEL-1300	347	420	73	1	4	1	1	0
MEL-1300	347	350	3	1	3	1	4	2
MEL-1300	347	354	7	1	3	1	4	2
MEL-1300	347	423	76	1	4	4	2	1
MEL-1300	347	355	8	1	3	1	4	0
MEL-1300	348	350	2	1	4	1	3	0
MEL-1301	350	351	1	1	3	3	2	0
MEL-1301	350	351	1	1	3	1	0	0
MEL-1301	350	374	24	1	3	1	4	1
MEL-1301	351	354	3	1	3	3	2	0
MEL-1301	351	352	1	1	3	1	4	0
MEL-1301	351	353	2	1	4	2	4	1
MEL-1301	352	353	1	1	3	1	4	0
MEL-1301	352	353	1	1	3	1	3	1
MEL-1301	352	361	9	1	4	4	2	0
MEL-1301	353	354	1	1	3	4	0	1
MEL-1302	353	354	1	1	3	1	2	0
MEL-1302	353	354	1	1	4	3	2	0
MEL-1302	353	354	1	1	4	1	4	0
MEL-1302	353	362	9	1	3	2	2	0
MEL-1302	353	477	124	0	4	1	0	0
MEL-1302	353	354	1	1	3	4	4	0
MEL-1302	354	394	40	1	3	4	2	0
MEL-1302	354	355	1	1	3	2	2	0
MEL-1302	354	355	1	1	3	1	4	0
MEL-1302	354	355	1	1	3	4	4	0
MEL-1303	354	477	123	0	3	1	0	0
MEL-1303	357	382	25	1	4	5	2	0
MEL-1303	361	477	116	0	4	3	0	0
MEL-1303	361	373	12	1	3	1	2	0
RBONDATA-195	1	28	27	1	3	1	1	0
RBONDATA-195	1	9	8	1	3	1	1	0
RBONDATA-195	1	50	49	1	3	1	0	0
RBONDATA-195	1	21	20	1	4	3	1	1
RBONDATA-196	1	21	20	1	5	3	1	1
RBONDATA-196	1	21	20	1	4	3	1	1
RBONDATA-196	1	21	20	1	4	3	0	1
RBONDATA-196	1	21	20	1	4	3	0	1
RBONDATA-196	1	30	29	1	3	1	1	0
RBONDATA-196	1	12	11	1	3	1	1	0
RBONDATA-196	1	3	2	1	3	1	1	0
RBONDATA-196	1	3	2	1	3	1	1	0
RBONDATA-196	1	15	14	1	3	2	1	0
RBONDATA-196	1	477	476	0	3	2	0	0
RBONDATA-197	2	3	1	1	4	4	1	0
RBONDATA-197	2	477	475	0	3	1	0	0
RBONDATA-197	2	4	2	1	3	1	1	0
RBONDATA-197	2	15	13	1	5	1	1	0
RBONDATA-197	2	31	29	1	3	1	1	0
RBONDATA-197	2	3	1	1	4	1	1	0
RBONDATA-197	2	5	3	1	3	1	1	0
RBONDATA-197	2	4	2	1	3	1	1	0
RBONDATA-197	2	11	9	1	3	1	1	0
RBONDATA-197	2	3	1	1	3	1	1	0
RBONDATA-198	2	4	2	1	3	1	1	0
RBONDATA-198	3	10	7	1	3	1	1	0
RBONDATA-198	3	16	13	1	4	1	1	0
RBONDATA-198	3	4	1	1	4	4	0	0
RBONDATA-198	3	4	1	1	3	1	1	0
RBONDATA-198	3	28	25	1	3	1	1	0
RBONDATA-198	3	21	18	1	3	1	1	0
RBONDATA-198	4	30	26	1	4	1	1	0
RBONDATA-198	4	30	26	1	4	1	1	0
RBONDATA-198	4	21	17	1	3	1	1	0
RBONDATA-199	4	50	46	1	3	1	1	0
RBONDATA-199	4	30	26	1	3	1	1	0
RBONDATA-199	4	477	473	0	3	1	0	0
RBONDATA-199	4	477	473	0	4	1	0	0
RBONDATA-199	5	477	472	0	3	2	0	0
RBONDATA-199	5	477	472	0	3	5	0	0
RBONDATA-199	5	477	472	0	3	5	0	0
RBONDATA-199	5	477	472	0	3	5	0	0
RBONDATA-199	5	79	74	1	3	5	1	0
RBONDATA-199	7	8	1	1	3	5	1	0
RBONDATA-200	7	477	470	0	5	1	0	0
RBONDATA-200	7	18	11	1	5	1	1	0
RBONDATA-200	7	43	36	1	3	1	1	0
RBONDATA-200	7	477	470	0	3	1	0	0
RBONDATA-200	7	30	23	1	3	1	0	0
RBONDATA-200	7	14	7	1	4	1	1	0
RBONDATA-200	7	477	470	0	4	3	0	0
RBONDATA-200	7	17	10	1	3	1	0	0
RBONDATA-200	7	477	470	0	3	1	0	0
RBONDATA-200	7	16	9	1	4	5	1	0
RBONDATA-201	8	14	6	1	3	5	1	0
RBONDATA-201	8	10	2	1	3	1	1	0
RBONDATA-201	8	31	23	1	3	4	1	0
RBONDATA-201	9	16	7	1	3	1	1	0
RBONDATA-201	9	11	2	1	4	1	1	0
RBONDATA-201	9	14	5	1	4	1	1	0
RBONDATA-201	9	28	19	1	4	1	1	0
RBONDATA-201	9	12	3	1	4	1	1	0
RBONDATA-201	10	42	32	1	3	4	1	0
RBONDATA-201	10	15	5	1	3	4	1	0
RBONDATA-202	10	16	6	1	3	1	1	0
RBONDATA-202	10	30	20	1	4	1	1	0
RBONDATA-202	10	11	1	1	3	1	1	0
RBONDATA-202	11	102	91	1	3	4	0	0
RBONDATA-202	11	16	5	1	4	1	1	0
RBONDATA-202	12	477	465	0	3	5	0	0
RBONDATA-202	13	477	464	0	3	1	0	0
RBONDATA-202	14	15	1	1	5	4	1	0
RBONDATA-202	14	16	2	1	3	1	1	0
RBONDATA-202	14	15	1	1	3	1	1	0
RBONDATA-203	14	16	2	1	3	1	1	0
RBONDATA-203	15	16	1	1	4	1	1	0
RBONDATA-203	15	70	55	1	3	4	1	0
RBONDATA-203	15	477	462	0	4	4	0	0
RBONDATA-203	15	16	1	1	3	4	1	0
RBONDATA-203	15	17	2	1	3	1	1	0
RBONDATA-203	15	18	3	1	4	1	1	0
RBONDATA-203	15	17	2	1	3	4	1	0
RBONDATA-203	16	17	1	1	3	1	1	0
RBONDATA-203	16	17	1	1	4	1	1	0
RBONDATA-204	16	28	12	1	4	3	1	0
RBONDATA-204	16	32	16	1	3	1	0	0
RBONDATA-204	16	18	2	1	3	1	1	0
RBONDATA-204	16	32	16	1	4	4	1	0
RBONDATA-204	16	30	14	1	4	5	1	0
RBONDATA-204	16	18	2	1	3	1	0	0
RBONDATA-204	16	18	2	1	3	1	1	0
RBONDATA-204	17	18	1	1	3	4	1	0
RBONDATA-204	17	18	1	1	4	1	1	0
RBONDATA-204	17	30	13	1	3	1	1	0
RBONDATA-205	17	18	1	1	4	3	1	0
RBONDATA-205	17	18	1	1	3	1	1	0
RBONDATA-205	17	477	460	0	3	1	0	0
RBONDATA-205	17	18	1	1	3	1	1	0
RBONDATA-205	17	25	8	1	4	3	1	0
RBONDATA-205	17	59	42	1	4	2	2	0
RBONDATA-205	17	97	80	1	3	1	1	0
RBONDATA-205	18	19	1	1	3	1	1	0
RBONDATA-205	18	19	1	1	2	1	1	0
RBONDATA-205	18	477	459	0	3	5	0	0
RBONDATA-206	18	22	4	1	4	1	1	0
RBONDATA-206	21	28	7	1	3	1	1	0
RBONDATA-206	21	477	456	0	4	1	0	0
RBONDATA-206	21	27	6	1	4	1	1	0
RBONDATA-206	21	31	10	1	4	4	1	0
RBONDATA-206	22	477	455	0	4	1	0	0
RBONDATA-206	22	27	5	1	4	1	1	0
RBONDATA-206	22	203	181	1	3	1	0	0
RBONDATA-206	22	23	1	1	3	1	1	0
RBONDATA-206	22	27	5	1	4	1	1	0
RBONDATA-207	22	23	1	1	4	1	1	0
RBONDATA-207	22	23	1	1	3	4	0	0
RBONDATA-207	23	477	454	0	4	5	0	0
RBONDATA-207	23	87	64	1	3	5	1	0
RBONDATA-207	23	477	454	0	4	1	0	0
RBONDATA-207	24	30	6	1	4	1	1	0
RBONDATA-207	24	25	1	1	3	4	1	0
RBONDATA-207	24	33	9	1	4	1	1	0
RBONDATA-207	24	32	8	1	4	4	1	0
RBONDATA-207	24	30	6	1	3	1	0	0
RBONDATA-208	24	142	118	1	4	1	1	0
RBONDATA-208	24	25	1	1	3	1	1	0
RBONDATA-208	25	32	7	1	4	1	1	0
RBONDATA-208	25	26	1	1	3	1	1	0
RBONDATA-208	25	26	1	1	3	1	1	0
RBONDATA-208	25	41	16	1	3	1	1	0
RBONDATA-208	25	33	8	1	3	1	1	0
RBONDATA-208	25	26	1	1	4	1	1	0
RBONDATA-208	25	33	8	1	3	4	1	1
RBONDATA-208	25	27	2	1	3	1	1	0
RBONDATA-209	28	30	2	1	4	4	1	0
RBONDATA-209	28	55	27	1	3	4	1	0
RBONDATA-209	28	31	3	1	3	1	1	0
RBONDATA-209	28	477	449	0	3	4	0	0
RBONDATA-209	28	31	3	1	3	1	1	0
RBONDATA-209	29	30	1	1	3	1	1	0
RBONDATA-209	29	30	1	1	4	4	1	0
RBONDATA-209	29	30	1	1	3	2	1	0
RBONDATA-209	29	33	4	1	4	1	2	0
RBONDATA-209	29	142	113	1	3	4	1	0
RBONDATA-210	29	30	1	1	4	4	1	0
RBONDATA-210	29	33	4	1	3	4	1	0
RBONDATA-210	29	31	2	1	3	1	1	0
RBONDATA-210	29	52	23	1	4	4	2	0
RBONDATA-210	30	33	3	1	3	1	1	0
RBONDATA-210	30	33	3	1	3	1	1	0
RBONDATA-210	30	31	1	1	3	3	1	0
RBONDATA-210	30	31	1	1	3	1	1	0
RBONDATA-210	30	32	2	1	3	4	1	0
RBONDATA-210	30	33	3	1	4	4	1	0
RBONDATA-211	31	33	2	1	3	1	1	0
RBONDATA-211	31	32	1	1	3	4	1	0
RBONDATA-211	31	33	2	1	4	1	1	0
RBONDATA-211	31	32	1	1	4	1	1	0
RBONDATA-211	31	41	10	1	3	1	0	0
RBONDATA-211	31	477	446	0	4	1	0	0
RBONDATA-211	31	32	1	1	3	5	1	0
RBONDATA-211	31	33	2	1	3	1	1	0
RBONDATA-211	32	477	445	0	3	1	0	0
RBONDATA-211	32	33	1	1	3	1	2	0
RBONDATA-212	32	33	1	1	3	1	1	0
RBONDATA-212	32	33	1	1	3	1	1	0
RBONDATA-212	32	33	1	1	4	1	1	0
RBONDATA-212	33	34	1	1	4	4	1	0
RBONDATA-212	33	35	2	1	3	1	0	0
RBONDATA-212	33	63	30	1	3	1	1	0
RBONDATA-212	33	34	1	1	3	5	1	0
RBONDATA-212	33	34	1	1	4	5	1	0
RBONDATA-212	33	34	1	1	3	5	1	0
RBONDATA-212	35	315	280	1	2	4	0	0
RBONDATA-213	35	89	54	1	4	1	1	0
RBONDATA-213	35	38	3	1	4	1	2	0
RBONDATA-213	35	477	442	0	4	1	0	0
RBONDATA-213	36	52	16	1	4	1	2	0
RBONDATA-213	36	62	26	1	3	1	1	0
RBONDATA-213	36	54	18	1	3	3	2	0
RBONDATA-213	36	477	441	0	3	1	0	0
RBONDATA-213	36	62	26	1	3	4	1	0
RBONDATA-213	36	39	3	1	3	3	2	0
RBONDATA-213	37	71	34	1	5	4	1	0
RBONDATA-214	37	97	60	1	4	4	1	0
RBONDATA-214	37	477	440	0	4	1	0	0
RBONDATA-214	37	54	17	1	3	1	2	0
RBONDATA-214	37	62	25	1	3	1	1	0
RBONDATA-214	38	60	22	1	3	4	1	0
RBONDATA-214	38	86	48	1	4	4	0	0
RBONDATA-214	38	39	1	1	4	1	0	0
RBONDATA-214	38	62	24	1	4	1	2	0
RBONDATA-214	38	62	24	1	4	4	2	0
RBONDATA-214	38	55	17	1	4	1	1	0
RBONDATA-215	38	39	1	1	4	1	2	0
RBONDATA-215	39	53	14	1	3	1	1	0
RBONDATA-215	39	101	62	1	3	1	1	0
RBONDATA-215	39	477	438	0	3	4	0	0
RBONDATA-215	39	477	438	0	3	4	0	0
RBONDATA-215	39	101	62	1	4	1	1	0
RBONDATA-215	40	477	437	0	3	4	0	0
RBONDATA-215	41	477	436	0	3	1	0	0
RBONDATA-215	41	477	436	0	3	1	0	0
RBONDATA-215	41	142	101	1	3	4	1	0
RBONDATA-216	41	203	162	1	4	1	0	1
RBONDATA-216	41	53	12	1	4	1	2	1
RBONDATA-216	42	477	435	0	3	4	0	0
RBONDATA-216	42	477	435	0	3	5	0	0
RBONDATA-216	42	477	435	0	3	5	0	0
RBONDATA-216	42	86	44	1	3	5	1	0
RBONDATA-216	42	217	175	1	3	1	0	0
RBONDATA-216	42	477	435	0	3	1	0	0
RBONDATA-216	42	56	14	1	3	4	2	0
RBONDATA-216	42	477	435	0	4	1	0	0
RBONDATA-217	43	477	434	0	3	2	0	0
RBONDATA-217	43	477	434	0	3	4	0	0
RBONDATA-217	43	203	160	1	3	5	0	0
RBONDATA-217	43	203	160	1	3	5	0	0
RBONDATA-217	43	44	1	1	3	1	0	0
RBONDATA-217	43	203	160	1	3	5	0	0
RBONDATA-217	43	477	434	0	3	5	0	0
RBONDATA-217	43	477	434	0	3	5	0	0
RBONDATA-217	43	477	434	0	3	5	0	0
RBONDATA-217	43	477	434	0	3	5	0	0
RBONDATA-218	43	477	434	0	3	5	0	0
RBONDATA-218	43	477	434	0	3	1	0	0
RBONDATA-218	43	52	9	1	4	1	2	0
RBONDATA-218	44	53	9	1	4	1	2	0
RBONDATA-218	47	57	10	1	4	4	2	0
RBONDATA-218	49	53	4	1	4	1	1	0
RBONDATA-218	50	477	427	0	3	4	0	0
RBONDATA-218	50	56	6	1	3	4	2	0
RBONDATA-218	50	477	427	0	3	2	0	0
RBONDATA-218	50	54	4	1	3	5	1	0
RBONDATA-219	50	477	427	0	3	5	0	0
RBONDATA-219	50	477	427	0	3	5	0	0
RBONDATA-219	50	477	427	0	3	5	0	0
RBONDATA-219	50	477	427	0	3	5	0	0
RBONDATA-219	52	71	19	1	3	1	1	0
RBONDATA-219	52	477	425	0	4	4	0	0
RBONDATA-219	52	60	8	1	3	4	2	0
RBONDATA-219	53	477	424	0	4	1	0	0
RBONDATA-219	53	141	88	1	4	1	1	0
RBONDATA-219	53	58	5	1	4	1	2	0
RBONDATA-220	55	56	1	1	3	1	1	0
RBONDATA-220	55	62	7	1	3	4	1	0
RBONDATA-220	56	217	161	1	3	4	1	0
RBONDATA-220	56	127	71	1	3	4	0	0
RBONDATA-220	56	61	5	1	3	4	2	0
RBONDATA-220	56	477	421	0	4	1	0	0
RBONDATA-220	57	58	1	1	3	5	1	0
RBONDATA-220	57	58	1	1	3	1	2	0
RBONDATA-220	57	58	1	1	3	1	2	0
RBONDATA-220	57	60	3	1	3	1	2	0
RBONDATA-221	57	477	420	0	3	1	0	0
RBONDATA-221	57	60	3	1	3	1	2	0
RBONDATA-221	57	59	2	1	3	1	1	0
RBONDATA-221	58	59	1	1	3	1	1	0
RBONDATA-221	58	59	1	1	5	3	2	0
RBONDATA-221	58	59	1	1	5	3	2	0
RBONDATA-221	58	59	1	1	3	1	1	0
RBONDATA-221	59	60	1	1	4	1	2	0
RBONDATA-221	60	477	417	0	3	1	0	0
RBONDATA-221	60	61	1	1	3	1	2	0
RBONDATA-222	60	203	143	1	4	4	0	0
RBONDATA-222	60	142	82	1	3	1	1	0
RBONDATA-222	62	69	7	1	4	1	1	0
RBONDATA-222	63	78	15	1	4	4	2	0
RBONDATA-222	63	477	414	0	3	1	0	0
RBONDATA-222	63	477	414	0	3	1	0	0
RBONDATA-222	64	71	7	1	4	4	1	0
RBONDATA-222	64	141	77	1	4	4	1	0
RBONDATA-222	64	477	413	0	5	4	0	0
RBONDATA-222	64	65	1	1	5	1	1	0
RBONDATA-223	65	76	11	1	4	4	2	0
RBONDATA-223	65	70	5	1	4	4	1	0
RBONDATA-223	65	67	2	1	3	1	1	0
RBONDATA-223	65	477	412	0	5	4	0	0
RBONDATA-223	65	66	1	1	4	4	2	0
RBONDATA-223	65	70	5	1	4	1	1	0
RBONDATA-223	65	77	12	1	4	1	1	0
RBONDATA-223	66	67	1	1	3	1	2	0
RBONDATA-223	67	98	31	1	3	4	0	0
RBONDATA-223	67	477	410	0	4	4	0	0
RBONDATA-224	67	477	410	0	5	4	0	0
RBONDATA-224	67	70	3	1	5	1	1	0
RBONDATA-224	67	68	1	1	3	2	1	0
RBONDATA-224	67	477	410	0	5	5	0	0
RBONDATA-224	67	74	7	1	4	1	2	0
RBONDATA-224	69	477	408	0	2	1	1	0
RBONDATA-224	70	98	28	1	3	1	0	0
RBONDATA-224	70	72	2	1	3	5	1	0
RBONDATA-224	71	73	2	1	3	1	1	0
RBONDATA-224	71	84	13	1	3	1	1	0
RBONDATA-225	71	73	2	1	3	4	1	0
RBONDATA-225	71	115	44	1	4	4	1	0
RBONDATA-225	71	477	406	0	4	1	0	0
RBONDATA-225	71	74	3	1	3	2	1	0
RBONDATA-225	72	76	4	1	4	4	1	0
RBONDATA-225	72	73	1	1	5	4	1	0
RBONDATA-225	72	94	22	1	4	4	1	0
RBONDATA-225	72	100	28	1	4	5	1	0
RBONDATA-225	73	82	9	1	4	4	2	0
RBONDATA-225	75	84	9	1	4	3	1	0
RBONDATA-226	75	115	40	1	3	4	1	0
RBONDATA-226	76	79	3	1	4	1	2	0
RBONDATA-226	77	84	7	1	3	2	1	0
RBONDATA-226	77	170	93	1	4	1	0	0
RBONDATA-226	78	84	6	1	3	1	1	0
RBONDATA-226	78	79	1	1	3	1	2	0
RBONDATA-226	79	80	1	1	3	1	1	0
RBONDATA-226	79	100	21	1	5	2	1	0
RBONDATA-226	80	477	397	0	3	5	0	0
RBONDATA-226	81	477	396	0	3	5	0	0
RBONDATA-227	81	477	396	0	3	4	0	0
RBONDATA-227	81	82	1	1	3	4	1	0
RBONDATA-227	81	477	396	0	4	1	0	0
RBONDATA-227	81	477	396	0	4	5	0	0
RBONDATA-227	81	87	6	1	3	1	1	0
RBONDATA-227	81	115	34	1	3	1	1	0
RBONDATA-227	82	142	60	1	3	2	1	1
RBONDATA-227	83	94	11	1	3	1	1	0
RBONDATA-227	84	86	2	1	3	2	1	0
RBONDATA-227	84	477	393	0	3	1	1	0
RBONDATA-228	84	477	393	0	3	1	0	0
RBONDATA-228	84	477	393	0	3	1	1	0
RBONDATA-228	84	477	393	0	3	1	1	0
RBONDATA-228	84	477	393	0	4	4	1	0
RBONDATA-228	84	477	393	0	3	4	1	0
RBONDATA-228	84	87	3	1	4	4	1	0
RBONDATA-228	84	477	393	0	4	4	0	0
RBONDATA-228	85	86	1	1	3	1	1	0
RBONDATA-228	86	102	16	1	3	4	0	0
RBONDATA-228	86	88	2	1	4	1	1	0
RBONDATA-229	86	477	391	0	5	1	0	0
RBONDATA-229	87	88	1	1	3	2	1	0
RBONDATA-229	87	107	20	1	3	1	0	0
RBONDATA-229	87	477	390	0	3	1	0	0
RBONDATA-229	87	94	7	1	3	5	1	0
RBONDATA-229	87	89	2	1	3	4	1	0
RBONDATA-229	88	89	1	1	3	2	1	0
RBONDATA-229	89	94	5	1	3	2	1	3
RBONDATA-229	89	91	2	1	4	4	2	0
RBONDATA-229	89	97	8	1	4	4	1	0
RBONDATA-230	90	91	1	1	4	3	1	0
RBONDATA-230	90	142	52	1	3	5	1	0
RBONDATA-230	90	91	1	1	3	1	1	0
RBONDATA-230	91	100	9	1	3	1	2	0
RBONDATA-230	91	106	15	1	3	4	1	0
RBONDATA-230	91	477	386	0	3	1	0	0
RBONDATA-230	91	477	386	0	3	1	0	0
RBONDATA-230	91	103	12	1	3	1	1	0
RBONDATA-230	91	97	6	1	3	1	1	0
RBONDATA-230	92	162	70	1	3	4	2	0
RBONDATA-231	92	126	34	1	4	4	1	0
RBONDATA-231	92	203	111	1	3	1	0	0
RBONDATA-231	93	109	16	1	3	2	1	0
RBONDATA-231	93	477	384	0	3	2	0	0
RBONDATA-231	93	94	1	1	3	1	1	0
RBONDATA-231	94	95	1	1	4	4	2	0
RBONDATA-231	95	100	5	1	3	4	2	0
RBONDATA-231	95	100	5	1	4	4	2	0
RBONDATA-231	96	477	381	0	4	4	0	0
RBONDATA-231	97	98	1	1	4	1	1	0
RBONDATA-232	97	98	1	1	3	1	1	0
RBONDATA-232	97	100	3	1	4	1	2	0
RBONDATA-232	98	112	14	1	3	1	0	0
RBONDATA-232	98	110	12	1	3	2	1	0
RBONDATA-232	98	102	4	1	3	4	1	0
RBONDATA-232	99	106	7	1	3	4	1	0
RBONDATA-232	99	203	104	1	4	1	0	0
RBONDATA-232	99	137	38	1	5	1	1	0
RBONDATA-232	99	477	378	0	3	1	0	0
RBONDATA-232	99	100	1	1	3	1	2	0
RBONDATA-233	99	477	378	0	4	1	0	0
RBONDATA-233	99	477	378	0	3	1	0	0
RBONDATA-233	99	477	378	0	4	1	0	0
RBONDATA-233	100	119	19	1	4	1	1	0
RBONDATA-233	100	127	27	1	3	4	0	0
RBONDATA-233	100	106	6	1	3	1	1	0
RBONDATA-233	100	477	377	0	4	1	0	0
RBONDATA-233	100	142	42	1	4	1	1	0
RBONDATA-233	101	112	11	1	3	4	1	0
RBONDATA-233	101	217	116	1	1	1	1	0
RBONDATA-234	101	217	116	1	1	1	1	0
RBONDATA-234	101	109	8	1	3	4	2	0
RBONDATA-234	102	477	375	0	4	1	0	0
RBONDATA-234	102	103	1	1	3	1	1	0
RBONDATA-234	102	114	12	1	3	1	0	0
RBONDATA-234	102	105	3	1	3	1	0	0
RBONDATA-234	102	106	4	1	3	1	1	0
RBONDATA-234	102	120	18	1	3	1	1	0
RBONDATA-234	104	477	373	0	4	1	0	0
RBONDATA-234	104	477	373	0	4	1	0	0
RBONDATA-235	105	106	1	1	3	1	1	0
RBONDATA-235	105	113	8	1	3	1	0	0
RBONDATA-235	105	129	24	1	4	5	1	0
RBONDATA-235	105	107	2	1	3	4	1	0
RBONDATA-235	106	477	371	0	3	1	0	0
RBONDATA-235	107	151	44	1	3	4	1	1
RBONDATA-235	107	116	9	1	4	5	1	0
RBONDATA-235	107	142	35	1	3	4	1	0
RBONDATA-235	108	110	2	1	3	4	2	0
RBONDATA-235	108	112	4	1	3	5	1	0
RBONDATA-236	108	111	3	1	3	5	1	0
RBONDATA-236	108	109	1	1	3	5	1	0
RBONDATA-236	108	477	369	0	3	4	0	0
RBONDATA-236	108	203	95	1	3	1	0	0
RBONDATA-236	109	110	1	1	3	1	1	0
RBONDATA-236	109	110	1	1	3	4	1	0
RBONDATA-236	109	121	12	1	3	1	1	0
RBONDATA-236	109	477	368	0	3	4	0	2
RBONDATA-236	109	477	368	0	3	4	0	1
RBONDATA-236	109	130	21	1	4	5	1	0
RBONDATA-237	109	133	24	1	4	3	1	0
RBONDATA-237	109	118	9	1	3	2	1	0
RBONDATA-237	109	477	368	0	4	1	0	0
RBONDATA-237	110	111	1	1	3	2	1	0
RBONDATA-237	110	111	1	1	3	1	1	0
RBONDATA-237	111	112	1	1	3	4	1	0
RBONDATA-237	111	112	1	1	3	4	1	0
RBONDATA-237	111	203	92	1	3	2	0	0
RBONDATA-237	111	142	31	1	3	2	1	0
RBONDATA-237	112	122	10	1	3	4	1	0
RBONDATA-238	112	115	3	1	3	2	1	0
RBONDATA-238	112	119	7	1	3	4	1	0
RBONDATA-238	112	477	365	0	3	1	0	0
RBONDATA-238	112	477	365	0	3	1	0	0
RBONDATA-238	112	116	4	1	3	4	1	0
RBONDATA-238	112	477	365	0	3	1	0	0
RBONDATA-238	112	115	3	1	3	1	1	0
RBONDATA-238	112	477	365	0	3	5	0	0
RBONDATA-238	112	120	8	1	3	5	1	0
RBONDATA-238	112	149	37	1	3	4	1	0
RBONDATA-239	112	115	3	1	2	4	1	0
RBONDATA-239	112	115	3	1	3	1	1	0
RBONDATA-239	113	122	9	1	3	4	1	0
RBONDATA-239	113	119	6	1	4	1	0	0
RBONDATA-239	113	119	6	1	3	1	2	0
RBONDATA-239	113	477	364	0	3	1	0	1
RBONDATA-239	113	122	9	1	4	4	1	0
RBONDATA-239	114	477	363	0	3	1	0	1
RBONDATA-239	114	477	363	0	3	1	0	1
RBONDATA-239	114	477	363	0	3	1	0	1
RBONDATA-240	114	477	363	0	3	1	0	0
RBONDATA-240	114	129	15	1	4	1	1	0
RBONDATA-240	114	175	61	1	3	4	0	0
RBONDATA-240	115	477	362	0	3	4	0	0
RBONDATA-240	115	122	7	1	3	4	1	0
RBONDATA-240	115	477	362	0	4	5	0	0
RBONDATA-240	115	121	6	1	3	1	1	0
RBONDATA-240	115	116	1	1	3	4	1	0
RBONDATA-240	116	128	12	1	3	1	1	0
RBONDATA-240	116	477	361	0	3	1	0	0
RBONDATA-241	116	122	6	1	5	1	1	0
RBONDATA-241	116	119	3	1	4	1	0	0
RBONDATA-241	117	477	360	0	4	5	0	0
RBONDATA-241	117	138	21	1	4	1	1	0
RBONDATA-241	117	118	1	1	3	4	1	0
RBONDATA-241	118	125	7	1	3	2	1	0
RBONDATA-241	118	128	10	1	3	2	1	0
RBONDATA-241	119	120	1	1	3	1	1	0
RBONDATA-241	119	168	49	1	3	1	2	0
RBONDATA-241	119	121	2	1	3	1	1	0
RBONDATA-242	120	396	276	1	3	4	1	4
RBONDATA-242	120	127	7	1	4	1	0	0
RBONDATA-242	120	122	2	1	3	4	1	0
RBONDATA-242	121	122	1	1	3	5	1	0
RBONDATA-242	121	126	5	1	4	3	1	0
RBONDATA-242	121	477	356	0	3	1	0	0
RBONDATA-242	121	127	6	1	3	1	1	0
RBONDATA-242	121	122	1	1	4	1	1	0
RBONDATA-242	121	166	45	1	3	4	2	0
RBONDATA-242	122	477	355	0	4	4	0	0
RBONDATA-243	122	126	4	1	3	5	1	0
RBONDATA-243	122	133	11	1	3	1	1	0
RBONDATA-243	122	124	2	1	3	1	1	0
RBONDATA-243	122	140	18	1	3	5	1	0
RBONDATA-243	123	127	4	1	4	3	1	0
RBONDATA-243	123	129	6	1	3	1	1	0
RBONDATA-243	123	126	3	1	3	1	1	0
RBONDATA-243	123	125	2	1	3	1	1	0
RBONDATA-243	123	124	1	1	3	1	1	0
RBONDATA-243	123	125	2	1	3	1	1	0
RBONDATA-244	123	141	18	1	3	1	1	0
RBONDATA-244	124	128	4	1	3	1	1	0
RBONDATA-244	124	129	5	1	3	1	1	0
RBONDATA-244	126	127	1	1	3	5	1	0
RBONDATA-244	126	477	351	0	3	1	0	0
RBONDATA-244	126	477	351	0	3	1	0	0
RBONDATA-244	126	142	16	1	3	1	1	0
RBONDATA-244	126	417	291	1	1	1	0	0
RBONDATA-244	126	127	1	1	4	4	1	0
RBONDATA-244	126	477	351	0	3	5	0	0
RBONDATA-245	126	477	351	0	4	1	0	0
RBONDATA-245	126	477	351	0	4	1	0	0
RBONDATA-245	126	477	351	0	3	1	0	0
RBONDATA-245	126	477	351	0	3	1	0	0
RBONDATA-245	127	128	1	1	3	4	1	0
RBONDATA-245	127	130	3	1	4	4	1	0
RBONDATA-245	127	477	350	0	3	4	0	0
RBONDATA-245	127	129	2	1	3	5	1	0
RBONDATA-245	127	128	1	1	4	4	1	0
RBONDATA-245	128	131	3	1	3	4	1	0
RBONDATA-246	128	477	349	0	3	1	0	0
RBONDATA-246	128	477	349	0	3	1	0	0
RBONDATA-246	128	477	349	0	3	1	0	0
RBONDATA-246	128	134	6	1	3	1	1	0
RBONDATA-246	128	129	1	1	3	1	1	0
RBONDATA-246	128	136	8	1	3	1	1	0
RBONDATA-246	128	477	349	0	4	1	0	0
RBONDATA-246	129	137	8	1	3	4	1	0
RBONDATA-246	129	133	4	1	3	1	1	0
RBONDATA-246	129	130	1	1	3	1	1	0
RBONDATA-247	129	137	8	1	4	4	1	0
RBONDATA-247	129	477	348	0	3	4	0	0
RBONDATA-247	130	137	7	1	3	1	1	0
RBONDATA-247	131	132	1	1	3	4	1	0
RBONDATA-247	131	132	1	1	3	5	1	0
RBONDATA-247	131	132	1	1	3	5	1	0
RBONDATA-247	133	138	5	1	3	1	1	0
RBONDATA-247	133	136	3	1	3	1	1	0
RBONDATA-247	133	213	80	1	5	1	2	0
RBONDATA-247	133	136	3	1	3	1	1	0
RBONDATA-248	134	138	4	1	3	1	1	0
RBONDATA-248	134	143	9	1	4	5	1	0
RBONDATA-248	134	196	62	1	4	4	1	0
RBONDATA-248	134	477	343	0	3	1	0	0
RBONDATA-248	134	137	3	1	3	5	1	0
RBONDATA-248	135	477	342	0	3	1	0	0
RBONDATA-248	135	136	1	1	4	1	1	1
RBONDATA-248	135	140	5	1	4	1	1	0
RBONDATA-248	135	477	342	0	3	1	0	0
RBONDATA-248	135	140	5	1	4	1	1	0
RBONDATA-249	136	477	341	0	3	1	0	0
RBONDATA-249	137	143	6	1	3	1	1	0
RBONDATA-249	137	138	1	1	3	1	1	0
RBONDATA-249	137	140	3	1	3	1	1	0
RBONDATA-249	137	140	3	1	3	4	1	0
RBONDATA-249	138	141	3	1	3	4	1	0
RBONDATA-249	139	141	2	1	3	4	1	0
RBONDATA-249	140	217	77	1	3	1	0	0
RBONDATA-249	140	141	1	1	4	1	1	0
RBONDATA-249	140	147	7	1	3	4	0	0
RBONDATA-250	140	148	8	1	3	4	1	0
RBONDATA-250	140	477	337	0	1	1	0	0
RBONDATA-250	140	477	337	0	3	3	0	0
RBONDATA-250	140	141	1	1	3	1	1	0
RBONDATA-250	140	171	31	1	3	2	1	0
RBONDATA-250	141	477	336	0	5	1	0	0
RBONDATA-250	141	142	1	1	3	1	0	0
RBONDATA-250	141	147	6	1	3	3	1	0
RBONDATA-250	141	150	9	1	3	1	1	0
RBONDATA-250	141	171	30	1	4	5	0	0
RBONDATA-251	141	171	30	1	3	5	0	0
RBONDATA-251	141	171	30	1	3	5	0	0
RBONDATA-251	141	204	63	1	3	5	2	0
RBONDATA-251	141	171	30	1	3	5	0	0
RBONDATA-251	141	143	2	1	4	1	1	0
RBONDATA-251	141	176	35	1	3	1	2	0
RBONDATA-251	141	176	35	1	3	1	2	0
RBONDATA-251	142	477	335	0	3	4	0	0
RBONDATA-251	142	477	335	0	3	4	0	0
RBONDATA-251	142	147	5	1	3	4	1	0
RBONDATA-252	142	147	5	1	4	1	1	0
RBONDATA-252	142	150	8	1	3	4	1	0
RBONDATA-252	142	177	35	1	4	1	0	1
RBONDATA-252	142	477	335	0	3	1	0	1
RBONDATA-252	143	147	4	1	3	4	1	0
RBONDATA-252	143	477	334	0	3	1	0	0
RBONDATA-252	143	163	20	1	4	1	0	0
RBONDATA-252	143	477	334	0	3	1	0	1
RBONDATA-252	143	195	52	1	4	1	2	1
RBONDATA-252	143	151	8	1	4	1	1	0
RBONDATA-253	143	203	60	1	2	1	2	1
RBONDATA-253	143	204	61	1	3	1	2	1
RBONDATA-253	144	247	103	1	3	4	1	0
RBONDATA-253	144	477	333	0	4	1	0	1
RBONDATA-253	144	204	60	1	4	1	2	1
RBONDATA-253	144	477	333	0	3	1	0	1
RBONDATA-253	144	477	333	0	4	1	0	1
RBONDATA-253	144	177	33	1	4	1	0	1
RBONDATA-253	144	148	4	1	3	1	1	0
RBONDATA-253	144	205	61	1	4	1	2	1
RBONDATA-254	144	204	60	1	4	1	2	1
RBONDATA-254	144	477	333	0	4	1	0	1
RBONDATA-254	144	204	60	1	3	1	2	2
RBONDATA-254	145	477	332	0	3	1	0	0
RBONDATA-254	145	477	332	0	3	1	0	1
RBONDATA-254	147	148	1	1	3	1	1	0
RBONDATA-254	147	148	1	1	3	1	1	0
RBONDATA-254	147	186	39	1	4	1	1	0
RBONDATA-254	147	477	330	0	1	1	0	0
RBONDATA-254	147	178	31	1	3	4	2	0
RBONDATA-255	147	204	57	1	3	1	2	1
RBONDATA-255	147	477	330	0	3	1	0	1
RBONDATA-255	147	148	1	1	3	1	1	0
RBONDATA-255	148	168	20	1	3	4	2	0
RBONDATA-255	148	155	7	1	3	4	0	0
RBONDATA-255	148	149	1	1	3	1	1	0
RBONDATA-255	148	477	329	0	3	4	0	0
RBONDATA-255	148	155	7	1	3	1	1	0
RBONDATA-255	148	149	1	1	3	4	1	0
RBONDATA-255	148	154	6	1	3	1	0	0
RBONDATA-256	148	204	56	1	4	1	2	1
RBONDATA-256	148	477	329	0	3	2	0	0
RBONDATA-256	148	477	329	0	3	5	0	0
RBONDATA-256	148	346	198	1	4	1	0	0
RBONDATA-256	148	477	329	0	3	1	0	1
RBONDATA-256	149	477	328	0	3	1	0	1
RBONDATA-256	150	151	1	1	3	4	0	0
RBONDATA-256	150	477	327	0	3	4	0	0
RBONDATA-256	150	204	54	1	3	1	2	1
RBONDATA-256	151	162	11	1	3	4	1	0
RBONDATA-257	151	477	326	0	3	1	0	0
RBONDATA-257	151	155	4	1	4	1	1	0
RBONDATA-257	151	477	326	0	3	1	0	1
RBONDATA-257	154	161	7	1	3	4	1	0
RBONDATA-257	154	477	323	0	3	1	0	1
RBONDATA-257	154	225	71	1	3	4	1	0
RBONDATA-257	154	204	50	1	3	1	2	1
RBONDATA-257	155	477	322	0	3	1	0	0
RBONDATA-257	155	162	7	1	3	4	2	0
RBONDATA-257	155	477	322	0	3	4	0	0
RBONDATA-258	155	477	322	0	3	1	0	1
RBONDATA-258	155	199	44	1	3	4	0	0
RBONDATA-258	155	199	44	1	3	1	0	0
RBONDATA-258	155	199	44	1	3	4	0	0
RBONDATA-258	156	206	50	1	3	2	0	0
RBONDATA-258	156	169	13	1	3	5	0	0
RBONDATA-258	156	169	13	1	3	5	0	0
RBONDATA-258	156	177	21	1	3	5	1	0
RBONDATA-258	156	206	50	1	3	5	0	0
RBONDATA-258	156	190	34	1	3	5	1	0
RBONDATA-259	156	190	34	1	3	5	1	0
RBONDATA-259	157	162	5	1	3	4	1	0
RBONDATA-259	157	477	320	0	3	1	0	0
RBONDATA-259	157	165	8	1	4	4	2	0
RBONDATA-259	157	276	119	1	4	4	1	0
RBONDATA-259	157	439	282	1	4	4	0	0
RBONDATA-259	158	477	319	0	4	2	0	0
RBONDATA-259	158	477	319	0	4	5	0	0
RBONDATA-259	158	477	319	0	4	5	0	0
RBONDATA-259	161	164	3	1	4	4	1	0
RBONDATA-260	161	268	107	1	4	2	0	0
RBONDATA-260	161	477	316	0	3	5	0	0
RBONDATA-260	161	190	29	1	3	5	1	0
RBONDATA-260	161	162	1	1	3	4	0	0
RBONDATA-260	162	163	1	1	4	1	1	0
RBONDATA-260	163	477	314	0	3	4	0	4
RBONDATA-260	163	176	13	1	3	5	1	0
RBONDATA-260	163	190	27	1	3	5	1	0
RBONDATA-260	163	176	13	1	3	5	1	0
RBONDATA-260	163	477	314	0	3	4	1	0
RBONDATA-261	164	168	4	1	4	1	1	0
RBONDATA-261	164	170	6	1	4	5	0	0
RBONDATA-261	164	477	313	0	3	4	0	0
RBONDATA-261	165	197	32	1	3	5	0	0
RBONDATA-261	165	168	3	1	3	1	2	0
RBONDATA-261	169	171	2	1	3	5	0	0
RBONDATA-261	170	171	1	1	3	1	2	0
RBONDATA-261	170	171	1	1	3	1	1	0
RBONDATA-261	170	204	34	1	3	5	1	0
RBONDATA-261	170	477	307	0	3	3	0	0
RBONDATA-262	170	477	307	0	3	5	0	0
RBONDATA-262	170	204	34	1	3	1	1	0
RBONDATA-262	170	477	307	0	3	1	0	0
RBONDATA-262	170	171	1	1	4	1	1	0
RBONDATA-262	170	172	2	1	3	5	1	0
RBONDATA-262	171	477	306	0	3	1	0	0
RBONDATA-262	171	175	4	1	3	1	1	0
RBONDATA-262	171	175	4	1	4	1	1	0
RBONDATA-262	172	477	305	0	2	3	0	4
RBONDATA-262	172	180	8	1	3	1	2	0
RBONDATA-263	172	175	3	1	4	4	1	0
RBONDATA-263	172	477	305	0	3	4	0	0
RBONDATA-263	174	225	51	1	3	1	1	0
RBONDATA-263	174	184	10	1	3	5	2	0
RBONDATA-263	174	179	5	1	3	5	2	0
RBONDATA-263	174	180	6	1	3	5	2	0
RBONDATA-263	175	477	302	0	3	1	0	0
RBONDATA-263	175	192	17	1	3	5	2	0
RBONDATA-263	175	205	30	1	3	2	1	0
RBONDATA-263	175	477	302	0	3	4	0	0
RBONDATA-264	175	177	2	1	4	5	0	0
RBONDATA-264	175	176	1	1	4	5	0	0
RBONDATA-264	175	189	14	1	4	4	1	0
RBONDATA-264	175	477	302	0	3	5	0	0
RBONDATA-264	175	180	5	1	4	1	2	0
RBONDATA-264	175	186	11	1	4	5	1	0
RBONDATA-264	175	225	50	1	4	1	1	0
RBONDATA-264	175	178	3	1	3	5	1	0
RBONDATA-264	175	179	4	1	3	5	1	0
RBONDATA-264	175	191	16	1	4	5	1	0
RBONDATA-265	175	185	10	1	3	5	2	0
RBONDATA-265	175	205	30	1	4	5	1	0
RBONDATA-265	175	477	302	0	3	5	0	0
RBONDATA-265	175	180	5	1	3	5	2	0
RBONDATA-265	176	185	9	1	3	5	2	0
RBONDATA-265	176	192	16	1	3	5	2	0
RBONDATA-265	176	198	22	1	3	4	2	0
RBONDATA-265	176	186	10	1	3	5	2	0
RBONDATA-265	176	189	13	1	4	1	2	0
RBONDATA-265	176	219	43	1	3	4	1	0
RBONDATA-266	177	187	10	1	3	5	2	0
RBONDATA-266	177	477	300	0	3	1	0	1
RBONDATA-266	177	477	300	0	3	1	0	2
RBONDATA-266	177	477	300	0	4	1	0	0
RBONDATA-266	177	477	300	0	3	4	0	0
RBONDATA-266	177	477	300	0	3	1	0	0
RBONDATA-266	178	189	11	1	3	1	1	0
RBONDATA-266	178	477	299	0	4	1	0	0
RBONDATA-266	178	477	299	0	3	1	0	0
RBONDATA-266	178	179	1	1	3	1	1	0
RBONDATA-267	179	477	298	0	3	4	0	0
RBONDATA-267	179	477	298	0	4	1	0	0
RBONDATA-267	179	477	298	0	3	1	0	0
RBONDATA-267	179	477	298	0	1	1	0	0
RBONDATA-267	179	183	4	1	3	1	2	0
RBONDATA-267	180	186	6	1	3	5	2	0
RBONDATA-267	180	191	11	1	4	1	0	0
RBONDATA-267	182	477	295	0	3	4	0	0
RBONDATA-267	182	477	295	0	4	1	0	0
RBONDATA-267	182	477	295	0	3	1	0	0
RBONDATA-268	182	477	295	0	3	1	0	0
RBONDATA-268	182	189	7	1	3	5	2	0
RBONDATA-268	182	204	22	1	4	5	1	0
RBONDATA-268	183	186	3	1	3	5	2	0
RBONDATA-268	183	186	3	1	4	1	1	0
RBONDATA-268	184	190	6	1	3	5	2	0
RBONDATA-268	184	186	2	1	3	4	2	0
RBONDATA-268	184	185	1	1	3	5	2	0
RBONDATA-268	184	477	293	0	3	2	0	0
RBONDATA-268	184	189	5	1	3	5	1	0
RBONDATA-269	185	203	18	1	3	5	0	0
RBONDATA-269	185	203	18	1	3	5	0	0
RBONDATA-269	185	203	18	1	3	5	0	0
RBONDATA-269	185	195	10	1	3	5	2	0
RBONDATA-269	185	204	19	1	3	5	2	0
RBONDATA-269	185	186	1	1	3	5	0	0
RBONDATA-269	185	186	1	1	3	5	0	0
RBONDATA-269	185	477	292	0	3	4	0	0
RBONDATA-269	185	197	12	1	3	5	0	0
RBONDATA-269	185	198	13	1	3	5	0	0
RBONDATA-270	185	197	12	1	3	5	1	0
RBONDATA-270	185	189	4	1	4	5	1	0
RBONDATA-270	186	191	5	1	3	5	2	0
RBONDATA-270	186	190	4	1	3	1	2	0
RBONDATA-270	186	195	9	1	4	1	1	0
RBONDATA-270	187	203	16	1	3	5	0	0
RBONDATA-270	189	190	1	1	3	5	2	0
RBONDATA-270	189	477	288	0	2	1	0	0
RBONDATA-270	189	193	4	1	3	5	2	0
RBONDATA-270	189	477	288	0	3	5	0	0
RBONDATA-271	189	198	9	1	3	4	1	0
RBONDATA-271	189	284	95	1	3	1	1	0
RBONDATA-271	189	191	2	1	3	5	0	0
RBONDATA-271	190	477	287	0	3	5	0	0
RBONDATA-271	190	196	6	1	3	5	1	0
RBONDATA-271	190	191	1	1	3	1	2	0
RBONDATA-271	190	193	3	1	3	5	1	0
RBONDATA-271	190	193	3	1	4	1	1	0
RBONDATA-271	190	203	13	1	3	5	0	0
RBONDATA-271	191	193	2	1	4	5	1	0
RBONDATA-272	191	192	1	1	4	4	1	0
RBONDATA-272	191	193	2	1	3	1	1	0
RBONDATA-272	191	193	2	1	3	1	1	0
RBONDATA-272	191	193	2	1	3	5	1	0
RBONDATA-272	191	198	7	1	4	1	1	0
RBONDATA-272	191	477	286	0	4	1	0	0
RBONDATA-272	191	477	286	0	3	1	0	1
RBONDATA-272	191	198	7	1	3	5	1	0
RBONDATA-272	191	477	286	0	4	1	0	1
RBONDATA-272	191	194	3	1	3	1	2	0
RBONDATA-273	191	193	2	1	3	5	0	0
RBONDATA-273	191	477	286	0	3	1	0	0
RBONDATA-273	191	197	6	1	3	5	1	0
RBONDATA-273	191	477	286	0	3	1	0	0
RBONDATA-273	191	193	2	1	3	5	1	0
RBONDATA-273	191	199	8	1	3	1	1	0
RBONDATA-273	192	477	285	0	3	1	0	0
RBONDATA-273	192	477	285	0	3	4	0	0
RBONDATA-273	192	198	6	1	4	1	1	0
RBONDATA-273	193	477	284	0	3	1	0	0
RBONDATA-274	193	205	12	1	4	1	1	0
RBONDATA-274	193	198	5	1	4	1	1	0
RBONDATA-274	193	200	7	1	3	1	1	0
RBONDATA-274	193	477	284	0	3	1	0	0
RBONDATA-274	195	477	282	0	4	1	0	0
RBONDATA-274	196	204	8	1	3	5	1	0
RBONDATA-274	196	198	2	1	3	5	1	0
RBONDATA-274	197	204	7	1	3	1	1	0
RBONDATA-274	197	477	280	0	4	1	0	0
RBONDATA-274	197	210	13	1	3	1	1	0
RBONDATA-275	198	206	8	1	4	5	0	0
RBONDATA-275	198	199	1	1	3	1	1	0
RBONDATA-275	198	203	5	1	3	2	0	0
RBONDATA-275	198	203	5	1	3	1	1	0
RBONDATA-275	199	200	1	1	3	4	1	0
RBONDATA-275	199	346	147	1	3	5	1	0
RBONDATA-275	199	203	4	1	3	3	1	0
RBONDATA-275	199	204	5	1	3	5	1	0
RBONDATA-275	199	200	1	1	4	1	1	0
RBONDATA-275	199	203	4	1	3	4	0	0
RBONDATA-276	199	203	4	1	3	4	1	0
RBONDATA-276	200	477	277	0	3	1	0	0
RBONDATA-276	200	217	17	1	4	1	1	1
RBONDATA-276	200	217	17	1	4	1	1	1
RBONDATA-276	200	477	277	0	4	1	0	1
RBONDATA-276	200	477	277	0	4	1	0	0
RBONDATA-276	202	477	275	0	3	1	0	0
RBONDATA-276	203	205	2	1	4	1	0	0
RBONDATA-276	203	233	30	1	3	5	0	0
RBONDATA-276	203	204	1	1	3	1	2	0
RBONDATA-277	203	204	1	1	3	5	1	0
RBONDATA-277	203	205	2	1	4	1	0	0
RBONDATA-277	203	206	3	1	4	1	0	0
RBONDATA-277	204	477	273	0	3	1	0	0
RBONDATA-277	204	205	1	1	3	5	1	0
RBONDATA-277	204	209	5	1	3	1	0	0
RBONDATA-277	204	477	273	0	4	5	0	0
RBONDATA-277	204	205	1	1	3	1	1	0
RBONDATA-277	204	206	2	1	4	1	1	0
RBONDATA-277	204	205	1	1	3	1	1	0
RBONDATA-278	205	206	1	1	3	1	0	0
RBONDATA-278	205	212	7	1	3	1	1	0
RBONDATA-278	205	207	2	1	5	4	1	0
RBONDATA-278	205	213	8	1	3	5	1	0
RBONDATA-278	205	209	4	1	3	1	1	0
RBONDATA-278	206	477	271	0	3	5	0	0
RBONDATA-278	206	477	271	0	3	1	0	0
RBONDATA-278	206	477	271	0	4	1	0	0
RBONDATA-278	206	212	6	1	3	5	1	0
RBONDATA-278	207	211	4	1	3	3	1	0
RBONDATA-279	207	212	5	1	3	5	2	0
RBONDATA-279	207	209	2	1	4	4	1	0
RBONDATA-279	207	213	6	1	3	1	1	0
RBONDATA-279	207	213	6	1	3	5	1	0
RBONDATA-279	207	477	270	0	3	5	0	0
RBONDATA-279	209	216	7	1	4	1	1	0
RBONDATA-279	210	217	7	1	3	5	1	0
RBONDATA-279	210	477	267	0	3	1	0	0
RBONDATA-279	210	212	2	1	4	1	1	1
RBONDATA-279	210	213	3	1	3	1	1	0
RBONDATA-280	210	213	3	1	3	5	1	0
RBONDATA-280	210	211	1	1	3	4	2	0
RBONDATA-280	210	214	4	1	4	1	2	0
RBONDATA-280	210	213	3	1	3	1	1	0
RBONDATA-280	210	214	4	1	4	1	1	0
RBONDATA-280	210	212	2	1	3	1	1	0
RBONDATA-280	210	477	267	0	3	1	0	0
RBONDATA-280	210	218	8	1	3	4	1	0
RBONDATA-280	211	212	1	1	3	1	1	0
RBONDATA-280	212	218	6	1	4	1	0	0
RBONDATA-281	212	213	1	1	3	1	0	0
RBONDATA-281	213	254	41	1	3	5	1	0
RBONDATA-281	213	214	1	1	3	1	1	0
RBONDATA-281	213	214	1	1	4	1	1	0
RBONDATA-281	213	477	264	0	2	5	0	0
RBONDATA-281	213	215	2	1	3	4	2	0
RBONDATA-281	213	477	264	0	4	1	0	0
RBONDATA-281	213	219	6	1	3	1	0	0
RBONDATA-281	214	477	263	0	3	4	0	0
RBONDATA-281	214	477	263	0	3	4	0	0
RBONDATA-282	214	218	4	1	3	4	0	0
RBONDATA-282	214	477	263	0	4	1	0	0
RBONDATA-282	214	218	4	1	4	1	0	0
RBONDATA-282	214	218	4	1	4	1	2	0
RBONDATA-282	215	477	262	0	3	2	0	0
RBONDATA-282	215	477	262	0	3	5	0	0
RBONDATA-282	215	477	262	0	3	5	0	0
RBONDATA-282	215	477	262	0	3	4	0	0
RBONDATA-282	215	477	262	0	3	5	0	0
RBONDATA-282	217	218	1	1	4	1	1	0
RBONDATA-283	217	477	260	0	3	1	0	0
RBONDATA-283	217	218	1	1	3	1	1	0
RBONDATA-283	217	218	1	1	4	1	1	0
RBONDATA-283	217	477	260	0	3	1	0	0
RBONDATA-283	218	219	1	1	3	1	1	0
RBONDATA-283	218	241	23	1	3	5	1	0
RBONDATA-283	218	219	1	1	3	4	1	0
RBONDATA-283	218	245	27	1	3	4	2	0
RBONDATA-283	219	344	125	1	4	5	1	0
RBONDATA-283	219	223	4	1	4	3	1	0
RBONDATA-284	219	477	258	0	4	5	0	0
RBONDATA-284	219	477	258	0	3	1	0	0
RBONDATA-284	219	477	258	0	3	1	0	0
RBONDATA-284	219	477	258	0	3	1	0	0
RBONDATA-284	220	239	19	1	4	5	1	0
RBONDATA-284	220	254	34	1	3	5	1	0
RBONDATA-284	220	477	257	0	4	1	0	0
RBONDATA-284	220	477	257	0	4	1	0	0
RBONDATA-284	220	477	257	0	4	1	0	0
RBONDATA-284	220	477	257	0	4	1	0	0
RBONDATA-285	224	477	253	0	3	4	0	0
RBONDATA-285	224	254	30	1	3	5	1	0
RBONDATA-285	224	254	30	1	3	5	1	0
RBONDATA-285	224	247	23	1	3	5	1	0
RBONDATA-285	225	226	1	1	4	1	1	0
RBONDATA-285	225	477	252	0	4	1	0	0
RBONDATA-285	226	241	15	1	3	5	1	0
RBONDATA-285	226	227	1	1	4	4	1	0
RBONDATA-285	226	477	251	0	3	1	0	0
RBONDATA-285	226	250	24	1	4	5	1	0
RBONDATA-286	226	477	251	0	3	1	0	0
RBONDATA-286	226	477	251	0	2	1	0	0
RBONDATA-286	227	240	13	1	3	1	1	0
RBONDATA-286	227	477	250	0	3	4	0	0
RBONDATA-286	227	477	250	0	3	1	0	0
RBONDATA-286	228	477	249	0	4	1	0	0
RBONDATA-286	228	247	19	1	3	1	1	0
RBONDATA-286	231	477	246	0	3	5	0	0
RBONDATA-286	231	477	246	0	3	5	0	0
RBONDATA-286	231	240	9	1	3	5	1	0
RBONDATA-287	231	477	246	0	3	1	0	0
RBONDATA-287	232	477	245	0	4	1	0	0
RBONDATA-287	233	235	2	1	3	2	0	2
RBONDATA-287	233	477	244	0	3	5	0	0
RBONDATA-287	233	237	4	1	4	1	1	0
RBONDATA-287	233	477	244	0	4	1	0	0
RBONDATA-287	233	280	47	1	3	4	1	0
RBONDATA-287	234	477	243	0	3	1	0	0
RBONDATA-287	234	477	243	0	3	1	0	0
RBONDATA-287	234	250	16	1	3	4	1	0
RBONDATA-288	234	477	243	0	4	1	0	0
RBONDATA-288	234	477	243	0	3	5	0	0
RBONDATA-288	235	477	242	0	3	5	0	0
RBONDATA-288	235	477	242	0	4	5	0	0
RBONDATA-288	235	241	6	1	4	4	1	0
RBONDATA-288	235	238	3	1	3	1	0	0
RBONDATA-288	235	259	24	1	4	1	1	0
RBONDATA-288	235	240	5	1	3	1	0	0
RBONDATA-288	237	247	10	1	3	1	1	0
RBONDATA-288	238	252	14	1	3	5	0	0
RBONDATA-289	238	477	239	0	3	5	0	0
RBONDATA-289	238	477	239	0	4	1	0	1
RBONDATA-289	238	477	239	0	3	1	0	1
RBONDATA-289	238	477	239	0	3	1	0	1
RBONDATA-289	238	250	12	1	3	5	1	0
RBONDATA-289	238	247	9	1	3	1	0	0
RBONDATA-289	239	260	21	1	3	2	1	0
RBONDATA-289	239	477	238	0	3	1	0	0
RBONDATA-289	239	241	2	1	3	1	0	0
RBONDATA-289	240	241	1	1	4	4	2	0
RBONDATA-290	240	245	5	1	3	4	1	0
RBONDATA-290	241	245	4	1	2	1	1	0
RBONDATA-290	242	245	3	1	3	1	1	0
RBONDATA-290	242	284	42	1	3	4	1	0
RBONDATA-290	242	477	235	0	3	5	0	0
RBONDATA-290	242	245	3	1	3	4	1	1
RBONDATA-290	243	245	2	1	3	4	1	1
RBONDATA-290	243	245	2	1	3	4	1	0
RBONDATA-290	244	251	7	1	3	1	1	0
RBONDATA-290	245	253	8	1	3	4	1	0
RBONDATA-291	245	249	4	1	3	1	1	0
RBONDATA-291	246	247	1	1	3	4	1	0
RBONDATA-291	246	477	231	0	3	1	0	0
RBONDATA-291	246	477	231	0	3	1	0	0
RBONDATA-291	246	477	231	0	4	1	0	0
RBONDATA-291	246	249	3	1	4	4	1	0
RBONDATA-291	246	256	10	1	3	2	1	0
RBONDATA-291	247	477	230	0	4	4	0	0
RBONDATA-291	247	477	230	0	3	1	0	0
RBONDATA-291	247	284	37	1	3	2	1	0
RBONDATA-292	249	477	228	0	4	1	0	1
RBONDATA-292	250	251	1	1	4	4	0	0
RBONDATA-292	250	252	2	1	4	5	1	0
RBONDATA-292	252	477	225	0	4	4	0	0
RBONDATA-292	252	256	4	1	3	1	1	0
RBONDATA-292	252	256	4	1	3	1	1	0
RBONDATA-292	252	256	4	1	3	1	1	0
RBONDATA-292	253	261	8	1	3	1	1	0
RBONDATA-292	254	477	223	0	3	1	1	0
RBONDATA-292	254	255	1	1	3	4	1	0
RBONDATA-293	254	312	58	1	3	5	1	0
RBONDATA-293	254	477	223	0	3	4	0	0
RBONDATA-293	255	260	5	1	3	1	1	0
RBONDATA-293	256	257	1	1	3	1	1	0
RBONDATA-293	256	477	221	0	3	2	0	0
RBONDATA-293	256	260	4	1	3	5	1	0
RBONDATA-293	256	477	221	0	3	5	0	0
RBONDATA-293	256	477	221	0	3	5	0	0
RBONDATA-293	257	258	1	1	3	4	1	0
RBONDATA-293	257	477	220	0	3	1	0	0
RBONDATA-294	259	260	1	1	4	1	1	0
RBONDATA-294	259	477	218	0	3	4	0	0
RBONDATA-294	259	260	1	1	3	5	1	0
RBONDATA-294	259	477	218	0	3	5	0	0
RBONDATA-294	259	477	218	0	3	5	0	0
RBONDATA-294	259	284	25	1	3	2	1	0
RBONDATA-294	261	477	216	0	3	1	0	0
RBONDATA-294	261	267	6	1	4	4	1	0
RBONDATA-294	261	263	2	1	3	4	1	0
RBONDATA-294	262	477	215	0	3	2	0	0
RBONDATA-295	262	263	1	1	4	1	0	0
RBONDATA-295	262	477	215	0	2	3	1	3
RBONDATA-295	262	275	13	1	3	5	1	0
RBONDATA-295	262	263	1	1	4	1	0	0
RBONDATA-295	262	266	4	1	4	1	0	0
RBONDATA-295	263	264	1	1	3	1	1	0
RBONDATA-295	263	266	3	1	3	1	1	0
RBONDATA-295	263	268	5	1	3	5	1	0
RBONDATA-295	263	266	3	1	3	1	0	0
RBONDATA-295	263	477	214	0	4	4	0	0
RBONDATA-296	263	267	4	1	3	4	0	0
RBONDATA-296	265	267	2	1	4	4	1	0
RBONDATA-296	266	268	2	1	3	4	0	0
RBONDATA-296	266	267	1	1	4	4	1	0
RBONDATA-296	266	267	1	1	3	4	1	0
RBONDATA-296	266	268	2	1	3	2	1	0
RBONDATA-296	266	268	2	1	4	4	1	0
RBONDATA-296	267	275	8	1	3	1	1	0
RBONDATA-296	267	268	1	1	4	1	0	0
RBONDATA-296	267	268	1	1	3	1	1	0
RBONDATA-297	267	269	2	1	4	1	0	0
RBONDATA-297	268	269	1	1	3	4	0	0
RBONDATA-297	268	269	1	1	3	4	1	0
RBONDATA-297	268	269	1	1	4	4	1	0
RBONDATA-297	268	270	2	1	3	1	1	0
RBONDATA-297	268	276	8	1	3	1	1	0
RBONDATA-297	268	275	7	1	3	2	1	0
RBONDATA-297	268	297	29	1	3	2	1	0
RBONDATA-297	268	270	2	1	3	1	0	0
RBONDATA-297	269	275	6	1	4	1	1	0
RBONDATA-298	269	272	3	1	3	1	1	0
RBONDATA-298	270	298	28	1	3	5	1	0
RBONDATA-298	270	275	5	1	3	1	1	0
RBONDATA-298	270	276	6	1	3	4	1	0
RBONDATA-298	270	275	5	1	3	1	1	0
RBONDATA-298	270	276	6	1	3	4	1	0
RBONDATA-298	270	276	6	1	3	1	1	0
RBONDATA-298	270	275	5	1	2	4	0	0
RBONDATA-298	270	284	14	1	3	1	0	0
RBONDATA-298	270	272	2	1	4	4	1	0
RBONDATA-299	272	276	4	1	3	1	1	0
RBONDATA-299	275	276	1	1	3	1	1	0
RBONDATA-299	276	277	1	1	3	1	1	0
RBONDATA-299	277	278	1	1	4	1	1	0
RBONDATA-299	277	280	3	1	4	1	1	0
RBONDATA-299	280	281	1	1	3	1	1	0
RBONDATA-299	281	310	29	1	3	1	1	1
RBONDATA-299	281	316	35	1	3	5	1	0
RBONDATA-299	281	296	15	1	4	1	1	0
RBONDATA-299	282	362	80	1	3	5	0	0
RBONDATA-300	282	302	20	1	3	5	1	0
RBONDATA-300	283	477	194	0	4	4	0	0
RBONDATA-300	283	291	8	1	3	1	1	0
RBONDATA-300	284	309	25	1	3	5	1	0
RBONDATA-300	284	295	11	1	3	5	1	0
RBONDATA-300	284	344	60	1	4	2	0	0
RBONDATA-300	287	477	190	0	3	4	0	0
RBONDATA-300	287	290	3	1	5	1	1	0
RBONDATA-300	287	296	9	1	4	4	1	0
RBONDATA-300	288	290	2	1	4	4	1	0
RBONDATA-301	288	477	189	0	3	4	0	0
RBONDATA-301	288	297	9	1	3	5	0	0
RBONDATA-301	288	297	9	1	3	5	0	0
RBONDATA-301	288	298	10	1	3	5	0	0
RBONDATA-301	288	298	10	1	3	5	0	0
RBONDATA-301	288	299	11	1	3	5	0	0
RBONDATA-301	288	477	189	0	3	4	0	0
RBONDATA-301	288	347	59	1	3	5	1	0
RBONDATA-301	288	477	189	0	3	2	0	0
RBONDATA-301	289	290	1	1	4	4	1	0
RBONDATA-302	289	477	188	0	3	4	0	0
RBONDATA-302	289	477	188	0	3	1	0	0
RBONDATA-302	289	295	6	1	4	4	1	0
RBONDATA-302	289	299	10	1	4	4	1	0
RBONDATA-302	289	290	1	1	3	4	1	0
RBONDATA-302	289	297	8	1	3	1	1	0
RBONDATA-302	290	291	1	1	3	1	1	0
RBONDATA-302	290	477	187	0	3	1	0	0
RBONDATA-302	291	477	186	0	3	1	0	0
RBONDATA-302	291	295	4	1	3	1	1	0
RBONDATA-303	294	296	2	1	3	4	1	0
RBONDATA-303	294	320	26	1	3	4	1	0
RBONDATA-303	294	308	14	1	3	4	1	0
RBONDATA-303	294	477	183	0	3	4	0	0
RBONDATA-303	295	296	1	1	3	4	1	0
RBONDATA-303	295	296	1	1	3	4	1	0
RBONDATA-303	295	297	2	1	3	1	1	0
RBONDATA-303	295	477	182	0	3	4	0	0
RBONDATA-303	296	309	13	1	3	5	1	0
RBONDATA-303	296	299	3	1	4	4	1	0
RBONDATA-304	296	297	1	1	3	1	1	0
RBONDATA-304	297	301	4	1	4	4	1	0
RBONDATA-304	297	302	5	1	3	4	1	0
RBONDATA-304	297	477	180	0	3	5	1	0
RBONDATA-304	297	324	27	1	3	5	1	0
RBONDATA-304	298	318	20	1	3	1	1	0
RBONDATA-304	298	301	3	1	3	4	1	0
RBONDATA-304	299	300	1	1	3	4	1	0
RBONDATA-304	299	300	1	1	3	4	1	0
RBONDATA-304	301	477	176	0	3	2	0	0
RBONDATA-305	301	302	1	1	3	4	1	0
RBONDATA-305	301	303	2	1	3	4	1	0
RBONDATA-305	301	304	3	1	3	4	1	0
RBONDATA-305	301	304	3	1	3	4	1	0
RBONDATA-305	301	303	2	1	3	4	1	0
RBONDATA-305	301	477	176	0	4	4	0	0
RBONDATA-305	301	305	4	1	4	5	1	0
RBONDATA-305	301	308	7	1	4	5	1	0
RBONDATA-305	302	303	1	1	3	1	1	0
RBONDATA-305	302	477	175	0	3	1	0	0
RBONDATA-306	302	308	6	1	4	1	1	0
RBONDATA-306	302	305	3	1	3	4	1	0
RBONDATA-306	302	305	3	1	3	1	1	0
RBONDATA-306	303	315	12	1	3	5	1	0
RBONDATA-306	303	333	30	1	3	4	1	0
RBONDATA-306	303	316	13	1	3	1	1	0
RBONDATA-306	303	305	2	1	4	1	1	0
RBONDATA-306	304	309	5	1	3	4	1	0
RBONDATA-306	304	305	1	1	3	1	0	0
RBONDATA-306	305	308	3	1	3	1	1	0
RBONDATA-307	305	477	172	0	3	1	0	0
RBONDATA-307	307	308	1	1	4	4	1	0
RBONDATA-307	308	477	169	0	4	1	0	1
RBONDATA-307	308	351	43	1	3	5	1	0
RBONDATA-307	308	309	1	1	3	4	1	0
RBONDATA-307	308	316	8	1	3	4	1	0
RBONDATA-307	308	477	169	0	4	1	0	1
RBONDATA-307	308	317	9	1	3	1	1	0
RBONDATA-307	308	309	1	1	3	1	1	0
RBONDATA-307	308	477	169	0	3	5	1	0
RBONDATA-308	308	357	49	1	4	1	1	0
RBONDATA-308	308	316	8	1	3	1	1	0
RBONDATA-308	308	477	169	0	4	1	0	0
RBONDATA-308	309	333	24	1	3	1	1	0
RBONDATA-308	309	317	8	1	3	1	1	0
RBONDATA-308	309	477	168	0	4	1	0	0
RBONDATA-308	309	477	168	0	3	1	0	0
RBONDATA-308	310	318	8	1	3	4	1	0
RBONDATA-308	310	324	14	1	3	4	1	0
RBONDATA-308	311	477	166	0	3	4	0	0
RBONDATA-309	313	477	164	0	3	4	0	0
RBONDATA-309	315	477	162	0	3	1	0	0
RBONDATA-309	315	477	162	0	3	4	0	0
RBONDATA-309	315	477	162	0	3	5	0	0
RBONDATA-309	316	477	161	0	3	4	0	0
RBONDATA-309	316	333	17	1	3	5	1	0
RBONDATA-309	316	324	8	1	4	1	0	0
RBONDATA-309	317	477	160	0	3	5	0	0
RBONDATA-309	317	318	1	1	3	1	1	0
RBONDATA-309	317	477	160	0	3	1	1	1
RBONDATA-310	317	318	1	1	3	1	1	1
RBONDATA-310	318	477	159	0	3	1	0	0
RBONDATA-310	318	348	30	1	3	1	1	0
RBONDATA-310	318	477	159	0	3	1	0	0
RBONDATA-310	319	323	4	1	4	4	1	0
RBONDATA-310	319	477	158	0	4	4	1	0
RBONDATA-310	319	323	4	1	3	1	1	0
RBONDATA-310	322	417	95	1	3	4	0	0
RBONDATA-310	322	324	2	1	3	1	0	1
RBONDATA-310	323	477	154	0	3	5	0	0
RBONDATA-311	323	477	154	0	4	1	0	0
RBONDATA-311	323	477	154	0	4	1	0	1
RBONDATA-311	324	325	1	1	3	4	1	0
RBONDATA-311	324	325	1	1	3	4	1	0
RBONDATA-311	324	325	1	1	4	1	0	0
RBONDATA-311	324	325	1	1	3	1	0	0
RBONDATA-311	324	344	20	1	3	1	1	1
RBONDATA-311	324	325	1	1	4	1	1	0
RBONDATA-311	324	330	6	1	3	4	1	0
RBONDATA-311	325	361	36	1	1	4	1	1
RBONDATA-312	325	330	5	1	3	1	1	1
RBONDATA-312	325	330	5	1	4	4	1	0
RBONDATA-312	325	330	5	1	3	1	1	0
RBONDATA-312	326	330	4	1	3	1	1	0
RBONDATA-312	326	331	5	1	4	1	1	0
RBONDATA-312	326	477	151	0	3	3	0	4
RBONDATA-312	326	362	36	1	3	1	0	1
RBONDATA-312	327	354	27	1	3	1	1	1
RBONDATA-312	327	361	34	1	3	1	0	1
RBONDATA-312	327	477	150	0	3	1	0	1
RBONDATA-313	327	477	150	0	4	2	0	2
RBONDATA-313	330	331	1	1	4	5	1	0
RBONDATA-313	330	331	1	1	3	1	1	0
RBONDATA-313	330	331	1	1	3	4	1	0
RBONDATA-313	330	331	1	1	3	1	1	0
RBONDATA-313	330	477	147	0	3	4	0	0
RBONDATA-313	330	331	1	1	3	4	1	0
RBONDATA-313	331	337	6	1	4	5	0	0
RBONDATA-313	331	332	1	1	3	1	0	0
RBONDATA-313	331	477	146	0	3	1	0	0
RBONDATA-314	333	334	1	1	4	1	1	0
RBONDATA-314	333	344	11	1	4	5	1	0
RBONDATA-314	336	360	24	1	3	4	1	0
RBONDATA-314	336	343	7	1	3	1	0	0
RBONDATA-314	337	477	140	0	3	2	0	0
RBONDATA-314	337	343	6	1	3	5	0	0
RBONDATA-314	338	477	139	0	4	2	0	0
RBONDATA-314	338	344	6	1	3	1	1	0
RBONDATA-314	338	477	139	0	3	4	0	0
RBONDATA-314	338	353	15	1	3	2	1	0
RBONDATA-315	339	477	138	0	3	1	0	0
RBONDATA-315	339	477	138	0	3	2	1	0
RBONDATA-315	339	477	138	0	3	4	0	1
RBONDATA-315	340	347	7	1	3	1	1	0
RBONDATA-315	340	342	2	1	3	1	1	0
RBONDATA-315	341	477	136	0	3	4	0	0
RBONDATA-315	343	477	134	0	3	5	0	0
RBONDATA-315	343	345	2	1	3	4	1	0
RBONDATA-315	343	346	3	1	4	4	1	0
RBONDATA-315	343	351	8	1	4	1	1	0
RBONDATA-316	343	351	8	1	4	5	1	0
RBONDATA-316	344	477	133	0	4	1	0	0
RBONDATA-316	344	351	7	1	3	1	1	0
RBONDATA-316	344	477	133	0	3	1	0	0
RBONDATA-316	344	477	133	0	3	1	0	0
RBONDATA-316	345	360	15	1	2	1	1	0
RBONDATA-316	346	347	1	1	4	4	1	0
RBONDATA-316	346	477	131	0	3	5	0	0
RBONDATA-316	346	477	131	0	3	1	0	0
RBONDATA-316	347	477	130	0	3	5	0	1
RBONDATA-317	347	477	130	0	3	5	0	0
RBONDATA-317	347	477	130	0	3	5	0	0
RBONDATA-317	347	477	130	0	3	5	0	0
RBONDATA-317	347	362	15	1	4	4	1	1
RBONDATA-317	347	351	4	1	4	1	1	0
RBONDATA-317	347	350	3	1	4	5	1	0
RBONDATA-317	349	362	13	1	4	4	1	1
RBONDATA-317	350	477	127	0	3	4	0	0
RBONDATA-317	350	352	2	1	4	1	0	0
RBONDATA-317	351	353	2	1	3	1	0	0
RBONDATA-318	352	477	125	0	3	4	0	0
RBONDATA-318	352	353	1	1	3	1	1	0
RBONDATA-318	352	353	1	1	4	5	1	0
RBONDATA-318	352	477	125	0	3	1	0	0
RBONDATA-318	352	357	5	1	4	1	1	0
RBONDATA-318	353	477	124	0	3	1	0	0
RBONDATA-318	353	357	4	1	3	1	0	0
RBONDATA-318	353	354	1	1	4	3	0	0
RBONDATA-318	353	360	7	1	3	1	1	0
RBONDATA-318	353	477	124	0	4	1	0	0
RBONDATA-319	354	477	123	0	3	1	0	0
RBONDATA-319	354	477	123	0	3	1	0	0
RBONDATA-319	354	357	3	1	4	1	0	0
RBONDATA-319	355	477	122	0	3	4	0	0
RBONDATA-319	357	362	5	1	3	2	1	0
RBONDATA-319	357	361	4	1	4	4	0	0
RBONDATA-319	357	361	4	1	4	1	1	0
RBONDATA-319	358	477	119	0	3	1	0	0
RBONDATA-319	358	477	119	0	3	1	1	0
RBONDATA-319	359	477	118	0	4	1	0	0
RBONDATA-320	360	373	13	1	3	2	0	0
RBONDATA-320	360	373	13	1	3	2	0	0
RBONDATA-320	360	364	4	1	4	1	1	0
RBONDATA-320	360	361	1	1	4	1	1	0
RBONDATA-320	360	477	117	0	3	1	0	0
RBONDATA-320	360	366	6	1	4	1	1	0
RBONDATA-320	360	365	5	1	3	1	0	1
RBONDATA-320	360	477	117	0	3	5	0	0
RBONDATA-320	360	364	4	1	3	1	0	1
RBONDATA-320	361	365	4	1	3	4	0	0
RBONDATA-321	361	477	116	0	3	4	0	1
RBONDATA-321	361	372	11	1	3	4	0	1
RBONDATA-321	361	367	6	1	4	1	1	0
RBONDATA-321	361	368	7	1	3	4	0	1
RBONDATA-321	361	477	116	0	3	4	0	1
RBONDATA-321	361	396	35	1	3	4	1	0
RBONDATA-321	362	396	34	1	3	1	1	1
SSANDRA-1414	3	247	244	1	4	4	1	1
SSANDRA-1414	3	158	155	1	3	1	0	0
SSANDRA-1414	4	477	473	0	3	1	2	1
SSANDRA-1414	4	99	95	1	3	1	0	0
SSANDRA-1414	4	477	473	0	3	4	1	1
SSANDRA-1415	5	6	1	1	3	1	0	1
SSANDRA-1415	5	477	472	0	3	1	2	0
SSANDRA-1415	6	16	10	1	4	5	1	1
SSANDRA-1415	7	10	3	1	4	4	1	0
SSANDRA-1415	7	9	2	1	4	1	3	0
SSANDRA-1415	7	477	470	0	3	1	0	0
SSANDRA-1415	9	207	198	1	3	1	0	0
SSANDRA-1415	9	477	468	0	3	1	0	0
SSANDRA-1415	9	29	20	1	3	1	0	0
SSANDRA-1415	9	23	14	1	3	4	0	0
SSANDRA-1416	9	477	468	0	3	1	1	0
SSANDRA-1416	9	477	468	0	3	1	1	0
SSANDRA-1416	10	477	467	0	4	1	1	0
SSANDRA-1416	10	47	37	1	4	4	2	0
SSANDRA-1416	11	15	4	1	3	1	0	0
SSANDRA-1416	11	79	68	1	3	1	0	0
SSANDRA-1416	11	66	55	1	3	1	3	1
SSANDRA-1416	14	184	170	1	3	1	2	0
SSANDRA-1416	14	477	463	0	3	1	0	0
SSANDRA-1416	15	44	29	1	4	1	1	0
SSANDRA-1417	16	72	56	1	4	1	2	0
SSANDRA-1417	16	477	461	0	4	1	1	0
SSANDRA-1417	17	18	1	1	3	1	0	0
SSANDRA-1417	17	32	15	1	1	1	2	1
SSANDRA-1417	17	36	19	1	4	4	1	0
SSANDRA-1417	18	19	1	1	4	1	3	0
SSANDRA-1417	18	477	459	0	3	1	0	0
SSANDRA-1417	18	19	1	1	3	4	0	0
SSANDRA-1417	18	477	459	0	4	1	0	1
SSANDRA-1417	20	477	457	0	4	1	1	0
SSANDRA-1418	20	21	1	1	4	1	3	0
SSANDRA-1418	20	21	1	1	4	1	4	0
SSANDRA-1418	21	23	2	1	4	1	0	0
SSANDRA-1418	21	44	23	1	3	4	4	0
SSANDRA-1418	21	477	456	0	4	4	0	0
SSANDRA-1418	21	29	8	1	4	4	1	0
SSANDRA-1418	22	29	7	1	3	1	0	1
SSANDRA-1418	22	477	455	0	3	1	0	0
SSANDRA-1418	23	24	1	1	3	1	0	1
SSANDRA-1418	23	24	1	1	1	1	0	1
SSANDRA-1419	23	30	7	1	4	4	1	0
SSANDRA-1419	24	53	29	1	3	1	0	0
SSANDRA-1419	24	477	453	0	4	1	0	0
SSANDRA-1419	25	44	19	1	3	1	0	1
SSANDRA-1419	25	63	38	1	3	1	3	1
SSANDRA-1419	25	29	4	1	4	1	1	2
SSANDRA-1419	26	477	451	0	3	1	0	0
SSANDRA-1419	28	128	100	1	3	4	1	1
SSANDRA-1419	28	29	1	1	3	2	0	1
SSANDRA-1419	28	477	449	0	3	1	1	0
SSANDRA-1420	29	477	448	0	3	1	1	0
SSANDRA-1420	29	45	16	1	3	4	1	0
SSANDRA-1420	29	99	70	1	3	4	3	0
SSANDRA-1420	30	477	447	0	3	1	0	0
SSANDRA-1420	30	477	447	0	4	1	2	0
SSANDRA-1420	30	60	30	1	3	1	2	0
SSANDRA-1420	30	37	7	1	3	4	0	0
SSANDRA-1420	30	477	447	0	3	1	0	0
SSANDRA-1420	31	32	1	1	1	1	1	0
SSANDRA-1420	31	60	29	1	4	1	1	0
SSANDRA-1421	31	63	32	1	3	4	3	0
SSANDRA-1421	31	32	1	1	3	3	1	1
SSANDRA-1421	32	42	10	1	3	4	1	1
SSANDRA-1421	32	477	445	0	3	4	0	0
SSANDRA-1421	35	38	3	1	3	4	1	0
SSANDRA-1421	36	73	37	1	3	1	3	0
SSANDRA-1421	36	37	1	1	4	1	1	0
SSANDRA-1421	36	39	3	1	3	4	3	0
SSANDRA-1421	37	477	440	0	4	4	1	1
SSANDRA-1421	37	43	6	1	3	1	3	1
SSANDRA-1422	37	477	440	0	3	1	0	0
SSANDRA-1422	37	38	1	1	3	1	0	0
SSANDRA-1422	37	39	2	1	3	2	1	0
SSANDRA-1422	38	477	439	0	3	4	1	1
SSANDRA-1422	38	477	439	0	3	1	0	0
SSANDRA-1422	39	43	4	1	4	1	1	0
SSANDRA-1422	39	43	4	1	3	3	1	0
SSANDRA-1422	41	477	436	0	3	1	0	2
SSANDRA-1422	41	477	436	0	4	3	0	1
SSANDRA-1422	43	477	434	0	4	2	0	0
SSANDRA-1423	43	44	1	1	3	1	0	1
SSANDRA-1423	43	44	1	1	3	1	1	0
SSANDRA-1423	43	86	43	1	3	4	1	0
SSANDRA-1423	43	44	1	1	4	1	2	0
SSANDRA-1423	44	45	1	1	3	1	2	1
SSANDRA-1423	44	477	433	0	3	1	0	0
SSANDRA-1423	46	477	431	0	4	2	0	0
SSANDRA-1423	46	158	112	1	4	1	0	0
SSANDRA-1423	46	157	111	1	4	1	1	0
SSANDRA-1423	46	477	431	0	3	1	0	1
SSANDRA-1424	46	49	3	1	4	3	3	0
SSANDRA-1424	46	56	10	1	3	3	0	2
SSANDRA-1424	50	477	427	0	3	1	2	0
SSANDRA-1424	50	60	10	1	4	1	1	0
SSANDRA-1424	50	64	14	1	3	4	0	0
SSANDRA-1424	51	87	36	1	3	1	2	0
SSANDRA-1424	51	114	63	1	1	1	0	0
SSANDRA-1424	51	73	22	1	3	4	2	0
SSANDRA-1424	51	477	426	0	3	1	1	0
SSANDRA-1424	51	52	1	1	3	1	0	0
SSANDRA-1425	51	84	33	1	3	1	1	0
SSANDRA-1425	51	64	13	1	3	1	3	1
SSANDRA-1425	51	78	27	1	3	1	1	1
SSANDRA-1425	52	477	425	0	3	1	0	0
SSANDRA-1425	52	477	425	0	3	4	0	0
SSANDRA-1425	53	76	23	1	3	4	0	0
SSANDRA-1425	53	76	23	1	3	4	0	0
SSANDRA-1425	53	76	23	1	3	4	0	0
SSANDRA-1425	54	477	423	0	3	4	0	0
SSANDRA-1425	55	477	422	0	3	1	0	1
SSANDRA-1426	56	100	44	1	4	4	1	0
SSANDRA-1426	56	101	45	1	4	4	1	0
SSANDRA-1426	56	477	421	0	4	4	0	0
SSANDRA-1426	56	63	7	1	3	4	0	1
SSANDRA-1426	56	76	20	1	3	4	0	0
SSANDRA-1426	56	76	20	1	3	4	0	0
SSANDRA-1426	56	76	20	1	3	4	0	0
SSANDRA-1426	56	76	20	1	3	4	0	0
SSANDRA-1426	56	76	20	1	3	4	0	0
SSANDRA-1426	56	76	20	1	3	4	0	1
SSANDRA-1427	56	76	20	1	3	4	0	0
SSANDRA-1427	56	76	20	1	3	4	0	0
SSANDRA-1427	56	76	20	1	3	4	0	0
SSANDRA-1427	56	76	20	1	3	4	0	0
SSANDRA-1427	56	76	20	1	3	4	0	0
SSANDRA-1427	57	77	20	1	3	2	1	0
SSANDRA-1427	57	477	420	0	3	5	0	0
SSANDRA-1427	57	477	420	0	3	5	0	0
SSANDRA-1427	57	477	420	0	3	5	0	0
SSANDRA-1427	57	477	420	0	3	4	0	0
SSANDRA-1428	58	477	419	0	3	1	1	0
SSANDRA-1428	58	114	56	1	3	4	1	0
SSANDRA-1428	58	477	419	0	3	1	0	0
SSANDRA-1428	59	63	4	1	1	1	0	1
SSANDRA-1428	59	99	40	1	3	1	4	3
SSANDRA-1428	60	61	1	1	4	1	1	0
SSANDRA-1428	60	106	46	1	3	1	4	0
SSANDRA-1428	62	63	1	1	4	4	1	0
SSANDRA-1428	62	477	415	0	3	4	0	1
SSANDRA-1428	62	255	193	1	3	4	1	0
SSANDRA-1429	63	65	2	1	3	3	0	0
SSANDRA-1429	64	477	413	0	4	4	0	0
SSANDRA-1429	64	65	1	1	3	1	3	2
SSANDRA-1429	65	80	15	1	3	4	1	0
SSANDRA-1429	65	72	7	1	4	4	1	0
SSANDRA-1429	65	477	412	0	4	1	0	0
SSANDRA-1429	65	477	412	0	3	4	1	1
SSANDRA-1429	65	315	250	1	4	1	1	2
SSANDRA-1429	66	477	411	0	3	1	1	2
SSANDRA-1429	66	106	40	1	3	1	1	0
SSANDRA-1430	66	477	411	0	3	1	0	0
SSANDRA-1430	66	106	40	1	3	1	0	0
SSANDRA-1430	66	67	1	1	4	4	3	0
SSANDRA-1430	67	338	271	1	4	4	1	1
SSANDRA-1430	67	477	410	0	3	1	0	1
SSANDRA-1430	67	477	410	0	4	4	0	0
SSANDRA-1430	67	477	410	0	4	4	0	0
SSANDRA-1430	68	477	409	0	3	5	0	0
SSANDRA-1430	70	477	407	0	4	1	0	0
SSANDRA-1430	71	477	406	0	4	4	1	0
SSANDRA-1431	71	100	29	1	3	4	3	0
SSANDRA-1431	71	477	406	0	3	4	0	0
SSANDRA-1431	72	73	1	1	3	4	0	0
SSANDRA-1431	72	76	4	1	3	4	0	0
SSANDRA-1431	73	80	7	1	3	1	1	0
SSANDRA-1431	73	78	5	1	3	1	1	0
SSANDRA-1431	73	477	404	0	3	4	0	0
SSANDRA-1431	74	163	89	1	3	2	0	0
SSANDRA-1431	74	88	14	1	3	1	1	1
SSANDRA-1431	74	477	403	0	3	4	4	0
SSANDRA-1432	75	80	5	1	4	4	0	1
SSANDRA-1432	75	76	1	1	3	4	0	0
SSANDRA-1432	76	77	1	1	4	1	1	0
SSANDRA-1432	77	78	1	1	4	1	0	0
SSANDRA-1432	77	78	1	1	4	3	0	1
SSANDRA-1432	77	477	400	0	4	1	0	0
SSANDRA-1432	78	477	399	0	3	4	1	2
SSANDRA-1432	78	477	399	0	3	4	1	0
SSANDRA-1432	78	477	399	0	3	1	0	0
SSANDRA-1432	78	477	399	0	3	4	0	1
SSANDRA-1433	78	81	3	1	3	1	3	0
SSANDRA-1433	79	477	398	0	4	1	0	0
SSANDRA-1433	79	106	27	1	3	1	2	2
SSANDRA-1433	79	477	398	0	3	1	1	0
SSANDRA-1433	79	80	1	1	4	4	0	1
SSANDRA-1433	80	123	43	1	3	1	1	0
SSANDRA-1433	80	477	397	0	3	1	0	1
SSANDRA-1433	80	477	397	0	3	4	1	0
SSANDRA-1433	81	82	1	1	4	1	1	0
SSANDRA-1433	81	477	396	0	3	3	1	0
SSANDRA-1434	81	477	396	0	3	5	0	0
SSANDRA-1434	81	83	2	1	3	5	0	0
SSANDRA-1434	81	477	396	0	3	5	0	0
SSANDRA-1434	81	477	396	0	3	5	0	0
SSANDRA-1434	82	477	395	0	3	2	1	0
SSANDRA-1434	84	477	393	0	3	1	0	0
SSANDRA-1434	85	477	392	0	3	4	1	3
SSANDRA-1434	86	477	391	0	3	4	1	0
SSANDRA-1434	86	87	1	1	3	4	0	1
SSANDRA-1434	86	477	391	0	4	1	0	0
SSANDRA-1435	87	99	12	1	1	3	0	0
SSANDRA-1435	87	477	390	0	3	4	0	0
SSANDRA-1435	87	99	12	1	4	4	1	0
SSANDRA-1435	87	95	8	1	3	4	1	0
SSANDRA-1435	87	99	12	1	3	5	1	0
SSANDRA-1435	87	477	390	0	3	1	1	0
SSANDRA-1435	88	168	80	1	3	1	1	0
SSANDRA-1435	88	89	1	1	3	4	0	0
SSANDRA-1435	88	304	216	1	3	1	1	3
SSANDRA-1435	90	107	17	1	4	1	3	0
SSANDRA-1436	91	131	40	1	3	4	1	0
SSANDRA-1436	91	477	386	0	4	4	1	0
SSANDRA-1436	93	106	13	1	3	1	1	0
SSANDRA-1436	93	477	384	0	4	1	1	0
SSANDRA-1436	93	477	384	0	4	4	0	0
SSANDRA-1436	94	477	383	0	3	1	0	0
SSANDRA-1436	94	477	383	0	3	4	1	0
SSANDRA-1436	95	101	6	1	4	4	1	0
SSANDRA-1436	95	477	382	0	3	3	0	0
SSANDRA-1436	96	477	381	0	3	1	1	0
SSANDRA-1437	96	98	2	1	4	4	2	0
SSANDRA-1437	98	106	8	1	3	4	0	0
SSANDRA-1437	98	100	2	1	4	1	1	1
SSANDRA-1437	99	283	184	1	3	4	1	0
SSANDRA-1437	99	106	7	1	4	1	1	0
SSANDRA-1437	99	477	378	0	3	1	0	0
SSANDRA-1437	99	172	73	1	3	1	0	0
SSANDRA-1437	100	213	113	1	4	1	4	0
SSANDRA-1437	100	105	5	1	4	4	1	0
SSANDRA-1437	101	121	20	1	3	4	3	0
SSANDRA-1438	101	477	376	0	1	1	0	0
SSANDRA-1438	101	477	376	0	3	1	1	0
SSANDRA-1438	101	477	376	0	3	1	0	0
SSANDRA-1438	102	477	375	0	3	1	4	1
SSANDRA-1438	102	103	1	1	3	1	4	1
SSANDRA-1438	104	477	373	0	3	1	0	0
SSANDRA-1438	105	106	1	1	3	1	0	0
SSANDRA-1438	105	106	1	1	4	1	3	1
SSANDRA-1438	106	169	63	1	3	1	1	1
SSANDRA-1438	106	111	5	1	3	1	1	0
SSANDRA-1439	106	477	371	0	4	1	0	0
SSANDRA-1439	106	477	371	0	3	4	0	0
SSANDRA-1439	106	108	2	1	3	4	1	0
SSANDRA-1439	106	477	371	0	3	1	0	0
SSANDRA-1439	106	107	1	1	3	1	1	1
SSANDRA-1439	106	414	308	1	3	2	0	1
SSANDRA-1439	107	477	370	0	3	4	1	0
SSANDRA-1439	107	163	56	1	3	4	1	0
SSANDRA-1439	107	108	1	1	1	1	1	0
SSANDRA-1439	107	115	8	1	3	1	1	0
SSANDRA-1440	108	112	4	1	3	1	0	0
SSANDRA-1440	108	477	369	0	3	1	0	0
SSANDRA-1440	108	109	1	1	4	4	1	0
SSANDRA-1440	109	477	368	0	3	1	0	0
SSANDRA-1440	109	477	368	0	3	2	1	3
SSANDRA-1440	109	243	134	1	3	5	1	0
SSANDRA-1440	109	243	134	1	3	5	1	0
SSANDRA-1440	109	243	134	1	3	5	1	0
SSANDRA-1440	109	243	134	1	3	5	1	0
SSANDRA-1440	109	243	134	1	3	5	1	0
SSANDRA-1441	111	477	366	0	3	1	2	1
SSANDRA-1441	112	113	1	1	3	1	4	0
SSANDRA-1441	112	477	365	0	3	1	1	0
SSANDRA-1441	112	128	16	1	4	4	1	0
SSANDRA-1441	113	322	209	1	3	1	0	3
SSANDRA-1441	113	477	364	0	3	1	3	0
SSANDRA-1441	114	131	17	1	4	4	2	0
SSANDRA-1441	114	137	23	1	3	4	1	1
SSANDRA-1441	114	131	17	1	3	1	3	0
SSANDRA-1441	115	183	68	1	4	1	1	0
SSANDRA-1442	115	128	13	1	3	1	0	0
SSANDRA-1442	115	373	258	1	3	3	1	1
SSANDRA-1442	115	150	35	1	4	1	3	0
SSANDRA-1442	116	179	63	1	1	1	3	1
SSANDRA-1442	117	203	86	1	3	1	2	1
SSANDRA-1442	117	477	360	0	4	1	0	0
SSANDRA-1442	117	118	1	1	4	1	1	0
SSANDRA-1442	119	137	18	1	3	4	1	0
SSANDRA-1442	119	122	3	1	3	4	3	1
SSANDRA-1442	119	477	358	0	3	1	0	0
SSANDRA-1443	119	477	358	0	3	1	0	0
SSANDRA-1443	120	121	1	1	4	4	1	0
SSANDRA-1443	120	129	9	1	4	4	1	0
SSANDRA-1443	121	477	356	0	3	1	0	1
SSANDRA-1443	121	122	1	1	4	1	0	1
SSANDRA-1443	121	228	107	1	3	2	1	4
SSANDRA-1443	121	242	121	1	3	4	1	0
SSANDRA-1443	121	477	356	0	3	1	1	0
SSANDRA-1443	126	127	1	1	3	1	1	0
SSANDRA-1443	127	465	338	1	4	1	0	1
SSANDRA-1444	127	135	8	1	3	1	0	0
SSANDRA-1444	127	133	6	1	4	1	1	1
SSANDRA-1444	128	154	26	1	3	4	1	1
SSANDRA-1444	129	477	348	0	3	4	0	0
SSANDRA-1444	130	296	166	1	1	1	1	1
SSANDRA-1444	133	134	1	1	1	1	0	0
SSANDRA-1444	135	136	1	1	3	1	0	1
SSANDRA-1444	135	136	1	1	4	4	3	0
SSANDRA-1444	135	477	342	0	3	4	1	0
SSANDRA-1444	135	148	13	1	4	4	0	0
SSANDRA-1445	136	137	1	1	3	1	2	0
SSANDRA-1445	136	155	19	1	4	1	3	0
SSANDRA-1445	136	477	341	0	3	4	0	0
SSANDRA-1445	136	477	341	0	3	4	0	2
SSANDRA-1445	136	137	1	1	3	4	1	1
SSANDRA-1445	136	477	341	0	3	5	1	1
SSANDRA-1445	137	477	340	0	4	1	0	0
SSANDRA-1445	138	155	17	1	4	2	1	0
SSANDRA-1445	138	171	33	1	4	2	1	1
SSANDRA-1445	138	477	339	0	4	4	1	1
SSANDRA-1446	141	477	336	0	3	1	1	0
SSANDRA-1446	141	142	1	1	3	1	0	0
SSANDRA-1446	141	477	336	0	3	1	0	1
SSANDRA-1446	142	477	335	0	4	1	3	1
SSANDRA-1446	142	477	335	0	1	1	0	0
SSANDRA-1446	142	477	335	0	4	4	0	0
SSANDRA-1446	142	477	335	0	3	2	0	1
SSANDRA-1446	143	268	125	1	4	4	1	0
SSANDRA-1446	143	211	68	1	3	1	2	2
SSANDRA-1446	144	145	1	1	3	1	1	0
SSANDRA-1447	144	175	31	1	3	1	0	1
SSANDRA-1447	147	477	330	0	3	4	1	0
SSANDRA-1447	147	322	175	1	3	1	0	0
SSANDRA-1447	148	477	329	0	1	3	0	0
SSANDRA-1447	148	149	1	1	3	1	0	0
SSANDRA-1447	148	149	1	1	3	1	2	0
SSANDRA-1447	148	477	329	0	4	1	0	0
SSANDRA-1447	149	477	328	0	4	1	0	0
SSANDRA-1447	149	477	328	0	4	4	0	1
SSANDRA-1447	149	477	328	0	3	1	0	0
SSANDRA-1448	149	168	19	1	3	1	0	2
SSANDRA-1448	149	171	22	1	4	1	1	0
SSANDRA-1448	149	417	268	1	3	2	1	0
SSANDRA-1448	150	477	327	0	3	1	1	0
SSANDRA-1448	150	209	59	1	3	4	0	0
SSANDRA-1448	150	175	25	1	3	4	1	2
SSANDRA-1448	151	477	326	0	3	1	0	0
SSANDRA-1448	151	477	326	0	3	1	0	0
SSANDRA-1448	152	153	1	1	4	4	1	0
SSANDRA-1448	153	159	6	1	1	5	1	0
SSANDRA-1449	153	181	28	1	3	5	1	0
SSANDRA-1449	153	477	324	0	3	5	1	0
SSANDRA-1449	153	179	26	1	3	5	1	0
SSANDRA-1449	153	181	28	1	3	5	1	0
SSANDRA-1449	153	477	324	0	3	5	1	0
SSANDRA-1449	154	477	323	0	3	1	0	0
SSANDRA-1449	155	477	322	0	4	1	0	0
SSANDRA-1449	155	243	88	1	3	4	1	0
SSANDRA-1449	155	322	167	1	3	1	1	0
SSANDRA-1449	155	477	322	0	3	2	0	0
SSANDRA-1450	156	477	321	0	4	4	0	0
SSANDRA-1450	156	477	321	0	3	2	0	0
SSANDRA-1450	157	211	54	1	4	1	1	0
SSANDRA-1450	157	477	320	0	3	1	1	2
SSANDRA-1450	157	168	11	1	3	1	1	0
SSANDRA-1450	157	158	1	1	3	1	0	2
SSANDRA-1450	158	233	75	1	3	1	0	1
SSANDRA-1450	158	477	319	0	3	1	0	0
SSANDRA-1450	158	161	3	1	3	1	1	2
SSANDRA-1451	158	162	4	1	3	1	0	1
SSANDRA-1451	161	162	1	1	4	4	0	0
SSANDRA-1451	162	477	315	0	3	1	0	0
SSANDRA-1451	162	164	2	1	1	1	3	0
SSANDRA-1451	162	477	315	0	3	1	0	1
SSANDRA-1451	162	170	8	1	1	1	3	1
SSANDRA-1451	162	477	315	0	3	1	1	0
SSANDRA-1451	162	477	315	0	3	1	1	0
SSANDRA-1451	163	164	1	1	3	3	0	0
SSANDRA-1451	163	164	1	1	3	4	0	0
SSANDRA-1452	163	477	314	0	1	1	1	0
SSANDRA-1452	164	322	158	1	4	1	0	0
SSANDRA-1452	164	217	53	1	3	1	2	2
SSANDRA-1452	164	217	53	1	4	2	1	0
SSANDRA-1452	164	171	7	1	4	4	1	1
SSANDRA-1452	165	364	199	1	3	1	4	0
SSANDRA-1452	165	379	214	1	3	5	0	0
SSANDRA-1452	166	477	311	0	3	2	1	0
SSANDRA-1452	168	172	4	1	3	4	1	0
SSANDRA-1452	168	170	2	1	3	1	1	0
SSANDRA-1453	169	171	2	1	1	1	0	0
SSANDRA-1453	169	477	308	0	4	4	1	0
SSANDRA-1453	170	477	307	0	4	1	0	0
SSANDRA-1453	170	477	307	0	3	1	0	0
SSANDRA-1453	171	177	6	1	4	5	1	2
SSANDRA-1453	171	477	306	0	4	5	0	0
SSANDRA-1453	172	182	10	1	4	4	1	0
SSANDRA-1453	172	213	41	1	3	4	0	0
SSANDRA-1453	172	214	42	1	4	4	1	0
SSANDRA-1453	172	477	305	0	3	1	1	0
SSANDRA-1454	173	175	2	1	1	1	1	1
SSANDRA-1454	174	477	303	0	4	1	2	0
SSANDRA-1454	175	206	31	1	4	4	0	0
SSANDRA-1454	175	180	5	1	4	4	0	0
SSANDRA-1454	176	177	1	1	3	1	1	0
SSANDRA-1454	177	205	28	1	3	1	0	1
SSANDRA-1454	178	179	1	1	3	1	1	0
SSANDRA-1454	178	477	299	0	3	5	1	0
SSANDRA-1454	178	477	299	0	3	5	0	0
SSANDRA-1454	178	477	299	0	3	5	0	0
SSANDRA-1455	179	477	298	0	3	1	0	1
SSANDRA-1455	180	477	297	0	4	1	0	0
SSANDRA-1455	180	204	24	1	4	4	0	0
SSANDRA-1455	180	262	82	1	4	4	0	0
SSANDRA-1455	183	343	160	1	3	1	3	0
SSANDRA-1455	183	477	294	0	3	3	1	1
SSANDRA-1455	183	207	24	1	3	4	1	1
SSANDRA-1455	183	477	294	0	4	4	1	1
SSANDRA-1455	184	189	5	1	3	1	0	0
SSANDRA-1455	186	477	291	0	3	1	0	0
SSANDRA-1456	186	319	133	1	3	1	1	1
SSANDRA-1456	189	282	93	1	3	4	0	0
SSANDRA-1456	189	477	288	0	3	1	0	0
SSANDRA-1456	190	477	287	0	4	4	0	0
SSANDRA-1456	190	477	287	0	3	1	1	1
SSANDRA-1456	192	477	285	0	3	1	0	0
SSANDRA-1456	193	477	284	0	4	4	0	0
SSANDRA-1456	193	477	284	0	3	1	0	0
SSANDRA-1456	193	256	63	1	1	1	2	0
SSANDRA-1456	196	477	281	0	4	3	1	0
SSANDRA-1457	197	477	280	0	4	1	0	0
SSANDRA-1457	197	200	3	1	3	1	1	0
SSANDRA-1457	197	477	280	0	4	2	0	0
SSANDRA-1457	197	232	35	1	4	2	1	1
SSANDRA-1457	197	228	31	1	3	1	1	0
SSANDRA-1457	200	477	277	0	4	4	1	0
SSANDRA-1457	200	201	1	1	4	4	1	0
SSANDRA-1457	200	477	277	0	3	4	0	0
SSANDRA-1457	200	477	277	0	3	4	0	0
SSANDRA-1457	200	201	1	1	3	1	1	0
SSANDRA-1458	201	202	1	1	4	4	1	0
SSANDRA-1458	201	477	276	0	4	4	2	0
SSANDRA-1458	201	477	276	0	4	4	0	0
SSANDRA-1458	203	205	2	1	3	1	0	0
SSANDRA-1458	203	322	119	1	3	1	0	0
SSANDRA-1458	204	477	273	0	3	1	0	0
SSANDRA-1458	204	477	273	0	3	4	0	1
SSANDRA-1458	204	477	273	0	4	1	0	0
SSANDRA-1458	205	332	127	1	4	1	3	0
SSANDRA-1458	205	333	128	1	4	1	1	0
SSANDRA-1459	205	477	272	0	4	4	3	0
SSANDRA-1459	205	332	127	1	4	4	3	0
SSANDRA-1459	205	234	29	1	3	1	1	0
SSANDRA-1459	205	477	272	0	3	1	0	1
SSANDRA-1459	206	241	35	1	3	1	0	1
SSANDRA-1459	206	477	271	0	3	4	0	0
SSANDRA-1459	206	221	15	1	4	1	0	0
SSANDRA-1459	206	224	18	1	4	1	0	0
SSANDRA-1459	206	477	271	0	4	1	0	0
SSANDRA-1459	206	210	4	1	3	1	0	0
SSANDRA-1460	206	210	4	1	4	1	0	0
SSANDRA-1460	206	210	4	1	4	1	0	0
SSANDRA-1460	206	210	4	1	4	1	0	0
SSANDRA-1460	206	210	4	1	3	1	2	0
SSANDRA-1460	206	477	271	0	4	4	1	0
SSANDRA-1460	206	477	271	0	4	4	0	1
SSANDRA-1460	206	477	271	0	4	4	1	1
SSANDRA-1460	206	477	271	0	3	4	1	1
SSANDRA-1460	206	477	271	0	1	3	1	1
SSANDRA-1460	206	477	271	0	3	3	1	1
SSANDRA-1461	208	280	72	1	4	3	0	0
SSANDRA-1461	209	477	268	0	4	4	0	1
SSANDRA-1461	210	477	267	0	3	2	2	0
SSANDRA-1461	210	462	252	1	3	1	1	0
SSANDRA-1461	210	211	1	1	4	1	0	0
SSANDRA-1461	211	477	266	0	1	4	0	0
SSANDRA-1461	211	340	129	1	3	1	3	1
SSANDRA-1461	212	477	265	0	3	1	0	0
SSANDRA-1461	213	243	30	1	3	2	1	3
SSANDRA-1461	213	243	30	1	3	2	1	1
SSANDRA-1462	213	477	264	0	3	2	0	1
SSANDRA-1462	214	235	21	1	4	4	1	0
SSANDRA-1462	217	218	1	1	3	1	0	0
SSANDRA-1462	217	477	260	0	3	1	0	1
SSANDRA-1462	217	219	2	1	3	3	0	0
SSANDRA-1462	218	477	259	0	4	4	1	0
SSANDRA-1462	218	232	14	1	4	2	1	0
SSANDRA-1462	219	221	2	1	1	1	0	0
SSANDRA-1462	219	234	15	1	4	4	1	0
SSANDRA-1462	219	477	258	0	4	2	0	1
SSANDRA-1463	220	477	257	0	4	2	0	1
SSANDRA-1463	220	289	69	1	3	4	0	0
SSANDRA-1463	220	477	257	0	3	1	0	0
SSANDRA-1463	220	221	1	1	4	4	1	0
SSANDRA-1463	220	267	47	1	1	3	0	1
SSANDRA-1463	220	235	15	1	3	4	1	2
SSANDRA-1463	221	222	1	1	3	1	1	0
SSANDRA-1463	221	225	4	1	4	4	1	0
SSANDRA-1463	221	227	6	1	3	1	3	0
SSANDRA-1463	222	241	19	1	4	4	0	0
SSANDRA-1464	224	225	1	1	4	4	1	0
SSANDRA-1464	224	477	253	0	4	1	0	0
SSANDRA-1464	226	477	251	0	4	2	2	0
SSANDRA-1464	226	232	6	1	3	3	0	0
SSANDRA-1464	226	477	251	0	1	1	0	0
SSANDRA-1464	227	228	1	1	4	4	1	0
SSANDRA-1464	227	228	1	1	3	1	1	0
SSANDRA-1464	227	477	250	0	4	1	1	0
SSANDRA-1464	227	462	235	1	3	4	0	0
SSANDRA-1464	227	232	5	1	3	1	0	0
SSANDRA-1465	227	240	13	1	3	1	0	0
SSANDRA-1465	227	477	250	0	4	1	0	0
SSANDRA-1465	227	228	1	1	3	4	1	0
SSANDRA-1465	228	477	249	0	3	4	0	0
SSANDRA-1465	228	477	249	0	3	4	1	1
SSANDRA-1465	228	477	249	0	4	4	1	1
SSANDRA-1465	231	243	12	1	3	2	1	1
SSANDRA-1465	231	256	25	1	3	1	3	0
SSANDRA-1465	232	477	245	0	3	1	0	0
SSANDRA-1465	232	241	9	1	3	4	1	0
SSANDRA-1466	232	235	3	1	1	4	3	1
SSANDRA-1466	232	239	7	1	4	4	0	0
SSANDRA-1466	233	243	10	1	3	4	1	0
SSANDRA-1466	234	477	243	0	4	3	0	0
SSANDRA-1466	235	241	6	1	4	2	1	1
SSANDRA-1466	235	477	242	0	3	5	1	0
SSANDRA-1466	236	477	241	0	3	4	3	0
SSANDRA-1466	236	477	241	0	3	3	0	1
SSANDRA-1466	238	242	4	1	3	4	1	0
SSANDRA-1466	238	477	239	0	3	5	1	0
SSANDRA-1467	238	477	239	0	4	4	1	0
SSANDRA-1467	239	242	3	1	4	4	1	0
SSANDRA-1467	240	267	27	1	1	1	3	1
SSANDRA-1467	240	477	237	0	4	1	0	0
SSANDRA-1467	240	477	237	0	3	1	0	0
SSANDRA-1467	240	242	2	1	3	4	1	0
SSANDRA-1467	240	411	171	1	3	4	1	0
SSANDRA-1467	240	242	2	1	4	4	1	0
SSANDRA-1467	241	242	1	1	3	4	0	1
SSANDRA-1467	241	477	236	0	1	1	0	0
SSANDRA-1468	241	477	236	0	3	1	3	1
SSANDRA-1468	241	242	1	1	4	1	1	0
SSANDRA-1468	241	477	236	0	4	1	0	0
SSANDRA-1468	242	477	235	0	3	1	0	0
SSANDRA-1468	242	477	235	0	3	1	0	0
SSANDRA-1468	242	477	235	0	1	1	0	0
SSANDRA-1468	245	246	1	1	3	1	0	1
SSANDRA-1468	245	246	1	1	3	1	1	0
SSANDRA-1468	246	477	231	0	3	3	1	0
SSANDRA-1468	247	248	1	1	4	3	1	0
SSANDRA-1469	247	291	44	1	3	4	0	0
SSANDRA-1469	247	253	6	1	3	1	1	1
SSANDRA-1469	247	477	230	0	3	1	1	0
SSANDRA-1469	247	253	6	1	4	3	0	1
SSANDRA-1469	247	477	230	0	3	1	1	0
SSANDRA-1469	247	477	230	0	3	1	1	1
SSANDRA-1469	247	249	2	1	3	1	1	1
SSANDRA-1469	248	477	229	0	3	3	1	4
SSANDRA-1469	248	254	6	1	4	1	0	1
SSANDRA-1469	248	477	229	0	3	1	0	0
SSANDRA-1470	248	249	1	1	3	3	1	1
SSANDRA-1470	249	477	228	0	3	1	0	0
SSANDRA-1470	249	350	101	1	4	1	0	0
SSANDRA-1470	249	477	228	0	3	4	1	0
SSANDRA-1470	249	254	5	1	3	1	0	2
SSANDRA-1470	249	259	10	1	3	4	0	1
SSANDRA-1470	250	477	227	0	4	2	0	2
SSANDRA-1470	250	251	1	1	3	1	1	0
SSANDRA-1470	250	477	227	0	3	1	0	0
SSANDRA-1470	251	477	226	0	3	4	4	0
SSANDRA-1471	251	477	226	0	3	1	1	0
SSANDRA-1471	252	477	225	0	3	1	0	0
SSANDRA-1471	252	477	225	0	3	1	1	1
SSANDRA-1471	252	287	35	1	3	2	4	2
SSANDRA-1471	252	253	1	1	1	1	1	1
SSANDRA-1471	253	477	224	0	4	1	0	0
SSANDRA-1471	253	330	77	1	3	1	1	0
SSANDRA-1471	253	281	28	1	3	4	0	1
SSANDRA-1471	254	477	223	0	4	4	0	1
SSANDRA-1471	254	477	223	0	4	4	0	0
SSANDRA-1472	254	255	1	1	3	1	1	0
SSANDRA-1472	254	477	223	0	4	1	3	0
SSANDRA-1472	254	477	223	0	1	1	1	0
SSANDRA-1472	254	477	223	0	3	4	1	0
SSANDRA-1472	254	259	5	1	3	1	0	0
SSANDRA-1472	254	477	223	0	3	1	1	1
SSANDRA-1472	254	275	21	1	3	4	1	1
SSANDRA-1472	254	333	79	1	3	4	1	2
SSANDRA-1472	254	477	223	0	3	4	0	4
SSANDRA-1472	254	477	223	0	3	4	1	1
SSANDRA-1473	254	477	223	0	3	4	1	1
SSANDRA-1473	254	477	223	0	4	4	1	1
SSANDRA-1473	254	477	223	0	4	1	1	0
SSANDRA-1473	254	477	223	0	4	1	0	0
SSANDRA-1473	254	477	223	0	3	1	0	0
SSANDRA-1473	254	268	14	1	4	1	1	1
SSANDRA-1473	254	477	223	0	3	1	0	0
SSANDRA-1473	254	477	223	0	4	4	1	0
SSANDRA-1473	254	477	223	0	4	1	1	1
SSANDRA-1473	254	477	223	0	3	1	0	0
SSANDRA-1474	254	477	223	0	1	1	1	0
SSANDRA-1474	254	477	223	0	3	1	1	0
SSANDRA-1474	254	269	15	1	3	1	1	1
SSANDRA-1474	254	477	223	0	3	4	1	1
SSANDRA-1474	254	255	1	1	3	4	1	1
SSANDRA-1474	254	477	223	0	3	4	1	1
SSANDRA-1474	254	477	223	0	3	4	1	0
SSANDRA-1474	254	477	223	0	3	5	0	2
SSANDRA-1474	254	477	223	0	3	1	1	0
SSANDRA-1474	255	259	4	1	3	1	1	0
SSANDRA-1475	255	263	8	1	3	1	0	1
SSANDRA-1475	255	477	222	0	3	1	0	0
SSANDRA-1475	256	477	221	0	3	1	1	0
SSANDRA-1475	256	477	221	0	4	3	1	0
SSANDRA-1475	257	477	220	0	3	3	1	0
SSANDRA-1475	259	262	3	1	3	1	1	0
SSANDRA-1475	259	268	9	1	3	4	0	1
SSANDRA-1475	260	477	217	0	4	1	1	0
SSANDRA-1475	260	261	1	1	4	1	1	0
SSANDRA-1475	260	275	15	1	3	1	1	1
SSANDRA-1476	260	262	2	1	3	1	0	0
SSANDRA-1476	260	477	217	0	3	4	1	2
SSANDRA-1476	260	275	15	1	3	1	1	1
SSANDRA-1476	260	263	3	1	3	1	1	0
SSANDRA-1476	261	477	216	0	3	5	0	0
SSANDRA-1476	261	464	203	1	3	5	0	0
SSANDRA-1476	261	267	6	1	3	1	2	0
SSANDRA-1476	262	319	57	1	4	1	0	0
SSANDRA-1476	262	477	215	0	3	4	1	1
SSANDRA-1476	262	477	215	0	3	1	3	0
SSANDRA-1477	262	268	6	1	4	4	1	1
SSANDRA-1477	262	477	215	0	3	1	1	1
SSANDRA-1477	263	477	214	0	3	1	1	1
SSANDRA-1477	263	477	214	0	1	1	1	2
SSANDRA-1477	263	477	214	0	4	4	1	0
SSANDRA-1477	263	477	214	0	3	1	1	2
SSANDRA-1477	263	477	214	0	4	1	1	1
SSANDRA-1477	263	477	214	0	4	4	0	0
SSANDRA-1477	263	477	214	0	4	4	0	0
SSANDRA-1477	263	477	214	0	4	1	1	0
SSANDRA-1478	263	264	1	1	4	1	1	0
SSANDRA-1478	263	477	214	0	3	1	3	1
SSANDRA-1478	263	477	214	0	3	1	0	1
SSANDRA-1478	263	477	214	0	3	5	0	0
SSANDRA-1478	264	269	5	1	3	4	0	1
SSANDRA-1478	264	265	1	1	3	1	0	0
SSANDRA-1478	265	322	57	1	1	1	0	0
SSANDRA-1478	266	477	211	0	4	1	1	0
SSANDRA-1478	266	477	211	0	4	4	1	0
SSANDRA-1478	267	477	210	0	4	4	1	0
SSANDRA-1479	267	295	28	1	3	4	3	0
SSANDRA-1479	267	280	13	1	4	1	1	0
SSANDRA-1479	267	268	1	1	4	1	1	0
SSANDRA-1479	268	477	209	0	3	1	1	0
SSANDRA-1479	269	270	1	1	3	1	3	0
SSANDRA-1479	269	477	208	0	4	4	1	0
SSANDRA-1479	270	477	207	0	4	4	0	0
SSANDRA-1479	273	477	204	0	4	1	2	0
SSANDRA-1479	273	303	30	1	4	4	1	0
SSANDRA-1479	274	477	203	0	4	4	0	0
SSANDRA-1480	275	276	1	1	4	4	1	0
SSANDRA-1480	275	477	202	0	3	1	1	1
SSANDRA-1480	275	477	202	0	3	1	1	0
SSANDRA-1480	275	276	1	1	3	1	2	0
SSANDRA-1480	276	277	1	1	3	1	1	0
SSANDRA-1480	276	281	5	1	1	1	0	0
SSANDRA-1480	277	477	200	0	3	4	4	1
SSANDRA-1480	277	284	7	1	3	1	0	0
SSANDRA-1480	282	477	195	0	3	1	2	0
SSANDRA-1480	282	283	1	1	3	1	1	0
SSANDRA-1481	282	477	195	0	4	4	0	0
SSANDRA-1481	282	477	195	0	3	1	0	0
SSANDRA-1481	282	477	195	0	1	1	2	2
SSANDRA-1481	283	477	194	0	3	1	0	0
SSANDRA-1481	283	284	1	1	3	1	1	0
SSANDRA-1481	283	379	96	1	4	1	1	0
SSANDRA-1481	283	477	194	0	4	4	0	0
SSANDRA-1481	283	477	194	0	3	4	0	1
SSANDRA-1481	283	477	194	0	3	1	0	1
SSANDRA-1481	283	477	194	0	4	1	0	0
SSANDRA-1482	284	288	4	1	3	1	1	1
SSANDRA-1482	284	319	35	1	3	4	0	1
SSANDRA-1482	284	477	193	0	4	1	0	1
SSANDRA-1482	284	288	4	1	3	1	2	0
SSANDRA-1482	287	288	1	1	3	4	3	0
SSANDRA-1482	287	477	190	0	3	4	0	1
SSANDRA-1482	288	477	189	0	3	1	3	0
SSANDRA-1482	289	290	1	1	4	4	0	0
SSANDRA-1482	289	477	188	0	4	1	0	0
SSANDRA-1482	289	336	47	1	4	4	2	0
SSANDRA-1483	289	477	188	0	3	2	0	0
SSANDRA-1483	289	477	188	0	3	1	1	0
SSANDRA-1483	290	333	43	1	4	4	1	0
SSANDRA-1483	291	477	186	0	4	1	0	0
SSANDRA-1483	291	477	186	0	4	1	1	0
SSANDRA-1483	292	302	10	1	4	4	0	0
SSANDRA-1483	295	296	1	1	4	1	0	0
SSANDRA-1483	295	477	182	0	3	4	1	0
SSANDRA-1483	295	301	6	1	3	1	3	0
SSANDRA-1483	295	477	182	0	3	1	0	0
SSANDRA-1484	296	477	181	0	1	1	0	1
SSANDRA-1484	296	304	8	1	3	1	1	2
SSANDRA-1484	296	477	181	0	3	1	1	0
SSANDRA-1484	296	332	36	1	3	1	1	1
SSANDRA-1484	296	477	181	0	4	1	0	0
SSANDRA-1484	296	477	181	0	4	1	0	0
SSANDRA-1484	296	477	181	0	3	1	0	0
SSANDRA-1484	297	410	113	1	3	4	3	0
SSANDRA-1484	297	477	180	0	1	1	1	0
SSANDRA-1484	297	346	49	1	3	1	1	0
SSANDRA-1485	298	420	122	1	3	4	1	0
SSANDRA-1485	298	369	71	1	4	4	0	0
SSANDRA-1485	298	299	1	1	3	1	0	0
SSANDRA-1485	300	477	177	0	3	4	0	0
SSANDRA-1485	301	302	1	1	3	1	0	0
SSANDRA-1485	301	339	38	1	3	1	1	0
SSANDRA-1485	301	477	176	0	3	4	0	1
SSANDRA-1485	301	477	176	0	4	4	1	1
SSANDRA-1485	301	477	176	0	3	1	0	0
SSANDRA-1485	302	319	17	1	3	1	0	0
SSANDRA-1486	302	303	1	1	3	1	0	0
SSANDRA-1486	303	309	6	1	3	1	3	0
SSANDRA-1486	304	311	7	1	4	1	1	0
SSANDRA-1486	304	477	173	0	4	4	0	0
SSANDRA-1486	304	477	173	0	3	3	0	1
SSANDRA-1486	305	449	144	1	3	1	1	0
SSANDRA-1486	308	414	106	1	3	1	3	0
SSANDRA-1486	309	477	168	0	3	1	0	0
SSANDRA-1486	310	311	1	1	3	1	0	0
SSANDRA-1486	310	322	12	1	3	1	3	0
SSANDRA-1487	310	316	6	1	3	1	2	1
SSANDRA-1487	310	396	86	1	1	1	3	0
SSANDRA-1487	310	477	167	0	3	1	0	0
SSANDRA-1487	310	316	6	1	3	1	2	0
SSANDRA-1487	311	477	166	0	4	1	0	0
SSANDRA-1487	311	477	166	0	4	4	1	0
SSANDRA-1487	311	461	150	1	3	1	1	1
SSANDRA-1487	311	477	166	0	4	1	4	0
SSANDRA-1487	311	477	166	0	3	1	3	0
SSANDRA-1487	311	477	166	0	4	4	0	0
SSANDRA-1488	312	477	165	0	3	1	0	0
SSANDRA-1488	312	378	66	1	3	1	0	1
SSANDRA-1488	312	477	165	0	3	1	0	0
SSANDRA-1488	312	477	165	0	3	4	1	0
SSANDRA-1488	312	315	3	1	4	4	3	0
SSANDRA-1488	313	387	74	1	3	1	1	1
SSANDRA-1488	316	477	161	0	4	4	0	0
SSANDRA-1488	316	317	1	1	4	1	0	1
SSANDRA-1488	316	477	161	0	1	1	1	0
SSANDRA-1488	316	329	13	1	3	1	3	1
SSANDRA-1489	316	318	2	1	4	1	0	1
SSANDRA-1489	318	319	1	1	3	1	0	1
SSANDRA-1489	318	332	14	1	3	1	1	0
SSANDRA-1489	318	477	159	0	3	4	0	0
SSANDRA-1489	318	331	13	1	3	1	3	0
SSANDRA-1489	318	379	61	1	1	1	1	0
SSANDRA-1489	318	333	15	1	1	1	1	0
SSANDRA-1489	318	332	14	1	3	1	1	1
SSANDRA-1489	319	477	158	0	4	1	0	0
SSANDRA-1489	319	323	4	1	3	1	1	0
SSANDRA-1490	319	477	158	0	4	1	2	0
SSANDRA-1490	322	323	1	1	3	4	1	0
SSANDRA-1490	322	477	155	0	4	3	0	0
SSANDRA-1490	322	477	155	0	4	1	1	0
SSANDRA-1490	323	477	154	0	4	1	2	0
SSANDRA-1490	323	379	56	1	4	1	3	0
SSANDRA-1490	323	477	154	0	4	1	1	0
SSANDRA-1490	324	464	140	1	4	1	3	0
SSANDRA-1490	325	477	152	0	3	1	0	0
SSANDRA-1490	325	332	7	1	4	1	3	0
SSANDRA-1491	326	343	17	1	3	1	1	0
SSANDRA-1491	328	477	149	0	4	1	0	0
SSANDRA-1491	329	331	2	1	3	1	2	0
SSANDRA-1491	329	330	1	1	3	1	1	1
SSANDRA-1491	331	477	146	0	1	1	1	0
SSANDRA-1491	332	353	21	1	3	1	3	0
SSANDRA-1491	332	408	76	1	4	4	3	0
SSANDRA-1491	335	477	142	0	4	1	0	0
SSANDRA-1491	336	341	5	1	3	1	0	2
SSANDRA-1491	337	339	2	1	1	1	2	0
SSANDRA-1492	337	379	42	1	3	1	0	1
SSANDRA-1492	337	340	3	1	3	1	2	0
SSANDRA-1492	337	373	36	1	4	1	1	3
SSANDRA-1492	340	343	3	1	3	1	0	1
SSANDRA-1492	342	477	135	0	1	1	0	0
SSANDRA-1492	343	477	134	0	4	1	0	0
SSANDRA-1492	343	477	134	0	4	1	1	0
SSANDRA-1492	343	436	93	1	1	4	1	0
SSANDRA-1492	343	346	3	1	1	1	4	0
SSANDRA-1492	344	477	133	0	3	1	0	0
SSANDRA-1493	344	477	133	0	3	1	2	0
SSANDRA-1493	345	385	40	1	3	4	3	1
SSANDRA-1493	346	366	20	1	3	1	0	0
SSANDRA-1493	347	348	1	1	3	4	0	0
SSANDRA-1493	347	477	130	0	3	1	1	0
SSANDRA-1493	347	381	34	1	3	4	1	0
SSANDRA-1493	347	352	5	1	3	1	1	0
SSANDRA-1493	347	400	53	1	3	2	4	1
SSANDRA-1493	347	373	26	1	4	4	1	0
SSANDRA-1493	350	477	127	0	3	1	1	0
SSANDRA-1494	351	477	126	0	1	1	0	0
SSANDRA-1494	353	477	124	0	3	1	0	0
SSANDRA-1494	354	477	123	0	4	1	0	0
SSANDRA-1494	354	477	123	0	3	2	0	0
SSANDRA-1494	354	477	123	0	3	1	0	0
SSANDRA-1494	354	477	123	0	4	4	0	0
SSANDRA-1494	361	364	3	1	3	1	0	1
Y-239	11	18	7	1	4	1	2	0
Y-239	16	18	2	1	4	4	2	1
Y-239	18	19	1	1	4	3	1	0
Y-239	18	22	4	1	3	4	1	0
Y-239	21	22	1	1	4	3	1	0
Y-239	21	29	8	1	3	1	1	1
Y-239	25	85	60	1	4	3	1	0
Y-239	25	477	452	0	3	4	1	1
Y-240	25	87	62	1	4	3	1	0
Y-240	28	29	1	1	3	1	2	0
Y-240	32	477	445	0	4	1	1	0
Y-240	32	33	1	1	4	3	1	0
Y-240	32	35	3	1	4	3	1	0
Y-240	38	39	1	1	3	1	2	0
Y-240	38	44	6	1	3	4	1	0
Y-240	38	63	25	1	3	4	1	0
Y-240	45	117	72	1	3	3	1	0
Y-240	46	47	1	1	4	1	0	0
Y-241	53	63	10	1	4	4	1	0
Y-241	57	79	22	1	3	1	2	0
Y-241	64	477	413	0	4	1	0	0
Y-241	65	66	1	1	3	4	1	0
Y-241	79	80	1	1	3	4	2	0
Y-241	85	86	1	1	3	3	1	0
Y-241	85	87	2	1	3	4	1	0
Y-241	91	477	386	0	5	1	1	0
Y-241	94	136	42	1	4	1	2	0
Y-241	94	100	6	1	4	1	2	0
Y-242	94	95	1	1	3	1	2	0
Y-242	94	107	13	1	3	1	0	1
Y-242	98	100	2	1	4	3	1	1
Y-242	98	100	2	1	3	1	1	0
Y-242	100	477	377	0	3	1	0	0
Y-242	100	477	377	0	4	1	0	0
Y-242	101	477	376	0	3	1	0	0
Y-242	101	117	16	1	3	1	2	0
Y-242	102	477	375	0	3	1	0	0
Y-242	102	107	5	1	3	1	2	0
Y-243	103	190	87	1	3	1	2	0
Y-243	126	212	86	1	3	3	2	0
Y-243	135	136	1	1	3	1	1	0
Y-243	135	477	342	0	3	1	0	0
Y-243	136	477	341	0	4	1	0	0
Y-243	136	142	6	1	3	1	2	0
Y-243	142	143	1	1	3	1	3	0
Y-243	147	226	79	1	3	1	1	0
Y-243	149	203	54	1	3	4	1	0
Y-243	149	191	42	1	3	1	1	0
Y-244	150	151	1	1	4	4	1	0
Y-244	165	166	1	1	3	1	0	0
Y-244	185	186	1	1	1	1	2	0
Y-244	189	191	2	1	3	4	1	0
Y-244	193	194	1	1	4	3	2	0
Y-244	199	204	5	1	3	1	3	1
Y-244	207	210	3	1	3	4	1	0
Y-244	213	221	8	1	3	4	1	0
Y-244	226	233	7	1	4	4	1	0
Y-244	226	240	14	1	4	1	2	0
Y-245	226	240	14	1	3	1	2	0
Y-245	226	240	14	1	3	1	2	0
Y-245	226	233	7	1	4	1	0	0
Y-245	226	232	6	1	5	4	0	0
Y-245	226	240	14	1	5	1	2	0
Y-245	226	240	14	1	4	1	2	2
Y-245	226	240	14	1	3	1	2	1
Y-245	226	233	7	1	4	1	0	0
Y-245	226	233	7	1	4	1	0	1
Y-245	226	238	12	1	3	1	2	0
Y-246	226	477	251	0	5	1	1	0
Y-246	226	477	251	0	5	1	1	0
Y-246	233	240	7	1	3	1	2	0
Y-246	233	238	5	1	3	1	1	0
Y-246	239	240	1	1	3	1	2	0
Y-246	240	373	133	1	3	3	1	3
Y-246	240	373	133	1	3	3	1	1
Y-246	240	362	122	1	3	3	1	1
Y-246	240	373	133	1	3	3	1	1
Y-246	240	477	237	0	4	4	0	0
Y-247	245	247	2	1	4	1	2	0
Y-247	247	248	1	1	4	4	1	0
Y-247	247	248	1	1	3	4	2	0
Y-247	252	280	28	1	3	4	2	0
Y-247	255	280	25	1	3	3	2	0
Y-247	255	280	25	1	3	3	2	0
Y-247	259	261	2	1	4	1	1	0
Y-247	261	477	216	0	3	4	1	0
Y-247	261	291	30	1	3	4	1	0
Y-247	267	280	13	1	3	4	1	0
Y-248	269	280	11	1	3	1	2	0
Y-248	282	308	26	1	3	4	1	0
Y-248	282	477	195	0	3	4	1	0
Y-248	282	477	195	0	3	4	1	0
Y-248	283	287	4	1	1	1	1	0
Y-248	283	380	97	1	4	4	1	0
Y-248	287	477	190	0	3	4	1	0
Y-248	287	406	119	1	4	4	1	0
Y-248	288	477	189	0	3	1	1	1
Y-248	289	326	37	1	3	3	1	1
Y-249	289	295	6	1	4	4	1	0
Y-249	301	308	7	1	4	4	1	0
Y-249	303	326	23	1	4	4	1	0
Y-249	312	317	5	1	3	4	1	1
Y-249	315	326	11	1	3	3	1	0
Y-249	315	317	2	1	3	3	0	0
Y-249	317	326	9	1	4	1	1	0
Y-249	322	326	4	1	3	1	2	1
Y-249	329	477	148	0	3	3	1	0
Y-249	340	345	5	1	4	4	1	0
Y-250	340	343	3	1	3	1	0	1
Y-250	344	346	2	1	3	1	1	0
Y-250	345	346	1	1	3	1	1	0
Y-250	345	477	132	0	3	1	0	0
Y-250	352	353	1	1	3	1	2	0
Y-250	352	353	1	1	3	1	2	0
Y-250	362	477	115	0	4	1	1	0
Y-250	362	368	6	1	3	4	1	1
-1372	1	477	476	0	4	3	0	0
-1372	1	17	16	1	3	3	0	0
-1372	2	477	475	0	3	1	1	0
-1372	2	446	444	1	3	1	0	0
-1372	2	3	1	1	4	5	0	0
-1372	2	323	321	1	2	1	0	0
-1372	2	477	475	0	3	1	0	0
-1373	3	29	26	1	3	1	0	1
-1373	3	4	1	1	3	1	0	0
-1373	5	477	472	0	3	1	0	2
-1373	5	6	1	1	3	1	0	2
-1373	5	477	472	0	3	1	0	1
-1373	5	152	147	1	3	1	0	0
-1373	6	7	1	1	3	1	0	0
-1373	6	8	2	1	3	1	0	0
-1373	7	8	1	1	3	1	0	0
-1373	7	17	10	1	3	1	0	0
-1374	7	267	260	1	3	1	0	0
-1374	8	477	469	0	3	1	0	0
-1374	8	327	319	1	3	1	0	1
-1374	8	477	469	0	3	1	0	0
-1374	8	124	116	1	4	4	1	0
-1374	8	14	6	1	3	1	0	0
-1374	8	9	1	1	3	5	0	0
-1374	8	9	1	1	3	5	0	0
-1374	8	9	1	1	3	5	0	0
-1374	8	14	6	1	3	5	0	0
-1375	8	9	1	1	3	5	0	0
-1375	8	10	2	1	3	5	0	0
-1375	8	9	1	1	3	5	0	0
-1375	8	14	6	1	3	5	0	0
-1375	8	9	1	1	3	5	0	0
-1375	8	9	1	1	3	5	0	0
-1375	8	10	2	1	3	5	0	0
-1375	8	10	2	1	3	5	0	0
-1375	8	9	1	1	3	5	0	0
-1375	8	14	6	1	3	5	0	0
-1376	8	9	1	1	3	5	0	0
-1376	8	10	2	1	3	5	0	0
-1376	8	14	6	1	3	5	0	0
-1376	8	85	77	1	3	5	0	0
-1376	8	10	2	1	3	5	0	0
-1376	8	10	2	1	3	5	0	0
-1376	8	85	77	1	3	5	0	0
-1376	8	250	242	1	3	4	0	0
-1376	8	163	155	1	2	1	0	1
-1376	8	328	320	1	3	4	0	0
-1377	9	137	128	1	4	4	1	0
-1377	9	10	1	1	4	1	0	0
-1377	10	477	467	0	4	1	0	0
-1377	10	15	5	1	3	1	0	0
-1377	10	477	467	0	1	1	0	0
-1377	10	14	4	1	3	1	0	0
-1377	10	477	467	0	3	1	0	0
-1377	10	11	1	1	5	2	0	0
-1377	11	12	1	1	1	1	0	0
-1377	14	17	3	1	3	1	0	0
-1378	14	477	463	0	5	4	0	0
-1378	14	15	1	1	2	1	0	0
-1378	14	477	463	0	3	1	0	0
-1378	14	272	258	1	3	1	0	0
-1378	14	168	154	1	3	1	0	1
-1378	15	477	462	0	3	4	0	0
-1378	15	16	1	1	1	1	0	1
-1378	16	477	461	0	3	1	0	0
-1378	16	477	461	0	3	4	0	0
-1378	16	477	461	0	3	1	0	0
-1379	16	477	461	0	3	4	0	0
-1379	16	23	7	1	4	4	0	0
-1379	17	18	1	1	4	1	0	0
-1379	17	18	1	1	3	1	0	0
-1379	17	18	1	1	3	1	0	0
-1379	17	327	310	1	3	1	0	0
-1379	17	18	1	1	3	1	0	1
-1379	18	163	145	1	2	1	0	0
-1379	18	19	1	1	3	1	0	0
-1379	18	21	3	1	3	3	0	1
-1380	18	22	4	1	4	4	0	0
-1380	18	477	459	0	3	1	0	0
-1380	18	477	459	0	4	1	0	0
-1380	18	20	2	1	3	1	0	0
-1380	18	477	459	0	4	4	0	0
-1380	19	20	1	1	3	3	0	0
-1380	19	477	458	0	3	1	0	0
-1380	19	477	458	0	3	1	0	0
-1380	19	477	458	0	3	1	0	0
-1380	19	477	458	0	3	1	0	0
-1381	19	329	310	1	3	1	0	0
-1381	20	21	1	1	3	1	0	0
-1381	20	21	1	1	3	1	0	1
-1381	20	337	317	1	3	4	0	0
-1381	20	477	457	0	3	4	0	0
-1381	20	477	457	0	3	4	0	0
-1381	21	104	83	1	3	1	0	1
-1381	21	44	23	1	3	1	0	0
-1381	22	25	3	1	3	1	1	0
-1381	22	84	62	1	3	1	0	1
-1382	22	23	1	1	5	1	0	0
-1382	22	27	5	1	2	1	0	1
-1382	22	477	455	0	3	1	0	0
-1382	22	477	455	0	3	4	0	0
-1382	22	29	7	1	4	1	1	0
-1382	23	29	6	1	3	1	1	0
-1382	23	29	6	1	3	3	0	0
-1382	24	25	1	1	3	1	0	0
-1382	24	477	453	0	3	4	0	0
-1382	24	42	18	1	3	1	1	0
-1383	24	85	61	1	3	1	0	0
-1383	24	25	1	1	5	3	0	0
-1383	24	29	5	1	3	1	0	0
-1383	24	477	453	0	3	1	0	0
-1383	24	226	202	1	3	1	0	2
-1383	25	477	452	0	3	1	0	0
-1383	25	477	452	0	4	4	0	0
-1383	25	326	301	1	4	1	0	0
-1383	25	477	452	0	5	4	1	0
-1383	26	28	2	1	4	1	0	0
-1384	27	28	1	1	3	4	0	0
-1384	27	28	1	1	3	1	0	0
-1384	28	477	449	0	4	1	0	0
-1384	28	477	449	0	3	1	0	0
-1384	28	477	449	0	3	1	1	0
-1384	28	29	1	1	3	1	0	1
-1384	29	477	448	0	3	1	0	0
-1384	30	477	447	0	4	1	0	0
-1384	31	182	151	1	3	1	0	0
-1384	32	477	445	0	3	1	0	0
-1385	32	323	291	1	3	1	0	0
-1385	35	36	1	1	3	1	0	0
-1385	35	477	442	0	4	4	0	0
-1385	36	477	441	0	3	1	0	0
-1385	36	42	6	1	3	1	0	0
-1385	38	53	15	1	3	1	1	0
-1385	39	477	438	0	5	1	0	0
-1385	39	134	95	1	3	1	0	0
-1385	39	420	381	1	3	1	0	0
-1385	39	42	3	1	3	1	0	0
-1386	39	41	2	1	4	2	0	0
-1386	40	44	4	1	3	1	0	0
-1386	40	477	437	0	3	1	0	0
-1386	40	41	1	1	3	1	0	0
-1386	41	42	1	1	3	1	0	0
-1386	41	328	287	1	3	4	1	0
-1386	42	97	55	1	3	1	0	0
-1386	42	477	435	0	3	4	0	0
-1386	42	45	3	1	4	1	0	1
-1386	42	45	3	1	3	1	0	1
-1387	42	44	2	1	1	1	0	3
-1387	42	477	435	0	3	1	0	0
-1387	42	45	3	1	3	1	0	1
-1387	43	477	434	0	3	1	0	0
-1387	43	477	434	0	3	1	0	1
-1387	43	44	1	1	3	1	0	0
-1387	43	329	286	1	3	5	0	0
-1387	44	45	1	1	3	1	0	1
-1387	45	46	1	1	3	1	0	1
-1387	45	57	12	1	3	4	0	0
-1388	45	46	1	1	3	4	0	0
-1388	45	46	1	1	3	1	0	0
-1388	45	46	1	1	3	1	0	0
-1388	45	46	1	1	3	1	0	0
-1388	45	477	432	0	3	1	0	0
-1388	45	477	432	0	3	1	0	0
-1388	45	53	8	1	3	1	0	0
-1388	45	477	432	0	3	1	0	0
-1388	45	477	432	0	3	1	0	0
-1388	45	46	1	1	3	1	0	2
-1389	45	53	8	1	3	1	0	0
-1389	45	477	432	0	3	1	0	0
-1389	46	102	56	1	3	1	0	0
-1389	46	83	37	1	3	1	0	0
-1389	49	50	1	1	3	1	1	0
-1389	49	75	26	1	3	1	0	0
-1389	49	57	8	1	3	3	0	0
-1389	49	477	428	0	3	1	0	0
-1389	49	477	428	0	3	4	0	0
-1389	49	50	1	1	3	1	0	0
-1390	49	477	428	0	3	1	0	0
-1390	49	477	428	0	3	1	0	0
-1390	49	477	428	0	3	1	0	0
-1390	49	50	1	1	3	1	0	1
-1390	50	329	279	1	2	1	0	0
-1390	50	329	279	1	3	1	0	0
-1390	50	329	279	1	2	1	0	1
-1390	50	477	427	0	3	1	0	0
-1390	50	477	427	0	3	1	0	0
-1390	50	477	427	0	3	1	1	0
-1391	50	329	279	1	3	1	0	1
-1391	50	477	427	0	3	1	0	0
-1391	50	57	7	1	3	3	0	0
-1391	51	52	1	1	3	1	0	0
-1391	51	52	1	1	3	1	0	0
-1391	51	477	426	0	3	4	0	0
-1391	51	477	426	0	3	1	0	0
-1391	52	477	425	0	3	4	0	0
-1391	53	477	424	0	5	1	0	0
-1391	53	54	1	1	3	1	0	1
-1392	53	477	424	0	3	4	0	0
-1392	57	58	1	1	3	4	1	0
-1392	57	477	420	0	5	1	0	0
-1392	57	70	13	1	3	1	0	0
-1392	57	138	81	1	3	3	0	0
-1392	57	477	420	0	3	1	0	0
-1392	58	477	419	0	3	3	0	0
-1392	58	373	315	1	3	4	0	0
-1392	58	477	419	0	3	4	0	0
-1392	58	81	23	1	3	1	0	0
-1393	58	59	1	1	3	3	0	0
-1393	58	477	419	0	3	3	0	0
-1393	59	63	4	1	4	4	0	0
-1393	59	477	418	0	3	4	0	0
-1393	59	477	418	0	3	1	0	0
-1393	59	477	418	0	3	1	0	0
-1393	59	477	418	0	3	1	0	0
-1393	59	477	418	0	3	1	0	0
-1393	59	477	418	0	3	1	0	0
-1393	59	477	418	0	3	1	0	0
-1394	59	477	418	0	3	1	0	0
-1394	59	477	418	0	3	4	0	0
-1394	60	477	417	0	3	1	0	0
-1394	60	63	3	1	3	1	0	0
-1394	60	477	417	0	3	4	0	0
-1394	60	477	417	0	3	3	0	0
-1394	60	477	417	0	3	4	0	0
-1394	61	477	416	0	3	1	0	0
-1394	62	66	4	1	3	1	0	0
-1394	62	63	1	1	3	1	0	0
-1395	63	64	1	1	3	1	0	1
-1395	63	327	264	1	3	1	0	0
-1395	63	477	414	0	2	1	0	0
-1395	63	64	1	1	4	4	0	0
-1395	64	477	413	0	3	1	0	0
-1395	64	477	413	0	3	1	0	0
-1395	64	477	413	0	3	1	0	0
-1395	65	66	1	1	3	1	0	1
-1395	65	71	6	1	3	1	0	0
-1395	65	477	412	0	3	1	0	0
-1396	66	323	257	1	3	1	0	0
-1396	66	70	4	1	3	1	0	0
-1396	67	477	410	0	3	1	0	0
-1396	67	76	9	1	3	1	0	1
-1396	68	78	10	1	2	1	0	0
-1396	70	477	407	0	3	1	0	0
-1396	71	477	406	0	3	1	0	0
-1396	71	75	4	1	3	1	1	0
-1396	71	477	406	0	3	1	0	0
-1396	71	477	406	0	4	4	0	0
-1397	71	477	406	0	3	1	0	0
-1397	71	72	1	1	3	1	0	0
-1397	71	477	406	0	3	1	0	2
-1397	72	166	94	1	4	1	0	0
-1397	72	477	405	0	3	1	0	0
-1397	72	85	13	1	3	1	0	0
-1397	73	75	2	1	3	3	0	0
-1397	73	75	2	1	3	3	0	0
-1397	73	477	404	0	3	1	0	0
-1397	73	137	64	1	4	1	1	0
-1398	73	81	8	1	3	1	0	0
-1398	74	75	1	1	3	1	0	0
-1398	74	477	403	0	3	1	0	0
-1398	74	477	403	0	3	1	0	0
-1398	74	102	28	1	3	1	0	0
-1398	74	477	403	0	3	1	0	0
-1398	76	78	2	1	2	1	0	0
-1398	77	127	50	1	3	1	0	0
-1398	77	91	14	1	3	1	0	0
-1398	77	78	1	1	3	1	0	0
-1399	77	347	270	1	3	4	0	0
-1399	77	477	400	0	3	3	0	0
-1399	78	163	85	1	4	5	0	1
-1399	78	79	1	1	2	2	0	0
-1399	78	79	1	1	2	1	0	0
-1399	79	80	1	1	3	1	0	0
-1399	80	477	397	0	3	1	0	0
-1399	80	477	397	0	4	1	0	0
-1399	81	232	151	1	3	1	0	0
-1399	81	446	365	1	4	1	0	0
-1400	83	106	23	1	1	1	0	0
-1400	83	84	1	1	3	1	0	0
-1400	83	84	1	1	3	1	0	0
-1400	84	338	254	1	5	3	0	0
-1400	86	477	391	0	3	1	0	0
-1400	86	477	391	0	2	1	0	0
-1400	86	477	391	0	4	3	0	0
-1400	86	91	5	1	3	1	0	1
-1400	87	477	390	0	3	1	1	0
-1400	91	477	386	0	3	1	0	0
-1401	91	477	386	0	3	1	0	0
-1401	92	93	1	1	1	1	0	0
-1401	92	94	2	1	1	1	0	0
-1401	93	138	45	1	3	2	0	0
-1401	93	94	1	1	2	3	0	0
-1401	93	477	384	0	3	1	0	0
-1401	94	327	233	1	3	1	0	0
-1401	94	138	44	1	3	1	0	0
-1401	94	327	233	1	3	1	1	1
-1401	95	96	1	1	3	1	0	0
-1402	95	192	97	1	3	1	0	0
-1402	95	460	365	1	4	1	1	0
-1402	96	101	5	1	4	1	1	0
-1402	97	190	93	1	3	1	0	0
-1402	98	477	379	0	3	1	0	0
-1402	98	99	1	1	3	1	0	0
-1402	100	420	320	1	3	1	0	0
-1402	101	477	376	0	3	1	0	0
-1402	101	477	376	0	3	1	0	0
-1402	101	103	2	1	2	1	0	1
-1403	101	106	5	1	3	3	0	0
-1403	102	420	318	1	4	1	0	0
-1403	102	477	375	0	4	1	0	0
-1403	102	192	90	1	3	1	0	0
-1403	103	477	374	0	3	1	0	0
-1403	105	106	1	1	3	1	0	0
-1403	105	477	372	0	3	1	0	0
-1403	106	232	126	1	3	1	0	0
-1403	107	118	11	1	3	1	0	0
-1403	107	127	20	1	3	1	0	0
-1404	108	109	1	1	3	1	0	0
-1404	108	477	369	0	3	1	0	0
-1404	108	109	1	1	3	1	0	1
-1404	108	477	369	0	3	1	0	0
-1404	108	109	1	1	4	1	0	1
-1404	109	446	337	1	1	1	0	0
-1404	109	477	368	0	3	1	0	0
-1404	110	112	2	1	4	4	0	0
-1404	111	138	27	1	4	1	0	0
-1404	113	114	1	1	3	1	0	1
-1405	113	328	215	1	3	5	0	1
-1405	113	477	364	0	3	1	0	0
-1405	114	327	213	1	3	1	0	0
-1405	114	477	363	0	4	1	0	0
-1405	114	310	196	1	3	1	0	0
-1405	115	119	4	1	1	1	0	0
-1405	115	121	6	1	3	2	0	0
-1405	116	477	361	0	4	1	0	0
-1405	117	477	360	0	3	1	0	0
-1405	118	120	2	1	4	4	0	0
-1406	120	126	6	1	3	1	0	0
-1406	121	138	17	1	4	1	0	0
-1406	122	477	355	0	4	1	0	0
-1406	123	477	354	0	3	3	0	0
-1406	123	137	14	1	4	5	1	0
-1406	123	135	12	1	4	5	0	0
-1406	123	157	34	1	4	5	0	0
-1406	123	133	10	1	4	5	0	0
-1406	123	134	11	1	4	5	0	0
-1406	123	253	130	1	4	5	0	0
-1407	123	134	11	1	4	5	0	0
-1407	123	253	130	1	4	5	0	0
-1407	123	163	40	1	4	5	0	0
-1407	123	253	130	1	4	5	0	0
-1407	123	213	90	1	4	5	0	0
-1407	123	253	130	1	4	5	0	0
-1407	123	134	11	1	3	1	0	0
-1407	124	126	2	1	3	1	0	0
-1407	124	126	2	1	2	1	0	0
-1407	126	477	351	0	3	1	0	0
-1408	127	128	1	1	3	1	0	0
-1408	127	128	1	1	3	1	0	0
-1408	127	337	210	1	4	4	0	0
-1408	127	477	350	0	3	1	0	0
-1408	129	190	61	1	3	1	0	0
-1408	129	133	4	1	2	1	0	0
-1408	130	477	347	0	3	1	0	0
-1408	131	160	29	1	2	1	0	0
-1408	133	477	344	0	4	2	1	0
-1409	135	477	342	0	3	1	0	0
-1409	135	477	342	0	5	5	1	1
-1409	135	136	1	1	4	1	0	0
-1409	135	136	1	1	3	1	0	0
-1409	136	175	39	1	5	3	0	1
-1409	136	137	1	1	3	1	0	0
-1409	137	141	4	1	4	1	0	0
-1409	137	185	48	1	2	1	1	0
-1409	137	140	3	1	3	4	0	0
-1409	138	177	39	1	3	1	1	1
-1410	139	477	338	0	3	1	0	0
-1410	139	162	23	1	3	1	0	0
-1410	140	477	337	0	4	5	1	0
-1410	140	477	337	0	3	1	0	0
-1410	141	154	13	1	3	1	0	0
-1410	141	477	336	0	3	1	0	0
-1410	141	142	1	1	4	4	0	1
-1410	142	226	84	1	3	1	0	0
-1410	143	310	167	1	3	1	1	0
-1410	143	477	334	0	3	1	1	0
-1411	149	477	328	0	2	1	0	0
-1411	149	153	4	1	3	1	0	0
-1411	150	154	4	1	4	3	1	0
-1411	150	153	3	1	5	1	0	0
-1411	150	477	327	0	3	1	0	0
-1411	152	178	26	1	3	1	1	0
-1411	154	477	323	0	3	5	1	0
-1411	154	155	1	1	3	1	0	0
-1411	155	157	2	1	3	1	0	0
-1411	155	477	322	0	3	1	0	0
-1412	156	477	321	0	1	1	0	0
-1412	156	477	321	0	3	1	0	0
-1412	156	159	3	1	3	3	1	0
-1412	156	234	78	1	3	1	0	0
-1412	158	165	7	1	3	1	0	0
-1412	160	163	3	1	3	4	0	0
-1412	161	211	50	1	1	1	1	0
-1412	161	162	1	1	3	1	0	0
-1412	162	477	315	0	3	1	0	0
-1412	162	477	315	0	3	1	0	0
-1413	162	477	315	0	3	1	0	0
-1413	163	477	314	0	4	1	0	1
-1413	163	477	314	0	3	1	0	0
-1413	163	166	3	1	4	5	0	1
-1413	164	477	313	0	3	1	1	0
-1413	164	477	313	0	4	1	1	1
-1413	164	446	282	1	3	1	0	0
-1413	165	477	312	0	3	1	0	0
-1413	165	177	12	1	3	3	1	0
-1413	165	447	282	1	1	1	0	0
-1414	165	446	281	1	4	4	0	0
-1414	166	460	294	1	4	4	1	0
-1414	166	177	11	1	3	1	0	1
-1414	168	477	309	0	3	1	0	0
-1414	168	170	2	1	3	1	0	0
-1414	169	224	55	1	3	1	0	0
-1414	169	170	1	1	3	1	0	0
-1414	169	477	308	0	3	1	0	0
-1414	169	226	57	1	4	1	0	0
-1414	170	477	307	0	3	1	0	0
-1415	170	175	5	1	3	1	0	0
-1415	170	234	64	1	3	1	0	0
-1415	171	477	306	0	3	3	0	0
-1415	171	477	306	0	3	4	0	0
-1415	171	477	306	0	3	4	0	0
-1415	171	172	1	1	3	5	0	0
-1415	171	260	89	1	3	1	0	0
-1415	171	477	306	0	4	3	0	0
-1415	172	477	305	0	4	3	0	0
-1415	172	477	305	0	3	5	0	0
-1416	172	477	305	0	2	1	0	0
-1416	172	173	1	1	2	1	0	0
-1416	172	182	10	1	3	1	0	0
-1416	172	477	305	0	4	1	0	0
-1416	172	184	12	1	4	5	0	0
-1416	175	176	1	1	4	1	0	1
-1416	175	438	263	1	1	1	0	0
-1416	175	477	302	0	3	1	0	0
-1416	175	477	302	0	3	4	0	0
-1416	175	477	302	0	3	1	0	0
-1417	176	177	1	1	3	1	0	0
-1417	176	177	1	1	3	1	0	2
-1417	176	245	69	1	3	1	0	0
-1417	176	178	2	1	3	4	0	1
-1417	177	213	36	1	4	3	1	0
-1417	177	178	1	1	3	1	0	0
-1417	177	477	300	0	3	1	0	0
-1417	177	178	1	1	4	4	0	1
-1417	178	196	18	1	5	3	0	1
-1417	178	477	299	0	3	1	0	0
-1418	178	477	299	0	2	1	0	0
-1418	178	180	2	1	3	1	0	0
-1418	179	477	298	0	1	1	0	0
-1418	182	258	76	1	3	1	0	0
-1418	182	477	295	0	3	1	0	0
-1418	182	477	295	0	3	1	0	0
-1418	183	477	294	0	4	4	0	0
-1418	183	477	294	0	3	2	0	0
-1418	183	477	294	0	3	2	0	0
-1418	183	477	294	0	3	1	0	0
-1419	184	477	293	0	4	1	0	0
-1419	184	310	126	1	3	1	0	0
-1419	185	372	187	1	4	1	0	0
-1419	185	197	12	1	1	1	0	0
-1419	185	477	292	0	3	1	0	0
-1419	189	234	45	1	4	1	0	0
-1419	189	477	288	0	4	4	0	0
-1419	189	477	288	0	3	1	0	0
-1419	190	446	256	1	3	1	0	0
-1419	190	477	287	0	3	1	0	0
-1420	190	477	287	0	3	1	0	0
-1420	191	304	113	1	4	4	1	0
-1420	191	192	1	1	4	1	0	0
-1420	191	203	12	1	3	3	0	0
-1420	192	193	1	1	3	1	0	0
-1420	192	477	285	0	4	4	0	0
-1420	192	195	3	1	2	1	0	0
-1420	193	329	136	1	3	1	0	0
-1420	193	329	136	1	4	1	0	0
-1420	193	477	284	0	3	1	0	0
-1421	197	198	1	1	3	4	0	0
-1421	197	477	280	0	3	4	0	0
-1421	198	477	279	0	3	1	0	0
-1421	199	446	247	1	3	1	0	0
-1421	199	203	4	1	2	1	0	0
-1421	201	477	276	0	2	1	1	0
-1421	202	477	275	0	3	1	0	0
-1421	203	206	3	1	3	3	0	0
-1421	204	206	2	1	3	1	1	0
-1421	204	477	273	0	3	1	0	0
-1422	205	477	272	0	3	1	0	0
-1422	205	460	255	1	2	1	1	0
-1422	205	206	1	1	3	3	0	0
-1422	206	477	271	0	3	3	0	0
-1422	206	446	240	1	4	1	0	0
-1422	206	446	240	1	4	4	0	0
-1422	207	477	270	0	3	3	0	0
-1422	207	211	4	1	3	1	0	0
-1422	210	225	15	1	3	3	0	0
-1423	210	221	11	1	3	3	0	0
-1423	210	477	267	0	3	1	0	0
-1423	210	477	267	0	3	1	0	0
-1423	210	477	267	0	3	1	0	0
-1423	210	233	23	1	4	1	0	1
-1423	211	477	266	0	3	1	0	0
-1423	211	212	1	1	3	1	0	0
-1423	211	214	3	1	3	1	0	0
-1423	212	477	265	0	4	1	0	0
-1423	212	477	265	0	3	4	0	0
-1424	212	213	1	1	3	3	0	0
-1424	212	460	248	1	3	3	1	0
-1424	212	324	112	1	3	5	0	0
-1424	212	420	208	1	4	1	0	0
-1424	212	213	1	1	3	3	0	0
-1424	213	460	247	1	3	3	1	0
-1424	213	477	264	0	4	1	0	0
-1424	213	420	207	1	3	1	0	0
-1424	213	254	41	1	3	3	0	0
-1424	213	477	264	0	3	1	0	0
-1425	213	460	247	1	3	3	1	0
-1425	213	217	4	1	3	3	0	0
-1425	214	446	232	1	4	4	0	0
-1425	214	477	263	0	3	4	0	0
-1425	215	477	262	0	2	1	0	0
-1425	217	477	260	0	3	4	0	0
-1425	217	218	1	1	3	1	0	0
-1425	218	477	259	0	2	1	0	0
-1425	218	238	20	1	4	1	0	0
-1425	218	232	14	1	3	1	0	2
-1426	219	263	44	1	3	1	0	0
-1426	219	477	258	0	3	1	0	0
-1426	219	477	258	0	3	1	0	0
-1426	219	455	236	1	3	4	1	0
-1426	220	402	182	1	1	1	1	0
-1426	225	477	252	0	3	1	0	1
-1426	225	231	6	1	3	1	0	1
-1426	225	226	1	1	3	1	0	1
-1426	225	226	1	1	3	1	0	0
-1426	226	477	251	0	3	1	0	0
-1427	226	227	1	1	3	1	0	1
-1427	227	477	250	0	4	1	0	0
LIX-41	8	477	469	0	4	4	1	0
LIX-42	8	477	469	0	4	4	1	0
LIX-42	27	28	1	1	5	1	0	0
LIX-42	29	477	448	0	3	4	1	0
LIX-42	30	477	447	0	3	4	1	0
LIX-42	30	182	152	1	4	4	1	0
LIX-42	30	477	447	0	3	4	1	0
LIX-42	30	477	447	0	3	4	1	0
LIX-42	30	477	447	0	3	4	1	0
LIX-42	30	477	447	0	3	4	1	0
LIX-42	30	477	447	0	3	4	1	0
LIX-43	98	477	379	0	4	4	1	0
LIX-43	98	477	379	0	3	4	1	0
LIX-43	98	477	379	0	3	4	0	0
LIX-43	98	477	379	0	3	4	0	0
LIX-43	98	477	379	0	3	4	1	0
LIX-43	98	477	379	0	3	4	1	0
LIX-43	98	477	379	0	3	4	0	0
LIX-43	98	477	379	0	3	4	1	0
LIX-43	98	477	379	0	3	4	1	0
LIX-43	99	477	378	0	3	4	1	0
LIX-44	99	477	378	0	3	4	1	0
LIX-44	99	477	378	0	3	4	1	0
LIX-44	99	477	378	0	3	4	1	0
LIX-44	99	477	378	0	3	4	1	0
LIX-44	99	477	378	0	3	4	1	0
LIX-44	100	477	377	0	3	4	1	0
LIX-44	107	477	370	0	3	1	1	0
LIX-44	125	477	352	0	3	4	1	0
LIX-44	178	477	299	0	3	4	0	0
LIX-44	182	477	295	0	3	4	1	0
LIX-45	183	477	294	0	3	4	0	0
LIX-45	183	190	7	1	3	4	0	0
LIX-45	190	477	287	0	3	1	0	0
LIX-45	246	247	1	1	4	4	0	0
LIX-45	262	477	215	0	3	1	0	0
LIX-45	282	477	195	0	3	1	0	0
AINSAW-	68	71	3	1	3	1	0	0
AINSAW-	68	477	409	0	3	3	0	0
AINSAW-	68	71	3	1	3	3	0	0
AINSAW-3	71	477	406	0	3	4	0	0
AINSAW-3	71	477	406	0	3	1	0	0
UKWA-82	337	477	140	0	3	4	0	0
EREZZA-102	132	133	1	1	3	5	1	2
EREZZA-102	135	399	264	1	3	5	1	2
EREZZA-102	323	477	154	0	2	4	1	0
EREZZA-102	323	336	13	1	3	1	1	0
EREZZA-102	323	337	14	1	5	4	1	0
EREZZA-103	323	477	154	0	3	4	1	0
I-28	56	57	1	1	4	1	1	0
I-28	83	477	394	0	3	1	0	0
I-28	84	477	393	0	3	1	0	0
I-28	116	477	361	0	3	4	0	0
I-28	127	477	350	0	4	1	0	0
I-28	160	477	317	0	5	1	0	0
I-28	181	477	296	0	3	1	0	0
I-28	181	477	296	0	4	4	0	0
I-29	306	477	171	0	4	2	0	0
I-29	319	477	158	0	3	4	0	0
I-29	320	477	157	0	3	1	0	0
I-29	363	477	114	0	4	2	0	0
IMATE-94	1	16	15	1	3	1	0	0
IMATE-94	1	22	21	1	3	1	0	0
IMATE-94	4	16	12	1	3	1	1	0
IMATE-94	5	16	11	1	3	1	0	0
IMATE-94	6	16	10	1	3	1	1	0
IMATE-94	16	17	1	1	3	1	1	0
IMATE-94	20	477	457	0	4	4	1	0
IMATE-94	72	154	82	1	3	4	1	0
IMATE-94	107	135	28	1	4	4	1	0
IMATE-95	112	170	58	1	3	3	1	0
IMATE-95	113	121	8	1	3	1	1	0
IMATE-95	162	477	315	0	3	4	1	0
IMATE-95	167	477	310	0	4	4	1	0
IMATE-95	168	477	309	0	2	1	1	0
IMATE-95	168	477	309	0	2	1	1	0
IMATE-95	168	477	309	0	1	1	1	0
IMATE-95	173	212	39	1	3	4	1	0
IMATE-95	179	477	298	0	1	1	1	0
IMATE-95	182	477	295	0	3	2	1	0
IMATE-96	186	477	291	0	4	1	0	0
IMATE-96	276	477	201	0	2	5	1	0
IMATE-96	328	477	149	0	2	1	1	0
IMATE-96	328	477	149	0	4	1	1	0
OUDSTACK-1025	27	477	450	0	3	1	0	0
OUDSTACK-1026	31	477	446	0	3	5	0	0
OUDSTACK-1026	31	477	446	0	3	5	0	0
OUDSTACK-1026	31	477	446	0	3	5	0	0
OUDSTACK-1026	31	477	446	0	3	5	0	0
OUDSTACK-1026	31	477	446	0	3	5	0	0
OUDSTACK-1026	31	477	446	0	3	5	0	0
IS-105	9	10	1	1	3	1	0	1
IS-105	32	33	1	1	4	4	1	0
IS-105	88	89	1	1	3	1	0	0
IS-105	99	477	378	0	3	4	0	0
IS-106	121	122	1	1	4	1	1	0
IS-106	141	477	336	0	4	4	0	0
IS-106	143	167	24	1	3	1	1	0
IS-106	158	169	11	1	3	1	0	0
IS-106	262	267	5	1	3	2	0	0
IS-106	295	296	1	1	5	1	1	0
IS-106	302	477	175	0	3	1	0	0
IS-106	302	303	1	1	3	1	0	0
IS-106	311	477	166	0	3	1	0	0
IS-106	357	477	120	0	4	4	0	0
COON-235	93	477	384	0	3	1	1	0
COON-236	111	477	366	0	3	4	0	0
COON3-13	220	221	1	1	3	1	0	0
DEC-24	42	477	435	0	3	1	0	0
DEC-24	63	149	86	1	5	4	1	0
DEC-24	63	477	414	0	5	4	0	0
DEC-24	217	477	260	0	4	1	0	0
DEC-24	226	477	251	0	3	1	0	0
DEC-25	264	418	154	1	3	1	1	0
DEC-25	345	346	1	1	3	2	1	0
LLECTIONS-66	1	2	1	1	3	4	1	0
LLECTIONS-67	9	10	1	1	3	2	1	0
LLECTIONS-67	9	10	1	1	3	2	1	0
LLECTIONS-67	27	477	450	0	3	4	0	0
LLECTIONS-67	32	162	130	1	3	1	1	0
LLECTIONS-67	50	477	427	0	5	4	0	0
LLECTIONS-67	51	477	426	0	5	4	1	0
LLECTIONS-67	51	477	426	0	5	4	1	0
LLECTIONS-67	51	56	5	1	5	4	0	0
LLECTIONS-67	66	67	1	1	3	4	1	0
LLECTIONS-67	74	477	403	0	5	1	0	0
LLECTIONS-68	113	162	49	1	3	1	0	0
LLECTIONS-68	159	160	1	1	3	4	1	0
LLECTIONS-68	161	162	1	1	5	1	1	1
LLECTIONS-68	161	477	316	0	4	1	0	1
LLECTIONS-68	162	163	1	1	4	4	1	0
LLECTIONS-68	162	477	315	0	5	1	1	0
LLECTIONS-68	163	477	314	0	5	1	0	0
LLECTIONS-68	170	477	307	0	3	4	0	0
LLECTIONS-68	195	196	1	1	3	4	1	0
LLECTIONS-68	197	198	1	1	4	1	1	0
LLECTIONS-69	200	201	1	1	3	1	0	0
LLECTIONS-69	203	205	2	1	4	4	1	0
LLECTIONS-69	207	208	1	1	3	2	1	0
LLECTIONS-69	210	477	267	0	3	2	0	0
LLECTIONS-69	251	477	226	0	4	4	0	0
LLECTIONS-69	255	281	26	1	3	1	0	0
LLECTIONS-69	261	344	83	1	3	4	1	0
LLECTIONS-69	274	477	203	0	3	1	0	0
LLECTIONS-69	284	477	193	0	4	4	0	0
LLECTIONS-69	284	477	193	0	3	4	0	0
LLECTIONS-70	285	477	192	0	3	2	0	0
LLECTIONS-70	303	326	23	1	2	1	1	0
LLECTIONS-70	326	327	1	1	3	4	1	0
LLECTIONS-70	331	477	146	0	4	4	0	0
LLECTIONS-70	333	338	5	1	3	4	0	0
LLECTIONS-70	333	344	11	1	3	2	1	0
LLECTIONS-70	333	392	59	1	3	4	0	0
LLECTIONS-70	338	477	139	0	3	4	0	0
MDEV-24	7	8	1	1	3	1	0	1
MDEV-24	10	477	467	0	3	4	0	0
MDEV-24	10	72	62	1	3	2	0	0
MDEV-24	21	477	456	0	3	5	0	0
MDEV-25	21	22	1	1	3	5	0	0
MDEV-25	21	22	1	1	3	4	0	0
MDEV-25	21	22	1	1	3	4	0	0
MDEV-25	22	72	50	1	3	4	0	0
MDEV-25	30	477	447	0	3	2	0	0
MDEV-25	30	477	447	0	3	2	0	0
MDEV-25	30	477	447	0	3	2	0	0
MDEV-25	30	31	1	1	3	1	0	0
MDEV-25	34	477	443	0	3	5	0	0
MDEV-25	34	477	443	0	3	5	0	0
MDEV-26	34	477	443	0	3	5	0	0
MDEV-26	34	477	443	0	3	5	0	0
MDEV-26	34	477	443	0	3	5	0	0
MDEV-26	34	477	443	0	3	5	0	0
MDEV-26	34	477	443	0	3	5	0	0
MDEV-26	34	477	443	0	3	5	0	0
MDEV-26	34	477	443	0	3	5	0	0
MDEV-26	34	477	443	0	3	5	0	0
MDEV-26	34	477	443	0	3	5	0	0
MDEV-26	38	477	439	0	3	2	0	0
MDEV-27	38	477	439	0	2	2	0	0
MDEV-27	56	57	1	1	3	1	0	1
MDEV-27	57	477	420	0	4	4	0	0
MDEV-27	57	477	420	0	4	4	0	0
MDEV-27	63	477	414	0	3	4	0	0
MDEV-27	65	477	412	0	3	5	0	0
MDEV-27	67	477	410	0	3	5	0	0
MDEV-27	67	477	410	0	3	5	0	0
MDEV-27	67	477	410	0	3	5	0	0
MDEV-27	67	477	410	0	3	5	0	0
MDEV-28	67	477	410	0	3	5	0	0
MDEV-28	67	477	410	0	3	5	0	0
MDEV-28	72	477	405	0	3	5	0	0
MDEV-28	73	76	3	1	3	3	0	2
MDEV-28	74	477	403	0	2	2	0	0
MDEV-28	92	477	385	0	5	1	0	0
MDEV-28	92	339	247	1	5	1	0	0
MDEV-28	92	477	385	0	5	5	0	1
MDEV-28	196	230	34	1	4	1	0	1
MDEV-29	206	209	3	1	3	1	0	0
MDEV-29	209	477	268	0	3	4	0	0
MDEV-29	209	234	25	1	3	1	0	0
MDEV-29	225	477	252	0	3	1	0	0
MDEV-29	225	477	252	0	3	2	0	0
MDEV-29	234	477	243	0	3	4	0	0
MDEV-29	276	277	1	1	4	3	0	0
MDEV-29	284	477	193	0	3	4	0	0
MDEV-29	285	477	192	0	4	5	0	0
MDEV-30	295	296	1	1	1	5	0	0
MDEV-30	331	367	36	1	3	1	0	0
MDEV-30	339	477	138	0	3	5	0	0
MDEV-30	352	477	125	0	3	1	0	0
MMONSRDF-7	28	43	15	1	5	4	1	0
MMONSRDF-7	62	477	415	0	4	2	0	0
MMONSRDF-7	208	209	1	1	3	5	1	0
MMONSRDF-8	362	477	115	0	3	3	1	0
MMONSSITE-10	7	477	470	0	3	1	0	0
MMONSSITE-10	16	17	1	1	3	1	0	0
MMONSSITE-10	45	46	1	1	2	1	1	0
MMONSSITE-10	58	477	419	0	3	2	0	0
MMONSSITE-10	58	59	1	1	3	1	1	0
MMONSSITE-10	63	74	11	1	3	4	1	0
MMONSSITE-10	64	65	1	1	3	4	1	0
MMONSSITE-10	74	130	56	1	3	1	1	0
MMONSSITE-10	91	141	50	1	3	1	1	0
MMONSSITE-10	130	132	2	1	3	4	1	0
MMONSSITE-11	130	435	305	1	3	1	0	0
MMONSSITE-11	131	477	346	0	3	4	0	0
MMONSSITE-11	133	154	21	1	3	2	1	1
MMONSSITE-11	135	154	19	1	3	4	1	1
MMONSSITE-11	136	152	16	1	1	1	0	0
MMONSSITE-11	136	236	100	1	1	1	0	0
MMONSSITE-11	145	146	1	1	3	2	1	0
MMONSSITE-11	165	166	1	1	3	1	1	0
MMONSSITE-11	207	211	4	1	5	2	0	0
MMONSSITE-11	210	477	267	0	3	2	0	3
MMONSSITE-12	227	228	1	1	3	4	1	0
MMONSSITE-12	235	477	242	0	3	2	0	0
MMONSSITE-12	240	241	1	1	3	1	1	0
MMONSSITE-12	241	242	1	1	3	4	1	0
MMONSSITE-12	248	261	13	1	3	4	0	0
MMONSSITE-12	261	477	216	0	3	1	0	1
MMONSSITE-9	6	7	1	1	3	4	0	0
MMONSSITE-9	6	10	4	1	3	4	0	0
MMONSSITE-9	6	51	45	1	3	4	0	0
MMONSSITE-9	6	8	2	1	3	4	0	0
MPRESS-43	4	13	9	1	3	1	1	0
MPRESS-43	4	12	8	1	3	4	1	0
MPRESS-43	8	9	1	1	4	4	1	2
MPRESS-43	9	10	1	1	4	1	0	0
MPRESS-44	10	11	1	1	4	4	1	0
MPRESS-44	11	13	2	1	5	4	1	0
MPRESS-44	36	37	1	1	2	1	1	0
MPRESS-44	37	114	77	1	3	5	1	0
MPRESS-44	49	50	1	1	4	1	1	1
MPRESS-44	62	119	57	1	3	4	1	0
MPRESS-44	75	87	12	1	3	1	1	1
MPRESS-44	106	112	6	1	3	1	1	0
MPRESS-44	107	108	1	1	3	1	0	1
MPRESS-44	107	121	14	1	3	1	1	1
MPRESS-45	115	477	362	0	4	4	0	0
MPRESS-45	122	123	1	1	3	1	1	0
MPRESS-45	125	128	3	1	3	1	1	0
MPRESS-45	134	144	10	1	3	1	1	0
MPRESS-45	148	149	1	1	3	1	1	0
MPRESS-45	162	217	55	1	3	1	1	0
MPRESS-45	168	169	1	1	3	1	1	0
MPRESS-45	178	181	3	1	4	4	1	0
MPRESS-45	185	477	292	0	3	4	0	0
MPRESS-45	189	191	2	1	3	1	1	0
MPRESS-46	191	208	17	1	4	4	1	0
MPRESS-46	217	477	260	0	4	5	0	0
MPRESS-46	220	221	1	1	3	1	1	0
MPRESS-46	220	221	1	1	3	1	1	0
MPRESS-46	261	477	216	0	5	4	1	0
MPRESS-46	262	263	1	1	3	1	0	0
MPRESS-46	268	280	12	1	3	4	1	0
MPRESS-46	285	291	6	1	3	1	0	0
MPRESS-46	300	477	177	0	4	1	0	0
MPRESS-46	309	313	4	1	3	1	1	0
MPRESS-47	312	321	9	1	3	1	1	1
MPRESS-47	317	329	12	1	3	1	0	0
MPRESS-47	329	477	148	0	3	4	0	0
MPRESS-47	331	477	146	0	3	4	0	0
MPRESS-47	342	477	135	0	3	1	0	0
MPRESS-47	346	348	2	1	3	1	1	0
MPRESS-47	353	354	1	1	3	2	0	1
NFIGURATION-68	66	129	63	1	3	1	1	0
NFIGURATION-68	67	69	2	1	3	1	1	0
NFIGURATION-68	74	82	8	1	3	1	0	0
NFIGURATION-69	74	75	1	1	3	1	1	0
NFIGURATION-69	74	76	2	1	3	4	1	0
NFIGURATION-69	80	82	2	1	4	4	1	0
NFIGURATION-69	81	86	5	1	3	4	1	0
NFIGURATION-69	87	477	390	0	3	4	1	1
NFIGURATION-69	87	88	1	1	3	4	1	0
NFIGURATION-69	87	88	1	1	3	4	1	0
NFIGURATION-69	87	88	1	1	3	4	1	0
NFIGURATION-69	95	96	1	1	3	4	1	0
NFIGURATION-69	114	115	1	1	3	1	0	0
NFIGURATION-70	127	477	350	0	3	1	1	0
NFIGURATION-70	127	136	9	1	4	4	1	0
NFIGURATION-70	130	137	7	1	3	5	0	0
NFIGURATION-70	144	159	15	1	3	1	1	0
NFIGURATION-70	149	477	328	0	3	2	0	0
NFIGURATION-70	187	188	1	1	3	4	1	0
NFIGURATION-70	187	188	1	1	3	4	1	0
NFIGURATION-70	187	188	1	1	3	4	0	0
NFIGURATION-70	197	199	2	1	3	1	0	0
NFIGURATION-70	198	199	1	1	2	1	0	0
NFIGURATION-71	224	225	1	1	3	4	1	0
NFIGURATION-71	232	269	37	1	3	4	1	0
NFIGURATION-71	233	258	25	1	3	1	1	0
NFIGURATION-71	245	247	2	1	3	4	1	0
NFIGURATION-71	260	261	1	1	3	1	0	0
NFIGURATION-71	261	277	16	1	3	1	1	1
NFIGURATION-71	262	277	15	1	3	1	1	1
NFIGURATION-71	263	267	4	1	3	4	1	0
NFIGURATION-71	267	268	1	1	3	1	1	1
NFIGURATION-72	269	276	7	1	3	4	0	0
NFIGURATION-72	269	270	1	1	3	4	1	0
NFIGURATION-72	269	270	1	1	3	4	1	0
NFIGURATION-72	269	270	1	1	3	4	1	0
NFIGURATION-72	270	271	1	1	3	4	1	1
NFIGURATION-72	276	277	1	1	3	4	1	0
NFIGURATION-72	276	277	1	1	3	4	1	1
NFIGURATION-72	281	282	1	1	3	1	1	0
NFIGURATION-72	289	290	1	1	3	1	1	0
NFIGURATION-72	301	477	176	0	5	1	0	0
NFIGURATION-73	312	477	165	0	4	4	0	0
NFIGURATION-73	318	423	105	1	3	4	1	0
NFIGURATION-73	318	319	1	1	3	1	1	1
NNECTORS-148	2	3	1	1	2	5	0	0
NNECTORS-148	8	11	3	1	3	1	2	0
NNECTORS-148	8	9	1	1	3	1	1	1
NNECTORS-148	11	12	1	1	3	5	0	0
NNECTORS-148	14	124	110	1	4	4	1	0
NNECTORS-148	14	124	110	1	5	1	1	0
NNECTORS-148	14	477	463	0	4	2	0	0
NNECTORS-148	15	16	1	1	3	3	0	0
NNECTORS-148	16	17	1	1	4	1	1	0
NNECTORS-148	16	124	108	1	2	1	1	0
NNECTORS-149	30	222	192	1	3	2	1	0
NNECTORS-149	30	477	447	0	3	2	0	0
NNECTORS-149	30	477	447	0	3	2	0	0
NNECTORS-149	35	36	1	1	3	1	1	0
NNECTORS-149	38	39	1	1	2	1	1	0
NNECTORS-149	51	477	426	0	3	2	1	2
NNECTORS-149	55	56	1	1	5	1	0	0
NNECTORS-149	56	477	421	0	3	4	1	0
NNECTORS-149	59	60	1	1	3	4	1	0
NNECTORS-149	71	72	1	1	3	1	1	0
NNECTORS-150	73	124	51	1	4	4	1	0
NNECTORS-150	101	123	22	1	4	2	1	0
NNECTORS-150	104	477	373	0	4	2	1	1
NNECTORS-150	108	114	6	1	3	1	1	0
NNECTORS-150	113	117	4	1	3	1	0	0
NNECTORS-150	148	477	329	0	4	4	0	0
NNECTORS-150	149	350	201	1	4	1	1	0
NNECTORS-150	154	155	1	1	3	1	1	0
NNECTORS-150	155	477	322	0	4	4	1	0
NNECTORS-150	165	166	1	1	4	4	0	0
NNECTORS-151	168	169	1	1	3	1	1	0
NNECTORS-151	176	177	1	1	3	1	1	0
NNECTORS-151	179	183	4	1	3	1	1	0
NNECTORS-151	195	196	1	1	3	1	1	1
NNECTORS-151	195	196	1	1	3	1	0	0
NNECTORS-151	195	196	1	1	4	5	1	0
NNECTORS-151	204	262	58	1	3	1	1	1
NNECTORS-151	206	217	11	1	3	1	1	0
NNECTORS-151	206	207	1	1	3	1	1	0
NNECTORS-151	207	477	270	0	3	1	1	0
NNECTORS-152	210	211	1	1	3	1	1	0
NNECTORS-152	218	477	259	0	3	1	1	0
NNECTORS-152	219	336	117	1	4	4	1	0
NNECTORS-152	220	248	28	1	3	1	1	0
NNECTORS-152	221	222	1	1	3	1	1	0
NNECTORS-152	226	231	5	1	4	1	1	0
NNECTORS-152	239	262	23	1	3	1	1	0
NNECTORS-152	246	350	104	1	3	1	1	0
NNECTORS-152	247	248	1	1	3	1	1	0
NNECTORS-152	248	350	102	1	3	4	1	0
NNECTORS-153	249	250	1	1	3	1	1	0
NNECTORS-153	249	250	1	1	3	1	1	0
NNECTORS-153	261	272	11	1	3	1	1	0
NNECTORS-153	263	267	4	1	3	1	1	0
NNECTORS-153	264	477	213	0	3	1	1	0
NNECTORS-153	274	382	108	1	3	1	1	0
NNECTORS-153	276	277	1	1	3	4	1	0
NNECTORS-153	276	277	1	1	3	1	1	0
NNECTORS-153	276	277	1	1	3	4	1	0
NNECTORS-153	276	277	1	1	3	4	1	0
NNECTORS-154	276	279	3	1	3	1	1	0
NNECTORS-154	276	279	3	1	3	1	1	0
NNECTORS-154	277	297	20	1	3	4	1	0
NNECTORS-154	278	279	1	1	3	4	1	0
NNECTORS-154	280	477	197	0	3	4	0	0
NNECTORS-154	282	284	2	1	4	1	1	0
NNECTORS-154	288	336	48	1	3	4	1	0
NNECTORS-154	289	290	1	1	4	1	1	0
NNECTORS-154	289	297	8	1	3	1	1	0
NNECTORS-154	290	291	1	1	2	1	1	0
NNECTORS-155	291	292	1	1	3	5	0	0
NNECTORS-155	296	297	1	1	3	1	1	0
NNECTORS-155	301	350	49	1	3	4	1	0
NNECTORS-155	309	310	1	1	3	3	1	0
NNECTORS-155	309	310	1	1	3	1	1	0
NNECTORS-155	311	477	166	0	3	1	0	0
NNECTORS-155	318	319	1	1	3	1	1	0
NNECTORS-155	324	477	153	0	3	2	0	0
NNECTORS-155	330	331	1	1	3	1	0	0
NNECTORS-155	331	332	1	1	3	1	0	0
NNECTORS-156	333	334	1	1	3	5	0	1
NNECTORS-156	333	477	144	0	3	4	0	1
NNECTORS-156	338	348	10	1	2	1	1	0
NNECTORS-156	346	385	39	1	3	3	0	0
AIL-	2	21	19	1	3	1	1	0
AIL-1	53	58	5	1	3	4	1	0
AIL-1	57	169	112	1	5	4	1	0
AIL-1	67	249	182	1	1	2	1	0
AIL-1	68	477	409	0	5	2	0	0
AIL-1	74	477	403	0	3	4	0	0
AIL-1	78	249	171	1	4	4	1	0
AIL-1	79	477	398	0	3	1	0	0
AIL-1	85	87	2	1	4	4	1	0
AIL-1	86	87	1	1	4	4	1	0
AIL-1	86	294	208	1	3	4	1	0
AIL-	3	21	18	1	3	1	1	0
AIL-2	87	249	162	1	3	4	1	0
AIL-2	87	477	390	0	3	4	0	0
AIL-2	99	100	1	1	3	2	1	0
AIL-2	99	100	1	1	3	4	1	0
AIL-2	99	291	192	1	3	4	1	0
AIL-2	102	107	5	1	1	1	1	0
AIL-2	108	249	141	1	4	4	1	0
AIL-2	108	249	141	1	4	4	1	0
AIL-2	112	113	1	1	4	1	1	0
AIL-2	114	171	57	1	3	1	1	0
AIL-	25	58	33	1	2	1	1	0
AIL-3	122	134	12	1	3	1	1	0
AIL-3	122	134	12	1	3	1	1	0
AIL-3	122	134	12	1	3	1	1	0
AIL-3	133	134	1	1	3	1	1	0
AIL-3	134	249	115	1	3	1	1	0
AIL-3	136	477	341	0	3	1	0	0
AIL-3	137	291	154	1	4	1	1	0
AIL-3	137	477	340	0	3	1	0	0
AIL-3	148	477	329	0	3	1	0	0
AIL-3	155	249	94	1	3	4	1	0
AIL-	27	51	24	1	3	1	1	0
AIL-4	170	171	1	1	3	1	1	0
AIL-4	171	249	78	1	4	4	1	0
AIL-4	175	477	302	0	3	1	0	0
AIL-4	175	477	302	0	3	1	0	0
AIL-4	175	477	302	0	3	4	0	0
AIL-4	176	249	73	1	4	4	1	0
AIL-4	185	199	14	1	1	1	1	0
AIL-4	205	477	272	0	3	1	0	0
AIL-4	206	477	271	0	4	4	0	0
AIL-4	206	249	43	1	3	5	1	0
AIL-	29	249	220	1	3	1	1	0
AIL-5	241	249	8	1	4	4	1	0
AIL-5	268	269	1	1	4	1	1	0
AIL-5	268	269	1	1	4	1	1	0
AIL-5	290	291	1	1	3	4	1	0
AIL-5	290	291	1	1	3	4	1	0
AIL-5	290	291	1	1	3	4	1	0
AIL-5	291	298	7	1	3	4	1	0
AIL-5	291	477	186	0	3	4	0	0
AIL-5	291	294	3	1	3	1	1	0
AIL-5	294	477	183	0	3	4	0	0
AIL-	49	477	428	0	3	1	0	0
AIL-6	294	477	183	0	3	4	1	0
AIL-6	294	477	183	0	3	4	1	0
AIL-6	294	295	1	1	3	4	1	0
AIL-6	295	477	182	0	3	4	0	0
AIL-6	295	296	1	1	3	1	1	0
AIL-6	295	477	182	0	3	4	0	0
AIL-6	295	296	1	1	4	1	1	0
AIL-6	295	296	1	1	4	4	1	0
AIL-6	296	477	181	0	3	4	0	0
AIL-6	296	297	1	1	3	4	1	0
AIL-	51	58	7	1	3	4	1	0
AIL-7	297	477	180	0	3	4	0	0
AIL-7	297	298	1	1	3	4	1	0
AIL-7	297	298	1	1	4	4	1	0
AIL-7	298	302	4	1	3	4	1	0
AIL-7	299	308	9	1	4	4	1	0
AIL-7	303	477	174	0	3	4	0	0
AIL-7	305	477	172	0	3	4	0	0
AIL-7	308	309	1	1	3	4	1	0
AIL-7	310	477	167	0	4	4	0	0
AIL-7	313	318	5	1	3	4	1	0
AIL-	52	58	6	1	3	1	1	0
AIL-8	313	318	5	1	3	4	1	0
AIL-8	315	316	1	1	3	4	1	0
AIL-8	316	317	1	1	3	1	1	0
AIL-8	318	329	11	1	3	4	1	0
AIL-8	318	325	7	1	3	1	1	0
AIL-8	319	477	158	0	3	1	0	0
AIL-8	322	477	155	0	4	5	0	0
AIL-8	322	329	7	1	3	1	1	0
AIL-8	322	329	7	1	3	4	1	0
AIL-8	326	329	3	1	3	1	1	0
AIL-	53	58	5	1	3	4	1	0
AIL-9	329	330	1	1	3	4	1	0
AIL-9	337	477	140	0	3	4	0	0
AIL-9	337	477	140	0	3	4	0	0
UNCH-66	17	18	1	1	3	1	1	0
UNCH-66	23	24	1	1	3	4	1	0
UNCH-66	29	32	3	1	3	4	1	0
UNCH-66	35	36	1	1	4	4	1	0
UNCH-66	63	67	4	1	3	4	0	0
UNCH-66	64	67	3	1	3	4	1	0
UNCH-66	71	477	406	0	4	4	0	0
UNCH-66	85	88	3	1	3	4	1	0
UNCH-66	119	120	1	1	3	4	1	0
UNCH-67	143	477	334	0	3	4	0	0
UNCH-67	220	224	4	1	3	1	1	1
UNCH-67	253	477	224	0	3	4	0	0
UNCH-67	256	477	221	0	4	1	0	0
UNCH-67	291	477	186	0	4	1	0	0
YPTO-13	31	415	384	1	3	1	1	2
YPTO-13	130	477	347	0	2	2	0	0
YPTO-14	148	346	198	1	1	1	0	1
YPTO-14	268	277	9	1	3	1	1	0
YPTO-14	276	346	70	1	3	1	0	1
V-22	28	29	1	1	3	1	0	0
V-22	79	477	398	0	3	1	0	1
V-22	89	92	3	1	4	1	1	0
V-22	101	137	36	1	4	1	1	0
V-22	138	139	1	1	4	4	1	0
V-22	145	477	332	0	4	5	0	0
V-22	147	477	330	0	3	1	0	0
V-22	157	477	320	0	4	1	0	0
V-22	183	477	294	0	3	2	0	0
V-23	223	477	254	0	3	5	0	0
V-23	235	242	7	1	3	4	1	0
V-23	279	295	16	1	4	1	1	0
V-23	292	293	1	1	3	2	1	0
V-23	341	342	1	1	5	4	1	0
AKES-49	17	477	460	0	4	2	0	0
AKES-49	22	477	455	0	3	3	1	0
AKES-49	29	477	448	0	4	2	0	0
AKES-49	63	477	414	0	5	2	1	0
AKES-49	63	477	414	0	4	2	1	0
AKES-49	63	477	414	0	4	2	1	0
AKES-49	64	477	413	0	4	3	0	1
AKES-49	65	477	412	0	4	1	0	0
AKES-49	66	477	411	0	4	4	0	0
AKES-50	67	477	410	0	4	4	1	1
AKES-50	67	477	410	0	4	4	0	0
AKES-50	85	227	142	1	5	4	1	0
AKES-50	92	477	385	0	3	1	1	0
AKES-50	98	477	379	0	5	4	1	0
AKES-50	99	477	378	0	4	1	0	0
AKES-50	99	101	2	1	5	1	0	0
AKES-50	104	227	123	1	4	4	1	0
AKES-50	126	477	351	0	4	1	0	0
AKES-50	144	477	333	0	3	1	0	0
AKES-51	149	477	328	0	4	2	1	0
AKES-51	174	477	303	0	4	4	0	0
AKES-51	182	477	295	0	3	1	0	0
AKES-51	183	358	175	1	3	5	0	0
AKES-51	184	477	293	0	3	5	0	0
AKES-51	198	477	279	0	3	1	0	0
AKES-51	203	358	155	1	3	1	0	0
AKES-51	203	477	274	0	3	1	0	0
AKES-51	203	358	155	1	3	1	1	0
AKES-51	218	477	259	0	3	1	0	0
AKES-52	227	477	250	0	4	4	0	0
AKES-52	254	477	223	0	3	1	0	0
AKES-52	295	296	1	1	3	1	0	0
AKES-52	295	477	182	0	3	1	0	0
AKES-52	295	296	1	1	3	1	0	0
AKES-52	297	477	180	0	3	1	0	0
AKES-52	302	303	1	1	2	1	1	0
AKES-52	320	358	38	1	3	1	0	0
AKES-52	339	477	138	0	3	5	0	0
AKES-52	353	364	11	1	4	1	1	0
AKES-53	357	477	120	0	4	4	0	0
RATOR-44	1	50	49	1	4	4	1	0
RATOR-44	22	174	152	1	3	4	1	0
RATOR-44	23	34	11	1	5	1	1	0
RATOR-45	35	174	139	1	5	4	1	0
RATOR-45	36	477	441	0	3	1	0	0
RATOR-45	38	174	136	1	2	1	1	0
RATOR-45	43	477	434	0	3	1	0	0
RATOR-45	45	477	432	0	3	1	0	0
RATOR-45	50	52	2	1	3	1	1	0
RATOR-45	58	477	419	0	5	4	0	0
RATOR-45	59	477	418	0	4	4	0	0
RATOR-45	75	477	402	0	3	4	0	0
RATOR-45	78	477	399	0	4	5	0	0
RATOR-46	82	101	19	1	3	1	1	0
RATOR-46	84	342	258	1	3	3	1	0
RATOR-46	99	119	20	1	3	1	1	1
RATOR-46	102	477	375	0	4	3	1	0
RATOR-46	114	115	1	1	3	1	0	0
RATOR-46	114	477	363	0	3	4	1	0
RATOR-46	134	316	182	1	3	1	0	0
RATOR-46	151	477	326	0	3	4	0	1
RATOR-46	151	342	191	1	3	4	1	1
RATOR-46	155	477	322	0	3	4	0	1
RATOR-47	157	477	320	0	3	4	0	0
RATOR-47	174	178	4	1	3	4	1	0
RATOR-47	203	336	133	1	2	1	1	0
RATOR-47	216	477	261	0	5	4	0	0
RATOR-47	219	240	21	1	3	1	0	0
RATOR-47	220	265	45	1	4	1	1	0
RATOR-47	221	225	4	1	3	1	1	0
RATOR-47	231	343	112	1	3	4	1	0
RATOR-47	247	477	230	0	5	1	0	0
RATOR-47	252	344	92	1	3	1	1	0
RATOR-48	252	341	89	1	3	1	1	0
RATOR-48	281	426	145	1	3	1	1	0
RATOR-48	304	338	34	1	3	1	0	0
RATOR-48	306	330	24	1	3	1	1	0
RATOR-48	315	477	162	0	3	4	0	0
RATOR-48	323	477	154	0	3	1	0	0
RATOR-48	330	477	147	0	3	1	0	0
RATOR-48	331	343	12	1	3	4	1	0
RATOR-48	337	338	1	1	3	1	0	0
RATOR-48	337	338	1	1	3	1	1	0
RATOR-49	339	342	3	1	4	5	1	1
RATOR-49	341	342	1	1	3	1	1	0
RATOR-49	342	343	1	1	3	4	1	0
RATOR-49	342	343	1	1	3	5	1	0
RATOR-49	343	344	1	1	3	4	1	0
RATOR-49	346	350	4	1	1	1	1	0
RATOR-49	352	355	3	1	3	4	0	0
RATOR-49	352	477	125	0	3	4	1	0
RATOR-49	358	406	48	1	1	1	1	1
F-760	2	256	254	1	4	1	0	0
F-760	3	4	1	1	3	4	2	0
F-760	4	7	3	1	4	1	2	0
F-760	7	477	470	0	3	1	0	0
F-760	8	32	24	1	3	1	1	0
F-760	9	10	1	1	3	1	2	0
F-760	11	18	7	1	3	1	2	0
F-760	11	255	244	1	4	4	0	0
F-761	13	37	24	1	3	2	2	0
F-761	13	477	464	0	3	2	0	0
F-761	13	477	464	0	3	2	0	0
F-761	16	17	1	1	3	1	2	0
F-761	16	477	461	0	3	1	0	0
F-761	17	252	235	1	4	1	0	0
F-761	17	18	1	1	3	4	2	0
F-761	18	19	1	1	3	4	2	0
F-761	20	21	1	1	4	4	1	2
F-761	21	22	1	1	3	4	2	0
F-762	22	255	233	1	3	1	0	0
F-762	22	255	233	1	3	1	1	0
F-762	23	477	454	0	3	1	0	1
F-762	24	31	7	1	4	1	1	1
F-762	24	477	453	0	3	4	0	0
F-762	24	30	6	1	3	1	1	0
F-762	29	30	1	1	3	3	1	0
F-762	30	31	1	1	3	1	0	0
F-762	31	32	1	1	4	1	1	0
F-762	31	32	1	1	3	1	2	0
F-763	31	32	1	1	3	1	2	0
F-763	34	45	11	1	3	4	2	0
F-763	34	477	443	0	3	4	0	0
F-763	35	477	442	0	4	1	0	0
F-763	35	97	62	1	3	4	1	0
F-763	36	41	5	1	3	4	2	0
F-763	36	72	36	1	3	2	2	0
F-763	37	38	1	1	4	1	2	0
F-763	37	42	5	1	3	1	2	1
F-763	38	42	4	1	3	1	2	0
F-764	38	119	81	1	3	4	2	0
F-764	39	477	438	0	3	1	0	0
F-764	41	45	4	1	3	4	2	0
F-764	42	477	435	0	5	1	0	0
F-764	43	477	434	0	3	1	0	0
F-764	44	45	1	1	3	1	0	1
F-764	44	255	211	1	3	1	0	1
F-764	45	477	432	0	3	1	0	0
F-764	45	477	432	0	4	5	0	0
F-764	47	55	8	1	3	3	2	0
F-765	49	477	428	0	3	1	0	0
F-765	49	300	251	1	3	1	0	0
F-765	50	51	1	1	3	4	3	0
F-765	50	56	6	1	3	1	3	0
F-765	51	52	1	1	3	1	3	0
F-765	51	53	2	1	3	1	2	0
F-765	53	253	200	1	3	4	2	0
F-765	53	255	202	1	3	1	1	0
F-765	56	84	28	1	3	1	1	0
F-765	56	60	4	1	3	4	2	0
F-766	58	206	148	1	3	1	0	0
F-766	59	60	1	1	3	4	3	1
F-766	59	477	418	0	3	1	0	0
F-766	59	66	7	1	3	1	0	0
F-766	60	164	104	1	3	1	0	0
F-766	60	61	1	1	3	4	3	0
F-766	63	477	414	0	3	1	0	0
F-766	63	64	1	1	5	4	3	0
F-766	63	83	20	1	3	4	2	0
F-766	65	74	9	1	2	1	2	0
F-767	65	80	15	1	3	1	1	1
F-767	66	67	1	1	3	4	2	0
F-767	67	70	3	1	3	4	3	1
F-767	69	212	143	1	3	2	2	0
F-767	70	71	1	1	4	4	2	0
F-767	70	71	1	1	3	1	2	0
F-767	70	74	4	1	3	1	2	0
F-767	70	71	1	1	2	1	0	0
F-767	71	73	2	1	3	4	3	0
F-767	73	92	19	1	3	1	1	0
F-768	77	113	36	1	2	5	0	0
F-768	78	152	74	1	3	1	2	0
F-768	79	86	7	1	3	1	1	2
F-768	79	80	1	1	3	1	2	0
F-768	80	81	1	1	3	1	0	0
F-768	80	81	1	1	3	1	2	0
F-768	80	81	1	1	3	1	2	0
F-768	81	100	19	1	4	1	2	0
F-768	84	85	1	1	3	1	1	0
F-769	84	85	1	1	3	1	0	2
F-769	85	86	1	1	3	1	2	0
F-769	86	88	2	1	3	1	1	0
F-769	88	93	5	1	3	4	2	1
F-769	90	92	2	1	4	1	1	0
F-769	92	255	163	1	3	1	1	0
F-769	93	477	384	0	3	4	0	1
F-769	93	477	384	0	3	1	0	0
F-769	93	477	384	0	3	4	0	0
F-769	93	477	384	0	3	1	0	0
F-770	93	97	4	1	3	1	2	0
F-770	94	95	1	1	3	4	1	0
F-770	94	95	1	1	3	4	1	0
F-770	95	102	7	1	3	1	1	0
F-770	98	101	3	1	4	4	2	0
F-770	101	102	1	1	3	1	2	0
F-770	101	477	376	0	3	1	0	0
F-770	101	109	8	1	3	1	1	0
F-770	102	109	7	1	4	1	1	2
F-770	105	106	1	1	3	1	0	0
F-771	106	477	371	0	2	1	0	1
F-771	106	112	6	1	3	4	2	0
F-771	106	109	3	1	3	1	0	0
F-771	106	114	8	1	3	1	1	1
F-771	107	252	145	1	3	1	1	0
F-771	107	108	1	1	3	5	1	0
F-771	107	130	23	1	3	1	2	0
F-771	108	162	54	1	3	1	0	0
F-771	109	206	97	1	2	1	0	0
F-771	109	477	368	0	5	4	0	2
F-772	109	115	6	1	3	1	1	0
F-772	109	110	1	1	4	1	2	0
F-772	109	179	70	1	3	1	0	0
F-772	109	300	191	1	3	1	0	0
F-772	109	301	192	1	3	1	0	0
F-772	113	204	91	1	3	3	1	0
F-772	113	114	1	1	5	1	1	0
F-772	113	114	1	1	1	1	0	1
F-772	114	139	25	1	3	4	1	0
F-772	114	115	1	1	4	4	1	0
F-773	115	152	37	1	3	1	1	0
F-773	120	130	10	1	4	4	0	0
F-773	120	121	1	1	4	1	0	0
F-773	121	122	1	1	3	4	2	0
F-773	122	123	1	1	3	1	1	0
F-773	122	252	130	1	3	4	0	1
F-773	123	135	12	1	3	1	2	0
F-773	128	130	2	1	1	1	1	0
F-773	128	143	15	1	1	1	0	0
F-773	133	164	31	1	3	1	1	0
F-774	135	136	1	1	3	1	2	0
F-774	141	193	52	1	3	3	1	1
F-774	141	152	11	1	3	1	1	0
F-774	142	144	2	1	3	2	1	0
F-774	144	145	1	1	3	4	1	0
F-774	147	151	4	1	3	1	1	0
F-774	148	155	7	1	3	1	1	0
F-774	149	151	2	1	4	1	2	0
F-774	151	477	326	0	3	1	0	0
F-774	151	335	184	1	3	2	1	0
F-775	151	154	3	1	3	4	1	1
F-775	151	154	3	1	2	1	2	0
F-775	154	155	1	1	3	4	2	0
F-775	155	380	225	1	3	2	1	0
F-775	158	159	1	1	3	1	2	0
F-775	162	163	1	1	3	3	2	0
F-775	162	206	44	1	3	4	0	0
F-775	162	163	1	1	3	1	2	0
F-775	162	191	29	1	3	1	1	1
F-776	163	175	12	1	3	1	2	0
F-776	163	252	89	1	3	1	0	0
F-776	169	227	58	1	3	4	1	0
F-776	169	172	3	1	4	1	2	0
F-776	169	172	3	1	1	1	0	0
F-776	169	176	7	1	3	1	2	0
F-776	175	177	2	1	3	1	0	0
F-776	176	182	6	1	3	4	1	0
F-776	176	285	109	1	3	1	2	0
F-776	177	183	6	1	2	1	0	0
F-777	178	182	4	1	3	1	0	0
F-777	178	255	77	1	1	5	0	0
F-777	178	179	1	1	1	1	0	0
F-777	180	182	2	1	3	3	1	0
F-777	182	254	72	1	3	1	0	0
F-777	183	253	70	1	3	1	2	0
F-777	183	184	1	1	3	1	0	0
F-777	183	184	1	1	3	4	0	0
F-777	183	185	2	1	4	1	1	0
F-777	184	185	1	1	3	4	1	0
F-778	184	185	1	1	3	4	0	0
F-778	184	193	9	1	3	1	1	0
F-778	185	186	1	1	3	1	2	0
F-778	185	477	292	0	4	1	0	0
F-778	187	202	15	1	4	1	0	0
F-778	189	255	66	1	4	1	0	0
F-778	190	191	1	1	4	4	0	0
F-778	191	192	1	1	3	5	2	0
F-778	192	193	1	1	3	3	1	0
F-778	195	477	282	0	3	1	0	0
F-779	195	477	282	0	3	1	0	0
F-779	196	199	3	1	3	1	0	0
F-779	197	198	1	1	2	5	0	0
F-779	197	198	1	1	3	3	2	0
F-779	197	198	1	1	3	1	1	0
F-779	197	198	1	1	2	1	1	0
F-779	197	198	1	1	3	4	2	0
F-779	197	198	1	1	3	3	2	0
F-779	197	203	6	1	3	1	2	0
F-779	197	198	1	1	4	1	3	0
F-780	197	198	1	1	3	1	0	0
F-780	198	199	1	1	3	4	0	0
F-780	198	203	5	1	3	1	1	0
F-780	199	200	1	1	3	3	2	0
F-780	200	203	3	1	3	1	2	0
F-780	200	205	5	1	3	1	2	0
F-780	206	233	27	1	3	3	2	0
F-780	206	207	1	1	4	5	0	0
F-780	207	252	45	1	3	4	1	0
F-780	210	224	14	1	3	2	1	0
F-781	210	225	15	1	3	5	1	0
F-781	217	218	1	1	3	1	1	0
F-781	218	477	259	0	3	5	0	0
F-781	218	477	259	0	3	5	0	0
F-781	219	477	258	0	3	2	0	0
F-781	220	311	91	1	3	1	1	0
F-781	220	241	21	1	1	1	0	0
F-781	220	252	32	1	3	1	0	0
F-781	220	252	32	1	3	1	0	0
F-781	221	242	21	1	4	5	0	0
F-782	225	226	1	1	4	1	1	0
F-782	232	252	20	1	2	1	0	0
F-782	232	477	245	0	4	1	0	0
F-782	233	239	6	1	3	1	3	0
F-782	233	241	8	1	3	1	3	1
F-782	233	477	244	0	3	1	0	0
F-782	238	288	50	1	4	4	2	0
F-782	238	280	42	1	3	4	3	0
F-782	238	255	17	1	3	1	0	0
F-782	239	240	1	1	3	4	2	0
F-783	240	242	2	1	2	1	1	2
F-783	245	246	1	1	3	1	2	0
F-783	247	249	2	1	3	1	3	0
F-783	247	256	9	1	3	1	2	0
F-783	249	477	228	0	3	1	0	0
F-783	249	250	1	1	3	1	0	0
F-783	249	250	1	1	3	1	1	0
F-783	252	253	1	1	4	1	2	0
F-783	252	299	47	1	3	3	2	3
F-783	253	254	1	1	3	3	1	1
F-784	254	261	7	1	3	1	0	0
F-784	255	256	1	1	3	1	0	0
F-784	255	477	222	0	3	1	0	0
F-784	255	477	222	0	3	1	0	0
F-784	256	271	15	1	3	4	3	1
F-784	256	260	4	1	3	1	1	0
F-784	265	266	1	1	3	3	1	0
F-784	267	272	5	1	3	1	3	0
F-784	267	477	210	0	3	1	0	0
F-784	268	272	4	1	2	1	1	0
F-785	269	270	1	1	3	5	1	0
F-785	269	270	1	1	3	1	2	3
F-785	269	272	3	1	3	1	1	0
F-785	270	283	13	1	3	4	2	1
F-785	270	275	5	1	3	1	2	0
F-785	271	370	99	1	3	4	3	1
F-785	272	477	205	0	4	1	1	0
F-785	273	274	1	1	3	1	2	1
F-785	273	274	1	1	1	1	2	0
F-785	273	274	1	1	3	1	0	0
F-786	274	281	7	1	3	1	2	0
F-786	275	283	8	1	3	1	0	0
F-786	276	283	7	1	3	1	0	0
F-786	277	278	1	1	3	1	1	0
F-786	277	278	1	1	3	1	1	0
F-786	277	278	1	1	3	3	1	0
F-786	282	288	6	1	4	1	0	0
F-786	282	291	9	1	3	1	2	0
F-786	283	288	5	1	3	1	2	0
F-787	283	285	2	1	3	1	3	0
F-787	283	289	6	1	3	1	2	0
F-787	284	285	1	1	3	4	1	0
F-787	284	288	4	1	3	1	0	0
F-787	284	289	5	1	3	1	2	0
F-787	287	288	1	1	3	1	1	0
F-787	288	296	8	1	3	3	1	0
F-787	288	477	189	0	3	1	0	0
F-787	288	289	1	1	3	1	1	0
F-787	289	290	1	1	3	1	1	0
F-788	291	292	1	1	3	1	0	1
F-788	294	295	1	1	3	1	2	0
F-788	295	296	1	1	3	3	1	0
F-788	296	298	2	1	3	1	2	0
F-788	298	299	1	1	3	3	0	0
F-788	301	477	176	0	3	1	0	0
F-788	303	304	1	1	3	3	1	0
F-788	303	343	40	1	3	3	2	1
F-788	304	305	1	1	4	1	2	0
F-788	305	381	76	1	3	3	1	0
F-789	308	477	169	0	3	1	0	0
F-789	309	310	1	1	3	1	2	1
F-789	309	310	1	1	3	1	0	0
F-789	311	312	1	1	3	4	1	0
F-789	311	312	1	1	4	4	2	1
F-789	312	477	165	0	3	1	0	0
F-789	312	477	165	0	3	1	0	0
F-789	313	314	1	1	5	4	1	0
F-789	316	477	161	0	3	1	0	0
F-789	317	318	1	1	3	3	0	1
F-790	318	319	1	1	3	3	1	0
F-790	318	319	1	1	3	1	0	0
F-790	319	320	1	1	3	1	0	0
F-790	321	477	156	0	3	1	0	0
F-790	323	477	154	0	3	1	0	0
F-790	326	330	4	1	3	1	2	0
F-790	328	329	1	1	4	3	1	0
F-790	328	379	51	1	4	3	1	1
F-790	329	339	10	1	3	4	2	0
F-790	329	477	148	0	3	4	0	0
F-791	329	477	148	0	4	3	1	2
F-791	329	331	2	1	3	3	1	0
F-791	331	332	1	1	3	1	2	0
F-791	332	333	1	1	3	1	2	0
F-791	332	382	50	1	3	1	0	0
F-791	333	334	1	1	3	3	1	0
F-791	333	334	1	1	3	5	1	0
F-791	337	338	1	1	3	4	1	0
F-791	337	338	1	1	4	1	0	0
F-791	338	339	1	1	3	4	1	0
F-792	338	477	139	0	4	1	0	0
F-792	339	477	138	0	3	1	0	0
F-792	339	350	11	1	4	1	2	0
F-792	340	343	3	1	3	4	1	0
F-792	343	350	7	1	3	1	2	1
F-792	343	477	134	0	3	1	0	0
F-792	344	387	43	1	3	2	1	0
F-792	345	373	28	1	4	1	0	0
F-792	345	353	8	1	3	1	0	0
F-792	346	382	36	1	3	1	0	0
F-793	346	477	131	0	3	1	0	0
F-793	352	477	125	0	3	1	0	0
F-793	353	361	8	1	3	1	1	0
F-793	353	354	1	1	3	3	1	0
F-793	354	355	1	1	3	4	1	0
F-793	354	367	13	1	3	1	2	0
F-793	359	445	86	1	2	4	0	0
FXJC-2	86	477	391	0	4	4	0	0
FXJC-2	102	105	3	1	3	1	1	0
FXJC-2	107	108	1	1	3	4	1	0
FXJC-2	159	161	2	1	4	1	1	0
FXJC-2	193	194	1	1	3	4	1	0
FXJC-2	210	248	38	1	4	1	0	2
FXJC-2	308	310	2	1	1	1	0	0
FXJC-3	351	367	16	1	3	1	1	1
EMON-38	15	477	462	0	4	1	0	0
EMON-38	55	477	422	0	3	1	0	0
EMON-38	77	78	1	1	3	1	0	0
EMON-38	86	477	391	0	3	4	0	0
EMON-38	92	97	5	1	3	1	1	0
EMON-38	125	477	352	0	3	1	0	0
EMON-38	131	132	1	1	3	5	0	0
EMON-38	141	147	6	1	3	1	1	0
EMON-38	141	477	336	0	3	1	0	0
EMON-38	147	477	330	0	2	1	0	0
EMON-39	245	477	232	0	3	1	0	0
EMON-39	252	477	225	0	4	1	0	0
EMON-39	261	262	1	1	3	1	1	1
EMON-39	261	262	1	1	3	1	1	1
EMON-39	305	477	172	0	3	1	0	0
EMON-39	330	340	10	1	3	4	0	0
EMON-39	354	477	123	0	2	1	0	1
FFODIL-187	10	58	48	1	3	1	1	0
FFODIL-187	15	477	462	0	4	4	0	0
FFODIL-187	15	25	10	1	3	4	1	0
FFODIL-187	16	18	2	1	3	1	1	0
FFODIL-187	21	477	456	0	3	1	1	0
FFODIL-187	24	477	453	0	3	1	1	0
FFODIL-188	24	477	453	0	3	1	0	0
FFODIL-188	28	38	10	1	3	1	1	0
FFODIL-188	29	227	198	1	3	1	1	4
FFODIL-188	30	477	447	0	3	1	1	0
FFODIL-188	30	42	12	1	3	1	1	0
FFODIL-188	30	46	16	1	3	1	1	0
FFODIL-188	30	477	447	0	3	1	1	0
FFODIL-188	31	477	446	0	3	1	0	0
FFODIL-188	32	197	165	1	4	2	1	0
FFODIL-188	32	477	445	0	4	2	0	0
FFODIL-189	37	42	5	1	3	1	1	0
FFODIL-189	37	477	440	0	3	1	0	0
FFODIL-189	37	38	1	1	3	1	1	0
FFODIL-189	37	59	22	1	3	1	1	0
FFODIL-189	37	477	440	0	3	1	1	0
FFODIL-189	38	42	4	1	3	1	1	0
FFODIL-189	38	42	4	1	3	1	1	0
FFODIL-189	38	46	8	1	1	1	1	0
FFODIL-189	38	477	439	0	3	1	0	0
FFODIL-189	42	46	4	1	3	1	1	0
FFODIL-190	42	255	213	1	3	1	1	0
FFODIL-190	42	46	4	1	3	1	1	0
FFODIL-190	43	46	3	1	3	1	1	0
FFODIL-190	44	45	1	1	3	1	1	0
FFODIL-190	46	235	189	1	3	1	1	1
FFODIL-190	46	477	431	0	3	1	1	0
FFODIL-190	50	94	44	1	1	1	1	0
FFODIL-190	50	59	9	1	3	1	1	0
FFODIL-190	50	477	427	0	3	1	0	0
FFODIL-190	52	477	425	0	3	1	0	0
FFODIL-191	57	59	2	1	3	1	1	0
FFODIL-191	58	64	6	1	3	1	1	0
FFODIL-191	60	61	1	1	3	1	1	0
FFODIL-191	63	67	4	1	3	1	1	0
FFODIL-191	63	67	4	1	3	1	1	0
FFODIL-191	66	67	1	1	3	1	1	0
FFODIL-191	66	477	411	0	4	1	1	0
FFODIL-191	71	477	406	0	4	2	0	0
FFODIL-191	84	142	58	1	3	4	1	0
FFODIL-191	87	477	390	0	3	1	1	0
FFODIL-192	87	94	7	1	3	4	1	0
FFODIL-192	88	94	6	1	3	4	1	0
FFODIL-192	88	94	6	1	1	1	1	0
FFODIL-192	101	210	109	1	3	1	1	0
FFODIL-192	102	142	40	1	3	2	1	0
FFODIL-192	106	122	16	1	3	1	1	0
FFODIL-192	109	477	368	0	4	2	0	0
FFODIL-192	109	477	368	0	4	2	0	0
FFODIL-192	109	477	368	0	3	1	0	0
FFODIL-192	114	115	1	1	3	1	1	0
FFODIL-193	115	227	112	1	3	1	1	0
FFODIL-193	119	477	358	0	3	1	1	0
FFODIL-193	121	477	356	0	4	2	0	0
FFODIL-193	123	142	19	1	2	1	1	0
FFODIL-193	123	124	1	1	3	1	1	0
FFODIL-193	126	127	1	1	3	1	1	0
FFODIL-193	134	135	1	1	3	1	1	0
FFODIL-193	134	189	55	1	2	4	1	0
FFODIL-193	134	225	91	1	2	1	1	0
FFODIL-193	135	226	91	1	4	1	1	0
FFODIL-194	136	477	341	0	3	4	0	0
FFODIL-194	141	210	69	1	3	2	1	1
FFODIL-194	141	226	85	1	3	2	1	1
FFODIL-194	141	226	85	1	3	2	1	1
FFODIL-194	143	281	138	1	3	3	1	0
FFODIL-194	143	477	334	0	3	1	0	0
FFODIL-194	150	308	158	1	4	1	1	0
FFODIL-194	151	226	75	1	3	1	1	0
FFODIL-194	154	226	72	1	3	1	1	0
FFODIL-194	161	477	316	0	4	2	1	0
FFODIL-195	161	477	316	0	4	2	1	0
FFODIL-195	161	477	316	0	4	2	0	0
FFODIL-195	161	477	316	0	3	1	0	0
FFODIL-195	162	317	155	1	4	1	1	0
FFODIL-195	163	350	187	1	3	1	1	0
FFODIL-195	163	312	149	1	3	1	1	1
FFODIL-195	163	304	141	1	3	1	1	0
FFODIL-195	168	169	1	1	4	1	0	0
FFODIL-195	171	477	306	0	4	4	0	0
FFODIL-195	182	477	295	0	4	2	0	0
FFODIL-196	182	226	44	1	3	4	1	1
FFODIL-196	183	193	10	1	3	2	1	0
FFODIL-196	185	189	4	1	3	4	1	1
FFODIL-196	189	477	288	0	3	4	0	0
FFODIL-196	191	226	35	1	3	1	1	0
FFODIL-196	193	267	74	1	3	1	1	0
FFODIL-196	196	197	1	1	2	1	1	0
FFODIL-196	196	197	1	1	3	2	1	0
FFODIL-196	197	477	280	0	4	2	0	1
FFODIL-196	199	217	18	1	4	1	1	0
FFODIL-197	203	204	1	1	4	1	1	1
FFODIL-197	204	477	273	0	3	1	1	1
FFODIL-197	206	477	271	0	4	1	0	0
FFODIL-197	207	224	17	1	3	4	1	0
FFODIL-197	211	477	266	0	4	4	1	0
FFODIL-197	212	477	265	0	4	1	0	0
FFODIL-197	213	477	264	0	3	1	1	0
FFODIL-197	217	224	7	1	3	1	1	0
FFODIL-197	220	224	4	1	4	4	1	0
FFODIL-197	221	224	3	1	3	1	1	0
FFODIL-198	221	224	3	1	3	1	1	0
FFODIL-198	224	477	253	0	4	1	0	0
FFODIL-198	224	225	1	1	3	1	1	0
FFODIL-198	224	477	253	0	3	4	0	0
FFODIL-198	225	226	1	1	1	1	1	0
FFODIL-198	226	227	1	1	3	1	1	1
FFODIL-198	226	249	23	1	3	1	1	0
FFODIL-198	227	228	1	1	3	1	1	0
FFODIL-198	227	249	22	1	3	1	1	0
FFODIL-198	227	301	74	1	3	1	1	0
FFODIL-199	227	248	21	1	3	1	1	0
FFODIL-199	231	232	1	1	3	1	1	0
FFODIL-199	231	232	1	1	3	1	1	0
FFODIL-199	231	232	1	1	3	1	1	0
FFODIL-199	239	248	9	1	3	1	1	0
FFODIL-199	239	240	1	1	3	1	1	0
FFODIL-199	239	262	23	1	2	1	1	0
FFODIL-199	239	267	28	1	3	1	1	0
FFODIL-199	239	262	23	1	3	1	1	0
FFODIL-199	240	477	237	0	3	1	1	0
FFODIL-200	247	477	230	0	4	2	0	0
FFODIL-200	253	477	224	0	4	1	0	0
FFODIL-200	254	343	89	1	3	1	1	0
FFODIL-200	255	410	155	1	4	4	1	0
FFODIL-200	255	477	222	0	4	4	0	0
FFODIL-200	256	290	34	1	3	1	1	0
FFODIL-200	256	288	32	1	4	1	1	0
FFODIL-200	261	477	216	0	3	1	0	0
FFODIL-200	269	274	5	1	3	3	1	0
FFODIL-200	276	287	11	1	3	1	1	0
FFODIL-201	280	287	7	1	3	1	1	0
FFODIL-201	282	330	48	1	3	1	1	0
FFODIL-201	287	288	1	1	4	1	1	0
FFODIL-201	294	477	183	0	3	1	0	0
FFODIL-201	297	333	36	1	3	1	1	0
FFODIL-201	298	333	35	1	1	1	1	0
FFODIL-201	308	309	1	1	3	1	1	0
FFODIL-201	322	402	80	1	3	1	1	0
FFODIL-201	322	393	71	1	3	1	0	0
FFODIL-201	323	344	21	1	3	1	1	0
FFODIL-202	323	347	24	1	3	1	1	0
FFODIL-202	324	375	51	1	3	1	1	0
FFODIL-202	325	333	8	1	3	1	1	0
FFODIL-202	331	477	146	0	4	4	0	0
FFODIL-202	332	410	78	1	3	1	1	0
FFODIL-202	340	343	3	1	3	1	1	0
FFODIL-202	343	350	7	1	3	4	1	0
FFODIL-202	343	344	1	1	3	1	1	0
FFODIL-202	344	477	133	0	3	4	0	0
FFODIL-202	344	477	133	0	4	2	0	0
FFODIL-203	344	477	133	0	4	2	0	0
FFODIL-203	344	347	3	1	3	1	1	0
FFODIL-203	344	345	1	1	3	4	1	0
FFODIL-203	344	345	1	1	3	1	1	0
FFODIL-203	344	345	1	1	3	1	1	0
FFODIL-203	345	346	1	1	3	1	1	0
FFODIL-203	346	392	46	1	3	1	1	0
FFODIL-203	350	477	127	0	3	1	0	0
FFODIL-203	354	355	1	1	3	1	1	0
FFODIL-203	359	387	28	1	3	1	1	0
FFODIL-204	359	477	118	0	3	4	0	0
FFODIL-204	361	367	6	1	4	1	1	0
FFODIL-204	361	477	116	0	3	1	0	0
FFODIL-204	361	375	14	1	3	1	1	0
TAFU-13	7	283	276	1	3	4	1	0
TAFU-13	17	18	1	1	3	4	1	0
TAFU-13	17	18	1	1	4	4	1	0
TAFU-13	17	18	1	1	4	4	1	0
TAFU-13	25	477	452	0	4	4	0	0
TAFU-13	44	57	13	1	3	1	0	0
TAFU-13	52	85	33	1	3	4	0	3
TAFU-13	52	75	23	1	3	5	0	0
TAFU-14	63	77	14	1	3	3	1	0
TAFU-14	66	74	8	1	4	1	0	0
TAFU-14	75	76	1	1	3	5	0	0
TAFU-14	75	85	10	1	3	5	1	0
TAFU-14	75	85	10	1	3	5	0	0
TAFU-14	77	85	8	1	3	5	0	0
TAFU-14	183	283	100	1	3	1	1	1
TAFU-14	185	283	98	1	4	3	1	0
TAFU-14	219	477	258	0	3	2	0	0
CP-48	18	20	2	1	3	4	1	0
CP-48	24	140	116	1	3	1	1	1
CP-48	28	168	140	1	4	5	0	0
CP-48	107	108	1	1	3	4	1	0
CP-48	107	108	1	1	3	4	1	0
CP-48	109	110	1	1	3	4	1	0
CP-48	120	477	357	0	3	2	0	0
CP-49	123	124	1	1	3	4	1	0
CP-49	136	148	12	1	3	1	1	1
CP-49	140	141	1	1	3	3	1	0
CP-49	142	188	46	1	3	1	1	2
CP-49	158	159	1	1	3	4	1	0
CP-49	158	159	1	1	3	4	1	0
CP-49	158	159	1	1	3	4	1	0
CP-49	159	160	1	1	3	4	1	0
CP-49	160	161	1	1	3	4	1	0
CP-49	160	161	1	1	3	4	1	0
CP-50	160	161	1	1	3	4	1	0
CP-50	160	161	1	1	3	4	1	0
CP-50	160	161	1	1	3	4	1	0
CP-50	161	162	1	1	3	1	1	0
CP-50	166	183	17	1	3	4	1	0
CP-50	166	167	1	1	3	4	1	0
CP-50	166	168	2	1	3	2	1	0
CP-50	168	169	1	1	3	4	1	1
CP-50	170	171	1	1	3	4	1	1
CP-50	177	477	300	0	3	4	1	0
CP-51	187	188	1	1	3	4	1	1
CP-51	188	189	1	1	3	4	1	0
CP-51	199	297	98	1	1	1	1	1
CP-51	200	204	4	1	3	4	1	0
CP-51	200	205	5	1	3	1	1	0
CP-51	204	205	1	1	3	1	1	0
CP-51	204	205	1	1	3	1	1	0
CP-51	227	228	1	1	3	1	1	0
CP-51	227	228	1	1	3	4	1	0
CP-52	241	247	6	1	3	4	1	0
CP-52	241	244	3	1	3	1	0	0
CP-52	241	477	236	0	3	1	0	0
CP-52	261	262	1	1	1	1	0	0
CP-52	262	477	215	0	1	1	0	0
CP-52	295	477	182	0	1	1	0	0
CP-52	301	477	176	0	3	4	0	0
CP-52	316	317	1	1	3	4	1	0
CP-52	316	317	1	1	3	4	1	0
CP-52	319	477	158	0	4	4	0	0
CP-53	321	322	1	1	4	1	0	0
CP-53	333	477	144	0	3	4	0	0
CP-53	333	477	144	0	3	3	0	0
CP-53	354	477	123	0	3	1	0	0
UTILS-13	122	123	1	1	4	1	0	0
UTILS-13	123	124	1	1	3	4	1	0
UTILS-14	204	233	29	1	3	1	1	1
UTILS-14	288	289	1	1	3	4	0	0
UTILS-14	289	291	2	1	3	4	0	0
LTASPIKE-131	3	59	56	1	3	1	1	0
LTASPIKE-131	4	7	3	1	3	4	1	0
LTASPIKE-131	4	5	1	1	3	3	1	0
LTASPIKE-131	7	8	1	1	3	1	1	0
LTASPIKE-131	8	477	469	0	3	1	0	0
LTASPIKE-131	12	112	100	1	4	2	1	0
LTASPIKE-131	39	59	20	1	3	1	1	0
LTASPIKE-131	53	59	6	1	3	1	1	0
LTASPIKE-131	57	477	420	0	3	1	0	0
LTASPIKE-131	57	58	1	1	3	2	1	0
LTASPIKE-132	57	58	1	1	3	2	1	0
LTASPIKE-132	59	63	4	1	3	2	1	0
LTASPIKE-132	63	93	30	1	3	4	1	0
LTASPIKE-132	64	477	413	0	3	3	1	0
LTASPIKE-132	64	79	15	1	3	1	1	0
LTASPIKE-132	65	93	28	1	3	3	1	0
LTASPIKE-132	65	67	2	1	3	4	1	0
LTASPIKE-132	66	93	27	1	4	1	1	0
LTASPIKE-132	67	477	410	0	3	2	0	0
LTASPIKE-132	75	76	1	1	3	4	1	0
LTASPIKE-133	79	351	272	1	2	1	1	0
LTASPIKE-133	81	82	1	1	5	4	1	0
LTASPIKE-133	81	82	1	1	3	4	1	0
LTASPIKE-133	85	477	392	0	4	4	0	0
LTASPIKE-133	87	88	1	1	4	4	1	0
LTASPIKE-133	93	249	156	1	3	2	1	0
LTASPIKE-133	106	249	143	1	4	1	1	0
LTASPIKE-133	109	110	1	1	3	2	1	0
LTASPIKE-133	109	110	1	1	3	2	1	0
LTASPIKE-133	112	113	1	1	3	4	2	0
LTASPIKE-134	114	115	1	1	4	4	1	0
LTASPIKE-134	114	115	1	1	4	4	1	0
LTASPIKE-134	123	178	55	1	3	4	1	0
LTASPIKE-134	130	131	1	1	3	4	0	0
LTASPIKE-134	131	134	3	1	4	1	2	0
LTASPIKE-134	139	477	338	0	4	2	0	0
LTASPIKE-134	142	145	3	1	4	4	1	0
LTASPIKE-134	143	477	334	0	4	1	0	0
LTASPIKE-134	165	477	312	0	3	1	1	0
LTASPIKE-134	175	176	1	1	3	1	1	0
LTASPIKE-135	176	477	301	0	3	4	0	0
LTASPIKE-135	176	177	1	1	3	1	1	0
LTASPIKE-135	186	477	291	0	4	2	0	0
LTASPIKE-135	196	197	1	1	3	1	1	0
LTASPIKE-135	249	283	34	1	3	1	0	0
LTASPIKE-135	261	448	187	1	3	1	0	0
LTASPIKE-135	262	281	19	1	3	1	1	1
LTASPIKE-135	273	281	8	1	3	4	1	0
LTASPIKE-135	282	477	195	0	3	4	0	0
LTASPIKE-135	297	477	180	0	4	1	0	0
LTASPIKE-136	303	477	174	0	3	1	0	0
LTASPIKE-136	303	304	1	1	4	4	1	0
LTASPIKE-136	325	326	1	1	4	4	1	0
LTASPIKE-136	329	336	7	1	4	3	0	0
LTASPIKE-136	332	477	145	0	3	1	0	0
LTASPIKE-136	345	372	27	1	4	4	1	0
LTASPIKE-136	347	477	130	0	3	5	0	0
RBY-698	30	38	8	1	3	1	1	0
RBY-698	31	477	446	0	4	4	0	0
RBY-698	56	477	421	0	3	4	0	0
RBY-698	56	477	421	0	3	4	0	0
RBY-698	58	477	419	0	3	1	0	2
RBY-698	76	77	1	1	3	1	1	0
RBY-698	76	77	1	1	3	1	1	0
RBY-698	76	124	48	1	3	3	1	1
RBY-698	82	477	395	0	4	4	0	1
RBY-699	82	477	395	0	3	1	0	1
RBY-699	82	477	395	0	4	4	0	2
RBY-699	83	477	394	0	3	4	0	1
RBY-699	85	477	392	0	3	1	0	0
RBY-699	88	89	1	1	3	1	0	1
RBY-699	107	477	370	0	3	4	0	1
RBY-699	112	477	365	0	3	4	0	0
RBY-699	124	477	353	0	4	4	0	0
RBY-699	147	477	330	0	3	1	0	2
RBY-699	170	477	307	0	3	1	0	1
RBY-700	181	477	296	0	4	1	0	0
RBY-700	184	477	293	0	3	1	0	0
RBY-700	184	477	293	0	3	4	0	4
RBY-700	188	477	289	0	3	1	0	1
RBY-700	191	477	286	0	3	1	0	1
RBY-700	197	477	280	0	3	4	0	0
RBY-700	218	477	259	0	3	4	0	2
RBY-700	232	477	245	0	1	1	0	1
RBY-700	263	477	214	0	3	4	0	0
RBY-700	268	477	209	0	3	1	0	0
RBY-701	269	477	208	0	3	3	0	4
RBY-701	276	477	201	0	3	3	0	1
RBY-701	283	477	194	0	3	4	0	3
RBY-701	289	477	188	0	1	1	0	0
RBY-701	300	477	177	0	3	1	0	1
RBY-701	302	477	175	0	4	1	0	0
RBY-701	312	332	20	1	3	1	1	1
RBY-701	315	317	2	1	3	1	0	0
RBY-701	317	332	15	1	3	3	1	2
RBY-701	320	321	1	1	3	1	0	1
RBY-702	329	332	3	1	3	1	1	2
RBY-702	334	343	9	1	3	3	1	4
RBY-702	336	477	141	0	3	1	1	0
RBY-702	336	477	141	0	3	1	1	0
RBY-702	358	477	119	0	3	1	0	0
RBY-702	360	477	117	0	3	1	0	0
GESTER-18	50	477	427	0	4	1	0	0
GESTER-19	308	477	169	0	3	1	1	0
R-32	13	14	1	1	4	1	0	0
R-32	84	477	393	0	2	3	0	0
R-32	150	152	2	1	3	4	0	1
R-33	188	477	289	0	3	3	0	0
R-33	205	477	272	0	2	1	0	0
R-33	287	290	3	1	3	1	0	0
RAPI-30	11	31	20	1	3	5	0	0
RAPI-30	11	14	3	1	3	5	0	0
RAPI-30	21	98	77	1	3	1	1	0
RAPI-31	22	57	35	1	3	4	1	0
RAPI-31	31	32	1	1	3	4	1	0
RAPI-31	75	170	95	1	3	4	1	0
RAPI-31	89	92	3	1	5	5	1	0
RAPI-31	90	92	2	1	2	1	1	0
RAPI-31	136	137	1	1	3	4	1	0
RAPI-31	208	372	164	1	3	1	0	0
RAPI-31	228	229	1	1	3	1	1	0
RAPI-31	238	239	1	1	2	4	1	0
RAPI-31	238	239	1	1	3	1	1	0
RAPI-32	253	477	224	0	4	1	0	0
RAPI-32	260	262	2	1	3	1	1	0
RAPI-32	266	371	105	1	3	4	2	0
RAPI-32	290	366	76	1	4	1	1	0
RAPI-32	292	371	79	1	3	5	1	1
RAPI-32	292	295	3	1	3	4	1	0
RAPI-32	308	313	5	1	3	1	1	0
RAPI-32	328	477	149	0	3	4	0	0
RAPI-32	328	477	149	0	3	4	1	0
RAPI-32	345	371	26	1	3	5	0	0
RAPI-33	351	360	9	1	3	4	1	1
RKRB-68	7	8	1	1	3	4	2	0
RKRB-68	10	477	467	0	3	2	0	0
RKRB-68	11	41	30	1	3	5	1	0
RKRB-68	15	16	1	1	3	4	1	0
RKRB-68	21	23	2	1	3	2	2	0
RKRB-68	25	73	48	1	3	4	1	0
RKRB-68	28	29	1	1	3	5	1	0
RKRB-69	35	36	1	1	3	5	1	0
RKRB-69	35	43	8	1	3	5	0	0
RKRB-69	36	42	6	1	3	1	1	0
RKRB-69	39	42	3	1	4	4	1	0
RKRB-69	39	109	70	1	3	1	1	0
RKRB-69	39	42	3	1	4	4	1	0
RKRB-69	43	44	1	1	3	5	0	0
RKRB-69	60	123	63	1	3	5	1	0
RKRB-69	60	64	4	1	3	5	1	0
RKRB-69	72	85	13	1	3	5	1	0
RKRB-70	72	92	20	1	3	5	1	0
RKRB-70	72	144	72	1	3	5	1	0
RKRB-70	74	86	12	1	3	4	1	0
RKRB-70	74	79	5	1	3	4	2	0
RKRB-70	77	78	1	1	3	5	1	0
RKRB-70	79	84	5	1	3	4	2	0
RKRB-70	98	214	116	1	4	1	1	1
RKRB-70	98	281	183	1	3	4	1	1
RKRB-70	109	110	1	1	3	5	1	0
RKRB-71	112	113	1	1	3	4	1	0
RKRB-71	115	116	1	1	3	5	1	0
RKRB-71	127	128	1	1	3	5	1	0
RKRB-71	128	129	1	1	3	5	1	0
RKRB-71	135	136	1	1	3	5	1	0
RKRB-71	137	138	1	1	3	5	1	0
RKRB-71	149	151	2	1	3	5	1	0
RKRB-71	149	150	1	1	3	5	2	0
RKRB-71	151	152	1	1	3	5	1	0
RKRB-71	172	173	1	1	3	5	0	0
RKRB-72	182	477	295	0	3	1	0	0
RKRB-72	184	186	2	1	3	4	1	1
RKRB-72	186	187	1	1	3	5	0	0
RKRB-72	192	213	21	1	3	5	1	0
RKRB-72	198	200	2	1	3	5	0	0
RKRB-72	213	214	1	1	3	5	1	0
RKRB-72	216	224	8	1	3	2	1	0
RKRB-72	260	273	13	1	3	4	2	0
RKRB-72	273	477	204	0	3	3	0	0
RKRB-72	351	352	1	1	3	4	1	0
RMINA-107	39	61	22	1	3	1	1	1
RMINA-107	42	61	19	1	3	1	1	1
RMINA-107	46	202	156	1	4	2	0	0
RMINA-107	60	477	417	0	3	1	1	0
RMINA-108	74	83	9	1	3	4	1	0
RMINA-108	85	105	20	1	3	1	0	0
RMINA-108	85	477	392	0	3	1	0	0
RMINA-108	86	89	3	1	3	1	1	0
RMINA-108	94	95	1	1	3	1	0	1
RMINA-108	142	152	10	1	3	1	1	0
RMINA-108	154	414	260	1	3	1	0	0
RMINA-108	156	416	260	1	3	1	1	0
RMINA-108	179	181	2	1	3	1	1	1
RMINA-108	188	415	227	1	3	3	0	0
RMINA-109	197	198	1	1	4	1	1	1
RMINA-109	210	477	267	0	3	2	0	0
RMINA-109	238	416	178	1	5	1	1	0
RMINA-109	252	477	225	0	3	1	1	0
RMINA-109	256	260	4	1	3	1	1	0
RMINA-109	271	477	206	0	3	4	1	0
RMINA-109	350	396	46	1	1	1	1	0
RSERVER-221	9	477	468	0	3	1	0	0
RSERVER-221	14	477	463	0	3	1	0	0
RSERVER-221	15	477	462	0	3	1	0	0
RSERVER-222	17	22	5	1	3	1	1	0
RSERVER-222	19	477	458	0	3	1	0	0
RSERVER-222	50	51	1	1	3	1	0	0
RSERVER-222	52	477	425	0	3	1	0	0
RSERVER-222	70	477	407	0	4	5	1	0
RSERVER-222	76	89	13	1	4	4	1	0
RSERVER-222	77	78	1	1	3	1	0	0
RSERVER-222	80	81	1	1	3	1	0	0
RSERVER-222	81	477	396	0	3	5	1	0
RSERVER-222	89	90	1	1	5	4	1	0
RSERVER-223	89	90	1	1	4	4	1	0
RSERVER-223	92	93	1	1	3	1	1	0
RSERVER-223	93	94	1	1	3	1	0	0
RSERVER-223	112	477	365	0	3	1	0	0
RSERVER-223	140	141	1	1	3	1	1	0
RSERVER-223	157	477	320	0	3	1	0	0
RSERVER-223	162	477	315	0	3	1	0	0
RSERVER-223	163	477	314	0	2	1	0	0
RSERVER-223	185	186	1	1	3	1	0	0
RSERVER-224	186	477	291	0	3	4	0	0
RSERVER-224	190	477	287	0	3	5	0	0
RSERVER-224	208	220	12	1	3	4	1	1
RSERVER-224	209	210	1	1	3	3	1	0
RSERVER-224	228	477	249	0	3	2	1	0
RSERVER-224	229	230	1	1	3	1	0	0
RSERVER-224	231	287	56	1	3	1	1	2
RSERVER-224	236	477	241	0	3	2	1	1
RSERVER-224	248	477	229	0	3	1	0	0
RSERVER-225	254	477	223	0	3	1	0	0
RSERVER-225	258	477	219	0	3	1	0	0
RSERVER-225	260	477	217	0	3	1	1	0
RSERVER-225	268	477	209	0	2	1	0	0
RSERVER-225	290	477	187	0	2	1	1	0
RSERVER-225	301	477	176	0	3	1	0	0
RSERVER-225	311	477	166	0	3	1	0	0
RSTUDIO-116	15	477	462	0	4	5	1	0
RSTUDIO-116	18	140	122	1	3	1	1	0
RSTUDIO-116	43	477	434	0	3	1	0	0
RSTUDIO-116	49	50	1	1	3	1	0	0
RSTUDIO-116	49	477	428	0	3	1	0	0
RSTUDIO-117	49	50	1	1	3	1	0	1
RSTUDIO-117	50	477	427	0	4	1	0	0
RSTUDIO-117	53	140	87	1	3	1	1	0
RSTUDIO-117	59	60	1	1	3	1	0	0
RSTUDIO-117	82	251	169	1	3	1	1	0
RSTUDIO-117	91	92	1	1	4	4	1	0
RSTUDIO-117	93	251	158	1	3	4	1	0
RSTUDIO-117	107	230	123	1	4	4	1	0
RSTUDIO-117	122	477	355	0	4	1	0	0
RSTUDIO-117	142	230	88	1	1	1	1	1
RSTUDIO-118	150	230	80	1	3	1	1	1
RSTUDIO-118	150	151	1	1	5	5	0	0
RSTUDIO-118	150	151	1	1	3	5	0	0
RSTUDIO-118	172	477	305	0	3	1	0	0
RSTUDIO-118	172	233	61	1	3	1	1	0
RSTUDIO-118	176	250	74	1	3	1	1	0
RSTUDIO-118	209	210	1	1	3	3	1	0
RSTUDIO-118	209	210	1	1	3	3	1	0
RSTUDIO-118	209	210	1	1	3	1	1	0
RSTUDIO-118	209	477	268	0	3	3	1	0
RSTUDIO-119	209	220	11	1	3	4	1	2
RSTUDIO-119	249	250	1	1	3	1	1	0
RSTUDIO-119	250	251	1	1	3	3	1	0
RSTUDIO-119	250	251	1	1	3	3	1	0
RSTUDIO-119	263	264	1	1	3	1	1	0
RSTUDIO-119	270	284	14	1	2	1	1	0
RSTUDIO-119	297	477	180	0	3	1	0	0
RSTUDIO-119	298	313	15	1	3	1	1	0
RSTUDIO-119	298	477	179	0	3	4	0	0
RSTUDIO-119	304	477	173	0	3	1	1	1
RSTUDIO-120	312	324	12	1	3	1	1	0
RSTUDIO-120	312	477	165	0	4	5	0	0
RSTUDIO-120	319	477	158	0	3	1	0	0
RSTUDIO-120	321	477	156	0	4	1	1	0
RSTUDIO-120	321	477	156	0	3	1	1	1
RSTUDIO-120	333	477	144	0	3	1	1	1
RSTUDIO-120	339	477	138	0	3	4	0	0
RSTUDIO-120	360	477	117	0	3	4	1	2
SPATCH-100	135	137	2	1	3	3	1	0
SPATCH-100	135	143	8	1	3	3	1	0
SPATCH-100	135	148	13	1	3	4	1	0
SPATCH-100	136	163	27	1	3	1	1	2
SPATCH-100	137	162	25	1	3	1	0	2
SPATCH-100	137	141	4	1	3	5	1	0
SPATCH-100	140	141	1	1	3	1	0	0
SPATCH-100	140	190	50	1	3	4	0	2
SPATCH-100	142	217	75	1	3	1	2	0
SPATCH-100	143	198	55	1	3	1	0	0
SPATCH-101	143	284	141	1	3	1	1	0
SPATCH-101	144	154	10	1	3	1	1	1
SPATCH-101	144	155	11	1	3	4	1	1
SPATCH-101	144	155	11	1	3	4	1	0
SPATCH-101	148	149	1	1	3	2	1	0
SPATCH-101	148	149	1	1	3	4	1	0
SPATCH-101	148	149	1	1	4	4	1	0
SPATCH-101	148	175	27	1	3	4	1	1
SPATCH-101	148	163	15	1	3	4	1	2
SPATCH-101	148	477	329	0	3	1	0	0
SPATCH-102	149	177	28	1	3	4	1	0
SPATCH-102	151	157	6	1	3	1	1	0
SPATCH-102	151	154	3	1	3	1	1	0
SPATCH-102	151	157	6	1	3	1	1	0
SPATCH-102	155	156	1	1	3	4	1	0
SPATCH-102	157	162	5	1	3	1	1	0
SPATCH-102	157	163	6	1	3	1	1	0
SPATCH-102	158	477	319	0	3	1	0	0
SPATCH-102	161	477	316	0	3	1	0	0
SPATCH-102	161	163	2	1	4	1	1	0
SPATCH-103	161	163	2	1	4	1	1	0
SPATCH-103	161	163	2	1	4	1	1	0
SPATCH-103	161	308	147	1	4	1	0	0
SPATCH-103	161	163	2	1	4	1	1	0
SPATCH-103	162	163	1	1	3	1	1	0
SPATCH-103	162	163	1	1	3	1	0	0
SPATCH-103	163	164	1	1	3	1	1	0
SPATCH-103	163	164	1	1	3	1	1	0
SPATCH-103	165	186	21	1	4	4	1	0
SPATCH-103	165	477	312	0	3	1	0	0
SPATCH-104	165	477	312	0	3	1	0	1
SPATCH-104	165	175	10	1	3	1	1	0
SPATCH-104	165	477	312	0	3	1	0	0
SPATCH-104	169	170	1	1	3	1	1	0
SPATCH-104	170	172	2	1	3	1	1	0
SPATCH-104	170	178	8	1	3	1	1	3
SPATCH-104	172	178	6	1	3	1	1	0
SPATCH-104	172	176	4	1	3	1	1	0
SPATCH-104	172	176	4	1	3	1	1	0
SPATCH-104	175	176	1	1	3	4	1	0
SPATCH-105	176	177	1	1	3	1	1	0
SPATCH-105	176	177	1	1	3	1	1	0
SPATCH-105	177	178	1	1	3	1	1	0
SPATCH-105	177	178	1	1	4	4	1	0
SPATCH-105	177	186	9	1	4	4	1	0
SPATCH-105	177	191	14	1	3	1	1	0
SPATCH-105	177	178	1	1	3	1	1	0
SPATCH-105	178	182	4	1	3	1	1	0
SPATCH-105	179	180	1	1	3	1	1	0
SPATCH-105	180	183	3	1	4	4	1	0
SPATCH-106	182	190	8	1	3	5	1	0
SPATCH-106	183	184	1	1	4	1	1	0
SPATCH-106	183	189	6	1	3	1	1	0
SPATCH-106	183	185	2	1	3	1	1	0
SPATCH-106	185	217	32	1	3	4	1	0
SPATCH-106	185	190	5	1	3	4	1	0
SPATCH-106	186	194	8	1	3	4	1	0
SPATCH-106	190	217	27	1	3	4	1	2
SPATCH-106	190	193	3	1	3	4	0	1
SPATCH-106	190	191	1	1	3	1	1	1
SPATCH-107	191	196	5	1	3	4	1	0
SPATCH-107	191	204	13	1	3	1	1	0
SPATCH-107	191	192	1	1	3	1	1	0
SPATCH-107	191	308	117	1	3	4	0	1
SPATCH-107	191	197	6	1	4	1	1	0
SPATCH-107	191	192	1	1	4	4	1	0
SPATCH-107	191	192	1	1	4	4	1	0
SPATCH-107	191	203	12	1	3	1	1	0
SPATCH-107	191	197	6	1	5	1	1	0
SPATCH-107	193	477	284	0	3	1	1	0
SPATCH-108	196	197	1	1	3	1	1	0
SPATCH-108	198	274	76	1	3	1	1	0
SPATCH-108	198	226	28	1	3	4	1	0
SPATCH-108	198	199	1	1	3	1	1	0
SPATCH-108	203	204	1	1	3	1	1	0
SPATCH-108	203	217	14	1	3	1	1	0
SPATCH-108	204	262	58	1	3	1	1	0
SPATCH-108	204	205	1	1	3	1	1	0
SPATCH-108	205	477	272	0	3	2	0	0
SPATCH-108	206	207	1	1	3	1	1	0
SPATCH-109	207	252	45	1	3	1	1	0
SPATCH-109	207	208	1	1	3	1	1	0
SPATCH-109	211	213	2	1	3	1	1	0
SPATCH-109	211	214	3	1	3	1	1	0
SPATCH-109	212	217	5	1	3	1	1	0
SPATCH-109	213	214	1	1	3	1	1	0
SPATCH-109	217	277	60	1	3	2	1	0
SPATCH-109	217	218	1	1	3	1	1	0
SPATCH-109	219	220	1	1	3	1	1	0
SPATCH-109	220	233	13	1	3	4	1	0
SPATCH-110	220	277	57	1	4	2	0	1
SPATCH-110	221	222	1	1	3	1	1	0
SPATCH-110	221	233	12	1	3	1	1	0
SPATCH-110	224	235	11	1	3	4	1	0
SPATCH-110	227	228	1	1	3	1	1	0
SPATCH-110	233	235	2	1	4	4	1	0
SPATCH-110	234	235	1	1	3	1	1	0
SPATCH-110	235	254	19	1	3	4	1	0
SPATCH-110	239	240	1	1	3	4	1	0
SPATCH-110	240	253	13	1	3	4	1	0
SPATCH-111	240	283	43	1	3	1	1	2
SPATCH-111	242	243	1	1	3	1	1	1
SPATCH-111	242	243	1	1	3	1	1	0
SPATCH-111	247	248	1	1	3	1	1	0
SPATCH-111	247	254	7	1	3	1	0	1
SPATCH-111	248	354	106	1	3	3	1	0
SPATCH-111	248	249	1	1	3	1	1	0
SPATCH-111	248	249	1	1	3	1	1	0
SPATCH-111	252	282	30	1	3	1	1	0
SPATCH-111	253	284	31	1	3	1	1	0
SPATCH-112	253	477	224	0	3	1	0	0
SPATCH-112	257	283	26	1	4	1	1	0
SPATCH-112	260	261	1	1	3	1	0	1
SPATCH-112	260	282	22	1	3	4	1	0
SPATCH-112	260	262	2	1	3	1	1	0
SPATCH-112	262	284	22	1	3	1	1	0
SPATCH-112	263	283	20	1	3	1	1	0
SPATCH-112	266	477	211	0	3	4	0	0
SPATCH-112	266	267	1	1	3	4	1	0
SPATCH-112	266	267	1	1	3	4	1	0
SPATCH-113	268	283	15	1	3	4	1	0
SPATCH-113	269	281	12	1	3	1	1	0
SPATCH-113	269	282	13	1	4	4	1	0
SPATCH-113	269	282	13	1	3	2	1	0
SPATCH-113	270	273	3	1	3	1	1	0
SPATCH-113	273	477	204	0	3	1	0	0
SPATCH-113	274	275	1	1	3	1	1	0
SPATCH-113	275	280	5	1	3	1	2	1
SPATCH-113	275	277	2	1	3	1	0	2
SPATCH-113	276	290	14	1	3	2	1	0
SPATCH-114	277	284	7	1	3	2	0	0
SPATCH-114	282	303	21	1	3	4	1	0
SPATCH-114	282	284	2	1	3	2	1	0
SPATCH-114	283	298	15	1	3	2	1	0
SPATCH-114	283	477	194	0	3	4	0	0
SPATCH-114	284	295	11	1	3	2	1	0
SPATCH-114	287	288	1	1	3	1	1	0
SPATCH-114	290	297	7	1	3	4	1	0
SPATCH-114	290	291	1	1	3	1	1	0
SPATCH-114	290	291	1	1	3	1	1	0
SPATCH-115	294	298	4	1	3	2	1	0
SPATCH-115	295	296	1	1	3	1	1	0
SPATCH-115	295	303	8	1	4	4	1	0
SPATCH-115	296	297	1	1	3	1	1	0
SPATCH-115	296	340	44	1	3	2	1	0
SPATCH-115	296	374	78	1	3	1	1	0
SPATCH-115	296	297	1	1	3	2	1	0
SPATCH-115	296	297	1	1	3	1	1	0
SPATCH-115	301	307	6	1	3	4	1	1
SPATCH-115	302	303	1	1	3	4	1	0
SPATCH-116	302	304	2	1	3	4	1	0
SPATCH-116	302	308	6	1	3	4	1	2
SPATCH-116	303	375	72	1	3	4	1	0
SPATCH-116	303	333	30	1	3	1	1	0
SPATCH-116	303	304	1	1	3	1	1	0
SPATCH-116	305	310	5	1	4	4	1	0
SPATCH-116	307	308	1	1	3	4	1	0
SPATCH-116	307	477	170	0	3	4	1	0
SPATCH-116	307	320	13	1	3	4	1	0
SPATCH-116	308	309	1	1	3	1	1	0
SPATCH-117	308	309	1	1	3	1	1	0
SPATCH-117	308	309	1	1	3	1	1	0
SPATCH-117	308	477	169	0	3	1	0	0
SPATCH-117	309	477	168	0	3	4	0	0
SPATCH-117	310	311	1	1	3	1	1	0
SPATCH-117	310	311	1	1	3	3	1	0
SPATCH-117	310	312	2	1	3	1	1	0
SPATCH-117	310	477	167	0	3	1	0	0
SPATCH-117	311	312	1	1	3	4	1	0
SPATCH-117	312	477	165	0	3	1	0	0
SPATCH-118	312	314	2	1	3	1	1	0
SPATCH-118	312	315	3	1	3	1	1	0
SPATCH-118	314	315	1	1	3	1	1	0
SPATCH-118	315	477	162	0	3	4	0	0
SPATCH-118	316	317	1	1	3	1	1	0
SPATCH-118	316	317	1	1	3	1	1	0
SPATCH-118	317	477	160	0	3	4	0	0
SPATCH-118	322	339	17	1	3	1	1	0
SPATCH-118	322	333	11	1	3	1	0	0
SPATCH-118	323	351	28	1	3	1	1	0
SPATCH-119	323	329	6	1	3	1	1	0
SPATCH-119	323	332	9	1	3	4	1	0
SPATCH-119	324	325	1	1	4	1	1	0
SPATCH-119	329	330	1	1	5	4	1	0
SPATCH-119	330	344	14	1	3	2	1	0
SPATCH-119	331	338	7	1	3	4	1	0
SPATCH-119	331	332	1	1	3	1	1	0
SPATCH-119	332	333	1	1	3	1	1	0
SPATCH-119	333	337	4	1	3	1	1	0
SPATCH-119	333	334	1	1	3	4	1	0
SPATCH-120	333	334	1	1	3	4	1	0
SPATCH-120	333	334	1	1	3	4	1	0
SPATCH-120	333	336	3	1	3	4	1	0
SPATCH-120	336	375	39	1	3	1	1	0
SPATCH-120	336	375	39	1	3	4	1	0
SPATCH-120	336	337	1	1	3	4	1	0
SPATCH-120	336	338	2	1	4	4	1	0
SPATCH-120	336	338	2	1	3	4	1	0
SPATCH-120	337	338	1	1	3	4	1	0
SPATCH-120	338	339	1	1	3	4	1	0
SPATCH-121	338	352	14	1	3	4	1	0
SPATCH-121	338	339	1	1	4	4	1	0
SPATCH-121	338	339	1	1	3	1	1	0
SPATCH-121	339	351	12	1	3	1	1	0
SPATCH-121	340	477	137	0	3	1	1	0
SPATCH-121	340	477	137	0	3	1	1	0
SPATCH-121	343	352	9	1	3	4	1	0
SPATCH-121	343	344	1	1	3	1	1	0
SPATCH-121	343	351	8	1	3	1	1	0
SPATCH-121	343	347	4	1	3	1	1	0
SPATCH-122	345	351	6	1	3	1	1	0
SPATCH-122	345	346	1	1	1	1	1	0
SPATCH-122	346	351	5	1	3	1	1	0
SPATCH-122	347	352	5	1	3	1	1	0
SPATCH-122	347	351	4	1	3	2	1	0
SPATCH-122	351	357	6	1	3	5	1	0
SPATCH-122	351	357	6	1	3	5	1	0
SPATCH-122	351	352	1	1	3	4	1	0
SPATCH-122	352	353	1	1	3	1	1	0
SPATCH-122	353	354	1	1	3	1	1	0
SPATCH-123	354	477	123	0	3	1	1	0
SPATCH-123	357	366	9	1	3	1	1	0
SPATCH-123	359	366	7	1	3	1	1	0
SPATCH-90	2	14	12	1	3	1	0	0
SPATCH-90	8	15	7	1	3	1	1	0
SPATCH-90	9	21	12	1	3	1	1	0
SPATCH-90	11	12	1	1	3	1	0	0
SPATCH-91	11	23	12	1	3	1	1	1
SPATCH-91	11	57	46	1	3	2	1	0
SPATCH-91	14	15	1	1	3	1	1	2
SPATCH-91	14	15	1	1	3	1	0	0
SPATCH-91	15	16	1	1	3	1	1	0
SPATCH-91	15	23	8	1	3	1	1	0
SPATCH-91	18	23	5	1	3	1	1	0
SPATCH-91	21	25	4	1	3	3	1	0
SPATCH-91	22	100	78	1	3	4	1	0
SPATCH-91	24	29	5	1	4	1	1	0
SPATCH-92	26	28	2	1	1	1	1	0
SPATCH-92	28	148	120	1	3	4	1	1
SPATCH-92	28	29	1	1	3	1	1	0
SPATCH-92	31	32	1	1	4	4	1	0
SPATCH-92	43	44	1	1	3	1	2	0
SPATCH-92	43	73	30	1	3	4	1	0
SPATCH-92	44	45	1	1	3	1	0	0
SPATCH-92	45	53	8	1	3	1	1	0
SPATCH-92	46	53	7	1	3	1	1	0
SPATCH-92	49	477	428	0	3	1	1	0
SPATCH-93	51	477	426	0	3	2	1	0
SPATCH-93	52	78	26	1	3	1	1	0
SPATCH-93	58	59	1	1	4	2	1	0
SPATCH-93	58	477	419	0	3	1	1	0
SPATCH-93	58	477	419	0	4	2	1	0
SPATCH-93	59	477	418	0	3	1	1	0
SPATCH-93	59	477	418	0	3	5	1	0
SPATCH-93	59	148	89	1	3	1	0	0
SPATCH-93	64	86	22	1	3	4	1	0
SPATCH-93	65	477	412	0	3	1	1	0
SPATCH-94	66	87	21	1	4	1	1	0
SPATCH-94	71	148	77	1	3	1	1	0
SPATCH-94	71	72	1	1	3	4	1	0
SPATCH-94	72	73	1	1	3	1	1	0
SPATCH-94	72	73	1	1	3	1	1	0
SPATCH-94	78	81	3	1	3	1	1	0
SPATCH-94	78	80	2	1	3	4	1	0
SPATCH-94	79	91	12	1	3	1	1	0
SPATCH-94	79	80	1	1	3	1	1	0
SPATCH-94	80	477	397	0	3	1	1	1
SPATCH-95	80	477	397	0	3	2	1	1
SPATCH-95	87	91	4	1	4	4	1	0
SPATCH-95	87	94	7	1	3	1	1	0
SPATCH-95	87	88	1	1	3	1	1	0
SPATCH-95	91	92	1	1	3	1	1	0
SPATCH-95	93	107	14	1	3	3	1	0
SPATCH-95	94	100	6	1	3	1	0	0
SPATCH-95	95	108	13	1	3	1	0	0
SPATCH-95	95	477	382	0	3	1	0	0
SPATCH-95	95	477	382	0	3	1	1	0
SPATCH-96	99	477	378	0	3	1	0	0
SPATCH-96	100	477	377	0	4	4	0	0
SPATCH-96	100	101	1	1	3	1	1	2
SPATCH-96	100	116	16	1	3	4	1	1
SPATCH-96	100	101	1	1	3	1	1	0
SPATCH-96	100	163	63	1	3	4	1	0
SPATCH-96	101	136	35	1	1	1	1	1
SPATCH-96	101	102	1	1	3	1	1	0
SPATCH-96	105	477	372	0	4	4	0	0
SPATCH-96	107	108	1	1	3	1	1	0
SPATCH-97	107	108	1	1	3	2	1	0
SPATCH-97	108	109	1	1	3	4	1	1
SPATCH-97	108	112	4	1	3	4	1	0
SPATCH-97	108	109	1	1	3	1	0	0
SPATCH-97	112	477	365	0	3	1	0	2
SPATCH-97	112	477	365	0	3	1	0	0
SPATCH-97	112	128	16	1	3	1	1	0
SPATCH-97	113	190	77	1	3	4	1	0
SPATCH-97	113	114	1	1	3	3	1	0
SPATCH-97	114	119	5	1	4	1	1	0
SPATCH-98	116	177	61	1	3	2	1	0
SPATCH-98	116	120	4	1	3	1	1	0
SPATCH-98	119	149	30	1	3	4	1	0
SPATCH-98	119	120	1	1	3	1	1	0
SPATCH-98	119	120	1	1	3	1	1	0
SPATCH-98	120	121	1	1	3	1	1	0
SPATCH-98	120	121	1	1	3	1	1	0
SPATCH-98	122	477	355	0	3	1	0	0
SPATCH-98	126	127	1	1	3	1	1	0
SPATCH-98	127	128	1	1	4	3	1	0
SPATCH-99	127	144	17	1	3	1	1	1
SPATCH-99	127	128	1	1	3	1	1	0
SPATCH-99	127	128	1	1	3	1	1	0
SPATCH-99	128	218	90	1	3	1	1	0
SPATCH-99	128	156	28	1	3	1	1	1
SPATCH-99	129	477	348	0	3	1	0	1
SPATCH-99	129	477	348	0	4	2	0	0
SPATCH-99	129	135	6	1	3	1	0	1
SPATCH-99	129	130	1	1	3	1	1	0
SPATCH-99	133	134	1	1	3	1	0	1
-21	249	477	228	0	3	3	0	0
AB-	308	477	169	0	3	2	1	0
AB-1	309	477	168	0	3	5	0	0
AB-10	317	477	160	0	3	5	0	0
AB-10	317	477	160	0	3	2	0	0
AB-10	317	477	160	0	3	5	0	0
AB-10	317	477	160	0	3	5	0	0
AB-10	338	372	34	1	3	1	1	0
AB-10	352	442	90	1	3	2	1	0
AB-1	309	477	168	0	3	5	0	0
AB-11	352	353	1	1	3	5	1	0
AB-11	352	353	1	1	3	5	1	0
AB-11	352	477	125	0	3	4	1	0
AB-11	352	353	1	1	3	5	1	0
AB-11	352	353	1	1	3	5	1	0
AB-11	352	403	51	1	3	5	1	0
AB-11	352	353	1	1	3	4	1	0
AB-11	352	353	1	1	3	5	1	0
AB-11	352	353	1	1	3	5	1	0
AB-11	352	353	1	1	3	5	1	0
AB-1	309	477	168	0	3	5	0	0
AB-12	352	353	1	1	3	5	1	0
AB-12	352	353	1	1	3	5	1	0
AB-12	352	353	1	1	3	5	1	0
AB-12	352	353	1	1	3	5	1	0
AB-12	352	353	1	1	3	5	1	0
AB-12	352	353	1	1	3	2	1	0
AB-12	352	353	1	1	3	5	1	0
AB-12	352	353	1	1	3	5	1	0
AB-12	352	353	1	1	3	5	1	0
AB-12	352	353	1	1	3	5	1	0
AB-1	309	477	168	0	3	2	0	0
AB-13	352	353	1	1	3	4	1	0
AB-13	352	353	1	1	3	5	1	0
AB-13	352	353	1	1	3	5	1	0
AB-13	352	353	1	1	3	4	1	0
AB-13	352	353	1	1	3	5	1	0
AB-13	352	353	1	1	3	5	1	0
AB-13	352	353	1	1	3	2	1	0
AB-13	352	353	1	1	3	5	1	0
AB-13	352	353	1	1	3	5	1	0
AB-13	352	353	1	1	3	5	1	0
AB-1	309	477	168	0	3	5	0	0
AB-14	352	353	1	1	3	3	1	0
AB-14	352	353	1	1	3	5	1	0
AB-14	352	353	1	1	3	5	1	0
AB-14	352	353	1	1	3	2	1	0
AB-14	352	353	1	1	3	5	1	0
AB-14	352	353	1	1	3	5	1	0
AB-14	352	353	1	1	3	4	1	0
AB-14	352	353	1	1	3	5	1	0
AB-14	352	353	1	1	3	5	1	0
AB-14	352	353	1	1	3	1	1	0
AB-1	309	477	168	0	3	5	0	0
AB-15	352	353	1	1	3	5	1	0
AB-15	352	353	1	1	3	5	1	0
AB-15	352	353	1	1	3	3	1	0
AB-15	352	353	1	1	3	1	1	0
AB-15	352	353	1	1	3	1	1	0
AB-15	352	353	1	1	2	3	1	0
AB-15	352	353	1	1	3	1	1	0
AB-15	352	353	1	1	3	1	1	0
AB-15	352	353	1	1	2	1	1	0
AB-15	352	353	1	1	2	1	1	0
AB-1	309	477	168	0	3	5	0	0
AB-16	352	353	1	1	3	3	1	0
AB-16	352	353	1	1	4	1	1	0
AB-16	352	353	1	1	3	1	1	0
AB-16	352	353	1	1	4	1	1	0
AB-16	352	353	1	1	3	1	1	0
AB-16	352	353	1	1	5	1	1	0
AB-16	352	353	1	1	3	4	1	0
AB-16	352	353	1	1	3	3	1	0
AB-16	352	353	1	1	3	1	1	0
AB-16	352	353	1	1	3	3	1	0
AB-1	309	477	168	0	4	3	0	0
AB-17	352	353	1	1	2	1	1	0
AB-17	352	353	1	1	3	1	1	0
AB-17	352	353	1	1	1	1	1	0
AB-17	352	353	1	1	3	3	1	0
AB-17	352	353	1	1	3	1	1	0
AB-17	352	353	1	1	2	1	1	0
AB-17	352	353	1	1	2	1	1	0
AB-17	352	353	1	1	2	1	1	0
AB-17	352	353	1	1	3	4	1	0
AB-17	352	353	1	1	3	4	1	0
AB-1	309	477	168	0	3	3	0	0
AB-18	352	353	1	1	3	3	1	0
AB-18	352	353	1	1	3	3	1	0
AB-18	352	353	1	1	3	3	1	0
AB-18	352	353	1	1	4	1	1	0
AB-18	352	353	1	1	4	1	1	0
AB-18	352	353	1	1	3	1	1	0
AB-18	352	353	1	1	3	1	1	0
AB-18	352	353	1	1	3	1	1	0
AB-18	352	353	1	1	4	1	1	0
AB-18	352	353	1	1	4	2	1	0
AB-1	309	477	168	0	3	3	0	0
AB-19	352	353	1	1	4	4	1	0
AB-19	352	353	1	1	3	3	1	0
AB-19	352	353	1	1	3	3	1	0
AB-19	352	353	1	1	3	1	1	0
AB-19	352	353	1	1	4	3	1	0
AB-19	352	353	1	1	4	3	1	0
AB-19	352	353	1	1	4	3	1	0
AB-19	352	353	1	1	3	1	1	0
AB-19	352	353	1	1	4	3	1	0
AB-19	352	353	1	1	4	3	1	0
AB-	308	477	169	0	3	5	0	0
AB-2	309	477	168	0	3	1	1	0
AB-20	352	353	1	1	3	1	1	0
AB-20	352	353	1	1	4	3	1	0
AB-20	352	353	1	1	3	1	1	0
AB-20	352	353	1	1	3	1	1	0
AB-20	352	353	1	1	3	1	1	0
AB-20	352	353	1	1	3	1	1	0
AB-20	352	353	1	1	3	3	1	0
AB-20	352	353	1	1	3	1	1	0
AB-20	352	353	1	1	4	1	1	0
AB-20	352	353	1	1	4	1	1	0
AB-2	309	477	168	0	4	1	0	0
AB-21	352	353	1	1	3	3	1	0
AB-21	352	353	1	1	4	1	1	0
AB-21	352	353	1	1	2	1	1	0
AB-21	352	353	1	1	4	1	1	0
AB-21	352	353	1	1	1	1	1	0
AB-21	352	353	1	1	2	1	1	0
AB-21	352	353	1	1	3	4	1	0
AB-21	352	353	1	1	3	3	1	0
AB-21	352	353	1	1	3	3	1	0
AB-21	352	353	1	1	3	3	1	0
AB-2	309	477	168	0	4	4	0	0
AB-22	352	353	1	1	4	1	0	0
AB-22	353	354	1	1	3	1	1	0
AB-22	353	354	1	1	3	1	1	0
AB-22	353	354	1	1	3	3	1	0
AB-22	353	354	1	1	3	3	1	0
AB-22	353	354	1	1	3	3	1	0
AB-22	353	354	1	1	2	1	1	0
AB-22	353	354	1	1	2	1	1	0
AB-22	353	354	1	1	4	1	1	0
AB-22	353	354	1	1	1	1	1	0
AB-2	309	477	168	0	3	2	1	0
AB-23	353	354	1	1	3	1	1	0
AB-23	353	354	1	1	3	1	1	0
AB-23	353	354	1	1	3	1	1	0
AB-23	353	354	1	1	3	3	1	0
AB-23	353	354	1	1	3	1	1	0
AB-23	353	354	1	1	3	1	1	0
AB-23	353	354	1	1	3	1	1	0
AB-23	353	354	1	1	3	1	1	0
AB-23	353	354	1	1	3	1	1	0
AB-23	353	354	1	1	4	1	1	0
AB-2	309	477	168	0	4	1	0	0
AB-24	353	354	1	1	4	1	1	0
AB-24	353	354	1	1	3	1	1	0
AB-24	353	354	1	1	4	1	1	0
AB-24	353	354	1	1	2	1	1	0
AB-24	353	354	1	1	3	4	1	0
AB-24	353	354	1	1	3	3	1	0
AB-24	353	354	1	1	3	1	1	0
AB-24	353	354	1	1	3	1	1	0
AB-24	353	381	28	1	3	3	1	0
AB-24	353	477	124	0	3	2	1	0
AB-2	309	477	168	0	3	2	0	0
AB-25	353	382	29	1	3	3	1	0
AB-25	354	455	101	1	3	2	1	0
AB-25	354	455	101	1	3	5	0	0
AB-25	354	444	90	1	3	5	1	0
AB-25	354	477	123	0	3	2	1	0
AB-25	354	477	123	0	3	5	1	0
AB-25	354	477	123	0	3	5	1	0
AB-2	309	477	168	0	3	5	0	0
AB-2	309	477	168	0	3	5	0	0
AB-2	309	477	168	0	4	5	0	0
AB-2	309	477	168	0	4	5	0	0
AB-	308	477	169	0	3	5	0	0
AB-3	309	477	168	0	4	5	0	0
AB-3	309	477	168	0	4	5	0	0
AB-3	309	477	168	0	4	2	0	0
AB-3	309	477	168	0	4	2	0	0
AB-3	309	477	168	0	4	5	0	0
AB-3	309	477	168	0	4	5	0	0
AB-3	309	477	168	0	4	5	0	0
AB-3	309	477	168	0	3	2	0	0
AB-3	309	477	168	0	3	2	0	0
AB-3	309	477	168	0	4	1	0	0
AB-	308	477	169	0	3	5	0	0
AB-4	309	477	168	0	3	5	0	0
AB-4	309	381	72	1	3	4	1	0
AB-4	309	477	168	0	3	3	0	0
AB-4	309	477	168	0	3	3	0	0
AB-4	309	477	168	0	3	3	0	0
AB-4	309	477	168	0	4	4	0	0
AB-4	309	477	168	0	4	5	0	0
AB-4	309	477	168	0	4	5	0	0
AB-4	309	477	168	0	4	5	0	0
AB-4	309	477	168	0	3	3	0	0
AB-	309	477	168	0	3	2	0	0
AB-5	309	477	168	0	3	3	0	0
AB-5	309	477	168	0	3	3	0	0
AB-5	309	435	126	1	2	1	1	0
AB-5	309	477	168	0	3	3	0	0
AB-5	309	477	168	0	3	3	0	0
AB-5	309	477	168	0	3	3	0	0
AB-5	309	477	168	0	3	4	0	0
AB-5	309	477	168	0	3	4	0	0
AB-5	309	477	168	0	3	5	0	0
AB-5	309	477	168	0	3	5	0	0
AB-	309	477	168	0	3	5	0	0
AB-6	309	477	168	0	3	5	0	0
AB-6	309	477	168	0	4	1	0	0
AB-6	309	477	168	0	3	5	0	0
AB-6	309	477	168	0	4	3	0	0
AB-6	309	477	168	0	3	3	0	0
AB-6	309	477	168	0	3	2	0	0
AB-6	309	477	168	0	3	4	0	0
AB-6	309	477	168	0	3	5	0	0
AB-6	309	477	168	0	3	5	0	0
AB-6	309	477	168	0	4	2	0	0
AB-	309	477	168	0	3	5	0	0
AB-7	309	477	168	0	4	5	0	0
AB-7	309	477	168	0	4	5	0	0
AB-7	309	477	168	0	4	5	0	0
AB-7	309	477	168	0	3	4	1	0
AB-7	309	477	168	0	3	4	0	0
AB-7	309	477	168	0	3	4	0	0
AB-7	309	477	168	0	3	2	0	0
AB-7	309	477	168	0	4	2	1	0
AB-7	309	477	168	0	3	2	0	0
AB-7	309	477	168	0	3	5	0	0
AB-	309	477	168	0	3	5	0	0
AB-8	309	477	168	0	3	5	0	0
AB-8	309	477	168	0	3	5	0	0
AB-8	309	477	168	0	3	2	0	0
AB-8	309	477	168	0	3	2	0	0
AB-8	309	477	168	0	3	2	0	0
AB-8	309	477	168	0	3	5	0	0
AB-8	309	477	168	0	3	5	0	0
AB-8	309	477	168	0	3	5	0	0
AB-8	309	477	168	0	3	1	0	0
AB-8	309	330	21	1	3	1	1	0
AB-	309	477	168	0	3	2	0	0
AB-9	309	477	168	0	3	1	0	0
AB-9	310	477	167	0	3	4	0	0
AB-9	310	477	167	0	3	4	0	0
AB-9	310	477	167	0	3	5	0	0
AB-9	310	477	167	0	3	5	0	0
AB-9	310	477	167	0	3	5	0	0
AB-9	311	477	166	0	3	3	0	0
AB-9	317	477	160	0	3	2	0	0
AB-9	317	477	160	0	3	5	0	0
AB-9	317	477	160	0	3	5	0	0
SGI-27	182	183	1	1	3	4	1	0
XIA-56	15	477	462	0	3	1	0	1
XIA-56	19	477	458	0	3	2	0	0
XIA-57	41	477	436	0	4	1	0	0
XIA-57	55	477	422	0	4	1	0	0
XIA-57	96	244	148	1	4	5	1	1
XIA-57	96	244	148	1	4	5	1	1
XIA-57	98	477	379	0	3	1	0	0
XIA-57	132	477	345	0	3	4	1	3
XIA-57	160	477	317	0	4	5	0	2
XIA-57	325	326	1	1	3	1	1	1
XIA-57	325	477	152	0	3	1	1	0
XIA-57	325	326	1	1	3	1	1	0
XIA-58	325	477	152	0	3	1	1	0
XIA-58	329	330	1	1	3	1	1	0
XIA-58	329	330	1	1	3	1	1	0
XIA-58	348	477	129	0	3	1	0	0
XIA-58	357	477	120	0	3	1	0	0
XIASITETOOLS-18	37	64	27	1	2	1	1	2
XIASITETOOLS-18	69	477	408	0	3	2	0	0
XIASITETOOLS-18	69	70	1	1	3	4	1	1
XIASITETOOLS-19	132	477	345	0	3	4	0	2
XIASITETOOLS-19	243	244	1	1	4	5	1	0
XIATOOLS-5	219	477	258	0	4	4	0	0
ILL-606	0	477	477	0	3	1	0	0
ILL-606	1	477	476	0	4	1	0	0
ILL-606	1	425	424	1	3	1	1	1
ILL-606	2	477	475	0	4	1	0	0
ILL-606	2	54	52	1	3	2	1	1
ILL-606	3	297	294	1	3	1	1	0
ILL-607	3	36	33	1	3	1	1	2
ILL-607	3	30	27	1	3	4	1	1
ILL-607	4	477	473	0	4	1	0	0
ILL-607	4	477	473	0	4	1	0	0
ILL-607	6	477	471	0	4	1	0	0
ILL-607	6	477	471	0	4	1	0	0
ILL-607	7	477	470	0	2	3	1	0
ILL-607	8	477	469	0	3	1	0	0
ILL-607	8	477	469	0	3	1	0	0
ILL-607	8	24	16	1	4	1	1	0
ILL-608	10	30	20	1	4	1	1	1
ILL-608	10	21	11	1	3	1	1	1
ILL-608	10	155	145	1	3	1	1	0
ILL-608	10	14	4	1	3	1	1	0
ILL-608	11	291	280	1	3	4	1	1
ILL-608	11	21	10	1	3	1	1	0
ILL-608	11	477	466	0	3	1	0	1
ILL-608	13	477	464	0	3	1	0	0
ILL-608	14	21	7	1	3	1	1	0
ILL-608	14	49	35	1	3	4	1	0
ILL-609	15	54	39	1	3	1	1	0
ILL-609	15	31	16	1	3	1	0	0
ILL-609	15	477	462	0	3	1	0	0
ILL-609	15	24	9	1	3	1	1	0
ILL-609	17	123	106	1	3	4	1	4
ILL-609	17	477	460	0	4	4	0	0
ILL-609	17	477	460	0	3	1	0	0
ILL-609	18	477	459	0	3	4	0	0
ILL-609	18	477	459	0	3	4	0	0
ILL-609	18	61	43	1	3	1	1	0
ILL-610	20	24	4	1	3	1	1	0
ILL-610	21	214	193	1	2	4	1	0
ILL-610	21	25	4	1	3	4	1	0
ILL-610	21	89	68	1	3	1	1	0
ILL-610	22	199	177	1	3	4	1	1
ILL-610	23	477	454	0	2	1	0	0
ILL-610	24	31	7	1	4	4	1	0
ILL-610	24	477	453	0	3	1	0	0
ILL-610	24	477	453	0	3	2	0	1
ILL-610	24	477	453	0	4	2	0	1
ILL-611	24	25	1	1	5	4	0	0
ILL-611	24	49	25	1	3	1	1	1
ILL-611	25	26	1	1	3	4	0	0
ILL-611	25	477	452	0	3	4	0	1
ILL-611	28	61	33	1	3	4	1	0
ILL-611	28	54	26	1	3	4	1	0
ILL-611	28	477	449	0	3	1	0	0
ILL-611	29	30	1	1	2	1	1	0
ILL-611	29	55	26	1	3	4	1	2
ILL-611	29	37	8	1	1	1	1	0
ILL-612	29	477	448	0	4	1	0	1
ILL-612	29	477	448	0	4	1	0	1
ILL-612	29	477	448	0	4	1	0	1
ILL-612	30	49	19	1	3	4	1	1
ILL-612	30	31	1	1	4	1	1	0
ILL-612	30	88	58	1	4	1	1	1
ILL-612	30	66	36	1	2	4	1	0
ILL-612	30	49	19	1	3	1	1	1
ILL-612	30	46	16	1	3	1	1	0
ILL-612	31	39	8	1	4	1	1	0
ILL-613	31	49	18	1	3	3	1	2
ILL-613	31	477	446	0	4	4	0	0
ILL-613	32	100	68	1	3	1	1	1
ILL-613	33	477	444	0	4	1	0	0
ILL-613	35	477	442	0	3	1	0	0
ILL-613	35	477	442	0	3	2	0	0
ILL-613	35	477	442	0	3	1	0	0
ILL-613	35	59	24	1	3	1	1	0
ILL-613	36	39	3	1	4	3	1	0
ILL-613	36	477	441	0	3	1	0	0
ILL-614	36	49	13	1	3	1	1	1
ILL-614	37	477	440	0	2	1	0	0
ILL-614	37	477	440	0	4	1	0	1
ILL-614	38	49	11	1	3	1	1	0
ILL-614	38	39	1	1	3	1	1	0
ILL-614	38	162	124	1	3	4	1	3
ILL-614	38	477	439	0	2	1	0	0
ILL-614	39	180	141	1	3	4	1	0
ILL-614	39	49	10	1	4	1	1	0
ILL-614	40	477	437	0	3	2	0	0
ILL-615	42	477	435	0	3	1	0	2
ILL-615	43	66	23	1	3	1	1	1
ILL-615	43	477	434	0	3	1	0	1
ILL-615	43	61	18	1	3	4	1	0
ILL-615	43	54	11	1	3	1	1	0
ILL-615	43	477	434	0	3	1	0	0
ILL-615	44	477	433	0	3	4	0	0
ILL-615	44	477	433	0	4	4	0	0
ILL-615	44	477	433	0	3	1	1	0
ILL-615	44	477	433	0	3	1	1	0
ILL-616	45	477	432	0	2	4	0	2
ILL-616	45	162	117	1	2	4	1	1
ILL-616	45	70	25	1	3	4	1	1
ILL-616	45	71	26	1	3	4	1	1
ILL-616	46	49	3	1	3	1	1	0
ILL-616	46	477	431	0	3	1	0	0
ILL-616	48	477	429	0	2	1	0	0
ILL-616	49	477	428	0	3	1	0	3
ILL-616	49	477	428	0	3	1	0	3
ILL-616	49	477	428	0	3	1	0	1
ILL-617	50	477	427	0	4	4	0	0
ILL-617	50	477	427	0	3	1	0	0
ILL-617	51	54	3	1	3	1	1	0
ILL-617	51	118	67	1	3	4	1	4
ILL-617	51	61	10	1	3	4	1	0
ILL-617	51	52	1	1	4	1	0	0
ILL-617	52	67	15	1	2	1	0	0
ILL-617	52	70	18	1	3	4	1	1
ILL-617	52	477	425	0	3	1	0	0
ILL-617	52	232	180	1	3	2	1	0
ILL-618	52	61	9	1	2	4	1	1
ILL-618	52	477	425	0	3	1	0	1
ILL-618	53	170	117	1	5	1	1	0
ILL-618	53	477	424	0	4	1	0	0
ILL-618	53	477	424	0	3	4	0	1
ILL-618	56	61	5	1	1	1	1	2
ILL-618	56	477	421	0	3	1	0	0
ILL-618	56	70	14	1	3	1	1	0
ILL-618	57	61	4	1	3	1	1	0
ILL-618	57	62	5	1	3	1	1	1
ILL-619	57	61	4	1	3	1	1	0
ILL-619	57	61	4	1	3	1	1	0
ILL-619	57	68	11	1	3	1	1	0
ILL-619	57	477	420	0	2	1	0	0
ILL-619	58	477	419	0	3	1	0	0
ILL-619	58	61	3	1	3	1	1	1
ILL-619	58	477	419	0	4	5	0	3
ILL-619	58	61	3	1	4	1	1	0
ILL-619	59	61	2	1	4	1	1	0
ILL-619	59	78	19	1	3	1	1	1
ILL-620	59	477	418	0	3	1	0	0
ILL-620	59	477	418	0	3	1	0	0
ILL-620	59	118	59	1	3	1	1	0
ILL-620	59	70	11	1	3	1	1	0
ILL-620	60	61	1	1	3	1	1	0
ILL-620	60	61	1	1	3	1	1	0
ILL-620	60	477	417	0	3	1	0	0
ILL-620	61	477	416	0	3	1	0	1
ILL-620	61	62	1	1	3	3	1	0
ILL-620	62	477	415	0	3	1	0	0
ILL-621	62	67	5	1	3	4	1	0
ILL-621	63	280	217	1	3	1	1	2
ILL-621	64	167	103	1	2	1	1	1
ILL-621	64	68	4	1	3	3	1	0
ILL-621	64	477	413	0	3	1	0	0
ILL-621	64	477	413	0	3	1	1	0
ILL-621	64	67	3	1	1	1	1	0
ILL-621	65	68	3	1	3	1	1	0
ILL-621	65	66	1	1	3	3	1	0
ILL-621	65	477	412	0	3	4	0	1
ILL-622	66	477	411	0	3	1	0	0
ILL-622	66	126	60	1	4	1	0	1
ILL-622	66	315	249	1	3	4	0	1
ILL-622	66	477	411	0	3	4	0	1
ILL-622	66	84	18	1	3	1	1	1
ILL-622	67	477	410	0	4	3	0	0
ILL-622	67	68	1	1	3	1	1	0
ILL-622	67	477	410	0	3	5	0	0
ILL-622	67	477	410	0	3	1	0	2
ILL-622	67	477	410	0	3	1	0	0
ILL-623	69	96	27	1	3	4	1	0
ILL-623	70	84	14	1	2	4	1	0
ILL-623	70	477	407	0	2	1	0	1
ILL-623	70	477	407	0	3	1	0	1
ILL-623	70	89	19	1	3	4	1	0
ILL-623	70	477	407	0	2	1	0	0
ILL-623	71	154	83	1	3	4	1	2
ILL-623	71	84	13	1	4	3	1	1
ILL-623	71	477	406	0	3	2	0	4
ILL-623	72	84	12	1	3	4	1	0
ILL-624	72	477	405	0	4	4	0	0
ILL-624	72	78	6	1	3	1	1	0
ILL-624	72	131	59	1	3	1	1	3
ILL-624	72	84	12	1	4	4	1	0
ILL-624	72	477	405	0	4	4	0	0
ILL-624	72	477	405	0	4	1	1	0
ILL-624	72	318	246	1	3	1	1	1
ILL-624	72	477	405	0	3	1	0	0
ILL-624	72	84	12	1	4	4	1	0
ILL-624	72	130	58	1	3	4	1	0
ILL-625	73	78	5	1	3	1	1	1
ILL-625	73	477	404	0	3	1	0	0
ILL-625	73	107	34	1	3	1	1	3
ILL-625	73	477	404	0	3	4	1	1
ILL-625	73	88	15	1	3	1	1	0
ILL-625	73	137	64	1	3	1	1	0
ILL-625	74	88	14	1	3	1	1	0
ILL-625	74	75	1	1	3	1	0	0
ILL-625	74	477	403	0	3	4	1	2
ILL-625	74	89	15	1	3	4	1	0
ILL-626	74	425	351	1	3	1	1	0
ILL-626	74	81	7	1	3	1	0	1
ILL-626	75	84	9	1	3	1	1	0
ILL-626	75	477	402	0	4	4	0	0
ILL-626	75	477	402	0	4	1	0	0
ILL-626	75	477	402	0	4	1	0	0
ILL-626	75	477	402	0	4	1	0	0
ILL-626	75	477	402	0	4	4	0	0
ILL-626	75	477	402	0	3	1	0	0
ILL-626	75	477	402	0	4	4	0	0
ILL-627	77	118	41	1	3	3	1	0
ILL-627	77	96	19	1	3	3	1	0
ILL-627	77	131	54	1	2	3	1	0
ILL-627	77	103	26	1	2	3	1	0
ILL-627	77	151	74	1	3	1	1	0
ILL-627	77	87	10	1	4	1	1	0
ILL-627	77	477	400	0	3	1	0	0
ILL-627	78	105	27	1	3	1	1	2
ILL-627	78	88	10	1	3	1	1	0
ILL-627	78	96	18	1	3	4	1	2
ILL-628	78	84	6	1	4	4	0	0
ILL-628	78	124	46	1	3	5	1	0
ILL-628	79	118	39	1	3	1	1	0
ILL-628	79	84	5	1	3	1	1	0
ILL-628	79	96	17	1	2	4	1	1
ILL-628	79	477	398	0	4	1	0	0
ILL-628	80	118	38	1	3	1	1	2
ILL-628	80	96	16	1	4	1	1	1
ILL-628	80	84	4	1	3	3	1	1
ILL-628	81	112	31	1	3	4	1	4
ILL-629	81	84	3	1	4	3	1	0
ILL-629	81	477	396	0	3	1	1	0
ILL-629	81	477	396	0	3	4	0	0
ILL-629	84	157	73	1	3	1	0	3
ILL-629	85	103	18	1	3	3	1	3
ILL-629	86	107	21	1	2	1	1	1
ILL-629	86	96	10	1	3	4	1	1
ILL-629	86	477	391	0	3	4	0	0
ILL-629	86	151	65	1	3	1	1	0
ILL-629	86	88	2	1	3	1	1	1
ILL-630	87	88	1	1	3	3	1	0
ILL-630	87	126	39	1	3	3	1	0
ILL-630	88	118	30	1	3	1	1	1
ILL-630	88	96	8	1	5	4	1	0
ILL-630	90	477	387	0	4	4	0	0
ILL-630	90	477	387	0	4	4	0	0
ILL-630	91	477	386	0	3	1	0	0
ILL-630	92	118	26	1	3	1	1	0
ILL-630	93	477	384	0	3	1	0	0
ILL-630	94	477	383	0	4	2	0	0
ILL-631	94	182	88	1	3	4	1	2
ILL-631	94	103	9	1	3	1	1	0
ILL-631	96	477	381	0	3	2	0	0
ILL-631	97	477	380	0	3	1	0	0
ILL-631	97	477	380	0	3	4	0	0
ILL-631	98	226	128	1	3	5	1	1
ILL-631	98	477	379	0	3	1	0	0
ILL-631	99	477	378	0	4	4	0	0
ILL-631	99	124	25	1	3	1	1	0
ILL-631	99	477	378	0	3	4	0	0
ILL-632	99	106	7	1	3	4	1	0
ILL-632	99	130	31	1	3	3	1	1
ILL-632	99	134	35	1	3	3	0	1
ILL-632	99	134	35	1	3	3	1	1
ILL-632	99	112	13	1	3	3	0	1
ILL-632	100	477	377	0	3	1	0	0
ILL-632	101	477	376	0	3	1	0	0
ILL-632	101	118	17	1	3	3	0	1
ILL-632	102	118	16	1	3	3	1	0
ILL-632	102	477	375	0	2	1	0	0
ILL-633	103	104	1	1	3	1	0	0
ILL-633	105	116	11	1	3	4	1	0
ILL-633	105	477	372	0	3	4	0	0
ILL-633	105	112	7	1	4	4	1	1
ILL-633	106	112	6	1	5	4	1	0
ILL-633	106	118	12	1	3	4	1	0
ILL-633	106	133	27	1	3	4	0	0
ILL-633	106	477	371	0	3	1	0	0
ILL-633	106	112	6	1	3	1	1	0
ILL-633	106	112	6	1	4	4	1	0
ILL-634	106	172	66	1	3	4	1	1
ILL-634	107	118	11	1	3	1	1	0
ILL-634	108	116	8	1	3	1	1	0
ILL-634	108	154	46	1	3	1	1	0
ILL-634	108	109	1	1	3	4	0	0
ILL-634	109	118	9	1	3	4	1	0
ILL-634	109	193	84	1	3	4	1	0
ILL-634	110	124	14	1	3	4	1	0
ILL-634	112	138	26	1	3	4	1	0
ILL-634	112	329	217	1	3	1	1	2
ILL-635	113	477	364	0	3	4	0	4
ILL-635	113	119	6	1	1	1	1	1
ILL-635	113	120	7	1	3	1	0	0
ILL-635	114	164	50	1	3	3	1	2
ILL-635	114	477	363	0	4	1	0	0
ILL-635	114	477	363	0	3	1	0	1
ILL-635	114	149	35	1	3	4	1	1
ILL-635	115	477	362	0	3	1	0	0
ILL-635	115	477	362	0	3	1	0	0
ILL-635	115	477	362	0	3	1	0	0
ILL-636	116	477	361	0	4	3	0	0
ILL-636	116	125	9	1	4	4	1	0
ILL-636	116	477	361	0	3	4	0	0
ILL-636	116	132	16	1	3	3	1	0
ILL-636	116	130	14	1	3	1	1	0
ILL-636	117	477	360	0	3	1	0	0
ILL-636	117	477	360	0	3	1	0	0
ILL-636	118	477	359	0	5	1	0	0
ILL-636	118	477	359	0	4	1	0	0
ILL-636	118	425	307	1	4	1	1	0
ILL-637	118	477	359	0	4	1	0	0
ILL-637	118	477	359	0	4	4	1	3
ILL-637	119	477	358	0	3	1	0	0
ILL-637	120	214	94	1	3	4	0	0
ILL-637	120	142	22	1	2	1	1	2
ILL-637	121	157	36	1	3	2	1	0
ILL-637	121	477	356	0	4	1	0	0
ILL-637	121	456	335	1	4	1	1	0
ILL-637	121	123	2	1	3	1	0	1
ILL-637	121	477	356	0	3	4	1	1
ILL-638	121	124	3	1	3	1	1	0
ILL-638	122	298	176	1	3	2	1	1
ILL-638	122	477	355	0	3	4	0	0
ILL-638	122	477	355	0	4	1	0	0
ILL-638	123	124	1	1	2	1	0	1
ILL-638	126	234	108	1	3	2	1	2
ILL-638	126	133	7	1	3	4	0	0
ILL-638	126	135	9	1	3	1	1	0
ILL-638	126	477	351	0	3	4	0	0
ILL-638	126	156	30	1	3	4	1	0
ILL-639	127	477	350	0	3	1	0	0
ILL-639	127	477	350	0	3	1	0	0
ILL-639	127	477	350	0	3	4	0	0
ILL-639	127	177	50	1	3	1	1	0
ILL-639	128	477	349	0	3	4	0	0
ILL-639	128	477	349	0	3	1	0	0
ILL-639	128	477	349	0	3	4	0	0
ILL-639	128	477	349	0	3	4	0	0
ILL-639	128	477	349	0	3	4	0	0
ILL-639	128	477	349	0	3	4	0	0
ILL-640	128	477	349	0	4	4	1	0
ILL-640	129	130	1	1	3	1	1	0
ILL-640	129	149	20	1	3	1	1	0
ILL-640	129	477	348	0	3	4	0	0
ILL-640	129	136	7	1	3	4	0	0
ILL-640	129	477	348	0	3	4	0	0
ILL-640	130	477	347	0	3	1	0	1
ILL-640	130	477	347	0	3	4	0	2
ILL-640	130	477	347	0	3	4	0	1
ILL-640	130	215	85	1	3	1	1	0
ILL-641	130	280	150	1	3	1	1	0
ILL-641	130	136	6	1	3	1	1	1
ILL-641	131	477	346	0	4	1	1	4
ILL-641	133	137	4	1	3	1	1	0
ILL-641	133	477	344	0	3	4	0	0
ILL-641	133	151	18	1	3	1	1	0
ILL-641	133	149	16	1	3	1	1	1
ILL-641	134	191	57	1	3	1	0	2
ILL-641	134	138	4	1	3	4	1	1
ILL-641	134	142	8	1	3	3	1	1
ILL-642	134	137	3	1	3	3	1	1
ILL-642	135	137	2	1	3	3	1	0
ILL-642	135	239	104	1	3	3	1	1
ILL-642	135	138	3	1	3	2	1	0
ILL-642	136	137	1	1	3	4	1	0
ILL-642	136	302	166	1	3	3	1	1
ILL-642	137	138	1	1	3	3	1	0
ILL-642	137	168	31	1	4	1	0	0
ILL-642	137	477	340	0	3	4	0	0
ILL-642	137	477	340	0	3	4	0	0
ILL-643	137	442	305	1	3	4	1	1
ILL-643	138	151	13	1	3	1	1	1
ILL-643	139	156	17	1	4	2	1	0
ILL-643	140	477	337	0	3	1	0	0
ILL-643	140	477	337	0	3	2	0	0
ILL-643	141	143	2	1	3	1	1	3
ILL-643	141	143	2	1	3	4	1	0
ILL-643	141	143	2	1	2	1	1	0
ILL-643	141	156	15	1	3	4	1	0
ILL-643	141	211	70	1	3	1	0	2
ILL-644	141	142	1	1	3	4	1	2
ILL-644	142	477	335	0	3	1	0	0
ILL-644	142	146	4	1	3	1	1	0
ILL-644	142	144	2	1	3	1	1	0
ILL-644	143	477	334	0	4	4	0	1
ILL-644	143	154	11	1	3	3	1	0
ILL-644	144	157	13	1	3	3	1	1
ILL-644	144	178	34	1	3	1	1	1
ILL-644	144	477	333	0	3	1	0	0
ILL-644	145	477	332	0	3	1	0	0
ILL-645	148	155	7	1	3	1	1	0
ILL-645	148	477	329	0	3	2	1	0
ILL-645	149	150	1	1	4	3	0	0
ILL-645	149	224	75	1	1	1	1	0
ILL-645	149	172	23	1	3	2	1	2
ILL-645	149	166	17	1	2	1	1	0
ILL-645	150	154	4	1	3	1	1	1
ILL-645	150	477	327	0	3	4	0	0
ILL-645	150	425	275	1	4	1	1	0
ILL-645	151	161	10	1	2	1	1	0
ILL-646	151	477	326	0	3	2	0	2
ILL-646	151	238	87	1	3	5	1	1
ILL-646	151	238	87	1	3	5	0	1
ILL-646	152	157	5	1	3	1	1	1
ILL-646	154	477	323	0	3	3	0	0
ILL-646	155	477	322	0	4	1	1	1
ILL-646	155	157	2	1	4	4	1	0
ILL-646	155	157	2	1	5	1	1	0
ILL-646	155	166	11	1	3	1	1	0
ILL-646	156	477	321	0	3	4	0	0
ILL-647	156	172	16	1	3	1	1	0
ILL-647	156	193	37	1	3	1	1	1
ILL-647	156	193	37	1	3	1	1	1
ILL-647	156	288	132	1	3	3	1	3
ILL-647	156	164	8	1	3	1	1	0
ILL-647	157	199	42	1	3	1	1	0
ILL-647	157	163	6	1	3	1	1	1
ILL-647	157	163	6	1	3	1	1	1
ILL-647	157	162	5	1	3	1	1	1
ILL-647	157	176	19	1	3	4	1	2
ILL-648	157	477	320	0	4	4	0	0
ILL-648	158	162	4	1	4	3	1	0
ILL-648	158	159	1	1	3	4	0	0
ILL-648	158	477	319	0	3	1	0	0
ILL-648	158	477	319	0	3	5	0	0
ILL-648	161	162	1	1	3	1	1	0
ILL-648	161	172	11	1	3	1	1	0
ILL-648	161	166	5	1	3	1	1	0
ILL-648	161	164	3	1	3	1	1	0
ILL-648	162	163	1	1	3	1	1	0
ILL-649	162	477	315	0	4	3	0	1
ILL-649	162	172	10	1	4	1	1	0
ILL-649	163	238	75	1	3	4	1	0
ILL-649	163	477	314	0	3	4	0	0
ILL-649	163	183	20	1	3	2	1	3
ILL-649	163	477	314	0	3	1	0	0
ILL-649	164	199	35	1	3	1	1	0
ILL-649	164	477	313	0	3	5	0	0
ILL-649	165	178	13	1	3	3	1	2
ILL-649	165	178	13	1	3	1	1	0
ILL-650	165	187	22	1	3	3	1	0
ILL-650	165	477	312	0	3	1	1	0
ILL-650	165	172	7	1	4	4	1	1
ILL-650	165	177	12	1	3	4	1	1
ILL-650	166	477	311	0	3	1	0	1
ILL-650	167	168	1	1	3	4	1	0
ILL-650	167	477	310	0	4	1	0	0
ILL-650	167	477	310	0	4	4	0	0
ILL-650	167	477	310	0	3	4	0	0
ILL-650	167	477	310	0	3	1	0	0
ILL-651	167	477	310	0	4	1	0	0
ILL-651	168	477	309	0	4	1	0	1
ILL-651	168	179	11	1	3	1	1	0
ILL-651	168	172	4	1	3	1	1	0
ILL-651	168	171	3	1	3	1	1	0
ILL-651	168	176	8	1	2	4	1	1
ILL-651	168	192	24	1	3	4	1	3
ILL-651	169	241	72	1	2	1	1	0
ILL-651	170	477	307	0	3	2	1	0
ILL-651	171	189	18	1	3	4	1	0
ILL-652	171	477	306	0	3	1	0	0
ILL-652	171	477	306	0	4	4	0	1
ILL-652	171	477	306	0	3	1	0	0
ILL-652	171	172	1	1	3	1	1	0
ILL-652	171	438	267	1	3	1	1	3
ILL-652	172	477	305	0	3	4	0	0
ILL-652	172	177	5	1	3	3	1	0
ILL-652	172	477	305	0	4	3	1	0
ILL-652	172	477	305	0	3	1	0	1
ILL-652	172	189	17	1	3	1	1	1
ILL-653	172	182	10	1	3	1	1	1
ILL-653	173	177	4	1	4	3	1	0
ILL-653	174	477	303	0	4	2	0	1
ILL-653	174	389	215	1	3	1	1	1
ILL-653	175	184	9	1	4	3	1	3
ILL-653	175	182	7	1	3	1	1	1
ILL-653	175	477	302	0	3	4	0	0
ILL-653	175	182	7	1	3	1	1	0
ILL-653	175	477	302	0	3	1	0	0
ILL-653	176	179	3	1	3	1	1	0
ILL-654	176	477	301	0	3	4	1	4
ILL-654	176	280	104	1	4	3	1	1
ILL-654	176	193	17	1	3	1	1	1
ILL-654	176	477	301	0	3	4	1	0
ILL-654	177	256	79	1	3	4	1	0
ILL-654	177	182	5	1	3	4	1	1
ILL-654	177	184	7	1	3	1	1	1
ILL-654	177	477	300	0	3	1	0	1
ILL-654	177	182	5	1	3	1	1	2
ILL-654	178	189	11	1	3	4	1	1
ILL-655	178	477	299	0	4	5	0	0
ILL-655	178	179	1	1	3	1	1	1
ILL-655	178	477	299	0	3	2	1	4
ILL-655	178	184	6	1	3	1	1	1
ILL-655	178	182	4	1	4	4	1	0
ILL-655	179	477	298	0	3	1	0	0
ILL-655	179	477	298	0	3	4	0	0
ILL-655	179	184	5	1	3	1	1	0
ILL-655	179	477	298	0	3	1	0	2
ILL-655	179	193	14	1	4	3	1	3
ILL-656	179	193	14	1	4	4	1	0
ILL-656	179	182	3	1	3	4	1	0
ILL-656	179	447	268	1	3	4	1	2
ILL-656	179	239	60	1	3	1	1	0
ILL-656	179	477	298	0	4	4	1	2
ILL-656	179	477	298	0	3	1	0	0
ILL-656	179	233	54	1	2	1	1	0
ILL-656	179	324	145	1	2	1	1	0
ILL-656	180	181	1	1	2	1	1	1
ILL-656	180	233	53	1	2	1	1	1
ILL-657	180	183	3	1	3	1	1	0
ILL-657	181	249	68	1	3	1	0	1
ILL-657	182	477	295	0	3	4	0	0
ILL-657	182	477	295	0	3	4	0	0
ILL-657	182	203	21	1	3	4	1	1
ILL-657	182	189	7	1	3	4	1	0
ILL-657	182	183	1	1	3	1	1	0
ILL-657	183	184	1	1	4	4	1	0
ILL-657	183	193	10	1	3	1	1	0
ILL-657	183	193	10	1	3	4	1	0
ILL-658	184	477	293	0	3	3	0	2
ILL-658	185	193	8	1	3	4	1	2
ILL-658	186	418	232	1	3	4	1	0
ILL-658	186	191	5	1	4	1	1	0
ILL-658	188	477	289	0	3	4	0	0
ILL-658	189	477	288	0	3	1	0	0
ILL-658	189	193	4	1	3	4	1	1
ILL-658	189	193	4	1	3	4	1	1
ILL-658	189	194	5	1	3	1	1	0
ILL-658	190	211	21	1	3	1	1	1
ILL-659	191	477	286	0	3	1	0	0
ILL-659	191	193	2	1	3	1	1	0
ILL-659	191	193	2	1	3	1	1	1
ILL-659	191	477	286	0	3	1	1	0
ILL-659	191	193	2	1	3	1	1	0
ILL-659	191	477	286	0	4	1	0	0
ILL-659	192	193	1	1	3	1	1	0
ILL-659	192	477	285	0	3	4	0	0
ILL-659	192	477	285	0	3	4	0	0
ILL-659	192	477	285	0	3	4	0	0
ILL-660	192	477	285	0	3	4	0	0
ILL-660	192	193	1	1	3	4	1	0
ILL-660	192	477	285	0	3	4	1	0
ILL-660	192	199	7	1	1	1	1	1
ILL-660	192	477	285	0	3	4	1	2
ILL-660	192	198	6	1	3	1	0	0
ILL-660	193	201	8	1	1	1	1	2
ILL-660	193	477	284	0	3	1	0	0
ILL-660	193	477	284	0	3	3	0	0
ILL-660	193	477	284	0	3	3	0	0
ILL-661	193	313	120	1	3	4	0	0
ILL-661	194	309	115	1	4	4	1	1
ILL-661	197	198	1	1	3	1	1	0
ILL-661	197	242	45	1	4	4	0	0
ILL-661	197	199	2	1	3	1	1	2
ILL-661	197	477	280	0	3	4	1	0
ILL-661	198	211	13	1	3	4	1	1
ILL-661	198	211	13	1	3	5	1	0
ILL-661	198	211	13	1	3	5	1	0
ILL-661	198	211	13	1	3	5	1	0
ILL-662	199	477	278	0	3	3	0	0
ILL-662	199	477	278	0	3	4	1	1
ILL-662	199	203	4	1	1	1	1	0
ILL-662	200	477	277	0	3	1	1	0
ILL-662	200	201	1	1	3	1	1	0
ILL-662	201	257	56	1	3	1	1	0
ILL-662	202	205	3	1	3	1	1	0
ILL-662	203	204	1	1	3	1	1	1
ILL-662	203	477	274	0	3	4	0	0
ILL-662	203	211	8	1	3	4	1	0
ILL-663	204	262	58	1	4	1	1	0
ILL-663	204	212	8	1	3	1	1	0
ILL-663	204	205	1	1	1	1	1	0
ILL-663	205	238	33	1	3	4	1	0
ILL-663	205	212	7	1	3	3	1	0
ILL-663	205	213	8	1	3	3	1	2
ILL-663	205	213	8	1	3	3	1	2
ILL-663	205	206	1	1	1	1	1	0
ILL-663	205	210	5	1	3	1	1	1
ILL-663	206	210	4	1	3	1	1	3
ILL-664	206	241	35	1	3	4	1	0
ILL-664	207	210	3	1	3	1	1	0
ILL-664	207	428	221	1	3	3	1	4
ILL-664	207	477	270	0	4	1	1	2
ILL-664	207	238	31	1	3	4	1	0
ILL-664	207	215	8	1	3	4	1	1
ILL-664	207	477	270	0	3	4	0	0
ILL-664	210	238	28	1	3	3	1	1
ILL-664	211	477	266	0	3	1	0	0
ILL-664	211	224	13	1	3	1	1	1
ILL-665	211	212	1	1	3	4	2	0
ILL-665	211	212	1	1	3	1	2	0
ILL-665	211	213	2	1	3	3	0	3
ILL-665	211	215	4	1	3	1	1	1
ILL-665	211	215	4	1	3	1	1	0
ILL-665	211	214	3	1	3	4	1	0
ILL-665	211	224	13	1	3	4	1	1
ILL-665	212	214	2	1	3	1	1	0
ILL-665	212	477	265	0	3	1	0	0
ILL-665	212	477	265	0	3	4	0	0
ILL-666	212	239	27	1	3	5	1	0
ILL-666	213	477	264	0	3	4	0	0
ILL-666	213	229	16	1	3	4	1	0
ILL-666	214	219	5	1	3	1	1	0
ILL-666	214	215	1	1	3	4	1	0
ILL-666	215	477	262	0	3	1	0	0
ILL-666	215	344	129	1	4	1	1	0
ILL-666	215	477	262	0	4	4	0	0
ILL-666	216	329	113	1	4	4	1	4
ILL-666	216	477	261	0	4	4	0	0
ILL-667	217	229	12	1	3	1	1	0
ILL-667	218	224	6	1	3	1	1	0
ILL-667	219	477	258	0	4	1	0	1
ILL-667	219	477	258	0	4	1	0	1
ILL-667	219	220	1	1	3	1	1	1
ILL-667	219	477	258	0	3	4	0	0
ILL-667	220	241	21	1	3	4	1	0
ILL-667	220	477	257	0	3	1	0	0
ILL-667	220	477	257	0	3	4	0	1
ILL-667	221	477	256	0	3	4	1	3
ILL-668	221	226	5	1	3	2	1	0
ILL-668	221	477	256	0	3	2	0	0
ILL-668	221	477	256	0	3	1	0	0
ILL-668	224	477	253	0	3	4	0	0
ILL-668	224	247	23	1	4	4	1	2
ILL-668	224	231	7	1	3	1	1	0
ILL-668	225	477	252	0	3	1	0	0
ILL-668	225	233	8	1	3	4	1	1
ILL-668	225	238	13	1	3	1	1	0
ILL-668	226	229	3	1	4	4	1	0
ILL-669	226	477	251	0	3	1	0	0
ILL-669	227	329	102	1	4	3	1	1
ILL-669	227	477	250	0	4	3	1	0
ILL-669	227	238	11	1	3	1	1	1
ILL-669	227	228	1	1	3	1	1	0
ILL-669	227	477	250	0	3	1	1	1
ILL-669	228	229	1	1	3	1	1	1
ILL-669	228	477	249	0	4	4	1	2
ILL-669	229	477	248	0	3	4	0	0
ILL-669	231	477	246	0	3	2	0	0
ILL-670	231	477	246	0	3	1	0	1
ILL-670	231	477	246	0	3	1	0	0
ILL-670	231	247	16	1	4	4	1	0
ILL-670	233	238	5	1	3	1	1	0
ILL-670	233	477	244	0	4	1	0	0
ILL-670	234	251	17	1	3	1	1	0
ILL-670	234	241	7	1	2	1	1	0
ILL-670	234	438	204	1	3	1	1	0
ILL-670	234	477	243	0	3	1	0	0
ILL-670	234	251	17	1	3	1	1	0
ILL-671	234	247	13	1	3	1	1	1
ILL-671	235	248	13	1	3	3	0	0
ILL-671	238	241	3	1	3	1	1	0
ILL-671	238	247	9	1	3	1	1	1
ILL-671	238	477	239	0	2	1	0	0
ILL-671	238	302	64	1	3	4	1	2
ILL-671	239	477	238	0	3	1	0	0
ILL-671	239	313	74	1	3	1	1	2
ILL-671	239	315	76	1	3	1	0	1
ILL-671	239	291	52	1	3	5	1	0
ILL-672	240	477	237	0	2	1	1	0
ILL-672	240	241	1	1	3	1	1	0
ILL-672	240	438	198	1	3	1	1	1
ILL-672	241	477	236	0	3	1	0	1
ILL-672	242	273	31	1	3	4	1	1
ILL-672	243	329	86	1	3	1	0	0
ILL-672	243	251	8	1	3	1	1	0
ILL-672	244	315	71	1	2	4	0	1
ILL-672	246	477	231	0	3	4	1	0
ILL-672	246	251	5	1	3	3	1	1
ILL-673	246	477	231	0	4	1	0	0
ILL-673	248	282	34	1	3	4	1	0
ILL-673	249	256	7	1	2	1	1	2
ILL-673	249	256	7	1	3	1	1	0
ILL-673	249	418	169	1	3	1	1	1
ILL-673	249	320	71	1	3	4	1	2
ILL-673	251	477	226	0	3	4	0	0
ILL-673	252	477	225	0	2	1	0	0
ILL-673	252	477	225	0	3	4	0	0
ILL-673	253	477	224	0	3	3	1	3
ILL-674	254	255	1	1	1	1	0	0
ILL-674	254	434	180	1	3	5	1	1
ILL-674	254	477	223	0	3	5	0	0
ILL-674	256	259	3	1	3	1	0	0
ILL-674	259	319	60	1	3	4	1	0
ILL-674	260	423	163	1	3	4	1	1
ILL-674	261	266	5	1	3	1	1	0
ILL-674	262	263	1	1	3	1	1	0
ILL-674	262	263	1	1	3	1	1	0
ILL-674	263	270	7	1	3	1	1	0
ILL-675	263	264	1	1	3	4	0	0
ILL-675	263	340	77	1	3	3	1	4
ILL-675	263	266	3	1	3	3	1	0
ILL-675	263	266	3	1	3	1	1	0
ILL-675	263	477	214	0	3	4	0	0
ILL-675	263	273	10	1	3	4	1	0
ILL-675	263	477	214	0	3	4	0	0
ILL-675	263	477	214	0	3	4	0	0
ILL-675	264	477	213	0	4	4	1	0
ILL-675	266	280	14	1	4	1	1	0
ILL-676	267	313	46	1	3	1	1	0
ILL-676	267	273	6	1	4	1	0	0
ILL-676	267	280	13	1	2	1	1	2
ILL-676	268	300	32	1	3	4	1	0
ILL-676	270	280	10	1	3	1	1	0
ILL-676	273	280	7	1	4	3	1	0
ILL-676	273	282	9	1	3	1	1	0
ILL-676	275	477	202	0	4	4	1	0
ILL-676	275	305	30	1	3	4	1	2
ILL-676	275	333	58	1	3	1	1	2
ILL-677	275	319	44	1	2	1	1	1
ILL-677	275	301	26	1	2	1	1	0
ILL-677	276	477	201	0	3	4	0	0
ILL-677	277	280	3	1	2	1	1	2
ILL-677	277	477	200	0	3	1	1	2
ILL-677	277	288	11	1	4	1	1	1
ILL-677	277	283	6	1	3	1	1	0
ILL-677	277	288	11	1	3	5	1	0
ILL-677	277	434	157	1	3	5	1	0
ILL-677	277	477	200	0	4	5	1	0
ILL-678	277	403	126	1	3	5	1	0
ILL-678	277	477	200	0	3	5	1	0
ILL-678	277	477	200	0	4	5	1	0
ILL-678	280	288	8	1	2	1	1	0
ILL-678	280	315	35	1	4	4	0	0
ILL-678	280	291	11	1	3	1	1	0
ILL-678	281	477	196	0	3	4	0	0
ILL-678	282	344	62	1	3	1	1	0
ILL-678	282	283	1	1	3	1	1	0
ILL-678	283	434	151	1	3	5	1	0
ILL-679	283	344	61	1	3	3	1	1
ILL-679	284	343	59	1	3	4	1	0
ILL-679	284	332	48	1	3	4	1	2
ILL-679	284	291	7	1	3	1	1	0
ILL-679	286	477	191	0	3	1	1	1
ILL-679	286	291	5	1	3	3	1	0
ILL-679	287	477	190	0	4	1	0	0
ILL-679	288	289	1	1	3	1	1	0
ILL-679	289	318	29	1	3	5	1	0
ILL-679	289	477	188	0	4	4	1	1
ILL-680	289	477	188	0	3	4	2	0
ILL-680	289	477	188	0	3	5	0	0
ILL-680	289	477	188	0	3	5	0	0
ILL-680	289	477	188	0	3	5	0	0
ILL-680	290	295	5	1	3	5	0	0
ILL-680	291	412	121	1	3	1	1	1
ILL-680	291	477	186	0	3	5	1	0
ILL-680	291	477	186	0	3	5	0	0
ILL-680	291	477	186	0	3	5	0	0
ILL-680	295	305	10	1	4	1	1	0
ILL-681	295	305	10	1	3	1	1	0
ILL-681	296	300	4	1	3	1	1	0
ILL-681	296	315	19	1	4	1	0	0
ILL-681	297	477	180	0	3	1	0	0
ILL-681	300	477	177	0	3	4	0	0
ILL-681	301	477	176	0	4	4	1	1
ILL-681	302	320	18	1	3	1	0	1
ILL-681	302	323	21	1	3	4	1	1
ILL-681	302	329	27	1	3	3	1	1
ILL-681	302	304	2	1	4	1	1	0
ILL-682	302	477	175	0	4	2	0	0
ILL-682	303	477	174	0	3	3	0	1
ILL-682	303	304	1	1	3	3	1	1
ILL-682	303	477	174	0	3	1	0	0
ILL-682	303	305	2	1	3	1	1	0
ILL-682	304	477	173	0	3	4	1	1
ILL-682	305	477	172	0	3	4	0	0
ILL-682	305	477	172	0	2	1	0	0
ILL-682	305	329	24	1	1	1	1	0
ILL-682	309	477	168	0	3	2	0	0
ILL-683	309	397	88	1	3	1	1	1
ILL-683	309	329	20	1	3	3	1	0
ILL-683	309	477	168	0	4	4	0	0
ILL-683	309	319	10	1	3	2	1	0
ILL-683	310	329	19	1	3	4	1	2
ILL-683	311	477	166	0	3	2	1	4
ILL-683	311	477	166	0	4	4	1	0
ILL-683	312	313	1	1	5	1	1	0
ILL-683	312	353	41	1	3	1	1	1
ILL-683	312	477	165	0	3	1	1	0
ILL-684	312	313	1	1	4	1	0	0
ILL-684	312	477	165	0	3	4	0	0
ILL-684	313	477	164	0	4	4	0	0
ILL-684	313	319	6	1	4	1	1	0
ILL-684	314	320	6	1	3	1	1	0
ILL-684	316	477	161	0	4	4	1	1
ILL-684	316	432	116	1	4	5	1	0
ILL-684	316	329	13	1	4	4	1	0
ILL-684	316	317	1	1	2	1	1	1
ILL-684	316	422	106	1	3	1	1	2
ILL-685	317	329	12	1	3	1	1	2
ILL-685	317	477	160	0	3	3	0	0
ILL-685	317	444	127	1	3	5	1	1
ILL-685	318	319	1	1	3	1	1	0
ILL-685	318	477	159	0	4	1	1	1
ILL-685	318	414	96	1	3	1	1	0
ILL-685	318	397	79	1	3	1	1	0
ILL-685	318	329	11	1	3	1	1	1
ILL-685	318	329	11	1	3	1	1	0
ILL-685	319	477	158	0	3	1	1	0
ILL-686	319	322	3	1	4	1	0	1
ILL-686	323	324	1	1	1	1	1	0
ILL-686	323	397	74	1	3	3	1	1
ILL-686	323	332	9	1	3	1	1	2
ILL-686	324	330	6	1	4	4	1	0
ILL-686	324	329	5	1	2	1	1	0
ILL-686	325	332	7	1	3	3	1	2
ILL-686	326	332	6	1	4	1	1	0
ILL-686	326	329	3	1	3	3	1	0
ILL-686	326	333	7	1	4	1	1	1
ILL-687	326	329	3	1	3	3	1	1
ILL-687	330	421	91	1	3	1	1	1
ILL-687	330	477	147	0	3	4	0	0
ILL-687	330	477	147	0	3	1	0	0
ILL-687	331	343	12	1	3	1	1	0
ILL-687	332	351	19	1	3	1	1	0
ILL-687	333	342	9	1	3	5	1	0
ILL-687	336	343	7	1	1	1	1	0
ILL-687	336	345	9	1	1	1	1	0
ILL-687	337	368	31	1	3	4	1	0
ILL-688	338	378	40	1	2	4	1	0
ILL-688	338	477	139	0	3	4	0	0
ILL-688	338	340	2	1	1	1	1	0
ILL-688	339	343	4	1	2	1	1	2
ILL-688	339	477	138	0	3	2	0	0
ILL-688	339	477	138	0	3	1	1	1
ILL-688	339	343	4	1	3	1	1	0
ILL-688	340	342	2	1	1	1	1	0
ILL-688	341	368	27	1	4	4	0	0
ILL-688	343	344	1	1	3	5	1	3
ILL-689	343	434	91	1	3	5	1	2
ILL-689	343	477	134	0	3	1	1	0
ILL-689	343	477	134	0	4	5	1	1
ILL-689	343	420	77	1	3	1	1	2
ILL-689	343	368	25	1	3	1	1	0
ILL-689	344	345	1	1	4	3	1	0
ILL-689	344	477	133	0	3	4	1	1
ILL-689	345	375	30	1	3	1	0	1
ILL-689	345	346	1	1	3	4	1	0
ILL-689	345	477	132	0	3	1	1	0
ILL-690	346	351	5	1	1	1	1	2
ILL-690	346	367	21	1	4	4	1	1
ILL-690	346	477	131	0	3	1	0	0
ILL-690	346	378	32	1	3	4	1	1
ILL-690	347	477	130	0	3	1	1	3
ILL-690	347	477	130	0	3	1	0	1
ILL-690	348	369	21	1	3	1	1	0
ILL-690	350	368	18	1	4	3	1	0
ILL-690	350	351	1	1	4	3	0	0
ILL-690	350	477	127	0	4	5	0	0
ILL-691	351	389	38	1	3	4	1	0
ILL-691	351	394	43	1	3	1	1	0
ILL-691	351	353	2	1	1	1	1	1
ILL-691	351	353	2	1	1	1	1	0
ILL-691	353	404	51	1	3	1	1	1
ILL-691	353	354	1	1	1	1	1	0
ILL-691	353	354	1	1	1	1	1	1
ILL-691	353	354	1	1	4	5	1	0
ILL-691	354	375	21	1	4	1	1	0
ILL-691	354	355	1	1	1	1	1	0
ILL-692	354	357	3	1	1	1	1	0
ILL-692	354	368	14	1	3	4	1	2
ILL-692	354	372	18	1	1	1	1	0
ILL-692	354	477	123	0	4	1	1	1
ILL-692	354	477	123	0	3	1	0	0
ILL-692	355	357	2	1	3	1	1	0
ILL-692	357	477	120	0	5	1	1	0
ILL-692	357	425	68	1	4	1	1	0
ILL-692	359	375	16	1	3	1	1	1
ILL-692	359	368	9	1	3	1	1	0
ILL-693	360	364	4	1	4	3	0	0
ILL-693	360	368	8	1	3	1	1	0
ILL-693	360	477	117	0	3	1	0	0
ILL-693	360	373	13	1	3	1	1	2
ILL-693	360	368	8	1	3	1	1	0
ILL-693	361	477	116	0	2	1	0	0
ILL-693	361	368	7	1	3	1	1	0
ILL-693	361	422	61	1	4	1	1	0
ILL-693	362	477	115	0	2	1	1	0
ILL-693	363	373	10	1	2	4	1	0
BBO-	54	78	24	1	3	3	0	0
BBO-1	71	477	406	0	4	2	0	0
BBO-1	71	477	406	0	4	2	0	0
BBO-1	71	241	170	1	4	4	0	0
BBO-1	71	477	406	0	3	4	0	0
BBO-1	71	477	406	0	3	4	0	0
BBO-1	71	477	406	0	3	4	0	0
BBO-1	71	477	406	0	3	4	0	0
BBO-1	71	477	406	0	3	4	0	0
BBO-1	71	477	406	0	3	4	0	0
BBO-1	71	398	327	1	3	4	0	0
BBO-	54	66	12	1	3	3	0	0
BBO-2	71	477	406	0	3	2	0	0
BBO-2	71	477	406	0	3	4	0	0
BBO-2	71	398	327	1	3	4	0	0
BBO-2	71	477	406	0	3	4	0	0
BBO-2	71	477	406	0	3	4	0	0
BBO-2	71	477	406	0	3	4	0	0
BBO-2	71	477	406	0	3	4	0	0
BBO-2	71	477	406	0	3	2	0	0
BBO-2	80	398	318	1	3	3	0	0
BBO-2	83	86	3	1	3	3	0	0
BBO-	54	241	187	1	3	3	0	0
BBO-3	84	477	393	0	3	2	0	0
BBO-3	87	477	390	0	3	2	0	0
BBO-3	296	297	1	1	3	4	0	0
BBO-	64	67	3	1	3	3	0	0
BBO-	66	67	1	1	3	3	0	1
BBO-	66	241	175	1	3	5	0	1
BBO-	66	108	42	1	3	5	0	0
BBO-	66	112	46	1	3	5	0	0
GLE-107	14	477	463	0	4	4	0	0
GLE-107	14	477	463	0	5	1	0	0
GLE-107	23	31	8	1	3	4	1	0
GLE-107	30	31	1	1	5	3	1	0
GLE-107	30	31	1	1	3	4	1	0
GLE-107	31	32	1	1	5	4	1	0
GLE-107	31	32	1	1	4	4	1	0
GLE-108	32	37	5	1	4	4	1	0
GLE-108	35	37	2	1	3	4	1	0
GLE-108	35	37	2	1	3	1	1	0
GLE-108	36	37	1	1	3	4	1	0
GLE-108	37	93	56	1	5	4	1	0
GLE-108	42	477	435	0	3	1	1	0
GLE-108	56	477	421	0	3	1	1	0
GLE-108	56	477	421	0	3	1	1	0
GLE-108	110	316	206	1	3	4	0	0
GLE-108	135	477	342	0	4	1	0	0
GLE-109	139	477	338	0	4	4	0	0
GLE-109	161	477	316	0	3	1	0	0
GLE-109	284	477	193	0	3	1	0	0
GENT-44	28	477	449	0	4	3	0	0
GENT-44	29	30	1	1	3	5	1	0
GENT-44	44	477	433	0	3	3	0	0
GENT-44	57	477	420	0	4	2	0	0
GENT-44	62	477	415	0	5	5	0	0
GENT-44	110	477	367	0	3	3	0	0
GENT-45	153	477	324	0	4	2	0	0
-2	82	477	395	0	4	1	0	0
AIL-17	6	7	1	1	3	2	1	0
AIL-17	65	66	1	1	3	4	1	0
AIL-17	108	109	1	1	3	1	1	0
AIL-17	184	185	1	1	3	1	0	0
AIL-18	196	477	281	0	3	1	0	0
AIL-18	197	477	280	0	4	1	0	0
PIREDB-26	6	7	1	1	3	4	0	0
PIREDB-26	6	15	9	1	4	4	0	0
PIREDB-26	8	291	283	1	5	4	1	0
PIREDB-26	14	15	1	1	3	1	1	0
PIREDB-27	15	130	115	1	4	4	1	0
PIREDB-27	15	291	276	1	3	4	1	0
PIREDB-27	47	291	244	1	4	4	1	0
PIREDB-27	57	291	234	1	4	1	1	0
PIREDB-27	63	130	67	1	3	4	1	0
PIREDB-27	63	276	213	1	3	4	1	0
PIREDB-27	74	130	56	1	3	4	1	0
PIREDB-27	78	276	198	1	4	4	1	0
PIREDB-27	142	276	134	1	3	4	1	0
PIREDB-27	248	254	6	1	4	1	1	1
PIREDB-28	274	276	2	1	4	1	1	0
PIREDB-28	302	477	175	0	4	1	0	0
PIREDB-28	312	477	165	0	4	4	1	0
EC-10	46	477	431	0	5	5	0	0
EC-10	64	477	413	0	3	4	0	0
EC-10	184	477	293	0	3	2	0	0
EC-10	260	477	217	0	3	1	0	0
LCON-231	4	7	3	1	3	1	2	1
LCON-232	4	7	3	1	2	1	2	1
LCON-232	46	51	5	1	3	1	0	0
LCON-232	49	477	428	0	3	1	1	1
LCON-232	50	477	427	0	4	1	1	0
LCON-232	51	56	5	1	3	1	0	0
LCON-232	51	56	5	1	3	1	0	0
LCON-232	53	56	3	1	3	1	1	0
LCON-232	53	63	10	1	3	1	1	0
LCON-232	56	63	7	1	3	4	1	0
LCON-232	61	477	416	0	4	1	1	0
LCON-233	63	64	1	1	3	1	1	0
LCON-233	67	477	410	0	3	1	0	0
LCON-233	71	129	58	1	3	1	0	1
LCON-233	86	106	20	1	3	1	1	0
LCON-233	100	106	6	1	3	1	1	0
LCON-233	106	220	114	1	4	4	0	0
LCON-233	106	220	114	1	4	4	1	0
LCON-233	107	477	370	0	3	1	0	0
LCON-233	126	220	94	1	3	1	1	0
LCON-233	144	220	76	1	3	1	1	0
LCON-234	157	220	63	1	4	3	1	0
LCON-234	207	220	13	1	3	1	1	0
LCON-234	261	477	216	0	4	1	0	0
-23	185	187	2	1	3	4	1	0
-23	185	187	2	1	3	4	1	0
-23	186	189	3	1	3	4	1	0
-23	192	200	8	1	3	1	1	0
-23	196	249	53	1	3	1	1	0
-23	210	477	267	0	3	4	1	0
-23	214	249	35	1	3	4	1	1
-24	216	249	33	1	3	2	1	0
-24	225	477	252	0	3	5	0	1
-24	235	249	14	1	3	4	1	1
-24	250	477	227	0	3	4	1	0
-24	252	477	225	0	3	4	0	0
-24	274	298	24	1	3	1	1	0
-24	274	298	24	1	3	1	1	0
-24	289	477	188	0	3	3	1	0
-24	296	298	2	1	3	4	1	0
-24	296	298	2	1	3	4	1	0
-25	297	309	12	1	3	5	1	0
-25	297	298	1	1	3	1	1	0
-25	305	306	1	1	3	1	1	0
-25	308	309	1	1	3	1	1	0
-25	308	309	1	1	3	4	1	0
-25	308	309	1	1	3	4	1	0
-25	308	477	169	0	3	4	1	0
-25	319	477	158	0	3	1	0	0
-25	324	477	153	0	3	1	1	0
-26	351	368	17	1	4	4	0	0
-26	351	368	17	1	4	4	0	0
DIZ-21	121	122	1	1	3	4	1	0
DIZ-21	133	135	2	1	3	1	1	0
DIZ-21	134	137	3	1	3	1	0	1
DIZ-21	136	137	1	1	3	4	1	0
DIZ-22	183	184	1	1	3	1	1	0
DIZ-22	189	196	7	1	3	3	1	1
DIZ-22	196	205	9	1	3	3	1	1
DIZ-22	234	263	29	1	3	2	1	1
DIZ-22	235	238	3	1	3	1	1	0
DIZ-22	235	236	1	1	4	3	1	0
DIZ-22	236	238	2	1	3	1	1	0
DIZ-22	238	239	1	1	3	3	1	0
DIZ-22	247	248	1	1	4	3	1	0
DIZ-22	247	248	1	1	3	3	1	0
DIZ-23	275	276	1	1	3	3	1	0
DIZ-23	276	277	1	1	3	3	1	0
DIZ-23	280	415	135	1	3	1	2	0
DIZ-23	317	477	160	0	3	4	0	0
DIZ-23	337	338	1	1	3	1	2	0
DIZ-23	344	345	1	1	3	1	1	0
LIX-576	6	7	1	1	1	1	1	0
LIX-576	7	8	1	1	3	1	1	0
LIX-577	9	10	1	1	3	4	0	0
LIX-577	9	10	1	1	3	1	4	1
LIX-577	10	477	467	0	4	1	0	0
LIX-577	15	16	1	1	3	3	1	0
LIX-577	17	477	460	0	4	1	0	0
LIX-577	19	20	1	1	1	1	1	0
LIX-577	21	477	456	0	3	1	0	0
LIX-577	22	23	1	1	3	1	0	0
LIX-577	23	24	1	1	3	4	1	0
LIX-577	23	123	100	1	3	4	1	0
LIX-578	24	115	91	1	1	1	1	2
LIX-578	31	32	1	1	3	1	1	0
LIX-578	31	66	35	1	4	4	1	0
LIX-578	34	477	443	0	3	1	0	0
LIX-578	36	93	57	1	3	3	0	1
LIX-578	36	477	441	0	3	4	0	1
LIX-578	39	265	226	1	4	1	0	0
LIX-578	40	41	1	1	3	1	1	0
LIX-578	43	44	1	1	3	1	0	0
LIX-578	45	51	6	1	3	1	1	0
LIX-579	53	164	111	1	3	4	0	2
LIX-579	53	75	22	1	3	2	1	4
LIX-579	53	70	17	1	3	5	1	0
LIX-579	56	57	1	1	3	4	1	0
LIX-579	61	158	97	1	3	1	1	0
LIX-579	61	477	416	0	3	5	1	0
LIX-579	66	72	6	1	3	5	1	2
LIX-579	66	74	8	1	3	5	1	0
LIX-579	66	70	4	1	3	5	1	1
LIX-579	66	75	9	1	3	1	1	1
LIX-580	66	102	36	1	3	4	1	1
LIX-580	69	477	408	0	3	4	0	0
LIX-580	70	73	3	1	3	1	0	1
LIX-580	70	71	1	1	3	4	1	2
LIX-580	71	72	1	1	3	4	1	3
LIX-580	71	72	1	1	2	1	1	1
LIX-580	72	73	1	1	3	1	1	0
LIX-580	72	73	1	1	5	1	1	0
LIX-580	72	73	1	1	3	4	1	2
LIX-580	72	73	1	1	3	4	1	0
LIX-581	74	75	1	1	3	1	1	0
LIX-581	74	75	1	1	3	5	1	0
LIX-581	78	79	1	1	3	1	3	0
LIX-581	78	79	1	1	4	1	1	0
LIX-581	80	81	1	1	3	1	3	0
LIX-581	80	81	1	1	3	1	3	0
LIX-581	81	92	11	1	3	4	1	1
LIX-581	81	477	396	0	3	4	0	0
LIX-581	85	92	7	1	3	4	1	1
LIX-581	87	88	1	1	3	1	3	0
LIX-582	93	94	1	1	3	3	1	0
LIX-582	93	94	1	1	3	1	1	1
LIX-582	93	94	1	1	3	4	1	2
LIX-582	95	96	1	1	3	4	1	0
LIX-582	102	103	1	1	4	4	1	0
LIX-582	102	103	1	1	4	4	1	0
LIX-582	102	103	1	1	4	4	1	0
LIX-582	102	103	1	1	4	4	1	0
LIX-582	102	168	66	1	3	4	1	2
LIX-582	102	112	10	1	4	4	1	0
LIX-583	102	477	375	0	3	3	1	4
LIX-583	105	106	1	1	3	1	1	0
LIX-583	108	109	1	1	3	1	1	1
LIX-583	108	109	1	1	3	2	1	1
LIX-583	108	109	1	1	3	2	1	1
LIX-583	108	109	1	1	3	2	4	0
LIX-583	108	109	1	1	3	2	4	0
LIX-583	108	109	1	1	3	2	1	0
LIX-583	109	119	10	1	3	4	1	0
LIX-583	109	110	1	1	3	2	1	0
LIX-584	110	477	367	0	3	1	0	0
LIX-584	116	258	142	1	3	3	1	0
LIX-584	116	122	6	1	3	1	0	0
LIX-584	121	122	1	1	3	1	0	0
LIX-584	124	126	2	1	3	1	0	0
LIX-584	127	128	1	1	3	1	1	0
LIX-584	127	128	1	1	3	1	0	0
LIX-584	128	217	89	1	3	1	1	0
LIX-584	128	129	1	1	4	2	0	0
LIX-584	128	477	349	0	4	1	0	0
LIX-585	129	134	5	1	3	1	0	0
LIX-585	131	477	346	0	3	4	0	0
LIX-585	133	477	344	0	4	4	0	0
LIX-585	134	477	343	0	3	4	0	0
LIX-585	136	294	158	1	5	5	1	0
LIX-585	136	137	1	1	3	4	1	1
LIX-585	136	137	1	1	3	4	1	1
LIX-585	136	137	1	1	3	4	3	1
LIX-585	137	213	76	1	3	1	1	1
LIX-585	141	477	336	0	5	1	0	0
LIX-586	142	477	335	0	3	4	1	0
LIX-586	147	477	330	0	3	1	0	0
LIX-586	158	164	6	1	3	2	0	0
LIX-586	161	477	316	0	4	4	0	0
LIX-586	162	189	27	1	3	1	1	0
LIX-586	162	163	1	1	3	1	1	0
LIX-586	162	163	1	1	3	1	1	0
LIX-586	162	163	1	1	3	1	1	0
LIX-586	163	477	314	0	1	5	0	0
LIX-586	164	165	1	1	3	4	1	1
LIX-587	165	166	1	1	3	1	1	0
LIX-587	169	477	308	0	4	1	0	0
LIX-587	175	176	1	1	3	1	1	0
LIX-587	176	177	1	1	3	1	1	0
LIX-587	177	178	1	1	3	1	1	0
LIX-587	179	180	1	1	3	1	1	0
LIX-587	182	184	2	1	3	4	1	1
LIX-587	183	184	1	1	4	4	1	1
LIX-587	183	477	294	0	3	4	1	0
LIX-587	183	355	172	1	3	1	0	0
LIX-588	184	185	1	1	3	2	1	0
LIX-588	184	477	293	0	3	2	1	0
LIX-588	189	190	1	1	3	4	1	0
LIX-588	190	192	2	1	3	4	1	0
LIX-588	192	213	21	1	1	1	1	1
LIX-588	192	193	1	1	3	1	1	0
LIX-588	193	194	1	1	4	1	1	0
LIX-588	193	477	284	0	2	1	0	1
LIX-588	194	477	283	0	3	1	0	0
LIX-588	196	197	1	1	3	1	1	0
LIX-589	201	477	276	0	3	1	0	0
LIX-589	205	206	1	1	3	4	1	0
LIX-589	207	208	1	1	1	1	1	0
LIX-589	211	217	6	1	3	1	1	0
LIX-589	212	477	265	0	3	1	0	0
LIX-589	212	294	82	1	3	4	0	0
LIX-589	213	214	1	1	3	4	3	0
LIX-589	214	231	17	1	3	1	1	0
LIX-589	216	217	1	1	1	1	1	0
LIX-589	217	219	2	1	3	4	1	0
LIX-590	217	232	15	1	3	2	1	0
LIX-590	218	253	35	1	3	4	1	0
LIX-590	219	220	1	1	1	1	1	0
LIX-590	219	220	1	1	3	1	1	0
LIX-590	224	225	1	1	1	1	1	0
LIX-590	224	258	34	1	1	1	1	0
LIX-590	224	225	1	1	3	1	1	0
LIX-590	225	226	1	1	4	1	1	0
LIX-590	226	227	1	1	3	1	1	0
LIX-590	231	253	22	1	3	1	0	0
LIX-591	232	258	26	1	3	1	1	0
LIX-591	232	268	36	1	3	1	1	0
LIX-591	233	235	2	1	4	4	1	0
LIX-591	233	477	244	0	3	5	0	1
LIX-591	233	235	2	1	3	4	1	0
LIX-591	234	477	243	0	3	1	0	0
LIX-591	234	235	1	1	3	4	0	0
LIX-591	235	236	1	1	3	1	1	0
LIX-591	235	254	19	1	3	1	1	0
LIX-591	235	477	242	0	3	1	0	0
LIX-592	238	280	42	1	3	3	1	0
LIX-592	240	258	18	1	3	1	1	0
LIX-592	253	477	224	0	3	1	0	0
LIX-592	255	256	1	1	3	2	1	0
LIX-592	255	477	222	0	3	1	0	1
LIX-592	255	258	3	1	3	4	1	0
LIX-592	255	258	3	1	3	1	1	0
LIX-592	255	258	3	1	3	1	1	0
LIX-592	256	258	2	1	3	4	3	0
LIX-592	258	259	1	1	3	1	1	0
LIX-593	258	259	1	1	3	1	1	0
LIX-593	258	259	1	1	3	4	1	0
LIX-593	260	261	1	1	3	1	1	0
LIX-593	262	263	1	1	3	4	1	0
LIX-593	263	316	53	1	3	1	1	1
LIX-593	263	264	1	1	2	1	0	0
LIX-593	264	265	1	1	2	1	1	0
LIX-593	265	268	3	1	4	4	1	0
LIX-593	265	268	3	1	3	1	0	0
LIX-593	266	268	2	1	4	4	1	0
LIX-594	266	267	1	1	3	1	1	0
LIX-594	266	268	2	1	4	4	1	0
LIX-594	266	267	1	1	3	1	1	0
LIX-594	267	477	210	0	4	4	0	0
LIX-594	267	268	1	1	3	4	3	0
LIX-594	269	270	1	1	3	4	1	0
LIX-594	269	270	1	1	3	1	0	0
LIX-594	273	274	1	1	3	1	1	0
LIX-594	273	274	1	1	3	4	1	0
LIX-594	275	276	1	1	3	1	1	0
LIX-595	276	290	14	1	3	1	1	0
LIX-595	276	277	1	1	4	2	1	0
LIX-595	276	352	76	1	3	2	3	1
LIX-595	278	279	1	1	4	1	0	1
LIX-595	279	477	198	0	2	4	0	0
LIX-595	279	280	1	1	5	1	1	0
LIX-595	280	281	1	1	3	1	1	0
LIX-595	280	281	1	1	4	4	1	0
LIX-595	281	282	1	1	4	1	1	1
LIX-595	282	283	1	1	3	1	1	0
LIX-596	282	283	1	1	5	3	1	0
LIX-596	283	284	1	1	3	2	1	0
LIX-596	283	284	1	1	3	1	1	0
LIX-596	283	386	103	1	3	4	1	0
LIX-596	284	285	1	1	4	1	1	0
LIX-596	288	289	1	1	3	1	0	0
LIX-596	288	291	3	1	3	1	3	0
LIX-596	289	290	1	1	3	4	1	0
LIX-596	289	386	97	1	4	1	1	0
LIX-596	290	291	1	1	3	4	1	1
LIX-597	290	352	62	1	3	4	4	0
LIX-597	294	477	183	0	3	1	1	0
LIX-597	296	477	181	0	3	1	0	0
LIX-597	297	477	180	0	3	1	0	0
LIX-597	298	306	8	1	3	1	1	0
LIX-597	302	477	175	0	1	1	1	0
LIX-597	305	308	3	1	1	1	0	0
LIX-597	306	477	171	0	4	4	0	0
LIX-597	311	312	1	1	2	1	1	0
LIX-597	312	477	165	0	3	4	0	0
LIX-598	315	477	162	0	2	1	0	0
LIX-598	319	477	158	0	4	4	0	0
LIX-598	322	477	155	0	3	1	0	0
LIX-598	323	477	154	0	3	2	0	0
LIX-598	323	477	154	0	3	2	0	0
LIX-598	323	477	154	0	3	4	0	1
LIX-598	324	477	153	0	3	1	0	0
LIX-598	325	333	8	1	3	4	1	0
LIX-598	326	477	151	0	3	4	0	0
LIX-598	329	330	1	1	3	1	1	0
LIX-599	331	332	1	1	3	1	1	0
LIX-599	331	332	1	1	4	5	1	0
LIX-599	331	332	1	1	5	3	1	0
LIX-599	332	477	145	0	3	1	0	0
LIX-599	336	337	1	1	3	1	1	0
LIX-599	336	421	85	1	3	1	3	0
LIX-599	339	352	13	1	4	3	1	0
LIX-599	344	345	1	1	3	1	1	0
LIX-599	345	346	1	1	3	3	0	0
LIX-599	351	352	1	1	3	4	4	0
LIX-600	351	352	1	1	3	4	1	0
LIX-600	351	352	1	1	3	4	1	0
LIX-600	352	353	1	1	3	4	1	0
LIX-600	352	353	1	1	3	4	4	0
LIX-600	352	372	20	1	3	2	1	0
LIX-600	352	368	16	1	3	4	1	0
LIX-600	353	354	1	1	3	1	1	0
LIX-600	354	355	1	1	3	4	4	0
LIX-600	358	434	76	1	3	1	1	0
LIX-600	360	477	117	0	2	1	1	0
LEUPLOAD-29	81	85	4	1	4	5	0	0
LEUPLOAD-29	301	477	176	0	2	1	0	0
LEUPLOAD-29	353	400	47	1	5	4	1	0
NCN-1	84	433	349	1	2	5	0	1
NCN-10	289	477	188	0	3	1	0	0
NCN-10	289	477	188	0	3	1	0	0
NCN-10	311	477	166	0	3	1	0	0
NCN-10	318	477	159	0	3	1	0	0
NCN-10	322	323	1	1	3	1	0	0
NCN-10	346	383	37	1	3	1	0	0
NCN-10	358	477	119	0	4	1	0	0
NCN-10	358	365	7	1	2	1	0	0
NCN-1	90	477	387	0	3	2	0	0
NCN-1	101	477	376	0	1	3	0	0
NCN-1	101	477	376	0	1	3	0	0
NCN-1	101	105	4	1	3	3	0	0
NCN-1	101	105	4	1	3	5	0	0
NCN-1	101	105	4	1	3	5	0	0
NCN-1	101	105	4	1	3	5	0	0
NCN-1	101	105	4	1	3	5	0	0
NCN-1	102	105	3	1	3	5	0	0
NCN-	44	477	433	0	1	3	0	0
NCN-2	102	105	3	1	3	5	0	0
NCN-2	102	105	3	1	3	5	0	0
NCN-2	105	283	178	1	3	1	0	0
NCN-2	105	287	182	1	3	3	0	0
NCN-2	105	477	372	0	3	3	0	0
NCN-2	106	477	371	0	3	4	0	0
NCN-2	107	477	370	0	1	3	0	0
NCN-2	107	477	370	0	3	3	0	0
NCN-2	107	477	370	0	3	4	0	0
NCN-2	125	477	352	0	4	4	0	1
NCN-	45	477	432	0	4	2	0	0
NCN-3	125	477	352	0	4	4	0	0
NCN-3	125	477	352	0	4	3	0	1
NCN-3	125	477	352	0	4	3	0	0
NCN-3	125	477	352	0	4	3	0	0
NCN-3	125	477	352	0	4	5	0	0
NCN-3	125	477	352	0	4	3	0	0
NCN-3	125	477	352	0	4	3	0	0
NCN-3	125	477	352	0	4	2	0	0
NCN-3	125	477	352	0	4	3	0	0
NCN-3	125	477	352	0	4	2	0	0
NCN-	45	477	432	0	4	2	0	0
NCN-4	125	477	352	0	4	2	0	0
NCN-4	125	477	352	0	4	4	0	0
NCN-4	125	477	352	0	4	2	0	0
NCN-4	125	477	352	0	4	4	0	0
NCN-4	125	477	352	0	4	2	0	0
NCN-4	125	477	352	0	4	4	0	0
NCN-4	125	477	352	0	4	4	0	0
NCN-4	125	477	352	0	4	4	0	1
NCN-4	125	477	352	0	4	4	0	2
NCN-4	125	477	352	0	4	1	0	1
NCN-	51	477	426	0	4	2	0	0
NCN-5	125	477	352	0	4	4	0	0
NCN-5	125	477	352	0	4	4	0	0
NCN-5	125	477	352	0	4	4	0	0
NCN-5	125	477	352	0	4	4	0	0
NCN-5	126	477	351	0	4	3	0	0
NCN-5	126	477	351	0	4	4	0	0
NCN-5	126	477	351	0	4	4	0	0
NCN-5	126	477	351	0	4	1	0	0
NCN-5	126	477	351	0	4	2	0	0
NCN-5	126	477	351	0	4	1	0	0
NCN-	64	477	413	0	3	2	0	0
NCN-6	126	477	351	0	4	4	0	0
NCN-6	126	477	351	0	4	4	0	0
NCN-6	126	477	351	0	4	4	0	0
NCN-6	126	477	351	0	4	2	0	0
NCN-6	126	477	351	0	4	4	0	0
NCN-6	126	477	351	0	4	4	0	0
NCN-6	126	477	351	0	4	4	0	0
NCN-6	126	477	351	0	4	4	0	0
NCN-6	126	477	351	0	4	1	0	0
NCN-6	126	477	351	0	4	1	0	0
NCN-	64	477	413	0	3	4	0	0
NCN-7	126	477	351	0	4	1	0	0
NCN-7	126	477	351	0	4	1	0	0
NCN-7	126	477	351	0	4	1	0	0
NCN-7	126	477	351	0	4	4	0	0
NCN-7	126	477	351	0	4	1	0	0
NCN-7	144	477	333	0	1	3	0	0
NCN-7	245	246	1	1	3	5	0	0
NCN-7	245	247	2	1	3	5	0	0
NCN-7	245	249	4	1	3	5	0	0
NCN-7	245	248	3	1	3	5	0	0
NCN-	64	477	413	0	3	2	0	0
NCN-8	245	249	4	1	3	5	0	0
NCN-8	245	248	3	1	3	5	0	0
NCN-8	245	248	3	1	3	5	0	0
NCN-8	245	248	3	1	3	5	0	0
NCN-8	245	366	121	1	3	5	0	0
NCN-8	248	273	25	1	3	5	0	0
NCN-8	248	273	25	1	3	5	0	0
NCN-8	256	290	34	1	3	1	0	0
NCN-8	256	283	27	1	3	1	0	0
NCN-8	264	269	5	1	3	1	0	0
NCN-	81	477	396	0	4	2	0	0
NCN-9	264	477	213	0	4	1	0	0
NCN-9	264	269	5	1	3	1	0	0
NCN-9	267	268	1	1	3	1	0	0
NCN-9	267	477	210	0	3	1	0	0
NCN-9	267	269	2	1	3	1	0	0
NCN-9	267	297	30	1	4	1	0	0
NCN-9	283	477	194	0	3	1	0	0
NCN-9	284	383	99	1	3	1	0	0
NCN-9	286	287	1	1	3	1	0	0
NCN-9	288	289	1	1	3	1	0	0
NERACT-59	3	477	474	0	3	1	1	0
NERACT-59	15	477	462	0	4	4	1	0
NERACT-59	15	280	265	1	4	4	1	0
NERACT-59	23	477	454	0	3	4	1	0
NERACT-59	36	477	441	0	4	5	0	0
NERACT-59	36	107	71	1	4	1	0	0
NERACT-60	36	340	304	1	3	1	0	0
NERACT-60	36	37	1	1	4	1	1	0
NERACT-60	43	323	280	1	1	1	0	0
NERACT-60	60	477	417	0	3	2	1	0
NERACT-60	60	276	216	1	3	4	1	0
NERACT-60	66	375	309	1	3	1	1	0
NERACT-60	67	319	252	1	3	1	0	0
NERACT-60	82	477	395	0	3	4	0	0
NERACT-60	85	477	392	0	2	1	1	0
NERACT-60	87	477	390	0	3	1	0	0
NERACT-61	92	323	231	1	4	4	0	0
NERACT-61	94	310	216	1	1	1	1	0
NERACT-61	95	477	382	0	3	1	0	0
NERACT-61	99	331	232	1	1	1	1	0
NERACT-61	101	477	376	0	4	4	1	0
NERACT-61	105	477	372	0	2	1	1	0
NERACT-61	108	352	244	1	2	1	1	0
NERACT-61	108	323	215	1	1	1	0	1
NERACT-61	108	333	225	1	4	4	1	0
NERACT-61	111	323	212	1	2	1	0	1
NERACT-62	113	323	210	1	1	1	0	0
NERACT-62	113	198	85	1	2	1	1	0
NERACT-62	119	199	80	1	3	1	0	0
NERACT-62	119	323	204	1	3	4	1	0
NERACT-62	121	319	198	1	2	1	0	0
NERACT-62	130	477	347	0	3	1	0	0
NERACT-62	134	477	343	0	3	2	1	0
NERACT-62	134	319	185	1	3	2	1	0
NERACT-62	144	330	186	1	3	2	1	0
NERACT-62	150	477	327	0	3	4	0	0
NERACT-63	157	326	169	1	3	4	1	0
NERACT-63	158	477	319	0	3	4	0	0
NERACT-63	164	336	172	1	4	4	1	0
NERACT-63	169	477	308	0	4	4	1	0
NERACT-63	170	477	307	0	3	1	0	0
NERACT-63	172	319	147	1	1	1	0	0
NERACT-63	172	477	305	0	3	4	0	0
NERACT-63	174	366	192	1	3	2	1	0
NERACT-63	183	477	294	0	3	2	1	0
NERACT-63	184	477	293	0	4	3	0	0
NERACT-64	185	323	138	1	1	1	0	0
NERACT-64	204	477	273	0	3	4	1	0
NERACT-64	206	477	271	0	4	4	0	0
NERACT-64	211	477	266	0	3	4	1	0
NERACT-64	218	477	259	0	3	4	0	0
NERACT-64	221	312	91	1	3	1	1	0
NERACT-64	233	421	188	1	3	2	1	0
NERACT-64	240	477	237	0	3	4	1	0
NERACT-64	241	323	82	1	2	1	0	0
NERACT-64	242	477	235	0	3	4	0	0
NERACT-65	243	477	234	0	3	1	0	0
NERACT-65	249	294	45	1	3	1	1	0
NERACT-65	249	477	228	0	2	1	1	0
NERACT-65	253	330	77	1	3	1	0	0
NERACT-65	266	319	53	1	3	1	0	0
NERACT-65	276	316	40	1	1	1	1	0
NERACT-65	282	316	34	1	2	1	1	0
NERACT-65	284	477	193	0	3	4	0	0
NERACT-65	297	298	1	1	1	1	1	0
NERACT-65	305	315	10	1	3	1	1	0
NERACT-66	309	477	168	0	3	1	0	0
NERACT-66	309	477	168	0	3	1	0	0
NERACT-66	311	316	5	1	3	1	1	0
NERACT-66	318	323	5	1	3	1	0	0
NERACT-66	318	323	5	1	1	1	0	0
NERACT-66	318	338	20	1	3	1	1	0
NERACT-66	322	477	155	0	3	1	0	0
NERACT-66	323	324	1	1	3	4	1	1
NERACT-66	331	344	13	1	2	1	1	0
NERACT-66	332	364	32	1	3	1	1	0
NERACT-67	337	477	140	0	3	4	1	0
NERACT-67	343	359	16	1	3	1	1	0
NERACT-67	344	477	133	0	3	5	1	0
NERACT-67	344	477	133	0	3	5	1	0
NERACT-67	344	477	133	0	3	5	1	0
NERACT-67	344	477	133	0	3	5	1	0
NERACT-67	344	477	133	0	3	5	1	0
NERACT-67	345	477	132	0	3	1	1	0
NERACT-67	350	477	127	0	3	4	0	0
NERACT-67	350	477	127	0	3	2	0	0
NERACT-68	352	364	12	1	3	1	1	0
NERACT-68	361	364	3	1	5	4	1	0
AGON-27	8	477	469	0	3	3	1	0
AGON-27	8	477	469	0	3	3	1	0
AGON-27	8	477	469	0	3	3	1	0
AGON-27	21	477	456	0	3	2	1	0
AGON-27	21	477	456	0	3	2	1	0
AGON-28	21	22	1	1	3	2	1	0
AGON-28	25	26	1	1	1	1	0	0
AGON-28	25	107	82	1	3	4	1	0
AGON-28	36	477	441	0	3	4	1	0
AGON-28	37	477	440	0	4	5	1	0
AGON-28	51	477	426	0	4	3	1	0
AGON-28	51	105	54	1	2	3	1	0
AGON-28	51	102	51	1	3	1	1	0
AGON-28	70	71	1	1	3	1	1	0
AGON-28	105	477	372	0	3	3	1	0
AGON-29	105	477	372	0	3	5	1	0
AGON-29	105	477	372	0	3	3	1	0
AGON-29	105	477	372	0	2	1	1	0
AGON-29	107	477	370	0	3	5	1	0
AGON-29	108	477	369	0	3	3	1	0
AGON-29	116	477	361	0	3	2	1	0
AGON-29	116	477	361	0	3	2	1	0
AGON-29	116	477	361	0	3	2	0	0
AGON-29	119	477	358	0	3	2	1	0
AGON-29	119	477	358	0	3	2	1	0
AGON-30	119	477	358	0	3	2	1	0
AGON-30	119	477	358	0	3	5	1	0
AGON-30	137	477	340	0	3	4	0	0
AGON-30	240	477	237	0	3	4	1	0
AGON-30	240	477	237	0	2	4	1	0
AGON-30	295	296	1	1	3	3	0	0
AGON-30	295	296	1	1	3	3	0	0
AGON-30	295	477	182	0	3	3	0	0
AGON-30	296	477	181	0	3	3	0	0
AGON-31	296	477	181	0	3	3	0	0
AGON-31	296	477	181	0	3	3	0	0
AGON-31	296	353	57	1	3	3	0	0
AGON-31	329	330	1	1	3	5	0	1
AGON-31	330	477	147	0	3	1	0	0
AGON-31	330	353	23	1	3	5	0	1
AGON-31	356	477	121	0	4	1	0	0
EX-3537	17	21	4	1	3	1	1	0
EX-3537	18	477	459	0	3	1	0	0
EX-3537	21	477	456	0	3	3	1	0
EX-3537	22	477	455	0	3	1	0	0
EX-3537	30	477	447	0	3	1	0	0
EX-3538	44	477	433	0	4	4	0	0
EX-3538	77	99	22	1	1	1	1	0
EX-3538	80	477	397	0	3	1	0	0
EX-3538	92	477	385	0	3	1	0	0
EX-3538	113	477	364	0	3	1	0	0
EX-3538	113	477	364	0	3	1	0	0
EX-3538	113	477	364	0	3	1	0	0
EX-3538	113	477	364	0	3	1	0	0
EX-3538	161	165	4	1	3	1	1	0
EX-3538	183	477	294	0	3	3	0	0
EX-3539	184	196	12	1	3	1	1	0
EX-3539	189	477	288	0	2	1	0	0
EX-3539	231	245	14	1	3	1	0	0
EX-3539	259	260	1	1	3	1	0	0
EX-3539	268	477	209	0	3	1	0	0
EX-3539	315	324	9	1	2	1	0	0
EX-3539	347	477	130	0	1	1	0	0
INK-1000	211	261	50	1	4	4	0	0
INK-1000	211	228	17	1	3	4	2	0
INK-1000	211	477	266	0	3	4	0	1
INK-1000	211	477	266	0	3	4	0	0
INK-1000	211	212	1	1	3	1	0	1
INK-1000	211	212	1	1	1	1	1	0
INK-1000	211	224	13	1	3	4	3	0
INK-1000	211	477	266	0	2	1	0	0
INK-1000	211	477	266	0	3	4	0	0
INK-1000	211	330	119	1	3	1	1	0
INK-1001	211	324	113	1	3	4	1	0
INK-1001	211	254	43	1	1	1	4	4
INK-1001	212	477	265	0	3	5	0	0
INK-1001	212	213	1	1	1	1	1	0
INK-1001	212	477	265	0	3	4	0	0
INK-1001	212	477	265	0	3	4	0	0
INK-1001	212	213	1	1	3	4	2	0
INK-1001	212	477	265	0	3	5	0	0
INK-1001	212	477	265	0	3	2	0	0
INK-1001	212	477	265	0	3	1	0	3
INK-1002	212	228	16	1	3	4	2	0
INK-1002	213	214	1	1	3	1	1	0
INK-1002	213	227	14	1	3	2	3	0
INK-1002	213	477	264	0	4	3	0	0
INK-1002	213	477	264	0	5	5	0	0
INK-1002	213	477	264	0	4	5	0	0
INK-1002	213	477	264	0	3	5	0	0
INK-1002	213	214	1	1	3	5	1	0
INK-1002	213	214	1	1	3	4	1	0
INK-1002	213	217	4	1	3	5	1	0
INK-1003	213	477	264	0	3	1	0	0
INK-1003	213	477	264	0	3	1	0	0
INK-1003	213	477	264	0	3	1	0	2
INK-1003	213	214	1	1	3	1	2	0
INK-1003	213	214	1	1	3	5	0	0
INK-1003	213	325	112	1	3	1	0	2
INK-1003	214	477	263	0	4	1	0	0
INK-1003	214	477	263	0	4	1	0	0
INK-1003	214	477	263	0	3	4	0	0
INK-1003	214	477	263	0	3	1	0	0
INK-1004	214	477	263	0	3	4	0	0
INK-1004	214	221	7	1	3	5	1	0
INK-1004	214	232	18	1	3	5	1	0
INK-1004	214	419	205	1	3	5	1	4
INK-1004	214	418	204	1	3	5	0	1
INK-1004	214	477	263	0	3	5	0	0
INK-1004	214	477	263	0	3	5	0	0
INK-1004	214	477	263	0	2	1	0	0
INK-1004	214	477	263	0	4	4	0	0
INK-1004	214	477	263	0	3	4	0	0
INK-1005	214	324	110	1	3	2	1	0
INK-1005	214	218	4	1	3	1	1	0
INK-1005	214	477	263	0	3	4	0	1
INK-1005	215	477	262	0	3	5	0	0
INK-1005	215	477	262	0	3	5	0	0
INK-1005	215	218	3	1	4	4	1	0
INK-1005	215	226	11	1	3	4	1	0
INK-1005	215	290	75	1	3	4	1	0
INK-1005	216	477	261	0	4	5	0	0
INK-1005	216	231	15	1	4	5	1	0
INK-1006	216	232	16	1	4	5	1	0
INK-1006	216	262	46	1	3	1	0	0
INK-1006	216	217	1	1	3	1	0	0
INK-1006	216	220	4	1	2	1	2	0
INK-1006	216	217	1	1	2	1	1	0
INK-1006	217	270	53	1	3	1	1	0
INK-1006	217	224	7	1	3	4	0	1
INK-1006	217	218	1	1	3	4	0	1
INK-1006	217	231	14	1	3	5	2	0
INK-1006	217	219	2	1	3	2	1	0
INK-1007	217	218	1	1	3	1	2	0
INK-1007	217	218	1	1	3	5	1	0
INK-1007	217	231	14	1	5	1	1	1
INK-1007	217	324	107	1	3	2	1	0
INK-1007	217	344	127	1	3	4	0	1
INK-1007	217	287	70	1	2	4	3	0
INK-1007	217	437	220	1	3	3	1	2
INK-1007	218	477	259	0	3	4	0	0
INK-1007	218	477	259	0	3	4	0	0
INK-1007	218	408	190	1	3	4	2	0
INK-1008	218	477	259	0	3	5	0	0
INK-1008	218	477	259	0	3	4	0	1
INK-1008	218	231	13	1	3	4	3	0
INK-1008	218	430	212	1	3	4	0	0
INK-1008	218	225	7	1	2	5	2	0
INK-1008	218	225	7	1	2	5	2	0
INK-1008	218	219	1	1	3	5	0	0
INK-1008	218	225	7	1	3	5	2	0
INK-1008	218	477	259	0	3	1	0	0
INK-1008	218	225	7	1	3	5	2	0
INK-1009	218	225	7	1	3	5	2	0
INK-1009	218	225	7	1	3	5	2	0
INK-1009	218	225	7	1	3	5	2	0
INK-1009	218	219	1	1	3	5	0	0
INK-1009	218	219	1	1	3	4	2	0
INK-1009	218	219	1	1	3	4	1	1
INK-1009	218	297	79	1	3	1	0	0
INK-1009	218	304	86	1	3	5	2	0
INK-1009	218	477	259	0	3	4	0	0
INK-1009	219	221	2	1	3	4	1	0
INK-1010	219	477	258	0	2	1	0	1
INK-1010	219	227	8	1	3	1	3	0
INK-1010	219	220	1	1	3	4	1	0
INK-1010	219	220	1	1	4	4	0	1
INK-1010	219	423	204	1	3	1	0	0
INK-1010	220	221	1	1	3	1	2	0
INK-1010	220	477	257	0	3	4	0	0
INK-1010	220	477	257	0	3	1	0	0
INK-1010	220	221	1	1	4	1	0	0
INK-1010	220	225	5	1	3	5	2	0
INK-1011	220	226	6	1	3	4	2	0
INK-1011	220	269	49	1	2	1	0	1
INK-1011	220	221	1	1	2	1	0	0
INK-1011	220	477	257	0	3	4	0	0
INK-1011	220	477	257	0	3	5	0	0
INK-1011	220	245	25	1	3	1	3	0
INK-1011	220	227	7	1	3	1	4	0
INK-1011	220	477	257	0	3	4	0	0
INK-1011	220	477	257	0	3	4	0	0
INK-1011	221	477	256	0	3	1	0	0
INK-1012	221	242	21	1	4	4	1	1
INK-1012	221	477	256	0	3	4	0	0
INK-1012	221	477	256	0	3	4	0	0
INK-1012	221	226	5	1	3	4	1	0
INK-1012	221	222	1	1	3	5	1	0
INK-1012	221	247	26	1	4	1	0	0
INK-1012	223	477	254	0	4	4	0	0
INK-1012	223	232	9	1	4	4	1	0
INK-1012	224	225	1	1	4	1	0	0
INK-1012	224	256	32	1	1	1	0	1
INK-1013	224	477	253	0	3	1	0	0
INK-1013	224	252	28	1	3	4	3	0
INK-1013	224	446	222	1	3	4	0	2
INK-1013	224	295	71	1	3	1	1	0
INK-1013	224	477	253	0	2	1	0	0
INK-1013	224	287	63	1	2	1	3	1
INK-1013	225	236	11	1	4	5	1	0
INK-1013	225	240	15	1	3	4	3	0
INK-1013	225	324	99	1	1	1	0	2
INK-1013	225	231	6	1	3	5	1	1
INK-1014	225	477	252	0	3	1	0	0
INK-1014	225	241	16	1	3	1	3	1
INK-1014	225	324	99	1	3	4	3	1
INK-1014	225	477	252	0	3	1	0	1
INK-1014	225	318	93	1	5	4	1	0
INK-1014	225	269	44	1	3	5	1	0
INK-1014	226	477	251	0	3	1	0	0
INK-1014	226	477	251	0	4	1	0	0
INK-1014	226	477	251	0	4	1	0	0
INK-1014	226	336	110	1	4	1	3	1
INK-1015	226	247	21	1	1	1	3	1
INK-1015	226	232	6	1	3	1	2	0
INK-1015	226	477	251	0	3	5	0	0
INK-1015	226	235	9	1	3	4	1	0
INK-1015	226	227	1	1	4	1	2	0
INK-1015	226	477	251	0	3	1	0	0
INK-1015	226	284	58	1	3	4	1	0
INK-1015	227	263	36	1	4	1	2	1
INK-1015	227	232	5	1	3	4	0	0
INK-1015	227	228	1	1	2	1	1	0
INK-1016	227	228	1	1	3	1	0	1
INK-1016	227	228	1	1	3	2	0	0
INK-1016	227	477	250	0	3	4	0	0
INK-1016	227	239	12	1	3	2	1	0
INK-1016	227	233	6	1	3	4	2	0
INK-1016	228	477	249	0	3	4	0	0
INK-1016	228	303	75	1	1	1	3	1
INK-1016	229	477	248	0	3	1	0	0
INK-1016	229	477	248	0	3	4	0	0
INK-1016	230	231	1	1	3	1	2	0
INK-1017	230	253	23	1	3	4	2	1
INK-1017	230	477	247	0	3	4	0	0
INK-1017	230	324	94	1	3	1	4	0
INK-1017	231	477	246	0	3	1	0	0
INK-1017	231	249	18	1	3	1	1	0
INK-1017	231	233	2	1	2	1	1	3
INK-1017	231	233	2	1	3	4	0	0
INK-1017	231	477	246	0	3	4	0	0
INK-1017	231	232	1	1	4	1	0	0
INK-1017	231	477	246	0	3	5	0	0
INK-1018	231	477	246	0	3	5	0	0
INK-1018	231	232	1	1	3	4	1	0
INK-1018	231	477	246	0	3	1	0	0
INK-1018	231	477	246	0	3	1	0	0
INK-1018	231	269	38	1	1	1	0	2
INK-1018	231	254	23	1	3	4	4	0
INK-1018	232	245	13	1	3	4	1	0
INK-1018	232	233	1	1	3	1	1	0
INK-1018	232	394	162	1	3	1	0	0
INK-1018	232	240	8	1	3	1	1	0
INK-1019	232	477	245	0	3	1	0	0
INK-1019	232	324	92	1	2	1	0	0
INK-1019	232	239	7	1	3	1	2	0
INK-1019	232	249	17	1	2	1	3	1
INK-1019	232	477	245	0	4	1	0	0
INK-1019	233	477	244	0	3	1	0	0
INK-1019	233	477	244	0	3	2	0	0
INK-1019	233	234	1	1	3	1	0	0
INK-1019	233	477	244	0	3	4	0	0
INK-1019	233	477	244	0	3	1	0	0
INK-1020	233	477	244	0	3	4	0	0
INK-1020	234	236	2	1	4	5	1	0
INK-1020	234	237	3	1	3	4	0	0
INK-1020	234	477	243	0	3	1	0	0
INK-1020	234	238	4	1	3	1	3	0
INK-1020	235	464	229	1	3	5	1	0
INK-1020	235	477	242	0	3	2	0	0
INK-1020	235	240	5	1	3	5	1	1
INK-1020	235	280	45	1	3	5	1	0
INK-1020	235	273	38	1	3	5	1	0
INK-1021	235	477	242	0	3	1	0	2
INK-1021	235	477	242	0	3	1	0	2
INK-1021	235	477	242	0	3	2	0	0
INK-1021	235	477	242	0	3	1	0	0
INK-1021	236	237	1	1	3	3	0	1
INK-1021	236	259	23	1	4	4	1	0
INK-1021	236	477	241	0	3	5	0	2
INK-1021	236	237	1	1	2	3	0	0
INK-1021	237	238	1	1	4	4	0	0
INK-1021	237	238	1	1	3	3	0	0
INK-1022	238	296	58	1	2	1	1	1
INK-1022	238	239	1	1	4	1	0	0
INK-1022	238	308	70	1	3	1	4	0
INK-1022	238	255	17	1	3	4	3	0
INK-1022	238	477	239	0	3	1	0	0
INK-1022	238	477	239	0	2	1	0	0
INK-1022	238	477	239	0	3	4	0	2
INK-1022	238	281	43	1	3	5	1	0
INK-1022	238	477	239	0	4	4	0	0
INK-1022	239	477	238	0	3	2	0	0
INK-1023	239	477	238	0	3	2	0	0
INK-1023	239	477	238	0	3	5	0	0
INK-1023	239	477	238	0	3	2	0	1
INK-1023	239	240	1	1	3	4	1	0
INK-1023	239	266	27	1	3	5	1	0
INK-1023	239	322	83	1	3	5	1	0
INK-1023	239	477	238	0	3	5	0	0
INK-1023	239	240	1	1	3	4	0	0
INK-1023	239	240	1	1	3	4	0	0
INK-1023	240	477	237	0	4	4	0	0
INK-1024	240	477	237	0	3	2	0	1
INK-1024	240	477	237	0	2	4	1	0
INK-1024	240	297	57	1	3	5	3	0
INK-1024	240	282	42	1	3	5	3	0
INK-1024	240	477	237	0	3	5	0	0
INK-1024	240	477	237	0	3	5	0	1
INK-1024	240	344	104	1	2	4	0	1
INK-1024	240	288	48	1	2	5	1	0
INK-1024	240	477	237	0	3	5	0	0
INK-1024	240	477	237	0	4	4	0	0
INK-1025	240	241	1	1	3	4	0	0
INK-1025	240	388	148	1	3	4	1	0
INK-1025	240	344	104	1	2	5	4	0
INK-1025	240	289	49	1	2	5	1	0
INK-1025	240	248	8	1	3	4	1	0
INK-1025	240	256	16	1	1	1	3	4
INK-1025	240	323	83	1	3	4	0	1
INK-1025	241	477	236	0	2	1	0	0
INK-1025	241	477	236	0	3	1	0	0
INK-1025	241	291	50	1	3	1	3	0
INK-1026	241	263	22	1	3	4	3	0
INK-1026	241	248	7	1	3	1	3	0
INK-1026	241	477	236	0	3	1	0	0
INK-1026	241	268	27	1	3	1	2	0
INK-1026	241	477	236	0	3	1	0	0
INK-1026	241	477	236	0	3	2	0	0
INK-1026	241	477	236	0	2	1	0	0
INK-1026	241	253	12	1	3	1	2	0
INK-1026	241	477	236	0	3	4	0	0
INK-1026	242	255	13	1	1	1	2	1
INK-1027	242	243	1	1	3	4	1	1
INK-1027	242	255	13	1	3	1	0	1
INK-1027	242	477	235	0	4	4	0	0
INK-1027	242	477	235	0	3	1	0	2
INK-1027	242	477	235	0	3	1	0	0
INK-1027	242	291	49	1	3	4	0	0
INK-1027	242	477	235	0	3	2	0	0
INK-1027	245	477	232	0	3	5	0	0
INK-1027	245	246	1	1	3	1	1	0
INK-1027	245	277	32	1	3	3	0	0
INK-1028	247	477	230	0	3	1	0	0
INK-1028	247	254	7	1	3	1	1	0
INK-1028	247	287	40	1	3	4	3	0
INK-1028	247	248	1	1	3	1	2	1
INK-1028	247	477	230	0	3	1	0	0
INK-1028	247	477	230	0	3	5	0	1
INK-1028	247	477	230	0	3	1	0	0
INK-1028	247	477	230	0	3	1	0	0
INK-1028	248	477	229	0	3	4	0	1
INK-1028	248	281	33	1	3	5	1	1
INK-1029	248	477	229	0	3	1	0	0
INK-1029	248	273	25	1	2	4	2	1
INK-1029	248	477	229	0	3	4	1	1
INK-1029	248	249	1	1	3	1	3	0
INK-1029	248	477	229	0	3	4	0	0
INK-1029	248	281	33	1	1	1	1	1
INK-1029	248	477	229	0	4	1	0	0
INK-1029	249	477	228	0	2	1	0	0
INK-1029	249	477	228	0	3	5	0	0
INK-1029	249	336	87	1	4	1	0	0
INK-1030	249	297	48	1	3	1	0	1
INK-1030	249	255	6	1	3	4	3	0
INK-1030	249	263	14	1	4	4	0	0
INK-1030	249	477	228	0	3	4	0	0
INK-1030	249	381	132	1	3	4	0	0
INK-1030	249	477	228	0	3	1	0	0
INK-1030	250	477	227	0	3	4	0	1
INK-1030	251	262	11	1	4	3	0	0
INK-1030	251	477	226	0	4	3	0	0
INK-1030	251	324	73	1	2	1	3	1
INK-1031	252	324	72	1	3	2	1	0
INK-1031	252	271	19	1	2	4	2	0
INK-1031	252	289	37	1	2	4	3	0
INK-1031	252	253	1	1	3	1	0	2
INK-1031	252	256	4	1	1	1	3	0
INK-1031	252	477	225	0	3	4	0	0
INK-1031	252	282	30	1	4	1	3	0
INK-1031	253	477	224	0	3	1	2	2
INK-1031	253	477	224	0	4	4	0	0
INK-1031	254	420	166	1	3	4	0	1
INK-1032	254	477	223	0	3	4	0	0
INK-1032	254	311	57	1	4	5	0	0
INK-1032	254	255	1	1	4	4	0	1
INK-1032	254	255	1	1	3	1	0	0
INK-1032	254	261	7	1	4	5	1	0
INK-1032	254	256	2	1	3	4	2	0
INK-1032	254	373	119	1	4	4	1	0
INK-1032	254	273	19	1	3	2	0	0
INK-1032	254	256	2	1	3	1	3	0
INK-1032	254	256	2	1	3	1	3	0
INK-1033	255	262	7	1	2	1	0	1
INK-1033	255	261	6	1	3	5	3	0
INK-1033	255	261	6	1	3	5	3	0
INK-1033	255	477	222	0	3	1	0	3
INK-1033	255	477	222	0	3	5	0	0
INK-1033	255	477	222	0	3	5	0	3
INK-1033	255	477	222	0	3	5	0	1
INK-1033	255	477	222	0	3	5	0	1
INK-1033	255	477	222	0	3	5	0	1
INK-1033	255	273	18	1	4	4	1	0
INK-1034	255	290	35	1	4	5	1	0
INK-1034	255	261	6	1	3	4	0	0
INK-1034	255	423	168	1	1	1	1	1
INK-1034	255	420	165	1	3	4	0	0
INK-1034	255	477	222	0	3	5	0	0
INK-1034	256	477	221	0	3	1	0	0
INK-1034	256	338	82	1	2	1	0	0
INK-1034	257	477	220	0	3	2	0	0
INK-1034	257	324	67	1	3	4	0	0
INK-1035	257	258	1	1	3	2	0	0
INK-1035	258	306	48	1	3	2	0	0
INK-1035	259	477	218	0	3	4	0	0
INK-1035	259	310	51	1	2	4	2	0
INK-1035	259	324	65	1	3	1	3	1
INK-1035	259	324	65	1	3	4	1	0
INK-1035	259	477	218	0	3	5	0	1
INK-1035	259	307	48	1	2	1	2	2
INK-1035	259	262	3	1	3	1	0	1
INK-1035	259	344	85	1	3	4	3	0
INK-1036	259	477	218	0	3	4	0	0
INK-1036	260	311	51	1	2	1	1	0
INK-1036	260	261	1	1	3	1	1	0
INK-1036	260	261	1	1	2	1	2	0
INK-1036	260	308	48	1	2	1	2	0
INK-1036	260	261	1	1	3	4	1	0
INK-1036	260	261	1	1	3	4	1	1
INK-1036	261	332	71	1	4	5	3	0
INK-1036	261	477	216	0	2	1	2	0
INK-1036	261	265	4	1	4	4	1	0
INK-1037	261	477	216	0	3	1	0	0
INK-1037	261	324	63	1	3	2	2	0
INK-1037	262	477	215	0	4	4	0	0
INK-1037	262	263	1	1	2	4	0	0
INK-1037	262	477	215	0	3	4	1	1
INK-1037	262	263	1	1	4	4	3	0
INK-1037	262	266	4	1	2	1	1	0
INK-1037	262	477	215	0	3	1	0	0
INK-1037	262	269	7	1	3	4	0	0
INK-1037	262	282	20	1	2	1	2	1
INK-1038	262	477	215	0	4	3	0	0
INK-1038	262	477	215	0	3	1	0	0
INK-1038	262	477	215	0	3	1	0	0
INK-1038	262	267	5	1	3	1	2	0
INK-1038	263	310	47	1	4	5	1	0
INK-1038	263	477	214	0	3	4	0	0
INK-1038	263	281	18	1	3	5	1	0
INK-1038	263	477	214	0	4	4	0	0
INK-1038	263	477	214	0	4	5	0	0
INK-1038	263	266	3	1	4	1	1	0
INK-1039	263	289	26	1	4	1	2	0
INK-1039	263	477	214	0	4	1	0	0
INK-1039	264	477	213	0	3	4	0	4
INK-1039	264	269	5	1	3	5	1	0
INK-1039	264	269	5	1	3	5	1	0
INK-1039	264	269	5	1	3	5	1	0
INK-1039	264	270	6	1	3	5	1	0
INK-1039	264	270	6	1	3	5	1	1
INK-1039	265	290	25	1	4	5	1	0
INK-1039	265	281	16	1	3	4	1	0
INK-1040	265	269	4	1	3	1	3	0
INK-1040	265	270	5	1	3	5	1	0
INK-1040	265	270	5	1	3	5	1	0
INK-1040	266	270	4	1	3	5	1	0
INK-1040	266	477	211	0	3	2	0	2
INK-1040	266	288	22	1	3	5	1	0
INK-1040	266	279	13	1	3	5	1	0
INK-1040	266	477	211	0	3	2	0	1
INK-1040	266	477	211	0	3	1	0	0
INK-1040	266	477	211	0	3	1	0	0
INK-1041	266	269	3	1	3	4	1	0
INK-1041	266	270	4	1	4	4	1	1
INK-1041	267	324	57	1	3	4	1	0
INK-1041	267	268	1	1	3	1	0	1
INK-1041	267	273	6	1	3	4	1	0
INK-1041	267	270	3	1	1	1	3	0
INK-1041	267	268	1	1	3	1	1	0
INK-1041	267	273	6	1	3	4	1	0
INK-1041	267	409	142	1	4	5	0	0
INK-1041	267	318	51	1	3	1	3	0
INK-1042	267	477	210	0	4	1	0	0
INK-1042	267	278	11	1	2	1	1	0
INK-1042	267	404	137	1	3	4	1	0
INK-1042	267	291	24	1	3	2	1	0
INK-1042	267	477	210	0	3	1	0	0
INK-1042	267	296	29	1	3	1	2	0
INK-1042	267	283	16	1	3	5	1	0
INK-1042	268	277	9	1	3	5	1	0
INK-1042	268	477	209	0	3	1	0	0
INK-1042	268	477	209	0	3	2	0	4
INK-1043	268	477	209	0	3	5	0	0
INK-1043	268	410	142	1	3	5	0	1
INK-1043	268	477	209	0	3	5	0	1
INK-1043	268	477	209	0	3	5	0	1
INK-1043	268	477	209	0	3	1	0	0
INK-1043	268	477	209	0	3	1	2	0
INK-1043	268	373	105	1	3	4	1	0
INK-1043	268	477	209	0	3	4	0	0
INK-1043	268	477	209	0	3	4	0	0
INK-1043	268	477	209	0	3	1	0	1
INK-1044	268	289	21	1	3	2	1	0
INK-1044	268	477	209	0	4	4	0	0
INK-1044	268	477	209	0	3	4	0	0
INK-1044	268	477	209	0	3	1	0	0
INK-1044	268	269	1	1	3	1	2	0
INK-1044	268	477	209	0	3	1	0	0
INK-1044	268	477	209	0	3	3	0	0
INK-1044	269	446	177	1	3	2	0	0
INK-1044	269	477	208	0	3	1	0	0
INK-1044	269	276	7	1	3	1	0	1
INK-1045	269	274	5	1	3	1	1	0
INK-1045	269	274	5	1	3	1	3	0
INK-1045	269	477	208	0	3	4	0	2
INK-1045	269	280	11	1	3	5	1	0
INK-1045	269	277	8	1	2	1	1	0
INK-1045	269	319	50	1	3	1	3	1
INK-1045	270	276	6	1	3	4	0	0
INK-1045	270	409	139	1	3	2	2	0
INK-1045	270	271	1	1	3	4	1	0
INK-1045	270	276	6	1	3	1	0	1
INK-1046	270	407	137	1	4	4	0	0
INK-1046	271	353	82	1	3	2	1	0
INK-1046	271	477	206	0	4	4	0	0
INK-1046	271	309	38	1	3	1	2	0
INK-1046	271	477	206	0	4	1	0	0
INK-1046	271	281	10	1	2	1	2	0
INK-1046	271	477	206	0	3	1	0	0
INK-1046	272	477	205	0	3	3	0	0
INK-1046	272	279	7	1	4	1	0	0
INK-1046	273	281	8	1	1	1	3	1
INK-1047	273	277	4	1	3	5	1	0
INK-1047	273	416	143	1	3	2	1	1
INK-1047	273	409	136	1	4	5	0	0
INK-1047	273	393	120	1	3	2	1	1
INK-1047	273	288	15	1	3	4	1	0
INK-1047	273	477	204	0	4	1	0	0
INK-1047	274	477	203	0	3	4	0	0
INK-1047	274	477	203	0	4	4	0	0
INK-1047	274	477	203	0	4	1	0	0
INK-1047	274	477	203	0	3	2	0	0
INK-1048	274	275	1	1	3	2	0	0
INK-1048	274	322	48	1	2	1	2	0
INK-1048	274	340	66	1	3	1	4	1
INK-1048	274	276	2	1	3	1	0	0
INK-1048	274	455	181	1	2	1	0	1
INK-1048	275	477	202	0	4	2	0	0
INK-1048	275	477	202	0	4	4	0	0
INK-1048	275	280	5	1	3	1	3	0
INK-1048	276	277	1	1	4	4	0	0
INK-1048	276	477	201	0	3	1	0	0
INK-1049	276	308	32	1	3	5	1	0
INK-1049	276	295	19	1	2	1	3	0
INK-1049	276	477	201	0	3	3	0	0
INK-1049	276	409	133	1	3	4	1	2
INK-1049	276	291	15	1	4	5	0	0
INK-1049	277	409	132	1	4	5	0	0
INK-1049	277	477	200	0	3	1	0	0
INK-1049	279	477	198	0	3	4	0	1
INK-1049	279	477	198	0	3	5	0	0
INK-1049	279	477	198	0	3	5	0	0
INK-1050	279	477	198	0	3	5	0	0
INK-1050	279	477	198	0	3	5	0	0
INK-1050	279	477	198	0	3	5	0	0
INK-1050	279	477	198	0	3	5	0	0
INK-1050	279	477	198	0	3	5	0	0
INK-1050	279	477	198	0	3	5	0	0
INK-1050	279	477	198	0	3	5	0	0
INK-1050	279	477	198	0	3	5	0	0
INK-1050	280	290	10	1	3	5	1	0
INK-1050	280	375	95	1	3	4	1	1
INK-1051	280	325	45	1	3	5	1	0
INK-1051	280	290	10	1	4	4	1	0
INK-1051	280	281	1	1	3	5	1	0
INK-1051	280	324	44	1	4	4	1	0
INK-1051	280	281	1	1	4	4	1	0
INK-1051	280	477	197	0	3	4	0	1
INK-1051	281	287	6	1	3	1	3	0
INK-1051	281	477	196	0	3	4	0	0
INK-1051	281	477	196	0	3	4	0	0
INK-1051	281	289	8	1	3	1	0	0
INK-1052	281	477	196	0	4	1	0	0
INK-1052	282	477	195	0	3	1	0	0
INK-1052	282	338	56	1	3	5	2	0
INK-1052	282	283	1	1	3	2	1	0
INK-1052	282	284	2	1	2	1	3	0
INK-1052	282	477	195	0	4	4	0	0
INK-1052	282	283	1	1	1	1	0	0
INK-1052	283	293	10	1	3	5	1	0
INK-1052	283	284	1	1	4	4	1	0
INK-1052	283	284	1	1	3	1	1	0
INK-1053	283	287	4	1	2	1	1	0
INK-1053	283	319	36	1	2	1	1	2
INK-1053	283	284	1	1	3	1	2	0
INK-1053	284	290	6	1	3	1	0	0
INK-1053	284	477	193	0	3	2	0	0
INK-1053	284	290	6	1	3	1	0	0
INK-1053	284	477	193	0	3	4	0	0
INK-1053	284	290	6	1	3	5	1	1
INK-1053	284	477	193	0	3	1	0	1
INK-1053	284	477	193	0	4	2	0	0
INK-1054	284	413	129	1	3	5	1	4
INK-1054	284	285	1	1	3	5	1	1
INK-1054	284	395	111	1	3	5	0	2
INK-1054	286	351	65	1	4	4	1	0
INK-1054	286	287	1	1	3	1	4	1
INK-1054	287	288	1	1	3	5	1	0
INK-1054	287	288	1	1	3	5	1	0
INK-1054	287	288	1	1	4	5	1	0
INK-1054	287	339	52	1	4	5	0	0
INK-1054	287	288	1	1	3	5	1	0
INK-1055	287	381	94	1	4	5	0	0
INK-1055	287	288	1	1	3	5	1	0
INK-1055	287	290	3	1	3	4	0	1
INK-1055	287	477	190	0	3	1	0	0
INK-1055	287	288	1	1	3	4	1	0
INK-1055	287	372	85	1	3	5	1	0
INK-1055	287	477	190	0	3	2	0	4
INK-1055	287	477	190	0	3	1	0	0
INK-1055	288	381	93	1	4	5	1	2
INK-1055	288	289	1	1	3	5	1	0
INK-1056	288	338	50	1	3	1	0	0
INK-1056	288	477	189	0	4	1	0	0
INK-1056	288	477	189	0	4	4	0	0
INK-1056	288	291	3	1	3	4	1	0
INK-1056	288	477	189	0	3	1	0	0
INK-1056	288	289	1	1	3	5	1	0
INK-1056	288	347	59	1	3	4	4	0
INK-1056	288	290	2	1	3	1	2	0
INK-1056	288	477	189	0	3	4	0	0
INK-1056	288	477	189	0	3	5	0	0
INK-1057	288	296	8	1	3	1	2	0
INK-1057	288	373	85	1	3	5	1	1
INK-1057	288	477	189	0	3	5	0	0
INK-1057	288	477	189	0	3	5	0	0
INK-1057	288	477	189	0	3	5	0	0
INK-1057	288	458	170	1	3	5	1	0
INK-1057	288	477	189	0	3	2	0	0
INK-1057	289	323	34	1	3	1	0	1
INK-1057	289	290	1	1	3	2	0	0
INK-1057	289	290	1	1	3	4	1	0
INK-1058	289	290	1	1	1	1	1	0
INK-1058	289	305	16	1	2	1	3	0
INK-1058	289	290	1	1	3	4	3	0
INK-1058	289	400	111	1	3	5	1	0
INK-1058	289	444	155	1	3	5	0	0
INK-1058	289	424	135	1	3	1	1	1
INK-1058	289	421	132	1	3	1	0	1
INK-1058	290	477	187	0	3	5	0	1
INK-1058	290	477	187	0	3	5	0	0
INK-1058	290	477	187	0	3	5	0	0
INK-1059	290	477	187	0	3	1	0	1
INK-1059	290	382	92	1	3	5	1	0
INK-1059	290	477	187	0	3	5	0	1
INK-1059	290	477	187	0	3	5	0	2
INK-1059	290	477	187	0	3	5	0	0
INK-1059	290	477	187	0	3	5	0	0
INK-1059	290	373	83	1	3	5	1	0
INK-1059	290	333	43	1	3	5	1	2
INK-1059	290	477	187	0	3	3	0	0
INK-1059	290	298	8	1	3	5	1	0
INK-1060	290	323	33	1	1	5	1	0
INK-1060	290	347	57	1	3	4	0	1
INK-1060	290	291	1	1	3	5	1	0
INK-1060	290	477	187	0	3	5	0	1
INK-1060	290	477	187	0	4	5	0	0
INK-1060	290	303	13	1	3	5	1	0
INK-1060	291	295	4	1	4	5	3	0
INK-1060	291	295	4	1	4	5	3	0
INK-1060	291	292	1	1	3	4	2	1
INK-1060	291	297	6	1	3	1	0	1
INK-1061	291	408	117	1	3	5	0	4
INK-1061	291	477	186	0	4	4	0	0
INK-1061	291	405	114	1	3	4	0	1
INK-1061	291	297	6	1	2	4	3	1
INK-1061	291	292	1	1	4	4	3	0
INK-1061	291	477	186	0	2	1	0	4
INK-1061	291	477	186	0	3	1	0	0
INK-1061	291	477	186	0	2	1	0	0
INK-1061	291	477	186	0	3	5	0	2
INK-1061	292	477	185	0	4	4	0	0
INK-1062	292	317	25	1	4	5	0	1
INK-1062	292	297	5	1	3	1	1	0
INK-1062	293	324	31	1	2	5	0	0
INK-1062	293	301	8	1	3	5	1	0
INK-1062	293	318	25	1	2	5	1	0
INK-1062	293	321	28	1	3	5	1	0
INK-1062	293	315	22	1	3	5	1	0
INK-1062	293	308	15	1	2	5	1	0
INK-1062	293	318	25	1	3	5	1	0
INK-1062	293	366	73	1	2	1	0	3
INK-1063	293	420	127	1	2	3	0	2
INK-1063	293	304	11	1	2	3	1	0
INK-1063	293	308	15	1	3	5	1	0
INK-1063	293	309	16	1	3	5	1	0
INK-1063	293	318	25	1	3	5	1	0
INK-1063	293	477	184	0	3	5	0	0
INK-1063	294	477	183	0	3	1	0	0
INK-1063	294	296	2	1	2	4	3	0
INK-1063	294	308	14	1	3	1	1	0
INK-1063	294	295	1	1	3	1	2	0
INK-1064	294	477	183	0	3	2	0	0
INK-1064	294	295	1	1	3	1	0	0
INK-1064	294	319	25	1	3	1	3	0
INK-1064	294	477	183	0	3	2	0	0
INK-1064	294	477	183	0	3	2	0	0
INK-1064	295	420	125	1	3	5	0	0
INK-1064	295	420	125	1	3	5	0	0
INK-1064	295	420	125	1	3	5	0	0
INK-1064	295	420	125	1	3	5	0	0
INK-1064	295	420	125	1	3	5	0	0
INK-1065	295	420	125	1	3	5	0	0
INK-1065	295	420	125	1	3	5	0	0
INK-1065	295	420	125	1	3	5	0	0
INK-1065	295	477	182	0	3	2	0	3
INK-1065	295	477	182	0	3	4	0	0
INK-1065	295	318	23	1	3	1	3	0
INK-1065	295	477	182	0	4	4	0	0
INK-1065	296	297	1	1	5	1	1	0
INK-1065	296	477	181	0	3	1	0	0
INK-1065	296	477	181	0	3	4	0	0
INK-1066	296	477	181	0	4	1	0	0
INK-1066	296	477	181	0	4	5	0	0
INK-1066	296	394	98	1	4	5	1	0
INK-1066	296	297	1	1	2	1	2	1
INK-1066	296	477	181	0	3	4	0	0
INK-1066	296	382	86	1	3	5	1	1
INK-1066	296	322	26	1	3	5	1	0
INK-1066	296	477	181	0	3	1	0	0
INK-1066	296	324	28	1	2	1	0	4
INK-1066	296	304	8	1	3	1	3	2
INK-1067	296	322	26	1	3	1	3	0
INK-1067	296	309	13	1	4	1	0	1
INK-1067	296	477	181	0	3	1	0	1
INK-1067	297	477	180	0	3	1	0	0
INK-1067	297	325	28	1	4	1	3	0
INK-1067	297	301	4	1	1	1	1	0
INK-1067	297	311	14	1	3	4	1	0
INK-1067	297	298	1	1	3	4	0	0
INK-1067	297	324	27	1	1	4	3	3
INK-1067	297	303	6	1	3	5	1	0
INK-1068	297	477	180	0	3	1	0	0
INK-1068	297	304	7	1	2	1	2	0
INK-1068	297	310	13	1	2	1	1	1
INK-1068	298	424	126	1	3	1	0	0
INK-1068	298	477	179	0	3	4	0	0
INK-1068	298	306	8	1	3	4	0	0
INK-1068	298	393	95	1	3	4	0	3
INK-1068	298	302	4	1	3	5	1	1
INK-1068	298	477	179	0	3	2	0	4
INK-1068	298	336	38	1	3	5	1	1
INK-1069	298	303	5	1	3	1	3	0
INK-1069	298	312	14	1	3	4	1	0
INK-1069	298	299	1	1	3	4	2	0
INK-1069	298	304	6	1	2	1	3	0
INK-1069	298	477	179	0	2	1	2	1
INK-1069	298	300	2	1	3	4	1	0
INK-1069	298	420	122	1	3	5	0	2
INK-1069	298	395	97	1	3	5	0	2
INK-1069	298	420	122	1	3	5	0	2
INK-1069	298	395	97	1	3	5	0	2
INK-1070	299	372	73	1	3	5	1	1
INK-1070	299	477	178	0	3	5	0	1
INK-1070	299	300	1	1	4	1	1	0
INK-1070	301	308	7	1	3	1	0	0
INK-1070	301	310	9	1	3	1	1	0
INK-1070	301	477	176	0	3	4	0	0
INK-1070	301	477	176	0	3	5	0	0
INK-1070	301	477	176	0	3	5	0	0
INK-1070	301	303	2	1	3	5	1	1
INK-1070	301	303	2	1	3	5	1	0
INK-1071	301	303	2	1	3	5	1	0
INK-1071	301	310	9	1	1	1	1	0
INK-1071	301	477	176	0	2	1	0	2
INK-1071	301	477	176	0	2	1	0	1
INK-1071	301	324	23	1	1	1	0	0
INK-1071	301	306	5	1	1	1	3	1
INK-1071	301	303	2	1	3	5	1	0
INK-1071	301	303	2	1	3	5	1	0
INK-1071	301	477	176	0	3	4	0	1
INK-1071	301	477	176	0	4	5	0	0
INK-1072	301	309	8	1	3	5	1	0
INK-1072	302	406	104	1	3	1	3	1
INK-1072	302	303	1	1	3	5	0	0
INK-1072	302	303	1	1	3	5	1	0
INK-1072	302	477	175	0	3	4	0	3
INK-1072	302	477	175	0	3	4	0	1
INK-1072	302	303	1	1	3	1	1	0
INK-1072	302	305	3	1	3	4	0	1
INK-1072	302	477	175	0	3	1	0	0
INK-1072	303	477	174	0	3	2	0	1
INK-1073	303	304	1	1	3	4	0	0
INK-1073	303	477	174	0	4	4	0	0
INK-1073	303	308	5	1	3	1	1	1
INK-1073	303	312	9	1	3	1	1	0
INK-1073	303	477	174	0	3	1	0	0
INK-1073	303	452	149	1	2	1	0	1
INK-1073	303	319	16	1	2	1	1	0
INK-1073	303	477	174	0	2	1	0	0
INK-1073	303	323	20	1	1	1	0	0
INK-1073	303	304	1	1	3	1	1	0
INK-1074	303	477	174	0	3	4	0	0
INK-1074	303	304	1	1	2	1	0	2
INK-1074	303	477	174	0	3	5	0	0
INK-1074	303	344	41	1	4	4	1	0
INK-1074	303	477	174	0	3	4	0	2
INK-1074	304	477	173	0	3	4	0	0
INK-1074	304	458	154	1	2	3	0	0
INK-1074	304	305	1	1	1	1	1	1
INK-1074	304	353	49	1	2	1	1	0
INK-1074	304	305	1	1	3	1	0	1
INK-1075	304	310	6	1	2	1	3	0
INK-1075	304	344	40	1	4	1	0	0
INK-1075	304	305	1	1	3	1	3	0
INK-1075	304	315	11	1	3	1	3	1
INK-1075	304	305	1	1	3	4	1	0
INK-1075	304	442	138	1	3	4	1	4
INK-1075	305	436	131	1	2	1	1	0
INK-1075	305	306	1	1	3	1	1	0
INK-1075	305	477	172	0	3	5	0	0
INK-1075	305	306	1	1	3	5	0	1
INK-1076	305	477	172	0	3	5	0	0
INK-1076	305	367	62	1	2	1	3	0
INK-1076	305	477	172	0	3	4	0	1
INK-1076	305	331	26	1	3	1	3	0
INK-1076	305	318	13	1	3	5	2	0
INK-1076	305	311	6	1	3	5	1	0
INK-1076	305	317	12	1	4	5	0	0
INK-1076	305	318	13	1	2	3	1	0
INK-1076	305	420	115	1	3	5	0	2
INK-1076	306	420	114	1	3	5	0	0
INK-1077	306	311	5	1	3	1	3	0
INK-1077	307	312	5	1	3	4	1	0
INK-1077	307	308	1	1	1	1	0	0
INK-1077	307	308	1	1	2	1	3	0
INK-1077	307	395	88	1	3	1	3	1
INK-1077	308	416	108	1	1	1	0	0
INK-1077	308	423	115	1	1	4	1	1
INK-1077	308	423	115	1	3	5	1	0
INK-1077	308	413	105	1	3	5	1	0
INK-1077	308	366	58	1	3	5	1	0
INK-1078	308	366	58	1	3	5	1	0
INK-1078	308	366	58	1	3	5	1	0
INK-1078	308	351	43	1	3	5	1	0
INK-1078	308	373	65	1	3	5	1	0
INK-1078	308	351	43	1	3	5	1	0
INK-1078	308	423	115	1	3	5	1	0
INK-1078	308	351	43	1	3	5	1	0
INK-1078	308	351	43	1	3	5	1	0
INK-1078	308	351	43	1	3	5	1	0
INK-1078	308	314	6	1	2	4	1	0
INK-1079	308	477	169	0	4	5	0	0
INK-1079	308	311	3	1	3	5	1	0
INK-1079	308	340	32	1	3	5	0	1
INK-1079	308	309	1	1	3	5	2	0
INK-1079	308	477	169	0	3	4	0	0
INK-1079	308	477	169	0	3	4	0	0
INK-1079	308	420	112	1	3	5	0	1
INK-1079	308	310	2	1	3	1	1	0
INK-1079	309	336	27	1	3	5	1	0
INK-1079	309	311	2	1	4	4	1	0
INK-1080	309	310	1	1	4	5	1	0
INK-1080	309	312	3	1	3	1	1	0
INK-1080	309	477	168	0	3	4	0	0
INK-1080	309	324	15	1	3	4	1	0
INK-1080	309	477	168	0	3	4	0	0
INK-1080	309	310	1	1	3	1	1	0
INK-1080	310	477	167	0	3	4	0	0
INK-1080	310	409	99	1	3	1	0	1
INK-1080	310	311	1	1	3	4	0	0
INK-1080	310	340	30	1	3	1	2	1
INK-1081	310	321	11	1	3	3	0	1
INK-1081	310	311	1	1	1	1	1	0
INK-1081	310	311	1	1	2	1	1	0
INK-1081	310	312	2	1	3	4	1	0
INK-1081	310	312	2	1	1	1	1	0
INK-1081	310	311	1	1	3	4	0	0
INK-1081	310	311	1	1	3	1	2	0
INK-1081	310	381	71	1	3	4	1	0
INK-1081	311	477	166	0	3	1	0	0
INK-1081	311	477	166	0	2	1	0	1
INK-1082	311	331	20	1	4	5	1	0
INK-1082	311	315	4	1	1	1	3	0
INK-1082	311	380	69	1	3	2	1	1
INK-1082	311	312	1	1	1	1	1	0
INK-1082	311	477	166	0	3	1	0	0
INK-1082	311	312	1	1	2	1	1	0
INK-1082	311	315	4	1	2	1	1	0
INK-1082	311	315	4	1	3	5	3	0
INK-1082	311	477	166	0	3	5	0	0
INK-1082	311	477	166	0	3	4	0	0
INK-1083	311	477	166	0	3	4	0	2
INK-1083	311	477	166	0	3	4	0	2
INK-1083	311	343	32	1	2	1	0	0
INK-1083	311	318	7	1	2	1	0	3
INK-1083	312	477	165	0	3	5	1	1
INK-1083	312	313	1	1	4	5	1	0
INK-1083	312	477	165	0	4	4	0	0
INK-1083	312	333	21	1	3	1	1	1
INK-1083	312	333	21	1	2	4	0	4
INK-1083	312	315	3	1	1	1	3	0
INK-1084	312	315	3	1	3	1	0	0
INK-1084	312	477	165	0	4	4	0	0
INK-1084	312	336	24	1	3	1	2	0
INK-1084	312	319	7	1	3	1	1	1
INK-1084	312	477	165	0	4	4	0	0
INK-1084	312	371	59	1	3	2	1	2
INK-1084	312	477	165	0	3	5	0	1
INK-1084	312	477	165	0	3	5	0	1
INK-1084	314	375	61	1	3	1	3	2
INK-1084	315	322	7	1	3	1	0	0
INK-1085	315	477	162	0	3	1	0	0
INK-1085	315	316	1	1	3	1	0	0
INK-1085	315	317	2	1	3	1	0	0
INK-1085	315	372	57	1	3	5	0	0
INK-1085	315	372	57	1	3	5	0	0
INK-1085	315	477	162	0	3	1	0	2
INK-1085	315	319	4	1	2	1	3	1
INK-1085	316	318	2	1	3	1	3	0
INK-1085	316	477	161	0	3	5	0	0
INK-1085	316	317	1	1	3	1	0	0
INK-1086	316	318	2	1	3	1	1	0
INK-1086	316	477	161	0	3	1	0	0
INK-1086	316	317	1	1	3	5	3	0
INK-1086	316	322	6	1	3	4	0	0
INK-1086	316	343	27	1	3	2	1	1
INK-1086	316	374	58	1	2	4	1	0
INK-1086	316	477	161	0	3	2	0	0
INK-1086	316	477	161	0	3	1	0	0
INK-1086	316	319	3	1	3	4	1	0
INK-1087	317	477	160	0	3	5	0	0
INK-1087	317	477	160	0	4	4	0	1
INK-1087	317	319	2	1	3	5	1	1
INK-1087	317	477	160	0	3	4	0	1
INK-1087	317	333	16	1	2	1	1	1
INK-1087	317	421	104	1	4	4	1	0
INK-1087	317	477	160	0	3	1	0	1
INK-1087	317	319	2	1	5	4	0	0
INK-1087	317	318	1	1	3	1	0	0
INK-1087	317	477	160	0	3	4	0	0
INK-1088	317	320	3	1	1	1	3	1
INK-1088	317	423	106	1	2	1	1	0
INK-1088	317	477	160	0	3	1	0	1
INK-1088	317	319	2	1	3	4	2	1
INK-1088	317	477	160	0	3	1	0	0
INK-1088	317	423	106	1	2	1	0	0
INK-1088	317	477	160	0	3	4	0	0
INK-1088	317	412	95	1	3	5	1	0
INK-1088	317	477	160	0	3	5	0	0
INK-1088	318	477	159	0	3	4	0	0
INK-1089	318	422	104	1	3	5	0	1
INK-1089	318	319	1	1	3	5	1	0
INK-1089	318	323	5	1	3	4	0	0
INK-1089	318	322	4	1	3	1	1	0
INK-1089	318	319	1	1	3	1	0	1
INK-1089	318	422	104	1	2	1	1	0
INK-1089	318	477	159	0	3	2	0	0
INK-1089	318	417	99	1	3	5	1	0
INK-1089	318	477	159	0	3	4	0	0
INK-1089	318	319	1	1	4	1	0	0
INK-1090	318	319	1	1	1	3	1	0
INK-1090	318	319	1	1	4	1	0	0
INK-1090	318	477	159	0	4	1	0	0
INK-1090	318	477	159	0	4	5	0	0
INK-1090	318	477	159	0	4	5	0	0
INK-1090	318	319	1	1	2	4	0	0
INK-1090	318	320	2	1	2	4	3	0
INK-1090	318	346	28	1	4	1	0	0
INK-1090	319	477	158	0	3	4	0	0
INK-1090	319	323	4	1	3	4	0	0
INK-1091	319	394	75	1	2	4	3	0
INK-1091	319	477	158	0	3	1	0	1
INK-1091	319	422	103	1	3	2	1	0
INK-1091	320	321	1	1	2	1	3	0
INK-1091	320	477	157	0	3	4	0	0
INK-1091	320	322	2	1	4	4	0	0
INK-1091	321	322	1	1	5	4	3	0
INK-1091	321	477	156	0	4	4	0	0
INK-1091	321	477	156	0	3	1	0	0
INK-1091	321	477	156	0	3	4	0	0
INK-1092	321	322	1	1	3	5	0	1
INK-1092	321	477	156	0	3	5	0	1
INK-1092	322	323	1	1	2	5	1	1
INK-1092	322	336	14	1	3	4	0	0
INK-1092	322	330	8	1	3	4	1	0
INK-1092	322	323	1	1	3	1	3	0
INK-1092	322	325	3	1	4	1	1	0
INK-1092	322	324	2	1	3	1	0	1
INK-1092	322	392	70	1	3	1	0	1
INK-1092	322	477	155	0	4	5	0	0
INK-1093	322	420	98	1	3	4	0	2
INK-1093	322	323	1	1	3	4	1	0
INK-1093	322	477	155	0	3	5	0	0
INK-1093	322	477	155	0	3	5	0	0
INK-1093	322	477	155	0	3	5	0	0
INK-1093	322	477	155	0	3	5	0	0
INK-1093	322	477	155	0	3	5	0	0
INK-1093	322	477	155	0	3	5	0	0
INK-1093	322	477	155	0	3	5	0	0
INK-1093	322	477	155	0	3	5	0	0
INK-1094	323	324	1	1	3	4	0	0
INK-1094	323	477	154	0	2	1	3	2
INK-1094	323	329	6	1	4	5	1	0
INK-1094	323	344	21	1	4	1	0	0
INK-1094	323	416	93	1	2	1	0	0
INK-1094	323	380	57	1	3	4	1	0
INK-1094	323	337	14	1	3	1	2	1
INK-1094	323	477	154	0	4	3	0	0
INK-1094	323	477	154	0	4	4	0	0
INK-1094	323	477	154	0	3	1	0	0
INK-1095	323	477	154	0	4	1	0	0
INK-1095	323	331	8	1	2	4	3	0
INK-1095	323	346	23	1	3	1	0	0
INK-1095	323	359	36	1	2	1	0	0
INK-1095	323	477	154	0	3	1	2	0
INK-1095	323	331	8	1	2	1	1	0
INK-1095	324	325	1	1	3	4	0	0
INK-1095	324	477	153	0	3	5	0	0
INK-1095	324	477	153	0	3	4	1	0
INK-1095	324	332	8	1	3	1	0	0
INK-1096	324	367	43	1	2	1	0	0
INK-1096	324	477	153	0	3	1	0	0
INK-1096	324	477	153	0	3	4	0	0
INK-1096	324	345	21	1	3	5	2	0
INK-1096	324	414	90	1	3	1	3	0
INK-1096	324	477	153	0	3	1	0	0
INK-1096	324	477	153	0	3	4	0	1
INK-1096	324	477	153	0	3	4	0	0
INK-1096	324	477	153	0	3	5	0	0
INK-1096	324	325	1	1	3	2	0	1
INK-1097	324	325	1	1	3	2	0	1
INK-1097	324	477	153	0	3	1	0	0
INK-1097	325	477	152	0	3	2	0	0
INK-1097	325	459	134	1	3	5	1	0
INK-1097	325	477	152	0	3	5	0	0
INK-1097	325	448	123	1	3	5	0	0
INK-1097	325	477	152	0	3	5	0	0
INK-1097	325	477	152	0	3	5	0	0
INK-1097	325	477	152	0	3	5	0	0
INK-1097	325	477	152	0	3	5	0	0
INK-1098	325	326	1	1	4	1	0	0
INK-1098	325	477	152	0	3	4	0	0
INK-1098	325	326	1	1	3	5	1	0
INK-1098	325	326	1	1	3	1	0	0
INK-1098	325	477	152	0	3	4	1	0
INK-1098	325	343	18	1	3	4	1	0
INK-1098	325	343	18	1	3	4	1	0
INK-1098	325	331	6	1	1	1	1	3
INK-1098	325	477	152	0	3	4	0	0
INK-1098	325	477	152	0	3	1	0	0
INK-1099	325	330	5	1	4	1	3	0
INK-1099	325	331	6	1	3	1	1	1
INK-1099	325	331	6	1	3	1	3	0
INK-1099	326	333	7	1	3	2	0	1
INK-1099	326	437	111	1	3	1	0	2
INK-1099	326	477	151	0	4	5	0	0
INK-1099	326	420	94	1	3	4	0	0
INK-1099	326	339	13	1	3	1	3	0
INK-1099	326	330	4	1	3	1	3	0
INK-1099	327	477	150	0	3	1	0	0
INK-1100	327	477	150	0	3	4	0	0
INK-1100	327	346	19	1	3	1	1	0
INK-1100	329	477	148	0	3	1	0	0
INK-1100	329	331	2	1	4	1	1	0
INK-1100	329	331	2	1	3	1	0	0
INK-1100	329	330	1	1	3	4	3	0
INK-1100	329	330	1	1	3	4	0	3
INK-1100	329	477	148	0	3	3	0	0
INK-1100	330	389	59	1	3	2	1	0
INK-1100	330	477	147	0	3	3	0	0
INK-1101	330	477	147	0	3	1	0	0
INK-1101	330	339	9	1	2	1	4	2
INK-1101	330	380	50	1	3	5	0	0
INK-1101	330	420	90	1	3	1	2	0
INK-1101	330	477	147	0	4	4	0	0
INK-1101	330	333	3	1	3	4	1	1
INK-1101	331	332	1	1	2	1	0	0
INK-1101	331	333	2	1	3	1	3	0
INK-1101	331	477	146	0	3	1	0	0
INK-1101	331	477	146	0	3	2	0	0
INK-1102	331	477	146	0	3	4	0	0
INK-1102	331	477	146	0	3	1	0	0
INK-1102	331	395	64	1	1	1	2	1
INK-1102	331	395	64	1	2	4	2	1
INK-1102	332	477	145	0	3	2	0	0
INK-1102	332	477	145	0	3	1	0	0
INK-1102	332	368	36	1	3	4	1	0
INK-1102	332	346	14	1	2	1	0	1
INK-1102	332	477	145	0	3	4	0	0
INK-1102	332	344	12	1	4	4	3	0
INK-1103	332	477	145	0	3	1	0	0
INK-1103	332	333	1	1	3	1	0	0
INK-1103	332	420	88	1	2	1	1	1
INK-1103	332	420	88	1	2	1	1	1
INK-1103	333	477	144	0	3	4	0	0
INK-1103	333	477	144	0	4	5	0	0
INK-1103	333	382	49	1	2	1	1	0
INK-1103	333	477	144	0	4	5	0	0
INK-1103	333	477	144	0	3	1	0	1
INK-1103	333	344	11	1	4	4	1	0
INK-1104	333	347	14	1	4	1	1	0
INK-1104	333	416	83	1	2	4	2	1
INK-1104	333	399	66	1	3	1	0	0
INK-1104	333	339	6	1	4	1	0	0
INK-1104	333	337	4	1	4	1	2	0
INK-1104	335	338	3	1	3	1	3	1
INK-1104	335	406	71	1	3	1	2	0
INK-1104	335	337	2	1	3	1	2	0
INK-1104	335	353	18	1	4	4	1	1
INK-1104	336	477	141	0	3	1	0	0
INK-1105	336	477	141	0	3	4	0	0
INK-1105	336	477	141	0	3	5	0	0
INK-1105	336	477	141	0	3	5	0	0
INK-1105	336	407	71	1	3	1	1	0
INK-1105	336	477	141	0	3	4	0	0
INK-1105	336	477	141	0	3	2	1	0
INK-1105	337	373	36	1	3	5	1	0
INK-1105	337	338	1	1	2	1	0	0
INK-1105	337	477	140	0	3	1	0	0
INK-1105	337	477	140	0	2	1	3	0
INK-1106	337	477	140	0	3	1	0	0
INK-1106	337	415	78	1	3	1	0	0
INK-1106	337	346	9	1	3	1	0	0
INK-1106	337	477	140	0	3	2	0	4
INK-1106	337	395	58	1	3	5	1	0
INK-1106	337	393	56	1	3	2	0	1
INK-1106	337	393	56	1	3	2	0	1
INK-1106	337	477	140	0	3	2	0	4
INK-1106	337	442	105	1	3	4	1	4
INK-1106	337	381	44	1	4	4	1	0
INK-1107	337	477	140	0	3	2	0	0
INK-1107	337	393	56	1	3	1	3	0
INK-1107	338	448	110	1	2	1	0	0
INK-1107	338	421	83	1	2	4	1	0
INK-1107	338	395	57	1	3	4	1	1
INK-1107	338	423	85	1	3	4	0	0
INK-1107	338	339	1	1	3	1	0	0
INK-1107	338	353	15	1	3	4	0	0
INK-1107	338	477	139	0	3	2	0	1
INK-1107	338	395	57	1	3	4	3	1
INK-1108	338	344	6	1	3	4	2	0
INK-1108	338	410	72	1	3	2	1	2
INK-1108	339	477	138	0	3	5	0	0
INK-1108	339	351	12	1	3	1	3	0
INK-1108	339	375	36	1	2	1	3	2
INK-1108	339	345	6	1	1	1	2	3
INK-1108	339	477	138	0	3	1	0	0
INK-1108	339	344	5	1	1	1	3	0
INK-1108	339	477	138	0	3	5	0	0
INK-1108	340	409	69	1	4	4	1	0
INK-1109	340	344	4	1	3	4	1	0
INK-1109	340	423	83	1	4	4	1	0
INK-1109	340	393	53	1	3	5	0	0
INK-1109	340	393	53	1	3	5	0	0
INK-1109	340	344	4	1	1	1	2	0
INK-1109	340	477	137	0	3	2	0	0
INK-1109	340	477	137	0	3	5	0	0
INK-1109	340	393	53	1	3	5	0	0
INK-1109	340	341	1	1	3	2	0	0
INK-1109	340	393	53	1	3	5	0	0
INK-1110	340	351	11	1	3	1	2	1
INK-1110	340	351	11	1	4	4	1	0
INK-1110	340	477	137	0	3	4	0	0
INK-1110	340	477	137	0	3	4	0	0
INK-1110	340	341	1	1	3	1	0	0
INK-1110	340	477	137	0	3	2	0	0
INK-1110	341	395	54	1	3	5	1	4
INK-1110	342	477	135	0	3	1	2	0
INK-1110	343	477	134	0	3	5	0	0
INK-1110	343	477	134	0	3	5	0	0
INK-1111	343	423	80	1	3	5	0	0
INK-1111	343	477	134	0	3	5	0	0
INK-1111	343	477	134	0	3	5	0	0
INK-1111	343	477	134	0	3	5	0	0
INK-1111	343	477	134	0	3	5	0	0
INK-1111	343	477	134	0	3	5	0	0
INK-1111	343	477	134	0	3	4	1	0
INK-1111	343	344	1	1	3	2	0	2
INK-1111	343	477	134	0	3	3	0	2
INK-1111	343	368	25	1	3	1	3	0
INK-1112	343	477	134	0	3	1	0	2
INK-1112	343	438	95	1	1	4	1	0
INK-1112	343	346	3	1	3	5	1	0
INK-1112	344	345	1	1	4	1	3	0
INK-1112	344	368	24	1	3	4	1	0
INK-1112	344	395	51	1	3	4	1	0
INK-1112	344	477	133	0	4	4	0	1
INK-1112	344	477	133	0	3	4	0	1
INK-1112	344	346	2	1	2	1	0	0
INK-1112	344	477	133	0	3	4	0	0
INK-1113	344	393	49	1	3	5	0	0
INK-1113	344	345	1	1	3	4	0	0
INK-1113	344	346	2	1	3	1	0	0
INK-1113	345	477	132	0	4	1	0	0
INK-1113	345	374	29	1	4	4	3	0
INK-1113	345	477	132	0	4	4	0	0
INK-1113	345	346	1	1	3	1	3	0
INK-1113	345	424	79	1	4	1	0	3
INK-1113	345	346	1	1	3	4	0	0
INK-1113	345	477	132	0	3	4	0	0
INK-1114	345	373	28	1	3	1	0	0
INK-1114	345	477	132	0	2	1	0	0
INK-1114	345	360	15	1	4	4	1	0
INK-1114	345	477	132	0	3	1	0	0
INK-1114	345	346	1	1	2	5	1	0
INK-1114	345	395	50	1	3	1	2	0
INK-1114	346	451	105	1	3	5	1	4
INK-1114	346	477	131	0	3	5	0	0
INK-1114	346	477	131	0	3	1	0	0
INK-1114	346	347	1	1	4	4	0	1
INK-1115	346	477	131	0	3	4	0	0
INK-1115	346	351	5	1	3	1	3	0
INK-1115	346	347	1	1	3	5	1	0
INK-1115	346	450	104	1	3	5	1	0
INK-1115	346	411	65	1	3	4	2	1
INK-1115	346	457	111	1	3	5	1	0
INK-1115	346	379	33	1	3	5	1	0
INK-1115	346	477	131	0	3	4	0	0
INK-1115	346	477	131	0	3	4	0	0
INK-1115	346	477	131	0	3	4	0	2
INK-1116	346	395	49	1	4	4	0	1
INK-1116	347	372	25	1	4	1	1	2
INK-1116	347	477	130	0	3	2	0	0
INK-1116	347	367	20	1	2	4	1	0
INK-1116	347	399	52	1	3	1	1	0
INK-1116	347	371	24	1	4	4	1	0
INK-1116	347	477	130	0	3	2	0	0
INK-1116	347	477	130	0	3	4	0	0
INK-1116	347	351	4	1	3	4	2	0
INK-1116	348	477	129	0	3	1	0	0
INK-1117	349	477	128	0	3	5	0	0
INK-1117	349	389	40	1	3	1	1	0
INK-1117	350	477	127	0	3	4	0	0
INK-1117	350	368	18	1	3	1	3	0
INK-1117	350	380	30	1	4	4	1	0
INK-1117	350	477	127	0	3	4	0	0
INK-1117	350	477	127	0	3	5	0	0
INK-1117	350	477	127	0	3	5	0	0
INK-1117	350	367	17	1	3	5	0	0
INK-1117	350	357	7	1	3	5	2	0
INK-1118	350	352	2	1	3	5	2	0
INK-1118	350	367	17	1	3	5	2	0
INK-1118	350	353	3	1	3	5	0	2
INK-1118	350	437	87	1	3	1	2	0
INK-1118	350	477	127	0	3	2	0	1
INK-1118	350	421	71	1	2	4	1	0
INK-1118	350	477	127	0	3	2	0	0
INK-1118	350	380	30	1	3	1	2	0
INK-1118	351	477	126	0	3	1	0	1
INK-1118	351	371	20	1	4	4	1	0
INK-1119	351	353	2	1	5	4	0	1
INK-1119	351	372	21	1	3	1	2	1
INK-1119	351	353	2	1	3	1	0	1
INK-1119	351	477	126	0	3	1	0	1
INK-1119	351	367	16	1	3	1	2	0
INK-1119	351	477	126	0	3	4	0	0
INK-1119	351	477	126	0	3	4	0	0
INK-1119	352	373	21	1	3	5	1	0
INK-1119	352	477	125	0	3	2	0	1
INK-1119	352	477	125	0	3	2	0	0
INK-1120	352	477	125	0	3	4	0	1
INK-1120	352	353	1	1	3	1	2	0
INK-1120	352	477	125	0	3	2	0	0
INK-1120	352	477	125	0	3	4	0	1
INK-1120	352	477	125	0	4	1	0	0
INK-1120	352	477	125	0	3	1	0	2
INK-1120	353	354	1	1	4	4	0	0
INK-1120	353	395	42	1	1	4	3	0
INK-1120	353	477	124	0	3	4	0	0
INK-1120	355	477	122	0	3	4	0	0
INK-1121	355	477	122	0	3	4	0	1
INK-1121	355	403	48	1	3	1	0	1
INK-1121	357	358	1	1	3	4	0	0
INK-1121	357	367	10	1	3	3	0	0
INK-1121	358	386	28	1	3	2	0	0
INK-1121	358	452	94	1	3	1	0	1
INK-1121	358	359	1	1	2	4	1	0
INK-1121	358	366	8	1	2	4	1	0
INK-1121	359	477	118	0	3	4	0	0
INK-1121	359	395	36	1	3	3	0	0
INK-1122	359	477	118	0	3	1	0	0
INK-1122	359	477	118	0	3	4	0	0
INK-1122	360	477	117	0	3	4	0	0
INK-1122	360	477	117	0	3	1	0	0
INK-1122	360	375	15	1	3	1	3	0
INK-1122	360	477	117	0	3	1	0	2
INK-1122	360	477	117	0	3	4	0	0
INK-1122	360	368	8	1	3	1	2	0
INK-1122	361	477	116	0	4	1	0	0
INK-1122	362	367	5	1	3	1	0	0
INK-1123	362	372	10	1	1	1	1	0
INK-1123	362	373	11	1	3	4	0	0
INK-1123	362	373	11	1	3	1	3	0
INK-1123	363	364	1	1	4	4	1	0
INK-833	0	2	2	1	3	1	0	0
INK-833	0	112	112	1	4	4	1	0
INK-833	1	338	337	1	2	1	3	2
INK-833	1	63	62	1	1	1	1	1
INK-833	1	10	9	1	3	5	1	0
INK-833	1	10	9	1	3	5	1	0
INK-834	1	11	10	1	3	5	1	0
INK-834	1	11	10	1	3	5	1	0
INK-834	1	11	10	1	3	5	1	0
INK-834	1	184	183	1	3	5	0	2
INK-834	1	25	24	1	3	4	1	0
INK-834	1	37	36	1	3	2	1	0
INK-834	1	4	3	1	3	4	2	0
INK-834	1	11	10	1	3	5	1	0
INK-834	1	11	10	1	3	5	1	0
INK-834	1	11	10	1	3	5	1	0
INK-835	1	17	16	1	3	4	1	1
INK-835	2	477	475	0	3	1	0	0
INK-835	2	24	22	1	3	1	2	1
INK-835	2	477	475	0	3	2	0	3
INK-835	2	417	415	1	3	2	1	4
INK-835	2	18	16	1	3	1	2	1
INK-835	2	4	2	1	3	1	0	0
INK-835	3	477	474	0	3	4	0	0
INK-835	3	477	474	0	3	1	0	0
INK-835	3	4	1	1	3	3	1	0
INK-836	3	57	54	1	3	2	1	4
INK-836	3	23	20	1	5	4	1	0
INK-836	3	38	35	1	3	4	2	0
INK-836	3	477	474	0	5	2	0	0
INK-836	3	74	71	1	3	4	0	0
INK-836	3	22	19	1	3	4	1	0
INK-836	4	106	102	1	3	1	1	0
INK-836	4	14	10	1	3	5	1	0
INK-836	4	13	9	1	3	5	1	0
INK-836	4	13	9	1	3	5	1	0
INK-837	4	105	101	1	1	5	1	0
INK-837	4	10	6	1	1	1	2	0
INK-837	4	5	1	1	3	1	0	0
INK-837	4	5	1	1	4	1	1	0
INK-837	4	5	1	1	2	1	1	0
INK-837	4	9	5	1	3	4	1	0
INK-837	4	477	473	0	3	4	0	0
INK-837	4	477	473	0	3	4	0	0
INK-837	4	477	473	0	4	2	0	0
INK-837	4	477	473	0	3	4	0	0
INK-838	4	477	473	0	3	4	0	0
INK-838	4	8	4	1	3	4	1	0
INK-838	5	477	472	0	3	1	0	0
INK-838	5	49	44	1	2	1	1	0
INK-838	7	35	28	1	4	4	1	0
INK-838	7	37	30	1	3	1	1	0
INK-838	7	477	470	0	4	1	0	0
INK-838	7	477	470	0	3	4	0	0
INK-838	7	8	1	1	3	1	1	0
INK-838	7	9	2	1	3	4	1	0
INK-839	7	477	470	0	3	1	0	0
INK-839	8	477	469	0	3	4	0	0
INK-839	8	9	1	1	3	5	1	0
INK-839	8	9	1	1	3	1	1	0
INK-839	8	79	71	1	4	5	0	0
INK-839	8	18	10	1	3	5	1	3
INK-839	8	58	50	1	3	5	0	1
INK-839	9	45	36	1	3	4	1	0
INK-839	9	36	27	1	3	1	2	0
INK-839	9	14	5	1	3	1	1	0
INK-840	9	10	1	1	3	1	1	0
INK-840	9	45	36	1	3	4	1	0
INK-840	9	112	103	1	2	1	1	1
INK-840	9	10	1	1	3	1	1	0
INK-840	9	10	1	1	3	4	1	0
INK-840	9	10	1	1	3	1	0	0
INK-840	9	23	14	1	1	1	2	0
INK-840	9	30	21	1	3	1	1	0
INK-840	9	291	282	1	2	1	0	1
INK-840	9	70	61	1	1	1	3	0
INK-841	10	477	467	0	3	1	0	0
INK-841	10	47	37	1	1	4	1	0
INK-841	10	11	1	1	3	1	0	0
INK-841	10	59	49	1	3	1	0	2
INK-841	10	15	5	1	4	1	0	0
INK-841	10	86	76	1	4	1	1	0
INK-841	11	477	466	0	3	4	0	0
INK-841	11	477	466	0	3	2	0	0
INK-841	11	406	395	1	2	1	0	0
INK-841	11	36	25	1	1	1	2	0
INK-842	11	12	1	1	3	1	1	0
INK-842	11	70	59	1	1	1	3	0
INK-842	11	30	19	1	5	4	1	1
INK-842	11	43	32	1	2	1	2	2
INK-842	11	477	466	0	3	4	0	0
INK-842	11	50	39	1	4	1	1	0
INK-842	11	101	90	1	5	1	1	0
INK-842	11	14	3	1	5	4	0	1
INK-842	12	136	124	1	3	5	1	0
INK-842	12	141	129	1	3	5	1	0
INK-843	12	155	143	1	3	5	1	0
INK-843	12	29	17	1	4	4	1	0
INK-843	13	29	16	1	3	4	1	0
INK-843	13	23	10	1	3	1	2	0
INK-843	14	136	122	1	3	1	1	1
INK-843	14	477	463	0	3	2	0	0
INK-843	15	477	462	0	3	4	0	0
INK-843	15	477	462	0	4	4	0	0
INK-843	15	477	462	0	3	1	0	0
INK-843	15	207	192	1	2	4	1	0
INK-844	15	423	408	1	5	3	0	0
INK-844	15	22	7	1	3	4	1	0
INK-844	16	477	461	0	3	1	0	0
INK-844	16	477	461	0	3	1	0	0
INK-844	16	477	461	0	3	4	0	0
INK-844	16	23	7	1	4	1	0	1
INK-844	16	37	21	1	3	5	1	0
INK-844	17	23	6	1	3	1	0	2
INK-844	17	477	460	0	3	1	0	0
INK-844	17	25	8	1	3	4	1	0
INK-845	17	25	8	1	4	4	1	0
INK-845	17	58	41	1	1	1	2	0
INK-845	17	291	274	1	2	1	0	0
INK-845	17	25	8	1	3	4	1	0
INK-845	17	25	8	1	3	4	1	0
INK-845	17	18	1	1	1	4	2	0
INK-845	17	39	22	1	3	5	1	0
INK-845	18	477	459	0	3	1	0	0
INK-845	18	64	46	1	3	5	1	0
INK-845	18	73	55	1	1	5	1	0
INK-846	18	87	69	1	1	1	1	0
INK-846	18	19	1	1	3	1	2	0
INK-846	18	21	3	1	3	1	1	0
INK-846	18	21	3	1	3	1	1	0
INK-846	18	19	1	1	4	5	0	0
INK-846	18	29	11	1	3	1	1	0
INK-846	19	23	4	1	1	1	2	0
INK-846	19	477	458	0	3	1	0	0
INK-846	19	177	158	1	3	4	1	0
INK-846	20	22	2	1	4	4	1	0
INK-847	21	477	456	0	3	2	0	0
INK-847	21	36	15	1	3	4	1	0
INK-847	21	36	15	1	1	5	2	0
INK-847	21	23	2	1	3	4	2	0
INK-847	21	477	456	0	3	4	0	0
INK-847	21	46	25	1	3	5	1	0
INK-847	21	29	8	1	5	4	1	0
INK-847	21	326	305	1	3	4	0	0
INK-847	21	477	456	0	3	2	0	0
INK-847	21	217	196	1	3	5	1	0
INK-848	21	217	196	1	3	5	1	0
INK-848	21	197	176	1	3	5	1	0
INK-848	21	477	456	0	3	5	0	0
INK-848	21	477	456	0	3	5	0	0
INK-848	21	70	49	1	1	1	3	0
INK-848	21	24	3	1	1	1	2	0
INK-848	22	477	455	0	4	2	0	0
INK-848	22	69	47	1	1	1	3	0
INK-848	22	29	7	1	1	1	1	0
INK-848	22	32	10	1	2	1	2	0
INK-849	22	25	3	1	3	4	1	0
INK-849	22	23	1	1	3	4	0	0
INK-849	22	30	8	1	3	1	1	0
INK-849	22	36	14	1	3	4	1	0
INK-849	22	29	7	1	1	5	1	0
INK-849	22	36	14	1	3	5	1	0
INK-849	22	30	8	1	3	1	2	0
INK-849	22	477	455	0	4	1	0	0
INK-849	22	113	91	1	3	1	0	1
INK-849	22	23	1	1	1	1	2	0
INK-850	23	420	397	1	3	5	0	1
INK-850	23	36	13	1	3	4	1	0
INK-850	23	36	13	1	4	4	1	0
INK-850	23	36	13	1	3	5	1	0
INK-850	23	29	6	1	2	1	1	0
INK-850	23	29	6	1	3	1	1	0
INK-850	23	33	10	1	3	1	0	0
INK-850	24	93	69	1	3	3	1	3
INK-850	24	93	69	1	3	3	1	1
INK-850	24	93	69	1	3	3	1	1
INK-851	24	477	453	0	3	5	0	0
INK-851	24	143	119	1	2	4	1	0
INK-851	24	87	63	1	1	1	0	0
INK-851	24	477	453	0	5	4	0	0
INK-851	25	94	69	1	3	5	0	0
INK-851	25	58	33	1	4	4	1	0
INK-851	25	45	20	1	3	2	1	0
INK-851	25	64	39	1	1	1	1	1
INK-851	25	477	452	0	3	4	0	1
INK-851	26	79	53	1	1	1	1	0
INK-852	28	46	18	1	1	1	2	0
INK-852	28	477	449	0	2	1	0	0
INK-852	28	37	9	1	3	1	1	0
INK-852	29	477	448	0	3	5	0	0
INK-852	29	30	1	1	5	1	1	0
INK-852	29	477	448	0	4	4	0	0
INK-852	29	477	448	0	3	1	0	0
INK-852	29	144	115	1	3	4	1	0
INK-852	29	477	448	0	3	5	0	0
INK-852	29	45	16	1	3	4	1	0
INK-853	29	45	16	1	3	4	1	0
INK-853	29	31	2	1	3	5	1	0
INK-853	30	278	248	1	3	4	1	0
INK-853	30	128	98	1	3	1	1	0
INK-853	30	477	447	0	3	1	0	0
INK-853	30	477	447	0	3	2	0	1
INK-853	30	477	447	0	3	5	0	0
INK-853	30	113	83	1	3	5	1	0
INK-853	30	57	27	1	3	5	1	0
INK-853	30	31	1	1	3	5	1	0
INK-854	30	31	1	1	3	5	1	0
INK-854	31	477	446	0	3	1	0	0
INK-854	31	477	446	0	3	4	0	0
INK-854	31	57	26	1	1	1	2	3
INK-854	31	195	164	1	3	1	1	0
INK-854	31	477	446	0	3	2	0	0
INK-854	31	48	17	1	3	4	1	0
INK-854	32	52	20	1	3	5	1	0
INK-854	32	48	16	1	3	5	1	0
INK-854	32	48	16	1	3	4	1	0
INK-855	32	36	4	1	3	4	1	0
INK-855	33	138	105	1	3	4	1	0
INK-855	33	35	2	1	3	1	0	0
INK-855	33	44	11	1	3	4	1	0
INK-855	34	477	443	0	4	4	0	0
INK-855	34	36	2	1	3	4	1	0
INK-855	34	477	443	0	3	4	0	0
INK-855	35	58	23	1	1	1	0	0
INK-855	35	195	160	1	3	2	1	1
INK-855	35	36	1	1	1	1	2	0
INK-856	35	64	29	1	3	4	1	1
INK-856	35	36	1	1	3	1	2	0
INK-856	36	80	44	1	1	1	1	0
INK-856	36	93	57	1	3	5	1	0
INK-856	36	37	1	1	3	4	0	0
INK-856	36	37	1	1	3	1	1	0
INK-856	36	477	441	0	3	4	0	2
INK-856	36	37	1	1	3	1	0	1
INK-856	36	37	1	1	3	1	0	1
INK-856	36	477	441	0	3	4	0	0
INK-857	36	477	441	0	3	4	0	0
INK-857	36	39	3	1	3	4	2	0
INK-857	37	38	1	1	3	1	0	0
INK-857	37	165	128	1	3	4	1	0
INK-857	37	50	13	1	4	4	2	0
INK-857	37	38	1	1	2	1	1	1
INK-857	37	46	9	1	4	4	2	0
INK-857	37	477	440	0	3	5	0	0
INK-857	37	477	440	0	3	5	0	0
INK-857	37	38	1	1	3	5	0	0
INK-858	37	477	440	0	3	4	0	0
INK-858	37	477	440	0	3	4	0	1
INK-858	37	49	12	1	3	5	0	0
INK-858	37	49	12	1	3	5	0	0
INK-858	37	49	12	1	3	5	0	2
INK-858	37	477	440	0	3	4	0	1
INK-858	37	49	12	1	3	5	0	0
INK-858	37	49	12	1	3	5	0	0
INK-858	37	49	12	1	3	5	0	1
INK-858	37	49	12	1	3	5	0	0
INK-859	37	49	12	1	3	5	0	0
INK-859	37	49	12	1	3	5	0	0
INK-859	37	477	440	0	3	4	0	2
INK-859	37	56	19	1	3	4	1	0
INK-859	37	394	357	1	3	4	0	2
INK-859	37	38	1	1	3	1	1	0
INK-859	37	56	19	1	1	1	1	0
INK-859	37	39	2	1	3	4	1	0
INK-859	37	38	1	1	1	1	0	1
INK-859	37	477	440	0	3	2	0	0
INK-860	37	112	75	1	1	1	2	0
INK-860	38	477	439	0	3	2	0	4
INK-860	38	155	117	1	3	4	0	3
INK-860	38	45	7	1	4	4	1	0
INK-860	38	45	7	1	3	4	1	0
INK-860	38	45	7	1	3	4	1	0
INK-860	38	477	439	0	3	4	0	0
INK-860	38	47	9	1	3	5	1	0
INK-860	38	45	7	1	3	2	1	1
INK-860	38	45	7	1	3	2	1	1
INK-861	38	45	7	1	4	4	1	0
INK-861	38	45	7	1	4	4	1	0
INK-861	38	47	9	1	3	4	1	1
INK-861	38	45	7	1	3	4	1	0
INK-861	38	48	10	1	1	5	1	0
INK-861	38	39	1	1	3	1	0	0
INK-861	39	40	1	1	3	1	0	1
INK-861	39	42	3	1	3	1	1	0
INK-861	39	477	438	0	5	4	0	0
INK-861	39	40	1	1	3	5	0	0
INK-862	39	123	84	1	3	2	1	2
INK-862	39	50	11	1	1	1	2	0
INK-862	39	477	438	0	3	1	0	0
INK-862	39	288	249	1	2	1	0	1
INK-862	39	101	62	1	1	1	0	0
INK-862	39	477	438	0	3	5	0	0
INK-862	39	43	4	1	4	4	1	0
INK-862	39	53	14	1	3	4	1	0
INK-862	39	56	17	1	1	1	0	0
INK-862	39	53	14	1	3	2	1	0
INK-863	40	422	382	1	1	5	1	0
INK-863	40	52	12	1	3	2	1	0
INK-863	40	52	12	1	3	4	1	1
INK-863	41	53	12	1	4	4	1	0
INK-863	41	53	12	1	3	2	1	0
INK-863	41	53	12	1	3	5	1	0
INK-863	41	42	1	1	4	4	1	0
INK-863	41	43	2	1	4	4	1	0
INK-863	42	43	1	1	3	1	0	0
INK-863	42	52	10	1	2	4	1	0
INK-864	42	477	435	0	4	5	0	0
INK-864	42	477	435	0	3	4	0	0
INK-864	43	44	1	1	3	1	1	0
INK-864	43	45	2	1	3	4	1	0
INK-864	43	45	2	1	3	5	1	0
INK-864	43	56	13	1	3	4	1	0
INK-864	43	477	434	0	4	4	0	0
INK-864	43	45	2	1	3	4	1	0
INK-864	43	53	10	1	4	3	1	1
INK-864	43	79	36	1	5	1	1	0
INK-865	44	182	138	1	3	4	3	0
INK-865	44	477	433	0	4	2	0	0
INK-865	44	45	1	1	3	4	2	0
INK-865	44	48	4	1	3	4	1	0
INK-865	44	183	139	1	3	4	3	0
INK-865	44	148	104	1	4	4	1	0
INK-865	44	53	9	1	3	2	1	0
INK-865	44	49	5	1	4	1	1	0
INK-865	44	45	1	1	3	1	0	0
INK-865	44	137	93	1	3	4	1	0
INK-866	44	262	218	1	3	4	1	1
INK-866	45	108	63	1	4	1	1	0
INK-866	45	47	2	1	2	1	1	0
INK-866	45	477	432	0	3	1	0	0
INK-866	45	54	9	1	4	5	1	0
INK-866	45	54	9	1	3	5	1	0
INK-866	45	54	9	1	4	4	1	0
INK-866	45	73	28	1	3	4	1	1
INK-866	46	51	5	1	3	2	1	0
INK-866	46	49	3	1	3	4	1	0
INK-867	46	54	8	1	3	4	1	0
INK-867	46	47	1	1	5	4	1	0
INK-867	46	477	431	0	3	2	0	0
INK-867	46	48	2	1	3	4	1	0
INK-867	46	52	6	1	3	5	1	0
INK-867	46	49	3	1	4	4	1	0
INK-867	46	47	1	1	1	1	1	0
INK-867	46	54	8	1	3	4	1	0
INK-867	46	54	8	1	3	5	1	0
INK-867	46	53	7	1	1	1	1	0
INK-868	46	48	2	1	5	4	1	0
INK-868	46	48	2	1	5	4	1	0
INK-868	46	48	2	1	4	4	1	0
INK-868	46	122	76	1	3	4	1	1
INK-868	46	101	55	1	3	4	1	1
INK-868	47	73	26	1	1	1	0	1
INK-868	47	477	430	0	3	5	0	0
INK-868	47	70	23	1	3	1	1	0
INK-868	48	255	207	1	3	4	1	4
INK-868	48	115	67	1	3	5	1	0
INK-869	48	126	78	1	3	5	1	0
INK-869	48	203	155	1	3	4	0	0
INK-869	48	49	1	1	5	1	2	0
INK-869	48	49	1	1	5	1	1	0
INK-869	49	58	9	1	1	5	1	0
INK-869	49	50	1	1	3	4	1	0
INK-869	49	51	2	1	3	5	1	0
INK-869	49	93	44	1	5	4	1	0
INK-869	49	50	1	1	3	4	1	0
INK-869	49	95	46	1	1	1	1	0
INK-870	49	114	65	1	1	4	1	0
INK-870	49	78	29	1	1	5	1	0
INK-870	49	99	50	1	1	5	1	0
INK-870	49	95	46	1	1	5	1	4
INK-870	49	108	59	1	1	5	1	4
INK-870	49	52	3	1	3	2	1	0
INK-870	49	50	1	1	5	1	0	0
INK-870	49	147	98	1	2	1	0	0
INK-870	49	87	38	1	4	1	1	0
INK-870	49	51	2	1	1	1	1	1
INK-871	50	52	2	1	4	4	1	0
INK-871	50	52	2	1	2	1	1	1
INK-871	50	477	427	0	2	1	0	1
INK-871	50	51	1	1	2	1	1	0
INK-871	50	322	272	1	5	4	0	0
INK-871	50	117	67	1	1	1	1	0
INK-871	50	477	427	0	3	1	0	0
INK-871	50	51	1	1	3	1	0	1
INK-871	50	477	427	0	3	1	0	0
INK-871	50	57	7	1	4	4	1	0
INK-872	50	56	6	1	2	1	0	0
INK-872	51	84	33	1	1	4	1	2
INK-872	51	477	426	0	3	4	0	0
INK-872	51	52	1	1	1	5	1	0
INK-872	51	477	426	0	3	5	0	0
INK-872	51	163	112	1	3	1	1	4
INK-872	51	122	71	1	5	4	1	0
INK-872	51	52	1	1	3	1	0	1
INK-872	51	52	1	1	3	4	1	0
INK-872	51	67	16	1	4	1	1	0
INK-873	51	58	7	1	2	4	1	0
INK-873	51	196	145	1	2	1	2	1
INK-873	51	52	1	1	3	1	1	0
INK-873	51	57	6	1	3	5	1	0
INK-873	51	57	6	1	3	5	1	0
INK-873	51	52	1	1	1	1	2	0
INK-873	51	57	6	1	2	5	1	0
INK-873	51	58	7	1	1	5	1	0
INK-873	51	52	1	1	3	1	1	0
INK-873	51	382	331	1	3	4	1	0
INK-874	51	86	35	1	1	1	1	0
INK-874	52	134	82	1	1	1	2	1
INK-874	52	95	43	1	5	4	1	0
INK-874	52	121	69	1	5	2	1	0
INK-874	52	164	112	1	5	2	1	0
INK-874	52	477	425	0	2	4	0	1
INK-874	52	54	2	1	3	4	1	0
INK-874	52	58	6	1	4	5	1	0
INK-874	52	54	2	1	4	4	1	0
INK-874	52	54	2	1	3	4	1	0
INK-875	52	58	6	1	1	5	1	1
INK-875	53	60	7	1	3	1	1	0
INK-875	53	54	1	1	3	1	0	1
INK-875	53	155	102	1	3	2	0	0
INK-875	53	54	1	1	1	1	1	0
INK-875	53	73	20	1	1	5	1	0
INK-875	53	79	26	1	1	4	1	0
INK-875	53	63	10	1	1	4	0	1
INK-875	53	64	11	1	1	4	1	0
INK-875	53	162	109	1	3	4	1	4
INK-876	53	58	5	1	1	5	1	0
INK-876	53	56	3	1	3	4	1	0
INK-876	53	56	3	1	3	5	1	0
INK-876	53	56	3	1	3	5	1	0
INK-876	53	56	3	1	3	5	1	0
INK-876	53	56	3	1	5	5	1	0
INK-876	53	56	3	1	3	5	1	0
INK-876	53	56	3	1	4	5	1	0
INK-876	53	162	109	1	3	4	1	0
INK-876	53	64	11	1	1	1	1	0
INK-877	53	203	150	1	3	1	0	0
INK-877	53	93	40	1	3	4	1	0
INK-877	54	56	2	1	5	1	2	0
INK-877	54	55	1	1	3	4	1	0
INK-877	54	55	1	1	3	4	1	0
INK-877	54	55	1	1	3	4	1	0
INK-877	55	56	1	1	1	1	1	0
INK-877	56	58	2	1	3	4	1	0
INK-877	56	69	13	1	1	5	1	0
INK-877	56	291	235	1	2	1	0	0
INK-878	56	133	77	1	2	1	1	1
INK-878	56	57	1	1	3	2	1	0
INK-878	56	394	338	1	3	4	0	0
INK-878	56	71	15	1	1	1	1	0
INK-878	56	477	421	0	3	4	0	0
INK-878	56	183	127	1	1	1	2	3
INK-878	56	73	17	1	1	5	1	0
INK-878	56	58	2	1	1	1	1	0
INK-878	56	57	1	1	4	4	1	1
INK-878	56	85	29	1	1	1	1	0
INK-879	56	155	99	1	3	4	1	1
INK-879	56	58	2	1	3	1	2	0
INK-879	57	58	1	1	4	4	1	0
INK-879	57	114	57	1	2	4	1	0
INK-879	57	477	420	0	3	4	0	0
INK-879	57	172	115	1	1	1	2	3
INK-879	57	163	106	1	1	4	1	0
INK-879	57	69	12	1	1	5	1	0
INK-879	57	73	16	1	1	1	2	0
INK-879	57	477	420	0	3	4	0	0
INK-880	57	68	11	1	1	1	1	0
INK-880	57	78	21	1	1	1	2	2
INK-880	58	87	29	1	1	1	1	0
INK-880	58	452	394	1	2	1	0	0
INK-880	58	93	35	1	1	4	1	1
INK-880	58	59	1	1	3	4	1	0
INK-880	58	73	15	1	1	1	0	1
INK-880	58	70	12	1	1	1	3	0
INK-880	58	73	15	1	1	1	1	0
INK-880	58	477	419	0	3	1	0	0
INK-881	58	59	1	1	3	4	1	0
INK-881	58	73	15	1	2	4	1	1
INK-881	58	76	18	1	1	1	1	1
INK-881	58	87	29	1	1	1	1	1
INK-881	58	59	1	1	3	4	1	1
INK-881	59	60	1	1	3	1	0	0
INK-881	59	134	75	1	3	1	1	0
INK-881	59	60	1	1	3	1	1	0
INK-881	59	64	5	1	1	5	1	0
INK-881	59	274	215	1	5	5	1	0
INK-882	59	338	279	1	2	1	0	0
INK-882	59	60	1	1	3	1	1	0
INK-882	59	477	418	0	3	1	0	0
INK-882	59	477	418	0	3	5	0	0
INK-882	59	73	14	1	3	1	1	0
INK-882	59	147	88	1	3	1	0	0
INK-882	59	61	2	1	1	1	1	0
INK-882	60	73	13	1	3	1	1	0
INK-882	60	477	417	0	3	4	0	0
INK-882	60	477	417	0	3	1	0	0
INK-883	60	78	18	1	1	1	1	0
INK-883	60	305	245	1	3	2	0	0
INK-883	60	72	12	1	3	5	1	0
INK-883	60	84	24	1	3	5	1	0
INK-883	60	66	6	1	3	1	1	1
INK-883	60	95	35	1	1	1	1	0
INK-883	60	144	84	1	1	1	3	1
INK-883	60	95	35	1	1	1	1	0
INK-883	60	141	81	1	3	2	1	0
INK-883	60	66	6	1	1	1	1	0
INK-884	60	73	13	1	3	4	1	0
INK-884	60	115	55	1	3	1	1	0
INK-884	60	73	13	1	1	4	1	0
INK-884	60	76	16	1	2	4	1	1
INK-884	60	477	417	0	3	4	0	0
INK-884	61	144	83	1	3	4	1	1
INK-884	61	65	4	1	3	4	0	1
INK-884	61	68	7	1	4	1	2	2
INK-884	62	63	1	1	3	1	0	0
INK-884	62	63	1	1	4	1	2	0
INK-885	62	72	10	1	1	5	1	0
INK-885	62	269	207	1	2	1	0	0
INK-885	62	84	22	1	1	5	1	0
INK-885	62	70	8	1	1	5	0	0
INK-885	62	67	5	1	1	1	1	0
INK-885	62	262	200	1	3	1	0	0
INK-885	63	73	10	1	1	1	2	1
INK-885	63	64	1	1	5	1	2	0
INK-885	63	195	132	1	3	5	1	1
INK-885	63	134	71	1	3	1	1	0
INK-886	63	67	4	1	1	1	1	0
INK-886	63	161	98	1	3	5	1	0
INK-886	63	477	414	0	3	4	0	0
INK-886	63	190	127	1	3	5	1	0
INK-886	63	477	414	0	3	5	0	0
INK-886	63	288	225	1	3	5	1	0
INK-886	63	195	132	1	3	2	1	3
INK-886	63	126	63	1	1	1	0	0
INK-886	63	394	331	1	3	4	0	1
INK-886	63	477	414	0	3	1	0	0
INK-887	63	64	1	1	3	1	0	0
INK-887	63	477	414	0	2	1	0	0
INK-887	63	102	39	1	1	1	1	0
INK-887	63	206	143	1	4	4	1	0
INK-887	63	147	84	1	3	4	0	0
INK-887	64	477	413	0	5	4	0	0
INK-887	64	73	9	1	3	4	1	0
INK-887	64	73	9	1	3	5	1	0
INK-887	64	73	9	1	3	5	1	0
INK-887	64	73	9	1	3	5	1	0
INK-888	64	295	231	1	3	5	1	2
INK-888	64	78	14	1	1	1	1	2
INK-888	64	70	6	1	1	1	1	1
INK-888	64	73	9	1	3	1	1	0
INK-888	64	73	9	1	3	1	1	1
INK-888	64	73	9	1	3	1	0	1
INK-888	64	477	413	0	3	4	0	3
INK-888	64	86	22	1	1	1	1	0
INK-888	64	74	10	1	4	4	1	0
INK-888	65	67	2	1	3	4	1	0
INK-889	65	66	1	1	3	4	3	0
INK-889	65	92	27	1	1	1	1	1
INK-889	66	224	158	1	1	1	1	1
INK-889	66	76	10	1	1	1	1	0
INK-889	66	477	411	0	3	1	0	0
INK-889	66	73	7	1	2	1	2	0
INK-889	66	308	242	1	3	1	1	2
INK-889	66	67	1	1	3	1	0	0
INK-889	66	477	411	0	3	1	2	1
INK-890	66	122	56	1	1	1	1	0
INK-890	66	85	19	1	1	1	1	0
INK-890	66	477	411	0	2	1	2	1
INK-890	67	80	13	1	2	1	1	0
INK-890	67	73	6	1	1	1	1	0
INK-890	67	77	10	1	1	1	1	0
INK-890	67	77	10	1	1	1	1	0
INK-890	67	147	80	1	4	1	0	0
INK-890	67	87	20	1	3	1	1	0
INK-890	67	79	12	1	1	1	0	0
INK-891	67	136	69	1	1	5	2	0
INK-891	67	69	2	1	3	4	1	0
INK-891	67	129	62	1	2	1	1	0
INK-891	67	70	3	1	3	1	0	0
INK-891	68	263	195	1	3	1	0	0
INK-891	68	76	8	1	1	1	1	0
INK-891	69	74	5	1	1	1	1	0
INK-891	70	288	218	1	4	1	0	0
INK-891	70	394	324	1	3	4	0	1
INK-891	70	81	11	1	4	4	1	0
INK-892	70	477	407	0	3	4	0	0
INK-892	70	477	407	0	3	4	0	0
INK-892	70	134	64	1	3	1	1	1
INK-892	70	71	1	1	3	4	0	0
INK-892	70	119	49	1	3	4	0	0
INK-892	70	79	9	1	1	4	1	4
INK-892	70	87	17	1	3	1	1	0
INK-892	70	71	1	1	3	1	1	0
INK-892	70	87	17	1	3	1	1	0
INK-892	70	477	407	0	4	1	0	0
INK-893	70	73	3	1	3	1	0	0
INK-893	70	81	11	1	3	1	1	0
INK-893	70	477	407	0	3	4	0	0
INK-893	71	143	72	1	4	3	0	0
INK-893	71	73	2	1	2	1	1	0
INK-893	71	78	7	1	1	4	1	0
INK-893	71	282	211	1	4	4	0	0
INK-893	71	189	118	1	3	4	0	0
INK-893	72	477	405	0	3	1	0	0
INK-893	72	266	194	1	3	4	0	3
INK-894	72	85	13	1	1	4	1	2
INK-894	72	184	112	1	2	1	0	0
INK-894	72	78	6	1	1	4	1	1
INK-894	72	86	14	1	1	1	1	0
INK-894	72	172	100	1	4	4	1	1
INK-894	72	74	2	1	4	4	1	1
INK-894	73	162	89	1	2	1	3	0
INK-894	73	77	4	1	2	1	0	0
INK-894	73	78	5	1	1	4	1	0
INK-894	73	477	404	0	3	1	0	1
INK-895	73	477	404	0	3	2	0	0
INK-895	73	477	404	0	4	2	0	0
INK-895	73	477	404	0	3	2	0	0
INK-895	73	477	404	0	3	4	0	0
INK-895	73	477	404	0	3	5	0	0
INK-895	73	108	35	1	1	4	1	2
INK-895	73	81	8	1	1	4	1	1
INK-895	73	81	8	1	1	4	1	1
INK-895	73	81	8	1	1	4	1	1
INK-895	73	81	8	1	1	4	1	1
INK-896	73	108	35	1	1	4	1	2
INK-896	73	105	32	1	1	5	1	0
INK-896	73	84	11	1	1	4	1	2
INK-896	73	93	20	1	1	4	1	1
INK-896	73	81	8	1	1	4	1	1
INK-896	73	81	8	1	1	4	1	1
INK-896	73	93	20	1	1	4	1	1
INK-896	73	114	41	1	3	5	1	0
INK-896	73	95	22	1	1	1	1	0
INK-896	74	477	403	0	3	4	0	0
INK-897	74	477	403	0	3	4	0	2
INK-897	74	477	403	0	2	3	0	1
INK-897	74	84	10	1	2	3	1	1
INK-897	74	92	18	1	1	5	1	0
INK-897	74	210	136	1	1	5	1	0
INK-897	74	84	10	1	1	5	1	0
INK-897	74	84	10	1	1	5	1	0
INK-897	74	141	67	1	1	5	2	0
INK-897	74	123	49	1	1	5	2	0
INK-897	74	165	91	1	1	5	1	0
INK-898	74	108	34	1	1	5	1	0
INK-898	74	206	132	1	1	5	1	0
INK-898	74	171	97	1	1	5	2	0
INK-898	74	178	104	1	2	5	1	0
INK-898	74	79	5	1	1	1	1	0
INK-898	74	310	236	1	3	5	1	0
INK-898	74	477	403	0	3	5	0	2
INK-898	74	303	229	1	1	5	1	0
INK-898	74	477	403	0	3	5	0	0
INK-898	74	141	67	1	3	5	2	0
INK-899	74	107	33	1	3	5	1	0
INK-899	74	477	403	0	3	5	0	0
INK-899	74	116	42	1	3	5	0	0
INK-899	74	210	136	1	3	5	1	0
INK-899	74	210	136	1	3	5	1	0
INK-899	74	302	228	1	3	5	1	0
INK-899	74	141	67	1	3	5	2	0
INK-899	74	322	248	1	3	5	1	0
INK-899	74	308	234	1	3	5	0	0
INK-899	74	128	54	1	3	5	0	0
INK-900	74	477	403	0	2	3	0	0
INK-900	74	477	403	0	3	5	0	0
INK-900	74	477	403	0	3	5	0	0
INK-900	74	424	350	1	3	5	1	0
INK-900	74	196	122	1	1	5	1	0
INK-900	74	196	122	1	1	5	1	0
INK-900	74	196	122	1	1	5	1	0
INK-900	74	438	364	1	2	5	1	0
INK-900	74	141	67	1	1	5	2	0
INK-900	74	477	403	0	3	1	0	0
INK-901	74	477	403	0	3	1	2	0
INK-901	74	107	33	1	1	1	1	0
INK-901	74	87	13	1	2	1	0	0
INK-901	74	227	153	1	3	4	2	0
INK-901	74	81	7	1	2	5	1	0
INK-901	74	94	20	1	3	3	0	0
INK-901	75	76	1	1	2	1	1	0
INK-901	76	477	401	0	2	1	0	0
INK-901	77	79	2	1	4	1	0	0
INK-901	77	78	1	1	4	1	1	0
INK-902	77	79	2	1	3	4	1	0
INK-902	77	78	1	1	3	1	0	0
INK-902	77	108	31	1	1	1	1	0
INK-902	77	477	400	0	3	4	0	0
INK-902	77	477	400	0	5	4	0	0
INK-902	77	78	1	1	3	1	0	0
INK-902	77	86	9	1	3	1	1	0
INK-902	77	81	4	1	1	1	1	0
INK-902	78	79	1	1	3	1	1	0
INK-902	78	424	346	1	3	1	0	0
INK-903	78	477	399	0	3	1	0	0
INK-903	78	93	15	1	2	1	3	0
INK-903	78	203	125	1	3	4	0	1
INK-903	78	114	36	1	3	4	1	0
INK-903	78	80	2	1	3	1	1	0
INK-903	78	80	2	1	3	1	1	0
INK-903	78	477	399	0	3	4	0	0
INK-903	79	109	30	1	1	1	0	0
INK-903	79	80	1	1	1	1	1	1
INK-903	79	477	398	0	4	1	0	0
INK-904	79	477	398	0	4	1	0	0
INK-904	79	121	42	1	5	4	1	0
INK-904	79	93	14	1	1	4	1	1
INK-904	79	477	398	0	3	2	0	2
INK-904	79	477	398	0	4	5	0	0
INK-904	79	105	26	1	1	1	1	0
INK-904	79	477	398	0	3	1	0	0
INK-904	79	81	2	1	1	1	1	0
INK-904	79	477	398	0	4	5	0	0
INK-904	79	84	5	1	3	3	0	1
INK-905	79	477	398	0	3	2	0	1
INK-905	79	92	13	1	3	4	1	0
INK-905	80	477	397	0	3	1	0	0
INK-905	80	112	32	1	1	1	1	0
INK-905	80	477	397	0	3	1	0	0
INK-905	80	477	397	0	3	1	0	0
INK-905	80	322	242	1	3	4	0	1
INK-905	80	86	6	1	1	1	1	0
INK-905	80	477	397	0	3	4	0	0
INK-905	80	95	15	1	3	3	1	3
INK-906	80	87	7	1	1	1	1	0
INK-906	80	289	209	1	2	4	2	1
INK-906	81	85	4	1	3	1	0	0
INK-906	81	86	5	1	1	1	1	0
INK-906	81	144	63	1	4	4	1	0
INK-906	81	87	6	1	1	1	1	0
INK-906	81	477	396	0	4	2	0	0
INK-906	81	85	4	1	3	5	1	0
INK-906	82	95	13	1	4	1	2	0
INK-906	82	93	11	1	5	3	1	0
INK-907	83	142	59	1	3	4	1	0
INK-907	83	477	394	0	5	1	0	0
INK-907	84	86	2	1	2	1	0	0
INK-907	84	128	44	1	1	5	1	0
INK-907	84	134	50	1	1	5	1	0
INK-907	84	276	192	1	3	1	0	0
INK-907	84	112	28	1	1	5	1	0
INK-907	84	86	2	1	1	1	1	0
INK-907	84	477	393	0	3	5	0	0
INK-907	84	477	393	0	3	5	0	0
INK-908	84	477	393	0	3	1	0	2
INK-908	84	86	2	1	1	5	1	0
INK-908	84	86	2	1	1	1	0	1
INK-908	84	395	311	1	4	2	1	0
INK-908	84	477	393	0	4	4	0	0
INK-908	84	477	393	0	4	4	0	0
INK-908	84	477	393	0	3	4	0	0
INK-908	84	101	17	1	4	1	1	0
INK-908	84	143	59	1	3	4	1	0
INK-908	84	105	21	1	4	4	1	0
INK-909	84	85	1	1	3	4	0	0
INK-909	84	193	109	1	3	1	2	1
INK-909	85	86	1	1	3	3	0	0
INK-909	85	86	1	1	3	4	3	0
INK-909	85	92	7	1	2	1	1	0
INK-909	85	477	392	0	4	4	0	0
INK-909	85	204	119	1	3	4	0	1
INK-909	85	87	2	1	1	1	1	0
INK-909	85	204	119	1	2	1	0	0
INK-909	85	86	1	1	2	1	1	0
INK-910	85	114	29	1	2	4	1	1
INK-910	86	269	183	1	1	1	0	1
INK-910	86	95	9	1	3	1	1	0
INK-910	86	102	16	1	3	1	2	0
INK-910	87	93	6	1	1	1	0	1
INK-910	87	92	5	1	3	1	0	0
INK-910	87	88	1	1	3	5	1	0
INK-910	87	93	6	1	3	4	2	0
INK-910	87	93	6	1	5	1	1	0
INK-910	87	184	97	1	3	4	2	1
INK-911	87	93	6	1	1	1	2	0
INK-911	87	88	1	1	3	1	0	1
INK-911	87	477	390	0	3	4	0	0
INK-911	87	108	21	1	1	1	2	0
INK-911	88	477	389	0	3	4	0	0
INK-911	88	113	25	1	4	4	0	1
INK-911	88	477	389	0	3	2	0	0
INK-911	88	477	389	0	4	1	0	0
INK-911	88	94	6	1	3	4	0	1
INK-911	89	121	32	1	4	1	2	0
INK-912	91	94	3	1	2	1	0	0
INK-912	91	92	1	1	1	4	1	0
INK-912	91	323	232	1	2	1	0	1
INK-912	91	477	386	0	3	1	0	0
INK-912	92	107	15	1	4	3	1	1
INK-912	92	129	37	1	3	4	1	0
INK-912	92	324	232	1	4	2	1	0
INK-912	93	95	2	1	5	1	0	0
INK-912	93	94	1	1	2	5	1	0
INK-912	93	94	1	1	4	4	0	0
INK-913	93	477	384	0	4	4	0	0
INK-913	93	94	1	1	2	4	1	0
INK-913	93	452	359	1	2	1	0	0
INK-913	93	477	384	0	2	4	0	0
INK-913	93	218	125	1	3	4	1	0
INK-913	93	218	125	1	3	5	1	1
INK-913	93	121	28	1	4	4	1	0
INK-913	93	99	6	1	4	4	0	0
INK-913	93	130	37	1	3	4	1	1
INK-913	94	477	383	0	3	4	0	0
INK-914	94	101	7	1	4	4	1	0
INK-914	94	129	35	1	2	1	1	1
INK-914	94	477	383	0	3	5	2	0
INK-914	95	194	99	1	3	1	1	0
INK-914	95	108	13	1	1	1	1	1
INK-914	95	108	13	1	1	1	1	0
INK-914	97	477	380	0	3	1	0	0
INK-914	97	101	4	1	1	1	1	0
INK-914	97	121	24	1	1	1	0	0
INK-914	98	99	1	1	4	1	0	1
INK-915	98	247	149	1	3	3	0	0
INK-915	98	101	3	1	4	4	0	0
INK-915	98	101	3	1	1	4	1	0
INK-915	99	184	85	1	3	2	2	0
INK-915	99	121	22	1	3	4	1	0
INK-915	99	477	378	0	4	4	0	0
INK-915	100	105	5	1	1	1	1	0
INK-915	100	477	377	0	3	5	0	1
INK-915	101	112	11	1	1	1	1	1
INK-915	101	211	110	1	1	1	1	1
INK-916	101	102	1	1	3	4	1	0
INK-916	101	477	376	0	3	2	0	1
INK-916	101	102	1	1	4	1	0	1
INK-916	101	105	4	1	3	1	1	0
INK-916	101	323	222	1	3	1	0	0
INK-916	101	477	376	0	4	4	0	0
INK-916	102	477	375	0	3	1	0	0
INK-916	102	423	321	1	4	2	0	0
INK-916	102	477	375	0	4	2	0	0
INK-916	102	126	24	1	1	1	1	0
INK-917	102	477	375	0	3	5	0	0
INK-917	102	477	375	0	3	3	0	0
INK-917	103	477	374	0	3	5	0	4
INK-917	103	477	374	0	3	1	0	0
INK-917	103	135	32	1	3	1	2	0
INK-917	104	477	373	0	2	4	0	0
INK-917	104	136	32	1	2	1	1	0
INK-917	105	106	1	1	5	1	1	0
INK-917	105	242	137	1	3	4	0	0
INK-917	105	129	24	1	1	4	1	0
INK-918	105	108	3	1	2	4	1	0
INK-918	105	133	28	1	3	5	2	0
INK-918	105	217	112	1	4	4	0	1
INK-918	105	106	1	1	3	5	2	0
INK-918	105	477	372	0	3	5	0	0
INK-918	105	202	97	1	4	1	1	0
INK-918	105	107	2	1	3	5	1	0
INK-918	106	191	85	1	4	2	1	1
INK-918	106	121	15	1	3	3	1	1
INK-918	106	477	371	0	2	4	0	0
INK-919	106	129	23	1	1	1	1	0
INK-919	106	477	371	0	3	1	0	0
INK-919	106	477	371	0	3	4	0	1
INK-919	106	477	371	0	3	4	0	0
INK-919	106	134	28	1	1	1	1	0
INK-919	106	477	371	0	3	4	0	0
INK-919	106	121	15	1	1	1	1	0
INK-919	106	112	6	1	3	4	1	0
INK-919	106	112	6	1	3	4	1	0
INK-919	107	108	1	1	3	1	1	1
INK-920	107	283	176	1	2	1	0	1
INK-920	107	133	26	1	1	1	1	0
INK-920	107	133	26	1	1	1	0	1
INK-920	107	108	1	1	3	4	1	0
INK-920	107	108	1	1	4	4	1	0
INK-920	107	477	370	0	3	4	0	0
INK-920	107	108	1	1	3	4	2	0
INK-920	107	477	370	0	3	1	0	0
INK-920	107	108	1	1	3	1	1	0
INK-920	107	108	1	1	3	1	0	0
INK-921	107	108	1	1	4	4	2	0
INK-921	107	121	14	1	1	1	1	0
INK-921	107	114	7	1	1	5	1	0
INK-921	107	121	14	1	1	1	1	0
INK-921	107	121	14	1	4	5	1	0
INK-921	108	149	41	1	3	1	2	0
INK-921	108	121	13	1	3	1	2	1
INK-921	108	197	89	1	2	1	1	0
INK-921	108	477	369	0	3	1	0	0
INK-921	108	477	369	0	3	2	0	0
INK-922	108	477	369	0	3	1	0	0
INK-922	108	477	369	0	4	3	0	0
INK-922	108	380	272	1	2	4	1	0
INK-922	108	112	4	1	4	5	1	0
INK-922	109	110	1	1	3	4	0	0
INK-922	109	114	5	1	5	1	1	0
INK-922	109	121	12	1	3	4	0	1
INK-922	109	110	1	1	3	4	1	1
INK-922	109	477	368	0	4	4	2	0
INK-922	109	114	5	1	3	1	2	0
INK-923	110	114	4	1	1	1	1	0
INK-923	110	220	110	1	3	4	0	0
INK-923	111	346	235	1	3	4	0	1
INK-923	111	477	366	0	3	1	0	0
INK-923	111	143	32	1	1	1	2	0
INK-923	111	266	155	1	3	5	0	0
INK-923	112	206	94	1	3	4	1	0
INK-923	112	113	1	1	4	5	1	0
INK-923	112	121	9	1	3	1	0	1
INK-923	112	477	365	0	3	4	0	0
INK-924	112	221	109	1	4	4	1	0
INK-924	112	113	1	1	3	1	2	0
INK-924	113	114	1	1	3	1	0	1
INK-924	113	114	1	1	1	1	1	0
INK-924	113	114	1	1	4	1	0	1
INK-924	113	123	10	1	4	1	0	1
INK-924	113	134	21	1	1	1	1	0
INK-924	113	477	364	0	3	4	0	0
INK-924	113	305	192	1	3	5	0	0
INK-924	113	121	8	1	4	4	1	0
INK-925	113	126	13	1	1	1	0	0
INK-925	113	121	8	1	3	4	0	0
INK-925	114	115	1	1	4	1	0	1
INK-925	114	477	363	0	3	5	2	0
INK-925	114	123	9	1	4	5	1	0
INK-925	114	116	2	1	3	1	0	0
INK-925	114	121	7	1	1	1	1	0
INK-925	114	164	50	1	2	1	2	0
INK-925	114	148	34	1	3	1	3	0
INK-925	115	116	1	1	3	1	0	0
INK-926	115	121	6	1	3	4	0	1
INK-926	115	129	14	1	1	1	1	1
INK-926	115	154	39	1	1	1	0	0
INK-926	116	121	5	1	1	1	1	1
INK-926	116	477	361	0	4	3	0	0
INK-926	116	129	13	1	4	4	1	1
INK-926	116	121	5	1	4	4	1	0
INK-926	116	423	307	1	3	1	0	0
INK-926	116	477	361	0	3	1	0	1
INK-926	117	123	6	1	2	1	1	0
INK-927	117	121	4	1	3	4	0	0
INK-927	117	121	4	1	4	1	0	0
INK-927	117	477	360	0	3	4	0	0
INK-927	118	122	4	1	3	1	0	0
INK-927	119	121	2	1	3	4	1	0
INK-927	119	121	2	1	3	4	1	0
INK-927	119	198	79	1	2	4	2	1
INK-927	119	477	358	0	2	4	0	0
INK-927	119	477	358	0	3	4	0	0
INK-927	119	120	1	1	2	1	0	1
INK-928	120	183	63	1	2	2	2	1
INK-928	120	477	357	0	3	1	0	0
INK-928	121	129	8	1	2	4	1	0
INK-928	121	136	15	1	3	4	1	0
INK-928	121	136	15	1	2	4	1	0
INK-928	121	136	15	1	2	4	1	0
INK-928	121	143	22	1	2	4	1	0
INK-928	121	126	5	1	1	1	1	0
INK-928	121	122	1	1	4	4	1	0
INK-928	121	226	105	1	3	1	4	0
INK-929	121	122	1	1	1	1	0	1
INK-929	122	123	1	1	3	1	0	1
INK-929	122	136	14	1	3	3	1	0
INK-929	122	123	1	1	1	1	1	0
INK-929	122	477	355	0	3	5	0	0
INK-929	122	141	19	1	3	1	1	1
INK-929	123	204	81	1	1	5	1	0
INK-929	123	477	354	0	3	4	0	0
INK-929	123	124	1	1	3	1	0	0
INK-929	123	136	13	1	4	1	1	0
INK-930	123	477	354	0	4	4	0	0
INK-930	124	183	59	1	2	4	1	0
INK-930	124	126	2	1	3	1	0	0
INK-930	126	477	351	0	3	4	0	0
INK-930	126	134	8	1	3	1	2	0
INK-930	126	143	17	1	3	4	1	0
INK-930	126	127	1	1	1	4	1	0
INK-930	126	477	351	0	2	4	0	0
INK-930	126	477	351	0	3	1	0	0
INK-930	126	129	3	1	3	4	1	0
INK-931	126	144	18	1	3	3	1	1
INK-931	126	477	351	0	4	2	0	0
INK-931	126	196	70	1	3	2	1	0
INK-931	126	196	70	1	3	5	1	0
INK-931	126	196	70	1	3	5	1	0
INK-931	127	252	125	1	3	1	0	0
INK-931	127	141	14	1	3	2	2	1
INK-931	128	129	1	1	4	1	2	0
INK-931	128	129	1	1	5	4	1	0
INK-931	128	129	1	1	5	4	1	0
INK-932	128	141	13	1	2	5	2	1
INK-932	128	129	1	1	5	1	1	0
INK-932	128	141	13	1	3	5	2	0
INK-932	128	129	1	1	4	4	1	0
INK-932	128	129	1	1	1	1	1	0
INK-932	128	394	266	1	3	4	0	1
INK-932	128	148	20	1	3	1	2	0
INK-932	128	477	349	0	3	2	0	0
INK-932	129	477	348	0	4	1	0	0
INK-932	129	158	29	1	2	1	0	0
INK-933	129	130	1	1	3	4	1	0
INK-933	129	130	1	1	1	1	1	0
INK-933	130	131	1	1	3	1	1	0
INK-933	130	136	6	1	5	1	1	0
INK-933	130	477	347	0	3	4	0	0
INK-933	130	477	347	0	4	2	0	0
INK-933	130	133	3	1	1	1	1	0
INK-933	130	142	12	1	3	2	1	1
INK-933	130	142	12	1	3	2	1	1
INK-933	130	131	1	1	4	1	1	0
INK-934	130	477	347	0	4	5	0	0
INK-934	130	134	4	1	3	1	0	0
INK-934	131	132	1	1	3	1	1	0
INK-934	131	262	131	1	4	4	0	0
INK-934	131	394	263	1	3	4	0	0
INK-934	131	394	263	1	3	4	0	0
INK-934	131	394	263	1	3	4	0	0
INK-934	131	477	346	0	5	4	0	0
INK-934	131	134	3	1	5	4	1	0
INK-934	132	142	10	1	2	1	2	0
INK-935	133	134	1	1	5	1	1	0
INK-935	133	182	49	1	2	1	1	0
INK-935	133	187	54	1	3	4	1	0
INK-935	133	206	73	1	1	5	1	0
INK-935	133	136	3	1	3	4	1	0
INK-935	133	147	14	1	3	4	2	0
INK-935	133	148	15	1	3	4	0	0
INK-935	133	136	3	1	3	4	1	0
INK-935	133	134	1	1	1	1	1	0
INK-935	133	136	3	1	3	1	2	0
INK-936	133	477	344	0	3	5	0	0
INK-936	133	134	1	1	3	5	1	0
INK-936	133	134	1	1	3	4	1	0
INK-936	133	464	331	1	3	4	1	0
INK-936	134	477	343	0	3	4	0	0
INK-936	134	135	1	1	3	5	1	1
INK-936	134	165	31	1	1	1	1	0
INK-936	134	169	35	1	3	4	0	0
INK-936	134	162	28	1	3	5	1	0
INK-936	134	135	1	1	1	1	0	0
INK-937	134	148	14	1	2	1	1	0
INK-937	134	477	343	0	3	1	0	0
INK-937	134	141	7	1	4	4	2	0
INK-937	135	136	1	1	1	1	2	0
INK-937	135	172	37	1	2	1	2	0
INK-937	135	477	342	0	3	4	0	0
INK-937	135	331	196	1	2	2	1	0
INK-937	135	282	147	1	2	5	1	1
INK-937	135	477	342	0	5	4	0	0
INK-937	135	136	1	1	2	1	0	0
INK-938	135	196	61	1	2	1	2	1
INK-938	135	136	1	1	1	1	1	0
INK-938	135	477	342	0	3	1	0	0
INK-938	135	148	13	1	4	4	1	0
INK-938	135	144	9	1	1	1	1	0
INK-938	135	477	342	0	3	3	0	0
INK-938	135	147	12	1	3	5	1	0
INK-938	136	137	1	1	4	4	0	0
INK-938	136	477	341	0	4	1	0	0
INK-938	136	477	341	0	4	4	0	0
INK-939	136	477	341	0	4	1	0	0
INK-939	136	477	341	0	3	2	0	0
INK-939	136	137	1	1	2	4	1	0
INK-939	136	179	43	1	3	1	0	0
INK-939	136	172	36	1	3	5	2	0
INK-939	136	477	341	0	3	1	0	0
INK-939	136	477	341	0	3	3	0	0
INK-939	136	137	1	1	3	1	2	0
INK-939	137	162	25	1	3	1	3	2
INK-939	137	477	340	0	3	1	0	0
INK-940	137	224	87	1	5	4	0	0
INK-940	138	139	1	1	1	1	0	0
INK-940	138	141	3	1	4	1	1	0
INK-940	139	141	2	1	4	1	4	0
INK-940	140	477	337	0	3	1	0	0
INK-940	140	477	337	0	3	1	0	0
INK-940	141	142	1	1	1	1	1	0
INK-940	141	477	336	0	3	2	0	1
INK-940	141	142	1	1	1	1	1	1
INK-940	141	144	3	1	3	4	2	0
INK-941	141	477	336	0	2	4	0	0
INK-941	141	220	79	1	3	2	0	2
INK-941	141	477	336	0	3	5	0	0
INK-941	141	477	336	0	2	1	0	0
INK-941	141	142	1	1	3	1	1	0
INK-941	142	143	1	1	4	1	1	0
INK-941	142	143	1	1	2	1	1	0
INK-941	142	477	335	0	3	4	0	0
INK-941	142	163	21	1	3	4	1	1
INK-941	142	143	1	1	3	1	0	1
INK-942	142	143	1	1	3	5	1	0
INK-942	142	143	1	1	2	1	1	0
INK-942	142	477	335	0	4	4	0	1
INK-942	142	150	8	1	3	4	1	1
INK-942	142	193	51	1	3	5	1	0
INK-942	142	143	1	1	2	4	1	0
INK-942	142	144	2	1	3	1	1	0
INK-942	142	143	1	1	1	1	1	1
INK-942	142	143	1	1	3	2	1	0
INK-942	142	477	335	0	2	1	0	0
INK-943	143	477	334	0	3	2	0	1
INK-943	143	477	334	0	3	4	0	0
INK-943	143	477	334	0	3	2	0	0
INK-943	143	477	334	0	2	1	0	0
INK-943	143	477	334	0	3	1	0	0
INK-943	143	199	56	1	3	4	1	0
INK-943	144	150	6	1	4	4	1	0
INK-943	144	145	1	1	1	1	1	1
INK-943	144	219	75	1	2	4	1	0
INK-943	144	191	47	1	2	1	2	0
INK-944	144	155	11	1	3	1	1	1
INK-944	145	276	131	1	3	1	0	1
INK-944	145	423	278	1	3	1	0	0
INK-944	145	288	143	1	3	4	1	0
INK-944	145	183	38	1	1	1	1	0
INK-944	145	477	332	0	4	1	0	0
INK-944	145	227	82	1	3	4	4	1
INK-944	145	477	332	0	5	1	0	0
INK-944	145	477	332	0	4	1	0	0
INK-944	145	477	332	0	3	1	0	0
INK-945	146	477	331	0	3	1	0	0
INK-945	146	162	16	1	1	5	1	0
INK-945	147	155	8	1	4	1	1	0
INK-945	147	477	330	0	3	1	0	0
INK-945	147	477	330	0	4	1	0	0
INK-945	147	270	123	1	3	4	1	2
INK-945	147	181	34	1	3	4	2	0
INK-945	147	477	330	0	3	4	2	0
INK-945	148	163	15	1	1	1	2	0
INK-945	148	426	278	1	3	1	1	0
INK-946	148	149	1	1	4	4	1	0
INK-946	148	477	329	0	3	5	0	2
INK-946	148	477	329	0	3	4	0	0
INK-946	148	163	15	1	3	1	1	0
INK-946	148	152	4	1	4	4	1	0
INK-946	148	477	329	0	3	4	0	0
INK-946	148	149	1	1	2	1	0	0
INK-946	148	171	23	1	1	1	2	0
INK-946	148	165	17	1	2	1	2	0
INK-946	148	477	329	0	3	4	2	0
INK-947	148	191	43	1	3	4	1	0
INK-947	148	477	329	0	3	1	0	0
INK-947	148	149	1	1	5	1	0	0
INK-947	149	214	65	1	3	5	0	0
INK-947	149	394	245	1	3	2	0	1
INK-947	149	394	245	1	3	2	0	1
INK-947	149	154	5	1	3	4	1	1
INK-947	149	477	328	0	3	2	0	2
INK-947	149	477	328	0	3	4	0	2
INK-947	149	477	328	0	3	4	0	1
INK-948	149	477	328	0	3	4	0	1
INK-948	150	429	279	1	2	1	0	0
INK-948	150	158	8	1	4	1	0	0
INK-948	150	195	45	1	4	4	1	0
INK-948	151	477	326	0	3	4	0	2
INK-948	151	477	326	0	3	4	0	1
INK-948	151	189	38	1	3	5	1	0
INK-948	151	165	14	1	3	5	1	0
INK-948	151	194	43	1	3	5	1	0
INK-948	151	196	45	1	3	5	1	0
INK-949	151	196	45	1	1	5	1	0
INK-949	151	183	32	1	3	5	1	1
INK-949	151	152	1	1	4	1	0	0
INK-949	151	172	21	1	2	1	2	1
INK-949	151	164	13	1	2	1	2	1
INK-949	151	477	326	0	3	5	0	0
INK-949	151	477	326	0	4	1	0	0
INK-949	151	477	326	0	3	1	0	0
INK-949	151	477	326	0	3	5	0	0
INK-949	151	203	52	1	4	2	2	2
INK-950	151	172	21	1	3	1	2	0
INK-950	151	477	326	0	3	5	0	0
INK-950	151	477	326	0	3	5	0	0
INK-950	151	193	42	1	4	5	1	0
INK-950	152	217	65	1	4	4	1	0
INK-950	152	477	325	0	3	5	0	0
INK-950	153	163	10	1	3	4	0	0
INK-950	153	477	324	0	3	4	0	0
INK-950	153	161	8	1	5	4	3	0
INK-950	153	154	1	1	3	4	0	1
INK-951	154	224	70	1	3	2	1	4
INK-951	154	191	37	1	3	5	1	0
INK-951	154	192	38	1	3	5	1	0
INK-951	154	184	30	1	3	5	1	0
INK-951	154	179	25	1	3	5	1	0
INK-951	154	179	25	1	3	5	1	0
INK-951	154	179	25	1	3	5	1	0
INK-951	154	155	1	1	5	4	3	0
INK-951	154	155	1	1	4	4	3	0
INK-951	154	182	28	1	4	1	2	0
INK-952	154	378	224	1	4	1	0	1
INK-952	154	184	30	1	4	1	0	0
INK-952	154	171	17	1	3	4	0	0
INK-952	154	477	323	0	3	3	0	0
INK-952	154	177	23	1	3	1	3	0
INK-952	155	402	247	1	3	1	0	0
INK-952	155	477	322	0	3	1	0	0
INK-952	155	477	322	0	3	1	0	0
INK-952	155	477	322	0	2	1	0	0
INK-952	155	477	322	0	3	5	0	0
INK-953	155	164	9	1	1	1	2	0
INK-953	155	477	322	0	3	4	0	0
INK-953	156	180	24	1	5	1	1	0
INK-953	156	157	1	1	3	1	0	0
INK-953	156	157	1	1	3	1	0	0
INK-953	156	477	321	0	3	1	0	0
INK-953	156	477	321	0	3	1	0	0
INK-953	156	477	321	0	3	4	0	1
INK-953	156	163	7	1	3	4	1	0
INK-953	156	161	5	1	3	4	1	0
INK-954	156	236	80	1	1	1	0	1
INK-954	156	477	321	0	3	4	0	0
INK-954	156	477	321	0	3	4	0	0
INK-954	156	477	321	0	3	2	0	1
INK-954	156	477	321	0	2	1	0	0
INK-954	156	165	9	1	3	4	1	0
INK-954	157	226	69	1	4	1	3	0
INK-954	157	158	1	1	3	1	0	0
INK-954	157	168	11	1	4	2	0	0
INK-954	157	161	4	1	5	4	2	0
INK-955	157	477	320	0	4	4	0	0
INK-955	157	165	8	1	4	4	1	0
INK-955	158	343	185	1	3	1	1	1
INK-955	158	477	319	0	4	5	0	0
INK-955	158	184	26	1	1	1	2	1
INK-955	158	347	189	1	3	2	1	0
INK-955	158	477	319	0	3	1	0	0
INK-955	158	176	18	1	3	2	1	0
INK-955	158	477	319	0	3	1	0	0
INK-955	159	477	318	0	3	1	0	0
INK-956	159	178	19	1	3	4	0	0
INK-956	159	160	1	1	3	4	0	0
INK-956	159	217	58	1	5	1	1	0
INK-956	159	193	34	1	4	5	1	0
INK-956	161	162	1	1	3	2	2	0
INK-956	161	477	316	0	3	2	0	0
INK-956	161	162	1	1	3	2	1	0
INK-956	161	263	102	1	2	1	3	0
INK-956	161	162	1	1	3	1	0	1
INK-956	162	347	185	1	3	4	0	0
INK-957	162	163	1	1	3	1	2	0
INK-957	162	168	6	1	3	5	1	0
INK-957	162	164	2	1	3	5	1	0
INK-957	162	164	2	1	3	4	2	1
INK-957	163	331	168	1	2	5	1	0
INK-957	163	198	35	1	2	1	2	1
INK-957	163	218	55	1	2	1	1	0
INK-957	163	402	239	1	3	1	0	0
INK-957	163	183	20	1	3	4	1	0
INK-957	163	165	2	1	3	4	1	0
INK-958	163	182	19	1	4	1	2	0
INK-958	163	185	22	1	5	1	3	0
INK-958	163	477	314	0	3	1	0	0
INK-958	164	192	28	1	3	1	0	1
INK-958	164	191	27	1	3	1	2	0
INK-958	164	175	11	1	5	1	1	0
INK-958	164	477	313	0	3	5	0	0
INK-958	164	324	160	1	2	1	0	0
INK-958	164	185	21	1	3	4	1	0
INK-958	164	165	1	1	3	1	1	0
INK-959	164	165	1	1	5	1	1	0
INK-959	164	165	1	1	3	1	1	0
INK-959	164	477	313	0	3	2	0	0
INK-959	165	185	20	1	3	4	1	1
INK-959	165	172	7	1	4	4	2	0
INK-959	165	172	7	1	2	4	3	0
INK-959	165	477	312	0	5	2	0	0
INK-959	165	166	1	1	3	1	0	0
INK-959	165	477	312	0	3	1	0	0
INK-959	165	172	7	1	3	2	2	0
INK-960	166	477	311	0	4	4	0	0
INK-960	166	168	2	1	3	1	1	0
INK-960	166	204	38	1	1	4	0	0
INK-960	166	192	26	1	3	1	2	0
INK-960	167	477	310	0	3	2	0	0
INK-960	167	477	310	0	3	2	0	0
INK-960	167	168	1	1	3	2	0	1
INK-960	167	477	310	0	3	2	0	1
INK-960	168	303	135	1	3	5	0	1
INK-960	168	477	309	0	3	2	0	0
INK-961	168	477	309	0	3	2	0	1
INK-961	169	477	308	0	3	4	0	0
INK-961	169	477	308	0	3	4	0	0
INK-961	169	477	308	0	3	1	0	0
INK-961	169	209	40	1	3	4	0	0
INK-961	169	193	24	1	3	4	0	0
INK-961	169	189	20	1	3	1	0	1
INK-961	169	477	308	0	3	4	0	0
INK-961	170	282	112	1	4	1	0	0
INK-961	170	194	24	1	3	4	1	0
INK-962	170	477	307	0	3	4	0	0
INK-962	170	477	307	0	4	4	0	0
INK-962	170	184	14	1	1	1	1	0
INK-962	170	171	1	1	3	4	1	0
INK-962	170	178	8	1	3	4	1	0
INK-962	170	477	307	0	3	4	0	0
INK-962	170	477	307	0	3	1	0	0
INK-962	170	179	9	1	3	1	3	0
INK-962	170	477	307	0	3	4	0	0
INK-962	171	178	7	1	3	1	2	1
INK-963	171	477	306	0	3	1	0	0
INK-963	171	477	306	0	5	4	0	0
INK-963	171	172	1	1	3	1	0	0
INK-963	171	184	13	1	2	1	2	0
INK-963	171	177	6	1	3	1	2	1
INK-963	171	304	133	1	2	1	2	3
INK-963	171	184	13	1	3	1	2	1
INK-963	171	220	49	1	3	5	2	0
INK-963	171	172	1	1	4	4	2	0
INK-963	171	477	306	0	4	4	0	0
INK-964	171	192	21	1	3	1	0	1
INK-964	171	477	306	0	4	2	0	1
INK-964	172	240	68	1	3	4	1	0
INK-964	172	205	33	1	3	1	1	0
INK-964	172	477	305	0	3	4	0	0
INK-964	172	177	5	1	2	1	0	0
INK-964	172	338	166	1	2	1	3	2
INK-964	172	477	305	0	3	4	0	1
INK-964	172	477	305	0	3	4	0	0
INK-964	172	190	18	1	3	1	0	1
INK-965	173	477	304	0	3	5	0	0
INK-965	173	477	304	0	3	5	0	0
INK-965	174	477	303	0	3	3	0	0
INK-965	174	175	1	1	4	2	0	2
INK-965	175	184	9	1	3	1	2	0
INK-965	175	213	38	1	3	1	2	0
INK-965	175	477	302	0	4	4	0	0
INK-965	175	477	302	0	3	1	0	0
INK-965	175	198	23	1	3	1	2	1
INK-965	175	186	11	1	3	4	2	0
INK-966	176	180	4	1	3	4	1	0
INK-966	176	477	301	0	3	4	0	0
INK-966	176	477	301	0	3	2	0	4
INK-966	176	477	301	0	3	2	0	1
INK-966	176	225	49	1	3	1	1	0
INK-966	176	183	7	1	3	1	3	0
INK-966	177	178	1	1	4	4	1	0
INK-966	177	477	300	0	3	1	0	1
INK-966	177	191	14	1	3	1	0	1
INK-966	177	197	20	1	3	2	0	0
INK-967	177	197	20	1	3	2	0	0
INK-967	177	197	20	1	3	2	0	0
INK-967	177	180	3	1	2	4	2	0
INK-967	177	477	300	0	3	4	0	0
INK-967	177	183	6	1	3	4	1	0
INK-967	177	477	300	0	4	4	0	0
INK-967	177	185	8	1	2	1	2	0
INK-967	177	182	5	1	3	1	2	0
INK-967	177	477	300	0	3	4	0	0
INK-967	177	477	300	0	3	4	0	1
INK-968	177	477	300	0	3	4	2	0
INK-968	177	185	8	1	3	4	1	0
INK-968	177	477	300	0	3	4	0	1
INK-968	177	477	300	0	3	1	0	0
INK-968	177	180	3	1	3	1	2	0
INK-968	177	477	300	0	3	4	0	0
INK-968	178	184	6	1	3	4	1	0
INK-968	178	191	13	1	3	4	1	0
INK-968	178	213	35	1	4	2	1	0
INK-968	178	477	299	0	3	4	0	0
INK-969	178	182	4	1	3	4	0	2
INK-969	178	217	39	1	3	4	2	0
INK-969	179	197	18	1	3	4	1	0
INK-969	179	223	44	1	3	1	4	1
INK-969	180	212	32	1	4	1	2	0
INK-969	180	184	4	1	3	4	1	0
INK-969	180	477	297	0	3	1	0	0
INK-969	180	324	144	1	3	2	1	1
INK-969	182	477	295	0	3	4	0	0
INK-969	182	477	295	0	3	4	0	0
INK-970	182	409	227	1	4	4	0	2
INK-970	182	194	12	1	3	5	1	0
INK-970	182	371	189	1	3	4	0	0
INK-970	182	193	11	1	3	1	1	1
INK-970	182	204	22	1	3	4	1	0
INK-970	182	186	4	1	3	1	0	1
INK-970	183	191	8	1	2	1	2	0
INK-970	183	184	1	1	1	4	2	0
INK-970	183	184	1	1	3	1	2	1
INK-970	183	477	294	0	5	1	0	0
INK-971	183	452	269	1	2	4	0	0
INK-971	183	184	1	1	3	1	0	1
INK-971	183	477	294	0	3	2	0	1
INK-971	183	263	80	1	3	5	1	0
INK-971	183	263	80	1	3	5	1	0
INK-971	183	290	107	1	3	5	1	0
INK-971	183	477	294	0	3	5	0	1
INK-971	183	477	294	0	3	5	0	0
INK-971	183	477	294	0	3	4	0	0
INK-971	183	477	294	0	3	1	0	0
INK-972	183	477	294	0	3	2	0	1
INK-972	183	477	294	0	3	2	0	1
INK-972	183	477	294	0	3	2	0	1
INK-972	183	477	294	0	3	2	0	1
INK-972	183	477	294	0	3	2	0	1
INK-972	183	477	294	0	3	2	0	1
INK-972	183	204	21	1	3	2	1	1
INK-972	183	477	294	0	3	2	0	0
INK-972	183	477	294	0	4	1	0	0
INK-972	183	184	1	1	5	4	3	0
INK-973	183	191	8	1	3	4	1	0
INK-973	183	184	1	1	2	1	0	0
INK-973	183	477	294	0	3	4	0	0
INK-973	183	477	294	0	3	4	0	0
INK-973	183	184	1	1	5	4	2	0
INK-973	184	252	68	1	4	1	0	0
INK-973	184	185	1	1	4	1	0	0
INK-973	184	295	111	1	3	5	1	0
INK-973	184	263	79	1	3	5	1	0
INK-973	184	477	293	0	3	1	0	1
INK-974	184	477	293	0	3	2	0	0
INK-974	184	477	293	0	3	4	0	0
INK-974	184	185	1	1	3	4	1	0
INK-974	184	191	7	1	3	1	3	1
INK-974	184	185	1	1	3	1	0	0
INK-974	184	196	12	1	3	1	0	0
INK-974	184	189	5	1	3	1	0	0
INK-974	184	477	293	0	3	1	0	0
INK-974	184	203	19	1	3	4	2	0
INK-974	184	477	293	0	3	2	0	1
INK-975	184	199	15	1	3	5	1	0
INK-975	184	195	11	1	3	5	1	0
INK-975	184	303	119	1	3	5	1	3
INK-975	184	200	16	1	3	5	1	1
INK-975	184	191	7	1	3	1	2	0
INK-975	184	199	15	1	2	1	2	1
INK-975	184	185	1	1	3	1	0	1
INK-975	184	185	1	1	5	4	2	0
INK-975	185	195	10	1	4	1	1	0
INK-975	185	186	1	1	3	4	0	0
INK-976	185	477	292	0	3	4	0	0
INK-976	185	477	292	0	2	1	2	0
INK-976	185	199	14	1	3	1	2	1
INK-976	185	477	292	0	3	5	0	0
INK-976	185	324	139	1	2	1	0	0
INK-976	185	204	19	1	3	4	2	0
INK-976	185	192	7	1	3	1	2	0
INK-976	185	477	292	0	3	4	0	0
INK-976	185	191	6	1	3	4	2	0
INK-976	185	186	1	1	1	1	2	0
INK-977	185	186	1	1	1	1	2	0
INK-977	186	193	7	1	3	1	2	0
INK-977	186	189	3	1	4	1	3	0
INK-977	186	477	291	0	3	4	0	0
INK-977	186	477	291	0	3	4	0	0
INK-977	186	187	1	1	3	4	0	0
INK-977	186	408	222	1	3	4	2	1
INK-977	188	198	10	1	1	1	1	0
INK-977	189	190	1	1	3	4	0	0
INK-977	189	477	288	0	3	4	0	0
INK-978	189	477	288	0	3	1	0	0
INK-978	189	239	50	1	3	5	1	0
INK-978	189	477	288	0	3	1	0	0
INK-978	189	423	234	1	3	1	0	1
INK-978	189	192	3	1	4	1	2	0
INK-978	189	192	3	1	3	4	2	0
INK-978	189	477	288	0	3	4	0	0
INK-978	190	477	287	0	4	4	1	0
INK-978	190	283	93	1	1	1	3	0
INK-978	190	191	1	1	1	1	2	0
INK-979	190	211	21	1	3	5	1	0
INK-979	190	218	28	1	3	1	0	1
INK-979	190	219	29	1	3	4	1	0
INK-979	190	203	13	1	4	1	3	0
INK-979	190	477	287	0	3	1	0	0
INK-979	190	221	31	1	3	4	2	1
INK-979	190	477	287	0	3	4	0	0
INK-979	191	477	286	0	3	4	0	0
INK-979	191	477	286	0	3	5	0	1
INK-979	191	192	1	1	3	5	1	0
INK-980	191	477	286	0	4	4	0	0
INK-980	191	193	2	1	3	4	2	0
INK-980	191	477	286	0	3	4	0	0
INK-980	191	421	230	1	3	4	1	1
INK-980	191	192	1	1	1	4	2	0
INK-980	191	477	286	0	4	4	0	0
INK-980	191	205	14	1	3	4	4	0
INK-980	191	193	2	1	3	4	1	0
INK-980	191	303	112	1	2	5	1	0
INK-980	191	192	1	1	3	4	1	0
INK-981	191	193	2	1	3	1	3	0
INK-981	191	199	8	1	3	4	2	0
INK-981	191	477	286	0	2	1	2	1
INK-981	191	477	286	0	5	5	0	0
INK-981	191	477	286	0	4	5	0	0
INK-981	191	199	8	1	1	1	1	0
INK-981	191	477	286	0	3	5	0	1
INK-981	191	196	5	1	1	1	1	0
INK-981	191	194	3	1	3	4	1	0
INK-981	191	194	3	1	3	2	1	0
INK-982	191	194	3	1	3	4	1	0
INK-982	191	194	3	1	3	4	1	1
INK-982	191	194	3	1	3	2	1	0
INK-982	191	194	3	1	3	2	1	0
INK-982	192	477	285	0	4	1	0	0
INK-982	192	242	50	1	4	4	0	1
INK-982	192	477	285	0	3	2	0	0
INK-982	192	477	285	0	3	1	0	0
INK-982	192	477	285	0	3	1	0	0
INK-982	192	197	5	1	3	4	0	0
INK-983	192	477	285	0	3	1	0	0
INK-983	192	477	285	0	3	1	0	0
INK-983	192	198	6	1	1	1	0	2
INK-983	192	213	21	1	1	5	1	0
INK-983	192	205	13	1	3	1	0	0
INK-983	192	196	4	1	3	4	0	0
INK-983	192	477	285	0	3	4	0	0
INK-983	192	477	285	0	4	4	0	1
INK-983	192	203	11	1	3	1	2	0
INK-983	193	196	3	1	1	5	2	1
INK-984	193	477	284	0	3	4	0	0
INK-984	193	203	10	1	3	1	2	0
INK-984	193	196	3	1	1	1	2	2
INK-984	193	477	284	0	3	4	0	0
INK-984	193	477	284	0	3	4	0	0
INK-984	193	477	284	0	3	4	0	0
INK-984	193	203	10	1	3	2	1	0
INK-984	193	196	3	1	2	1	2	1
INK-984	193	477	284	0	2	1	0	0
INK-984	193	477	284	0	3	4	0	0
INK-985	195	228	33	1	3	2	1	1
INK-985	195	217	22	1	2	4	1	0
INK-985	195	200	5	1	3	2	1	0
INK-985	195	225	30	1	3	4	1	0
INK-985	195	477	282	0	3	5	0	0
INK-985	196	198	2	1	1	1	1	0
INK-985	196	197	1	1	3	1	0	1
INK-985	196	197	1	1	1	1	2	0
INK-985	196	200	4	1	2	5	1	0
INK-985	196	227	31	1	3	4	3	0
INK-986	196	199	3	1	1	1	2	0
INK-986	196	214	18	1	1	5	1	0
INK-986	196	204	8	1	1	5	1	0
INK-986	196	477	281	0	3	2	0	0
INK-986	196	477	281	0	3	2	0	1
INK-986	196	197	1	1	3	1	1	0
INK-986	196	198	2	1	3	1	1	0
INK-986	196	219	23	1	1	4	1	0
INK-986	197	198	1	1	3	2	0	0
INK-986	197	311	114	1	3	4	1	0
INK-987	197	477	280	0	3	4	0	0
INK-987	197	199	2	1	3	4	1	0
INK-987	197	199	2	1	4	1	2	0
INK-987	197	203	6	1	3	4	2	0
INK-987	197	212	15	1	2	1	1	0
INK-987	197	311	114	1	3	4	0	1
INK-987	197	198	1	1	4	1	0	1
INK-987	197	212	15	1	3	5	1	0
INK-987	197	294	97	1	3	1	3	1
INK-987	197	477	280	0	3	4	1	1
INK-988	197	198	1	1	3	1	1	0
INK-988	197	199	2	1	3	4	2	0
INK-988	198	203	5	1	3	4	0	0
INK-988	198	204	6	1	3	4	0	0
INK-988	198	260	62	1	3	1	3	0
INK-988	198	212	14	1	1	5	1	1
INK-988	198	200	2	1	3	4	1	0
INK-988	198	213	15	1	1	5	1	0
INK-988	198	203	5	1	3	4	3	0
INK-988	198	477	279	0	4	5	0	0
INK-989	198	202	4	1	3	4	1	1
INK-989	198	288	90	1	3	1	3	0
INK-989	199	203	4	1	3	1	1	1
INK-989	199	204	5	1	3	5	1	0
INK-989	199	220	21	1	3	4	0	1
INK-989	199	203	4	1	3	4	1	0
INK-989	199	477	278	0	2	1	0	0
INK-989	199	212	13	1	3	4	1	0
INK-989	199	477	278	0	3	1	0	0
INK-989	199	228	29	1	3	4	2	0
INK-990	200	477	277	0	2	1	1	0
INK-990	200	477	277	0	3	5	0	0
INK-990	200	201	1	1	3	5	2	0
INK-990	200	201	1	1	3	5	1	0
INK-990	200	477	277	0	4	4	0	0
INK-990	200	211	11	1	4	1	0	0
INK-990	202	204	2	1	3	1	1	0
INK-990	202	477	275	0	3	2	0	0
INK-990	202	203	1	1	1	1	2	0
INK-990	202	203	1	1	3	4	2	0
INK-991	202	203	1	1	1	1	2	0
INK-991	202	203	1	1	1	1	2	0
INK-991	202	259	57	1	3	4	1	0
INK-991	203	263	60	1	3	5	1	3
INK-991	203	205	2	1	4	1	1	0
INK-991	203	214	11	1	4	5	1	0
INK-991	203	214	11	1	4	5	1	0
INK-991	203	259	56	1	3	4	1	0
INK-991	203	219	16	1	1	4	0	1
INK-991	203	224	21	1	3	4	1	0
INK-992	203	399	196	1	2	1	1	1
INK-992	203	204	1	1	3	5	1	0
INK-992	203	204	1	1	2	1	0	1
INK-992	203	211	8	1	2	1	2	2
INK-992	203	477	274	0	3	3	0	1
INK-992	203	477	274	0	2	1	0	0
INK-992	203	212	9	1	4	3	1	1
INK-992	203	206	3	1	4	1	1	0
INK-992	204	214	10	1	4	5	1	0
INK-992	204	205	1	1	3	2	0	0
INK-993	204	452	248	1	2	1	0	0
INK-993	204	205	1	1	3	1	0	1
INK-993	204	287	83	1	1	1	3	0
INK-993	204	219	15	1	4	4	1	0
INK-993	204	205	1	1	3	1	1	0
INK-993	204	206	2	1	2	1	4	0
INK-993	204	214	10	1	1	1	2	1
INK-993	204	211	7	1	3	5	0	0
INK-993	204	217	13	1	3	4	1	3
INK-993	204	205	1	1	1	1	2	1
INK-994	205	477	272	0	3	1	0	0
INK-994	205	477	272	0	3	4	0	0
INK-994	205	207	2	1	3	4	2	0
INK-994	205	284	79	1	3	2	0	0
INK-994	205	217	12	1	3	4	2	0
INK-994	205	477	272	0	3	1	0	0
INK-994	205	212	7	1	3	1	2	0
INK-994	205	213	8	1	3	4	1	0
INK-994	205	477	272	0	3	5	0	0
INK-994	205	206	1	1	2	1	1	0
INK-995	205	213	8	1	3	4	0	0
INK-995	205	206	1	1	3	5	4	0
INK-995	205	206	1	1	3	5	0	0
INK-995	205	477	272	0	3	2	0	0
INK-995	205	477	272	0	3	5	0	0
INK-995	205	266	61	1	3	5	0	1
INK-995	205	477	272	0	3	5	0	0
INK-995	205	394	189	1	3	1	0	0
INK-995	205	477	272	0	3	4	0	0
INK-996	205	477	272	0	3	1	0	0
INK-996	206	208	2	1	4	2	0	1
INK-996	206	240	34	1	3	4	1	0
INK-996	206	477	271	0	3	5	0	0
INK-996	206	421	215	1	3	5	1	0
INK-996	206	477	271	0	3	5	0	0
INK-996	206	477	271	0	3	5	0	0
INK-996	206	214	8	1	3	1	0	1
INK-996	206	207	1	1	3	5	0	0
INK-996	206	214	8	1	1	1	2	0
INK-997	206	477	271	0	4	5	0	1
INK-997	206	477	271	0	4	4	0	0
INK-997	206	219	13	1	2	1	3	0
INK-997	206	477	271	0	3	1	0	0
INK-997	206	477	271	0	3	4	0	0
INK-997	206	295	89	1	3	1	1	1
INK-997	206	219	13	1	3	4	1	0
INK-997	207	225	18	1	4	4	1	1
INK-997	207	211	4	1	3	1	2	0
INK-997	207	212	5	1	3	5	1	0
INK-998	207	477	270	0	3	1	0	0
INK-998	207	213	6	1	3	5	1	1
INK-998	207	477	270	0	3	1	0	0
INK-998	207	324	117	1	2	1	0	1
INK-998	207	477	270	0	3	5	0	0
INK-998	207	211	4	1	3	1	2	0
INK-998	207	211	4	1	3	4	2	0
INK-998	207	211	4	1	3	4	2	0
INK-998	207	212	5	1	3	1	2	0
INK-998	208	477	269	0	4	4	0	0
INK-999	209	286	77	1	4	5	0	1
INK-999	209	257	48	1	4	5	1	1
INK-999	209	477	268	0	2	1	0	0
INK-999	209	477	268	0	2	1	0	0
INK-999	209	210	1	1	3	1	1	0
INK-999	210	214	4	1	3	1	1	0
INK-999	210	211	1	1	3	1	1	0
INK-999	210	394	184	1	3	4	0	0
INK-999	210	477	267	0	3	1	0	0
INK-999	211	306	95	1	3	5	0	0
UME-320	6	477	471	0	3	1	0	0
UME-320	9	477	468	0	3	1	0	0
UME-321	11	477	466	0	3	5	0	0
UME-321	11	477	466	0	2	5	0	0
UME-321	14	477	463	0	3	1	0	0
UME-321	16	477	461	0	3	1	0	0
UME-321	17	477	460	0	3	4	1	0
UME-321	23	477	454	0	3	1	0	0
UME-321	32	477	445	0	2	4	2	0
UME-321	46	477	431	0	2	1	0	0
UME-321	53	54	1	1	3	1	1	0
UME-321	60	477	417	0	3	4	0	0
UME-322	63	477	414	0	3	1	0	0
UME-322	65	477	412	0	3	1	1	0
UME-322	65	155	90	1	3	1	1	0
UME-322	71	287	216	1	3	4	1	0
UME-322	73	477	404	0	3	1	1	0
UME-322	73	77	4	1	2	5	1	0
UME-322	74	80	6	1	3	1	1	0
UME-322	77	228	151	1	3	4	1	0
UME-322	78	316	238	1	5	5	1	0
UME-322	100	477	377	0	4	4	0	0
UME-323	102	477	375	0	4	4	0	0
UME-323	115	477	362	0	4	4	0	0
UME-323	116	477	361	0	1	1	0	0
UME-323	122	477	355	0	3	1	0	0
UME-323	122	477	355	0	3	1	0	0
UME-323	122	477	355	0	1	1	0	0
UME-323	148	477	329	0	3	1	0	0
UME-323	151	191	40	1	3	1	2	0
UME-323	153	477	324	0	2	5	0	0
UME-323	154	260	106	1	3	4	1	0
UME-324	156	477	321	0	3	4	1	0
UME-324	157	477	320	0	3	1	0	0
UME-324	158	477	319	0	3	4	0	0
UME-324	158	326	168	1	3	5	1	0
UME-324	158	477	319	0	3	5	0	0
UME-324	163	477	314	0	1	1	0	0
UME-324	169	240	71	1	3	4	1	4
UME-324	170	182	12	1	4	1	0	1
UME-324	178	477	299	0	4	5	0	1
UME-324	179	477	298	0	3	4	0	0
UME-325	179	477	298	0	3	2	0	0
UME-325	179	477	298	0	3	4	0	0
UME-325	179	477	298	0	3	2	0	1
UME-325	183	317	134	1	2	1	1	0
UME-325	189	198	9	1	3	1	1	0
UME-325	192	477	285	0	3	1	0	0
UME-325	193	477	284	0	3	2	1	0
UME-325	194	195	1	1	3	1	1	0
UME-325	194	477	283	0	3	2	0	0
UME-325	196	477	281	0	5	5	0	0
UME-326	204	477	273	0	3	2	0	0
UME-326	207	477	270	0	1	1	1	0
UME-326	207	477	270	0	3	4	0	0
UME-326	207	477	270	0	3	2	0	0
UME-326	208	477	269	0	5	1	0	0
UME-326	217	232	15	1	3	1	1	1
UME-326	220	477	257	0	4	1	0	0
UME-326	224	257	33	1	3	1	1	0
UME-326	224	477	253	0	3	2	0	0
UME-326	226	277	51	1	3	4	1	0
UME-327	239	248	9	1	3	1	1	0
UME-327	241	477	236	0	3	5	1	1
UME-327	247	477	230	0	3	5	1	0
UME-327	249	477	228	0	3	1	0	0
UME-327	268	323	55	1	3	1	0	0
UME-327	283	309	26	1	3	4	1	0
UME-327	283	309	26	1	3	4	1	0
UME-327	294	477	183	0	3	1	1	0
UME-327	298	304	6	1	3	1	1	0
UME-327	305	477	172	0	3	1	0	0
UME-328	309	311	2	1	3	4	1	0
UME-328	310	324	14	1	3	4	1	3
UME-328	311	324	13	1	3	4	1	0
UME-328	315	477	162	0	3	5	0	0
UME-328	315	326	11	1	3	5	0	0
UME-328	315	332	17	1	3	5	0	0
UME-328	315	332	17	1	3	5	0	0
UME-328	315	332	17	1	3	5	0	0
UME-328	315	329	14	1	3	5	0	0
UME-328	315	332	17	1	3	5	0	0
UME-329	315	372	57	1	3	5	1	0
UME-329	315	372	57	1	3	5	0	0
UME-329	315	372	57	1	3	5	0	0
UME-329	315	332	17	1	3	5	0	0
UME-329	325	326	1	1	3	1	1	1
UME-329	326	337	11	1	3	5	1	1
UME-329	326	337	11	1	3	5	1	0
UME-329	329	477	148	0	3	1	0	0
UME-329	329	369	40	1	3	1	1	0
UME-329	329	331	2	1	3	1	1	0
UME-330	336	477	141	0	3	4	0	0
UME-330	336	477	141	0	3	2	0	0
UME-330	337	372	35	1	3	5	0	0
UME-330	337	369	32	1	3	5	1	0
UME-330	338	477	139	0	3	1	0	0
UME-330	339	477	138	0	3	5	0	0
UME-330	350	477	127	0	3	1	0	0
UME-330	351	477	126	0	4	3	0	0
UME-330	359	477	118	0	2	1	0	0
UME-330	360	477	117	0	3	4	0	0
P-276	8	9	1	1	3	1	1	0
P-276	11	477	466	0	3	4	0	0
P-277	38	39	1	1	3	1	1	0
P-277	53	477	424	0	4	1	0	0
P-277	58	128	70	1	3	1	0	1
P-277	63	64	1	1	3	1	1	0
P-277	64	477	413	0	4	1	0	0
P-277	65	245	180	1	3	1	0	0
P-277	74	75	1	1	3	1	1	1
P-277	75	76	1	1	5	5	0	0
P-277	88	92	4	1	2	1	0	0
P-277	88	477	389	0	3	1	0	0
P-278	88	477	389	0	3	1	0	0
P-278	92	93	1	1	3	1	1	0
P-278	92	93	1	1	3	1	1	0
P-278	105	106	1	1	3	1	0	0
P-278	105	129	24	1	3	4	0	1
P-278	106	107	1	1	3	4	0	0
P-278	106	107	1	1	3	4	0	0
P-278	106	107	1	1	3	4	0	0
P-278	106	477	371	0	3	4	0	0
P-278	116	117	1	1	2	1	1	0
P-279	123	135	12	1	3	1	0	0
P-279	127	128	1	1	3	1	0	0
P-279	128	129	1	1	3	1	1	0
P-279	136	190	54	1	4	1	0	0
P-279	150	477	327	0	3	1	0	0
P-279	158	477	319	0	3	1	0	0
P-279	162	163	1	1	3	1	0	0
P-279	162	190	28	1	3	1	0	0
P-279	168	169	1	1	3	1	0	0
P-279	170	171	1	1	3	1	0	0
P-280	182	183	1	1	3	1	0	0
P-280	183	477	294	0	4	4	0	0
P-280	186	187	1	1	3	1	0	0
P-280	193	194	1	1	4	1	0	0
P-280	196	206	10	1	3	1	1	0
P-280	197	199	2	1	4	1	0	0
P-280	200	477	277	0	3	1	0	0
P-280	202	477	275	0	3	1	0	0
P-280	206	477	271	0	4	1	0	0
P-280	217	477	260	0	3	1	0	0
P-281	219	245	26	1	3	1	1	0
P-281	232	263	31	1	3	1	0	0
P-281	240	241	1	1	3	1	0	0
P-281	247	477	230	0	3	1	1	0
P-281	253	477	224	0	3	1	0	0
P-281	256	308	52	1	3	4	0	0
P-281	259	477	218	0	3	1	0	0
P-281	263	264	1	1	3	1	0	0
P-281	276	282	6	1	2	1	0	1
P-281	276	477	201	0	3	1	0	0
P-282	281	477	196	0	3	1	0	0
P-282	283	284	1	1	3	1	0	0
P-282	283	284	1	1	3	1	0	0
P-282	295	296	1	1	3	1	0	0
P-282	308	477	169	0	3	1	0	0
P-282	311	477	166	0	3	1	2	0
P-282	312	323	11	1	3	1	0	0
P-282	323	324	1	1	3	1	0	0
P-282	332	477	145	0	3	1	0	1
P-282	332	340	8	1	1	1	0	0
P-283	333	334	1	1	3	1	0	0
P-283	340	342	2	1	3	1	1	0
P-283	345	477	132	0	3	1	0	0
P-283	350	477	127	0	3	1	0	0
P-283	351	477	126	0	4	4	0	0
P-283	354	355	1	1	3	1	0	0
P-283	354	355	1	1	3	1	0	0
R-125	205	210	5	1	3	1	0	0
EEMARKER-10	190	477	287	0	4	4	0	0
EEMARKER-10	207	477	270	0	3	2	0	0
EEMARKER-10	219	220	1	1	3	1	0	0
EEMARKER-10	239	240	1	1	4	2	0	0
EEMARKER-10	262	268	6	1	2	4	0	0
EEMARKER-10	292	477	185	0	3	1	0	0
EEMARKER-10	302	314	12	1	3	1	0	0
EEMARKER-10	324	477	153	0	3	2	0	0
EEMARKER-10	329	477	148	0	3	1	0	0
EEMARKER-10	330	331	1	1	4	1	1	0
EEMARKER-11	332	339	7	1	3	4	0	0
EEMARKER-11	337	477	140	0	4	4	0	0
EEMARKER-11	359	477	118	0	2	5	1	0
EEMARKER-8	17	28	11	1	3	1	0	0
EEMARKER-8	33	34	1	1	3	1	1	0
EEMARKER-8	47	48	1	1	3	1	0	0
EEMARKER-9	48	51	3	1	2	1	0	0
EEMARKER-9	63	64	1	1	4	1	0	0
EEMARKER-9	71	72	1	1	3	4	1	0
EEMARKER-9	94	95	1	1	4	1	0	0
EEMARKER-9	107	249	142	1	3	1	0	0
EEMARKER-9	113	126	13	1	3	1	0	0
EEMARKER-9	127	477	350	0	3	1	0	0
EEMARKER-9	148	477	329	0	4	5	0	0
EEMARKER-9	161	162	1	1	3	1	1	0
EEMARKER-9	164	477	313	0	3	2	0	0
PSERVER-48	2	477	475	0	4	5	0	0
PSERVER-48	35	477	442	0	3	1	0	0
PSERVER-48	106	141	35	1	3	1	1	0
PSERVER-48	106	477	371	0	3	1	1	0
PSERVER-48	124	316	192	1	3	1	0	0
PSERVER-48	311	477	166	0	4	1	0	0
ARPUMP-36	44	45	1	1	4	4	1	0
ARPUMP-36	73	74	1	1	3	1	1	0
ARPUMP-36	80	99	19	1	3	4	1	1
ARPUMP-36	93	118	25	1	3	1	1	0
ARPUMP-36	93	155	62	1	4	1	1	0
ARPUMP-37	93	477	384	0	3	1	0	0
ARPUMP-37	93	477	384	0	3	4	0	0
ARPUMP-37	94	477	383	0	3	4	0	0
ARPUMP-37	116	118	2	1	3	1	1	0
ARPUMP-37	118	477	359	0	3	4	0	2
ARPUMP-37	118	477	359	0	3	4	0	1
ARPUMP-37	123	125	2	1	3	2	1	0
ARPUMP-37	124	155	31	1	3	2	1	0
ARPUMP-37	127	477	350	0	5	1	0	1
ARPUMP-37	159	160	1	1	3	1	1	0
ARPUMP-38	239	240	1	1	4	4	0	0
ODE-417	1	2	1	1	3	1	1	0
ODE-417	1	16	15	1	3	1	0	0
ODE-417	1	2	1	1	3	1	1	0
ODE-417	1	477	476	0	3	1	0	0
ODE-418	1	477	476	0	3	1	0	1
ODE-418	1	477	476	0	3	4	0	0
ODE-418	1	59	58	1	3	4	1	0
ODE-418	2	16	14	1	4	1	0	0
ODE-418	2	4	2	1	3	1	1	0
ODE-418	2	3	1	1	3	3	1	0
ODE-418	2	32	30	1	3	4	0	0
ODE-418	2	477	475	0	3	1	0	0
ODE-418	2	9	7	1	3	3	0	0
ODE-418	2	477	475	0	3	4	0	0
ODE-419	2	477	475	0	3	1	0	0
ODE-419	2	7	5	1	3	1	1	0
ODE-419	2	10	8	1	3	4	1	0
ODE-419	3	4	1	1	3	1	1	0
ODE-419	3	477	474	0	3	1	0	0
ODE-419	3	477	474	0	3	2	0	0
ODE-419	3	15	12	1	3	5	1	0
ODE-419	3	15	12	1	3	5	1	0
ODE-419	3	15	12	1	3	5	1	0
ODE-419	3	15	12	1	3	5	1	0
ODE-420	3	15	12	1	3	5	1	0
ODE-420	3	15	12	1	3	5	1	0
ODE-420	3	35	32	1	3	5	1	0
ODE-420	3	15	12	1	3	5	1	0
ODE-420	3	15	12	1	3	5	1	0
ODE-420	3	15	12	1	3	5	1	0
ODE-420	3	15	12	1	3	5	1	0
ODE-420	3	15	12	1	3	5	1	0
ODE-420	3	15	12	1	3	5	1	0
ODE-420	3	15	12	1	3	5	1	0
ODE-421	3	15	12	1	3	5	1	0
ODE-421	3	17	14	1	3	5	1	0
ODE-421	3	15	12	1	3	5	1	0
ODE-421	3	15	12	1	3	5	1	0
ODE-421	3	15	12	1	3	5	1	0
ODE-421	3	477	474	0	3	5	0	0
ODE-421	3	477	474	0	3	5	0	0
ODE-421	3	65	62	1	3	1	1	0
ODE-421	3	122	119	1	3	4	1	1
ODE-421	3	30	27	1	3	1	0	0
ODE-422	3	4	1	1	3	4	0	0
ODE-422	3	7	4	1	3	1	0	0
ODE-422	3	4	1	1	3	1	1	1
ODE-422	3	26	23	1	3	1	0	0
ODE-422	3	477	474	0	3	1	0	0
ODE-422	4	11	7	1	3	4	1	0
ODE-422	4	477	473	0	3	1	0	0
ODE-422	4	16	12	1	3	5	0	0
ODE-422	4	53	49	1	3	5	0	0
ODE-422	4	5	1	1	3	1	1	1
ODE-423	4	7	3	1	4	1	1	0
ODE-423	4	7	3	1	3	1	0	0
ODE-423	4	10	6	1	3	1	1	0
ODE-423	4	70	66	1	3	2	1	0
ODE-423	4	477	473	0	3	2	0	0
ODE-423	4	18	14	1	3	1	1	0
ODE-423	4	16	12	1	3	1	1	0
ODE-423	5	8	3	1	3	1	1	0
ODE-423	5	21	16	1	3	1	1	0
ODE-423	5	11	6	1	3	5	1	0
ODE-424	5	477	472	0	3	1	0	1
ODE-424	5	9	4	1	3	1	1	0
ODE-424	5	310	305	1	3	1	0	0
ODE-424	5	310	305	1	3	1	0	0
ODE-424	5	305	300	1	3	1	0	1
ODE-424	7	477	470	0	3	4	0	1
ODE-424	7	10	3	1	3	1	0	0
ODE-424	7	109	102	1	3	1	0	0
ODE-424	7	8	1	1	3	4	0	0
ODE-424	7	8	1	1	3	5	1	0
ODE-425	7	477	470	0	3	4	0	1
ODE-425	7	18	11	1	3	1	0	0
ODE-425	7	477	470	0	3	1	0	0
ODE-425	7	39	32	1	3	2	1	0
ODE-425	7	9	2	1	3	4	0	0
ODE-425	7	10	3	1	3	1	0	0
ODE-425	7	17	10	1	3	1	0	0
ODE-425	7	15	8	1	3	1	1	0
ODE-425	7	477	470	0	3	4	0	0
ODE-425	8	477	469	0	3	1	0	0
ODE-426	8	477	469	0	3	4	0	0
ODE-426	8	477	469	0	3	4	0	0
ODE-426	8	477	469	0	3	4	0	0
ODE-426	8	477	469	0	3	1	0	0
ODE-426	8	310	302	1	3	1	0	0
ODE-426	8	477	469	0	3	3	0	0
ODE-426	8	71	63	1	3	1	1	0
ODE-426	8	459	451	1	4	1	1	0
ODE-426	8	477	469	0	3	4	0	0
ODE-426	9	10	1	1	3	4	0	0
ODE-427	9	42	33	1	3	1	1	1
ODE-427	9	10	1	1	3	1	0	0
ODE-427	9	477	468	0	3	2	0	1
ODE-427	9	273	264	1	3	1	1	0
ODE-427	9	109	100	1	3	3	0	0
ODE-427	10	21	11	1	3	1	1	0
ODE-427	10	310	300	1	3	1	0	0
ODE-427	10	477	467	0	3	1	0	0
ODE-427	10	36	26	1	3	4	0	0
ODE-427	10	109	99	1	3	3	0	0
ODE-428	10	15	5	1	3	1	1	0
ODE-428	10	11	1	1	3	1	1	0
ODE-428	10	21	11	1	3	1	0	0
ODE-428	10	477	467	0	3	4	0	0
ODE-428	10	28	18	1	3	5	0	0
ODE-428	10	16	6	1	3	1	1	0
ODE-428	11	12	1	1	3	1	1	0
ODE-428	11	18	7	1	3	1	1	0
ODE-428	11	12	1	1	3	2	0	0
ODE-428	11	477	466	0	3	5	0	0
ODE-429	11	15	4	1	3	1	1	0
ODE-429	11	16	5	1	3	4	1	0
ODE-429	11	16	5	1	3	1	1	0
ODE-429	11	16	5	1	3	1	1	0
ODE-429	11	16	5	1	3	1	1	0
ODE-429	11	45	34	1	3	1	1	0
ODE-429	14	15	1	1	3	1	1	0
ODE-429	15	477	462	0	3	4	0	0
ODE-429	15	18	3	1	3	1	1	0
ODE-429	15	17	2	1	3	5	1	0
ODE-430	15	28	13	1	3	1	1	1
ODE-430	16	109	93	1	3	4	0	0
ODE-430	16	477	461	0	3	1	0	1
ODE-430	16	18	2	1	3	1	1	0
ODE-430	16	17	1	1	3	5	1	0
ODE-430	16	17	1	1	3	5	1	0
ODE-430	16	21	5	1	3	1	1	0
ODE-430	16	24	8	1	3	5	0	0
ODE-430	17	29	12	1	3	5	1	0
ODE-430	17	35	18	1	3	1	1	2
ODE-431	17	477	460	0	3	4	0	0
ODE-431	17	133	116	1	3	4	0	0
ODE-431	17	25	8	1	3	1	1	0
ODE-431	17	477	460	0	4	1	0	0
ODE-431	17	24	7	1	3	4	0	0
ODE-431	17	21	4	1	3	1	1	0
ODE-431	17	25	8	1	3	4	1	0
ODE-431	17	21	4	1	3	1	1	0
ODE-431	17	452	435	1	3	1	1	1
ODE-431	17	310	293	1	3	1	0	0
ODE-432	17	43	26	1	3	1	1	1
ODE-432	18	37	19	1	3	4	0	0
ODE-432	18	56	38	1	3	1	0	0
ODE-432	18	310	292	1	4	1	0	0
ODE-432	18	310	292	1	3	1	0	0
ODE-432	18	46	28	1	3	4	1	0
ODE-432	18	33	15	1	3	1	0	1
ODE-432	18	53	35	1	3	4	1	0
ODE-432	18	29	11	1	3	5	1	0
ODE-432	18	24	6	1	3	5	1	0
ODE-433	18	23	5	1	3	5	1	0
ODE-433	18	58	40	1	3	5	0	1
ODE-433	18	21	3	1	3	1	1	0
ODE-433	18	21	3	1	3	4	1	0
ODE-433	19	24	5	1	3	4	0	0
ODE-433	21	477	456	0	3	5	0	0
ODE-433	21	220	199	1	3	5	1	0
ODE-433	21	310	289	1	3	5	0	0
ODE-433	21	431	410	1	3	5	0	0
ODE-433	21	431	410	1	3	5	0	0
ODE-434	21	431	410	1	3	5	0	0
ODE-434	21	431	410	1	3	5	0	1
ODE-434	21	477	456	0	3	5	0	0
ODE-434	21	65	44	1	3	5	0	0
ODE-434	21	477	456	0	3	5	0	0
ODE-434	21	36	15	1	3	5	0	0
ODE-434	21	477	456	0	3	5	0	0
ODE-434	21	477	456	0	3	5	0	0
ODE-434	21	477	456	0	3	5	0	0
ODE-434	21	431	410	1	3	5	0	0
ODE-435	21	22	1	1	3	4	0	0
ODE-435	21	22	1	1	3	5	0	0
ODE-435	21	22	1	1	3	5	0	0
ODE-435	21	38	17	1	3	1	0	0
ODE-435	21	37	16	1	3	4	1	0
ODE-435	21	24	3	1	3	1	1	0
ODE-435	21	443	422	1	3	4	1	0
ODE-435	21	477	456	0	3	4	0	0
ODE-435	21	23	2	1	3	1	1	0
ODE-435	22	443	421	1	3	4	1	0
ODE-436	22	23	1	1	4	1	1	0
ODE-436	22	477	455	0	3	5	0	0
ODE-436	22	58	36	1	3	1	1	0
ODE-436	22	477	455	0	3	5	0	0
ODE-436	22	30	8	1	3	5	1	0
ODE-436	22	23	1	1	3	4	1	0
ODE-436	22	477	455	0	3	1	0	0
ODE-436	22	127	105	1	3	5	0	0
ODE-436	23	29	6	1	3	5	1	0
ODE-436	23	24	1	1	3	4	1	0
ODE-437	23	24	1	1	3	1	1	0
ODE-437	23	109	86	1	3	1	0	0
ODE-437	23	39	16	1	3	4	1	0
ODE-437	24	50	26	1	3	1	1	0
ODE-437	24	477	453	0	3	1	0	0
ODE-437	24	30	6	1	3	1	1	1
ODE-437	24	477	453	0	3	1	0	0
ODE-437	24	44	20	1	3	4	1	0
ODE-437	24	192	168	1	4	1	0	1
ODE-437	24	25	1	1	3	1	1	0
ODE-438	24	29	5	1	3	1	1	0
ODE-438	24	71	47	1	3	1	0	1
ODE-438	24	71	47	1	3	3	0	1
ODE-438	24	64	40	1	3	5	0	0
ODE-438	24	102	78	1	3	5	1	0
ODE-438	24	101	77	1	3	5	1	0
ODE-438	24	92	68	1	3	5	2	0
ODE-438	24	25	1	1	3	5	0	0
ODE-438	24	477	453	0	3	5	0	0
ODE-438	24	25	1	1	3	1	1	0
ODE-439	24	30	6	1	3	1	1	0
ODE-439	24	477	453	0	5	3	0	0
ODE-439	24	37	13	1	5	3	0	0
ODE-439	25	310	285	1	3	1	0	0
ODE-439	25	50	25	1	3	4	1	0
ODE-439	25	30	5	1	3	3	0	1
ODE-439	25	477	452	0	3	3	0	0
ODE-439	25	35	10	1	3	5	1	0
ODE-439	25	477	452	0	3	5	0	0
ODE-439	25	155	130	1	3	4	0	1
ODE-440	25	477	452	0	3	4	0	0
ODE-440	25	60	35	1	3	3	1	0
ODE-440	25	58	33	1	3	4	1	0
ODE-440	26	46	20	1	3	4	1	0
ODE-440	26	58	32	1	3	5	1	1
ODE-440	26	32	6	1	3	5	1	0
ODE-440	26	58	32	1	3	2	1	0
ODE-440	26	477	451	0	3	5	0	0
ODE-440	26	64	38	1	3	4	0	0
ODE-440	26	477	451	0	3	3	0	0
ODE-441	26	109	83	1	3	3	0	0
ODE-441	28	63	35	1	3	3	0	0
ODE-441	28	37	9	1	3	3	0	0
ODE-441	28	30	2	1	3	3	0	0
ODE-441	28	52	24	1	3	2	1	0
ODE-441	28	477	449	0	3	4	0	0
ODE-441	28	30	2	1	3	3	0	0
ODE-441	28	29	1	1	3	1	1	0
ODE-441	28	164	136	1	3	1	1	0
ODE-441	28	29	1	1	3	3	0	0
ODE-442	28	310	282	1	4	1	0	0
ODE-442	28	443	415	1	3	4	1	0
ODE-442	28	477	449	0	3	4	0	0
ODE-442	28	31	3	1	3	4	0	1
ODE-442	28	39	11	1	3	4	0	0
ODE-442	28	241	213	1	3	4	0	0
ODE-442	28	29	1	1	3	4	0	1
ODE-442	28	477	449	0	3	4	0	0
ODE-442	28	39	11	1	3	4	1	0
ODE-442	28	30	2	1	3	5	1	0
ODE-443	28	30	2	1	3	5	1	0
ODE-443	28	30	2	1	3	5	1	0
ODE-443	28	30	2	1	3	5	1	0
ODE-443	28	30	2	1	3	5	1	0
ODE-443	29	477	448	0	3	2	0	1
ODE-443	29	38	9	1	3	1	1	0
ODE-443	29	38	9	1	3	5	1	0
ODE-443	29	38	9	1	3	5	1	0
ODE-443	29	30	1	1	3	1	1	0
ODE-443	29	32	3	1	3	4	1	1
ODE-444	29	58	29	1	3	2	0	0
ODE-444	29	477	448	0	3	1	0	0
ODE-444	30	35	5	1	3	5	1	0
ODE-444	30	477	447	0	3	5	0	0
ODE-444	30	477	447	0	3	5	0	0
ODE-444	30	477	447	0	3	5	0	0
ODE-444	30	477	447	0	3	5	0	0
ODE-444	30	477	447	0	3	5	0	0
ODE-444	30	31	1	1	3	4	0	0
ODE-444	30	43	13	1	3	4	0	0
ODE-445	30	33	3	1	3	4	1	0
ODE-445	31	80	49	1	3	1	1	0
ODE-445	31	477	446	0	3	5	0	0
ODE-445	31	477	446	0	3	5	0	1
ODE-445	31	477	446	0	3	5	0	0
ODE-445	31	477	446	0	3	5	0	0
ODE-445	31	477	446	0	3	5	0	0
ODE-445	31	477	446	0	3	5	0	0
ODE-445	31	477	446	0	3	5	0	0
ODE-445	31	477	446	0	3	5	0	0
ODE-446	31	477	446	0	3	5	0	0
ODE-446	31	477	446	0	3	5	0	0
ODE-446	31	477	446	0	3	5	0	0
ODE-446	31	477	446	0	3	5	0	0
ODE-446	31	52	21	1	3	5	1	0
ODE-446	31	477	446	0	3	5	0	0
ODE-446	31	477	446	0	3	5	0	0
ODE-446	31	50	19	1	3	5	1	0
ODE-446	31	477	446	0	3	5	0	0
ODE-446	31	477	446	0	3	5	0	1
ODE-447	31	477	446	0	3	5	0	0
ODE-447	31	477	446	0	3	5	0	0
ODE-447	31	477	446	0	3	5	0	0
ODE-447	31	50	19	1	3	5	1	0
ODE-447	31	477	446	0	3	5	0	0
ODE-447	31	477	446	0	3	5	0	0
ODE-447	31	477	446	0	3	5	0	0
ODE-447	31	477	446	0	3	5	0	0
ODE-447	31	477	446	0	3	5	0	0
ODE-447	31	477	446	0	3	5	0	0
ODE-448	31	477	446	0	3	5	0	0
ODE-448	31	477	446	0	3	5	0	0
ODE-448	31	477	446	0	3	5	0	0
ODE-448	31	477	446	0	3	5	0	0
ODE-448	31	477	446	0	3	5	0	0
ODE-448	31	477	446	0	3	5	0	0
ODE-448	31	477	446	0	3	5	0	0
ODE-448	31	35	4	1	3	5	1	0
ODE-448	31	477	446	0	3	5	0	0
ODE-448	31	477	446	0	3	5	0	0
ODE-449	31	477	446	0	3	5	0	0
ODE-449	31	477	446	0	3	5	0	0
ODE-449	31	477	446	0	3	5	0	0
ODE-449	31	52	21	1	3	5	1	0
ODE-449	31	477	446	0	3	5	0	0
ODE-449	31	477	446	0	3	5	0	0
ODE-449	31	477	446	0	3	5	0	0
ODE-449	31	86	55	1	3	1	1	0
ODE-449	32	310	278	1	3	1	0	0
ODE-449	32	36	4	1	3	5	1	0
ODE-450	32	477	445	0	3	5	0	0
ODE-450	32	477	445	0	3	5	0	0
ODE-450	32	477	445	0	3	5	0	0
ODE-450	32	477	445	0	3	5	0	0
ODE-450	32	477	445	0	3	5	0	0
ODE-450	32	33	1	1	3	5	0	1
ODE-450	32	477	445	0	3	5	0	0
ODE-450	32	39	7	1	3	5	0	0
ODE-450	32	477	445	0	3	5	0	0
ODE-450	32	35	3	1	3	4	1	0
ODE-451	32	477	445	0	3	5	0	0
ODE-451	32	44	12	1	3	4	1	0
ODE-451	32	477	445	0	3	5	0	0
ODE-451	32	477	445	0	3	5	0	0
ODE-451	32	477	445	0	3	5	0	0
ODE-451	32	477	445	0	3	5	0	0
ODE-451	32	477	445	0	3	5	0	0
ODE-451	32	63	31	1	3	5	0	0
ODE-451	32	95	63	1	3	4	1	0
ODE-451	32	477	445	0	3	5	0	0
ODE-452	32	91	59	1	3	5	1	0
ODE-452	32	477	445	0	3	5	0	0
ODE-452	32	477	445	0	3	5	0	0
ODE-452	32	477	445	0	3	5	0	0
ODE-452	32	477	445	0	3	5	0	0
ODE-452	32	477	445	0	3	5	0	0
ODE-452	32	477	445	0	3	5	0	0
ODE-452	32	88	56	1	3	5	1	0
ODE-452	32	477	445	0	3	5	0	0
ODE-452	32	477	445	0	3	5	0	0
ODE-453	32	477	445	0	3	5	0	0
ODE-453	32	477	445	0	3	5	0	0
ODE-453	32	477	445	0	3	5	0	0
ODE-453	32	477	445	0	3	5	0	0
ODE-453	32	477	445	0	3	5	0	0
ODE-453	32	477	445	0	3	5	0	0
ODE-453	32	477	445	0	3	5	0	0
ODE-453	32	477	445	0	3	5	0	0
ODE-453	32	477	445	0	3	5	0	0
ODE-453	32	477	445	0	3	5	0	0
ODE-454	32	477	445	0	3	5	0	0
ODE-454	32	53	21	1	3	5	1	0
ODE-454	32	35	3	1	3	5	1	0
ODE-454	32	477	445	0	3	5	0	0
ODE-454	32	477	445	0	3	5	0	0
ODE-454	32	44	12	1	3	5	1	1
ODE-454	32	477	445	0	3	5	0	0
ODE-454	32	477	445	0	3	5	0	0
ODE-454	32	477	445	0	3	5	0	0
ODE-454	33	477	444	0	3	5	0	0
ODE-455	33	477	444	0	3	5	0	0
ODE-455	33	477	444	0	3	5	0	0
ODE-455	33	477	444	0	3	5	0	0
ODE-455	33	477	444	0	3	5	0	0
ODE-455	33	477	444	0	3	5	0	0
ODE-455	33	477	444	0	3	5	0	0
ODE-455	33	477	444	0	3	5	0	0
ODE-455	33	477	444	0	3	5	0	0
ODE-455	33	477	444	0	3	5	0	0
ODE-455	33	53	20	1	3	5	1	0
ODE-456	33	477	444	0	3	5	0	0
ODE-456	33	477	444	0	3	5	0	0
ODE-456	33	400	367	1	3	5	1	0
ODE-456	33	477	444	0	3	5	0	0
ODE-456	33	477	444	0	3	5	0	0
ODE-456	33	477	444	0	3	5	0	0
ODE-456	33	39	6	1	3	5	1	0
ODE-456	33	477	444	0	3	5	0	0
ODE-456	33	477	444	0	3	5	0	0
ODE-456	33	477	444	0	3	5	0	0
ODE-457	33	63	30	1	3	5	0	0
ODE-457	33	477	444	0	3	5	0	0
ODE-457	33	36	3	1	3	4	0	0
ODE-457	35	38	3	1	3	1	1	0
ODE-457	35	477	442	0	5	5	0	0
ODE-457	35	39	4	1	3	5	1	0
ODE-457	35	477	442	0	3	5	0	0
ODE-457	35	477	442	0	3	5	0	0
ODE-457	35	477	442	0	3	5	0	0
ODE-457	35	50	15	1	3	5	1	0
ODE-458	35	477	442	0	3	5	0	0
ODE-458	35	400	365	1	3	5	1	0
ODE-458	35	400	365	1	3	5	1	0
ODE-458	35	38	3	1	3	5	1	0
ODE-458	35	477	442	0	3	5	0	0
ODE-458	35	44	9	1	3	5	1	0
ODE-458	35	39	4	1	3	5	1	0
ODE-458	35	477	442	0	3	5	0	0
ODE-458	35	38	3	1	3	5	1	0
ODE-458	35	477	442	0	3	5	0	0
ODE-459	35	37	2	1	3	5	1	0
ODE-459	35	477	442	0	3	5	0	0
ODE-459	35	399	364	1	3	5	1	0
ODE-459	35	203	168	1	3	4	1	0
ODE-459	35	310	275	1	3	1	0	0
ODE-459	35	477	442	0	3	5	0	0
ODE-459	35	37	2	1	5	4	0	0
ODE-459	35	477	442	0	3	4	0	0
ODE-459	35	39	4	1	3	1	1	0
ODE-459	35	477	442	0	3	5	0	0
ODE-460	35	477	442	0	3	4	0	0
ODE-460	35	477	442	0	3	3	0	0
ODE-460	35	477	442	0	3	3	0	0
ODE-460	35	477	442	0	3	3	0	0
ODE-460	35	45	10	1	3	1	1	0
ODE-460	35	36	1	1	3	4	0	0
ODE-460	35	477	442	0	3	2	0	0
ODE-460	36	78	42	1	3	1	0	0
ODE-460	36	477	441	0	3	4	0	0
ODE-460	36	37	1	1	4	1	1	0
ODE-461	36	477	441	0	3	2	0	1
ODE-461	36	37	1	1	3	4	0	1
ODE-461	36	477	441	0	3	1	0	0
ODE-461	36	43	7	1	3	1	1	0
ODE-461	36	148	112	1	3	1	1	0
ODE-461	36	39	3	1	3	1	1	0
ODE-461	36	109	73	1	3	1	0	0
ODE-461	37	477	440	0	3	3	0	0
ODE-461	37	38	1	1	3	1	1	0
ODE-461	37	443	406	1	3	1	0	0
ODE-462	37	38	1	1	3	3	0	0
ODE-462	37	38	1	1	3	1	1	0
ODE-462	37	42	5	1	3	4	1	2
ODE-462	37	109	72	1	3	4	0	0
ODE-462	37	114	77	1	3	1	1	0
ODE-462	37	58	21	1	3	4	1	0
ODE-462	37	50	13	1	3	4	1	0
ODE-462	37	42	5	1	3	1	1	0
ODE-462	37	46	9	1	3	4	1	0
ODE-462	37	39	2	1	3	1	1	0
ODE-463	38	109	71	1	3	4	0	0
ODE-463	38	39	1	1	3	1	0	0
ODE-463	38	39	1	1	3	4	0	0
ODE-463	38	44	6	1	3	3	1	1
ODE-463	38	43	5	1	3	1	1	0
ODE-463	38	477	439	0	3	2	0	0
ODE-463	38	43	5	1	3	4	0	0
ODE-463	38	443	405	1	3	4	1	0
ODE-463	38	58	20	1	3	3	1	0
ODE-463	38	39	1	1	3	1	1	0
ODE-464	38	44	6	1	3	1	1	0
ODE-464	38	310	272	1	4	1	0	0
ODE-464	38	43	5	1	3	1	1	0
ODE-464	38	477	439	0	3	1	0	2
ODE-464	39	93	54	1	3	5	1	0
ODE-464	39	43	4	1	4	4	1	0
ODE-464	39	58	19	1	3	4	0	0
ODE-464	39	113	74	1	3	1	1	0
ODE-464	39	40	1	1	3	1	0	0
ODE-464	42	44	2	1	3	4	1	0
ODE-465	42	249	207	1	3	1	1	1
ODE-465	42	43	1	1	3	1	1	0
ODE-465	42	44	2	1	3	4	1	0
ODE-465	43	46	3	1	4	4	1	0
ODE-465	43	44	1	1	3	5	1	1
ODE-465	43	44	1	1	3	1	1	0
ODE-465	43	53	10	1	3	5	1	0
ODE-465	43	477	434	0	3	3	0	1
ODE-465	43	477	434	0	3	4	0	0
ODE-465	43	477	434	0	3	1	0	0
ODE-466	43	44	1	1	3	2	0	1
ODE-466	43	60	17	1	3	2	1	0
ODE-466	43	64	21	1	3	2	1	0
ODE-466	43	477	434	0	3	2	0	0
ODE-466	43	477	434	0	3	2	0	0
ODE-466	43	477	434	0	3	2	0	0
ODE-466	43	67	24	1	3	1	1	1
ODE-466	43	45	2	1	3	1	0	0
ODE-466	43	44	1	1	3	4	0	0
ODE-466	44	71	27	1	3	5	1	0
ODE-467	44	46	2	1	3	5	1	0
ODE-467	44	46	2	1	3	5	1	0
ODE-467	44	60	16	1	3	5	1	0
ODE-467	44	477	433	0	3	2	0	0
ODE-467	44	45	1	1	3	4	0	1
ODE-467	44	56	12	1	3	1	1	0
ODE-467	44	109	65	1	3	3	0	0
ODE-467	44	443	399	1	3	4	1	0
ODE-467	44	50	6	1	3	3	1	0
ODE-467	44	70	26	1	3	1	1	4
ODE-468	44	477	433	0	3	5	0	0
ODE-468	44	70	26	1	3	1	1	1
ODE-468	44	70	26	1	3	1	1	1
ODE-468	44	70	26	1	3	1	1	1
ODE-468	44	70	26	1	3	1	1	1
ODE-468	44	70	26	1	3	1	1	1
ODE-468	45	50	5	1	3	1	1	0
ODE-468	45	477	432	0	3	1	0	0
ODE-468	45	109	64	1	3	3	0	0
ODE-468	45	72	27	1	3	5	1	0
ODE-469	45	53	8	1	3	1	1	0
ODE-469	45	53	8	1	3	1	1	0
ODE-469	45	477	432	0	3	5	0	0
ODE-469	46	73	27	1	3	1	1	0
ODE-469	46	47	1	1	3	1	1	0
ODE-469	46	58	12	1	3	1	1	0
ODE-469	46	63	17	1	4	1	1	0
ODE-469	46	93	47	1	3	1	0	0
ODE-469	46	52	6	1	3	1	1	0
ODE-469	46	477	431	0	3	4	0	0
ODE-470	46	51	5	1	3	4	0	0
ODE-470	46	477	431	0	3	4	0	0
ODE-470	46	477	431	0	3	4	0	0
ODE-470	46	58	12	1	3	1	1	0
ODE-470	46	53	7	1	3	1	1	0
ODE-470	47	51	4	1	3	3	1	0
ODE-470	50	477	427	0	3	4	0	0
ODE-470	50	477	427	0	3	4	0	0
ODE-470	50	100	50	1	3	4	0	1
ODE-470	51	477	426	0	3	1	0	0
ODE-471	51	477	426	0	3	4	0	0
ODE-471	51	477	426	0	3	4	0	0
ODE-471	51	477	426	0	3	1	0	1
ODE-471	51	52	1	1	3	5	1	0
ODE-471	51	477	426	0	3	5	0	0
ODE-471	51	84	33	1	3	5	1	0
ODE-471	52	106	54	1	3	4	1	0
ODE-471	52	53	1	1	3	5	0	0
ODE-471	52	53	1	1	3	5	0	0
ODE-471	52	53	1	1	3	5	0	0
ODE-472	52	477	425	0	3	1	0	0
ODE-472	52	119	67	1	2	1	1	0
ODE-472	52	63	11	1	3	4	0	0
ODE-472	52	74	22	1	3	1	0	0
ODE-472	52	477	425	0	3	1	0	0
ODE-472	52	58	6	1	3	1	1	0
ODE-472	52	193	141	1	3	1	1	0
ODE-472	52	477	425	0	4	4	0	0
ODE-472	52	436	384	1	3	4	1	0
ODE-472	52	66	14	1	3	5	0	0
ODE-473	52	64	12	1	3	4	1	0
ODE-473	52	477	425	0	3	5	0	0
ODE-473	52	477	425	0	3	4	0	0
ODE-473	52	63	11	1	3	5	0	0
ODE-473	52	60	8	1	3	4	1	0
ODE-473	53	78	25	1	3	5	1	0
ODE-473	53	57	4	1	3	3	0	0
ODE-473	53	57	4	1	3	4	1	0
ODE-473	53	57	4	1	3	1	1	0
ODE-473	53	477	424	0	3	1	0	0
ODE-474	53	58	5	1	3	1	1	0
ODE-474	53	67	14	1	3	1	0	0
ODE-474	53	477	424	0	3	1	0	0
ODE-474	53	63	10	1	3	1	0	0
ODE-474	55	58	3	1	3	4	1	0
ODE-474	56	58	2	1	3	1	1	0
ODE-474	56	58	2	1	3	4	0	0
ODE-474	57	310	253	1	3	1	0	0
ODE-474	57	399	342	1	2	1	0	0
ODE-474	57	81	24	1	3	1	1	0
ODE-475	57	67	10	1	3	4	1	0
ODE-475	57	67	10	1	3	2	1	0
ODE-475	58	70	12	1	3	3	0	1
ODE-475	58	59	1	1	3	1	1	0
ODE-475	58	74	16	1	3	1	0	0
ODE-475	58	72	14	1	3	1	1	0
ODE-475	59	60	1	1	4	1	1	0
ODE-475	59	60	1	1	3	1	1	0
ODE-475	59	477	418	0	3	1	0	0
ODE-475	59	63	4	1	3	1	0	0
ODE-476	59	109	50	1	3	3	0	0
ODE-476	59	60	1	1	3	3	1	0
ODE-476	59	66	7	1	3	4	0	0
ODE-476	60	477	417	0	3	2	0	0
ODE-476	60	65	5	1	3	5	1	0
ODE-476	60	64	4	1	3	1	1	0
ODE-476	60	67	7	1	3	1	1	0
ODE-476	60	63	3	1	3	1	0	0
ODE-476	60	71	11	1	3	3	1	0
ODE-476	60	74	14	1	3	4	1	0
ODE-477	60	64	4	1	3	1	1	0
ODE-477	63	80	17	1	3	1	1	0
ODE-477	63	70	7	1	3	2	1	0
ODE-477	63	477	414	0	3	2	0	0
ODE-477	63	477	414	0	3	1	0	0
ODE-477	63	64	1	1	3	4	1	0
ODE-477	63	64	1	1	3	4	1	0
ODE-477	63	65	2	1	3	3	1	0
ODE-477	63	477	414	0	3	5	0	0
ODE-477	63	366	303	1	3	5	0	0
ODE-478	63	366	303	1	3	5	0	0
ODE-478	64	65	1	1	3	1	0	0
ODE-478	64	91	27	1	3	1	1	0
ODE-478	64	477	413	0	3	5	0	0
ODE-478	64	477	413	0	3	5	0	0
ODE-478	64	84	20	1	3	1	1	0
ODE-478	64	66	2	1	3	5	0	0
ODE-478	64	101	37	1	1	1	1	0
ODE-478	64	65	1	1	3	2	2	0
ODE-478	64	74	10	1	4	4	1	0
ODE-479	64	88	24	1	3	1	0	0
ODE-479	64	199	135	1	3	4	1	0
ODE-479	64	67	3	1	3	4	1	0
ODE-479	65	66	1	1	3	1	1	0
ODE-479	65	423	358	1	3	1	1	0
ODE-479	65	66	1	1	3	4	1	0
ODE-479	65	70	5	1	3	1	1	0
ODE-479	65	70	5	1	3	1	0	0
ODE-479	65	70	5	1	3	1	1	1
ODE-479	65	443	378	1	3	4	1	0
ODE-480	65	66	1	1	3	1	2	0
ODE-480	66	70	4	1	3	4	1	0
ODE-480	66	477	411	0	3	1	0	0
ODE-480	66	186	120	1	3	1	1	3
ODE-480	66	100	34	1	3	5	1	0
ODE-480	66	477	411	0	4	4	0	0
ODE-480	66	477	411	0	3	3	0	0
ODE-480	66	87	21	1	3	5	1	0
ODE-480	66	84	18	1	3	5	1	0
ODE-480	66	477	411	0	3	5	0	0
ODE-481	66	78	12	1	3	5	1	0
ODE-481	66	477	411	0	3	2	0	0
ODE-481	66	477	411	0	5	1	0	0
ODE-481	67	366	299	1	3	5	0	0
ODE-481	67	77	10	1	3	5	0	0
ODE-481	67	77	10	1	3	4	0	0
ODE-481	67	80	13	1	3	2	1	0
ODE-481	67	91	24	1	3	2	1	0
ODE-481	67	81	14	1	5	4	1	0
ODE-481	67	87	20	1	3	2	1	1
ODE-482	68	74	6	1	5	1	1	0
ODE-482	68	74	6	1	5	1	1	0
ODE-482	70	477	407	0	3	1	0	0
ODE-482	70	72	2	1	3	1	1	0
ODE-482	70	72	2	1	3	1	0	0
ODE-482	70	380	310	1	3	1	0	0
ODE-482	70	477	407	0	3	2	0	0
ODE-482	71	74	3	1	3	1	1	0
ODE-482	71	477	406	0	3	4	0	0
ODE-482	71	72	1	1	3	1	0	0
ODE-483	71	101	30	1	3	5	1	0
ODE-483	71	72	1	1	3	4	1	1
ODE-483	71	78	7	1	4	1	1	0
ODE-483	71	351	280	1	3	1	1	0
ODE-483	71	72	1	1	3	2	2	0
ODE-483	71	109	38	1	3	1	0	0
ODE-483	72	79	7	1	3	1	1	0
ODE-483	72	477	405	0	3	4	0	0
ODE-483	72	109	37	1	3	1	1	0
ODE-483	72	112	40	1	3	4	0	0
ODE-484	72	92	20	1	3	1	1	0
ODE-484	72	477	405	0	3	4	0	0
ODE-484	72	109	37	1	3	4	0	0
ODE-484	72	73	1	1	3	1	0	0
ODE-484	72	73	1	1	3	1	1	0
ODE-484	72	112	40	1	4	4	1	0
ODE-484	72	74	2	1	5	1	1	0
ODE-484	72	73	1	1	3	1	0	0
ODE-484	72	310	238	1	3	1	0	0
ODE-484	72	94	22	1	3	1	0	0
ODE-485	73	93	20	1	3	3	0	0
ODE-485	73	74	1	1	3	4	0	0
ODE-485	73	189	116	1	3	1	0	1
ODE-485	73	114	41	1	3	4	0	0
ODE-485	73	443	370	1	3	4	1	0
ODE-485	73	112	39	1	3	4	0	0
ODE-485	73	477	404	0	3	2	0	1
ODE-485	73	93	20	1	3	5	1	0
ODE-485	73	477	404	0	3	5	0	0
ODE-485	73	86	13	1	3	5	1	0
ODE-486	73	122	49	1	3	5	1	0
ODE-486	73	477	404	0	3	4	0	1
ODE-486	73	477	404	0	3	5	0	0
ODE-486	73	102	29	1	3	5	1	0
ODE-486	73	78	5	1	3	4	1	1
ODE-486	73	477	404	0	3	4	0	0
ODE-486	73	477	404	0	3	1	0	0
ODE-486	74	91	17	1	3	1	1	0
ODE-486	74	75	1	1	3	1	1	0
ODE-486	74	88	14	1	3	5	1	0
ODE-487	74	86	12	1	3	1	1	0
ODE-487	74	252	178	1	3	4	0	0
ODE-487	74	92	18	1	3	1	1	0
ODE-487	74	79	5	1	3	1	1	0
ODE-487	74	102	28	1	4	1	1	0
ODE-487	74	77	3	1	3	1	0	1
ODE-487	74	112	38	1	5	4	1	0
ODE-487	74	477	403	0	3	1	0	0
ODE-487	74	88	14	1	3	5	1	0
ODE-487	74	359	285	1	3	4	1	0
ODE-488	74	87	13	1	3	5	1	0
ODE-488	74	101	27	1	3	5	1	0
ODE-488	75	81	6	1	3	1	1	0
ODE-488	75	88	13	1	3	5	1	0
ODE-488	75	88	13	1	3	3	1	0
ODE-488	76	78	2	1	3	1	1	0
ODE-488	77	267	190	1	3	1	0	0
ODE-488	77	310	233	1	3	1	0	0
ODE-488	77	78	1	1	3	4	1	1
ODE-488	77	128	51	1	3	4	0	0
ODE-489	77	310	233	1	3	1	0	0
ODE-489	77	109	32	1	3	1	0	0
ODE-489	77	193	116	1	3	1	0	1
ODE-489	77	92	15	1	3	1	1	0
ODE-489	77	82	5	1	3	1	1	1
ODE-489	77	99	22	1	3	5	1	0
ODE-489	77	78	1	1	3	5	1	0
ODE-489	77	105	28	1	3	1	1	1
ODE-489	77	87	10	1	3	3	1	0
ODE-489	78	82	4	1	3	3	0	0
ODE-490	78	477	399	0	5	4	0	0
ODE-490	78	80	2	1	3	1	1	0
ODE-490	78	102	24	1	3	1	1	0
ODE-490	78	79	1	1	3	3	1	0
ODE-490	78	477	399	0	4	4	0	0
ODE-490	78	106	28	1	3	4	0	1
ODE-490	79	93	14	1	3	4	0	0
ODE-490	79	80	1	1	3	1	1	0
ODE-490	79	101	22	1	3	3	0	0
ODE-490	79	119	40	1	3	5	1	0
ODE-491	79	81	2	1	3	4	1	0
ODE-491	79	93	14	1	3	4	1	0
ODE-491	79	93	14	1	3	4	0	0
ODE-491	80	88	8	1	2	1	1	0
ODE-491	80	477	397	0	3	1	0	0
ODE-491	80	99	19	1	3	1	1	0
ODE-491	80	93	13	1	3	1	0	0
ODE-491	80	91	11	1	3	4	1	0
ODE-491	80	93	13	1	3	1	0	0
ODE-491	80	101	21	1	3	1	1	0
ODE-492	80	477	397	0	3	1	0	0
ODE-492	80	93	13	1	3	4	0	0
ODE-492	80	91	11	1	3	1	1	0
ODE-492	80	119	39	1	3	4	1	1
ODE-492	81	82	1	1	4	1	1	0
ODE-492	81	477	396	0	3	1	0	0
ODE-492	81	477	396	0	3	1	0	1
ODE-492	81	82	1	1	3	4	1	0
ODE-492	81	477	396	0	4	2	0	1
ODE-492	81	88	7	1	4	1	1	0
ODE-493	81	91	10	1	3	5	1	0
ODE-493	81	477	396	0	3	5	0	0
ODE-493	81	477	396	0	3	5	0	0
ODE-493	81	84	3	1	3	1	1	0
ODE-493	81	240	159	1	3	1	0	0
ODE-493	81	477	396	0	4	1	0	0
ODE-493	81	105	24	1	3	1	1	1
ODE-493	81	477	396	0	4	5	0	0
ODE-493	82	477	395	0	3	4	0	0
ODE-493	82	477	395	0	3	4	0	0
ODE-494	84	477	393	0	3	5	0	0
ODE-494	84	87	3	1	3	3	1	0
ODE-494	84	99	15	1	3	1	1	0
ODE-494	84	86	2	1	3	1	1	0
ODE-494	84	477	393	0	3	4	0	0
ODE-494	84	88	4	1	3	3	1	0
ODE-494	85	87	2	1	3	3	0	1
ODE-494	85	98	13	1	3	5	1	0
ODE-494	85	91	6	1	3	1	1	0
ODE-494	85	141	56	1	3	4	0	0
ODE-495	85	98	13	1	3	5	1	0
ODE-495	85	98	13	1	3	5	1	0
ODE-495	85	102	17	1	3	5	0	0
ODE-495	85	141	56	1	3	5	0	0
ODE-495	85	106	21	1	3	5	1	0
ODE-495	85	106	21	1	3	5	1	0
ODE-495	85	88	3	1	3	1	0	0
ODE-495	86	113	27	1	3	1	1	0
ODE-495	86	477	391	0	3	4	0	0
ODE-495	86	134	48	1	3	1	1	0
ODE-496	86	94	8	1	3	1	1	0
ODE-496	87	274	187	1	3	2	1	0
ODE-496	87	102	15	1	3	1	1	0
ODE-496	87	114	27	1	3	1	0	0
ODE-496	87	477	390	0	3	1	0	0
ODE-496	87	196	109	1	3	3	1	0
ODE-496	87	477	390	0	3	3	0	0
ODE-496	87	94	7	1	3	3	0	1
ODE-496	87	193	106	1	3	3	0	0
ODE-496	87	477	390	0	3	1	0	0
ODE-497	87	93	6	1	3	1	1	0
ODE-497	87	98	11	1	3	3	1	0
ODE-497	87	98	11	1	3	3	1	0
ODE-497	87	109	22	1	3	4	0	0
ODE-497	88	89	1	1	3	1	1	0
ODE-497	88	452	364	1	3	4	0	0
ODE-497	88	91	3	1	3	4	1	0
ODE-497	90	127	37	1	3	3	0	0
ODE-497	90	234	144	1	3	3	0	0
ODE-497	90	92	2	1	4	1	1	0
ODE-498	91	92	1	1	3	1	0	1
ODE-498	91	92	1	1	3	1	1	0
ODE-498	91	92	1	1	3	4	0	1
ODE-498	91	92	1	1	3	1	1	0
ODE-498	91	93	2	1	3	4	1	0
ODE-498	91	92	1	1	3	3	0	0
ODE-498	91	106	15	1	3	1	1	0
ODE-498	91	477	386	0	3	5	0	0
ODE-498	91	92	1	1	3	1	0	0
ODE-498	91	93	2	1	3	1	1	0
ODE-499	92	105	13	1	3	1	1	0
ODE-499	92	99	7	1	3	1	1	0
ODE-499	92	228	136	1	3	4	0	0
ODE-499	92	477	385	0	3	4	0	0
ODE-499	93	96	3	1	3	3	0	0
ODE-499	93	98	5	1	3	5	1	0
ODE-499	93	113	20	1	3	4	1	0
ODE-499	93	477	384	0	3	4	0	0
ODE-499	93	477	384	0	3	4	0	0
ODE-499	93	380	287	1	3	1	0	0
ODE-500	93	106	13	1	3	1	1	0
ODE-500	94	135	41	1	3	4	1	1
ODE-500	94	477	383	0	3	3	0	0
ODE-500	94	95	1	1	3	5	1	0
ODE-500	94	98	4	1	3	5	1	0
ODE-500	94	98	4	1	3	5	1	0
ODE-500	94	98	4	1	3	5	1	0
ODE-500	94	98	4	1	3	5	1	0
ODE-500	94	102	8	1	3	5	1	0
ODE-500	94	102	8	1	3	5	1	0
ODE-501	94	126	32	1	3	5	1	0
ODE-501	94	305	211	1	3	5	1	0
ODE-501	94	441	347	1	3	5	1	0
ODE-501	94	438	344	1	3	5	1	0
ODE-501	94	196	102	1	3	5	1	0
ODE-501	94	443	349	1	3	5	1	0
ODE-501	94	443	349	1	3	5	1	0
ODE-501	94	477	383	0	3	1	0	0
ODE-501	94	443	349	1	3	4	1	0
ODE-501	94	477	383	0	3	4	0	0
ODE-502	94	113	19	1	3	4	1	0
ODE-502	94	98	4	1	3	1	1	0
ODE-502	94	477	383	0	4	2	0	0
ODE-502	95	101	6	1	3	1	0	0
ODE-502	95	178	83	1	3	3	1	0
ODE-502	95	277	182	1	3	4	0	0
ODE-502	95	98	3	1	3	3	1	0
ODE-502	95	98	3	1	3	1	1	0
ODE-502	95	477	382	0	3	2	0	0
ODE-502	95	99	4	1	3	4	1	0
ODE-503	95	109	14	1	3	3	0	0
ODE-503	96	97	1	1	3	3	0	0
ODE-503	98	351	253	1	3	5	0	0
ODE-503	98	112	14	1	3	1	1	0
ODE-503	98	477	379	0	3	1	0	0
ODE-503	98	102	4	1	3	4	1	0
ODE-503	98	127	29	1	3	4	0	0
ODE-503	98	99	1	1	3	1	0	0
ODE-503	98	109	11	1	3	4	1	0
ODE-503	98	101	3	1	3	1	1	0
ODE-504	98	113	15	1	3	1	1	0
ODE-504	99	134	35	1	3	2	1	0
ODE-504	99	477	378	0	3	3	0	0
ODE-504	99	107	8	1	3	1	1	0
ODE-504	99	102	3	1	3	1	1	0
ODE-504	99	443	344	1	3	1	1	0
ODE-504	99	101	2	1	3	1	1	0
ODE-504	100	127	27	1	3	5	0	0
ODE-504	100	106	6	1	3	1	1	1
ODE-504	100	101	1	1	3	3	0	0
ODE-505	100	477	377	0	3	1	0	0
ODE-505	100	102	2	1	3	4	1	0
ODE-505	101	109	8	1	3	1	0	1
ODE-505	101	477	376	0	3	4	0	0
ODE-505	101	477	376	0	3	1	0	0
ODE-505	101	127	26	1	3	5	0	0
ODE-505	101	102	1	1	3	1	1	0
ODE-505	101	477	376	0	3	3	0	0
ODE-505	101	112	11	1	3	5	1	0
ODE-505	101	119	18	1	3	4	1	0
ODE-506	101	112	11	1	3	4	1	0
ODE-506	101	477	376	0	3	1	0	0
ODE-506	101	477	376	0	3	4	0	0
ODE-506	101	477	376	0	3	4	0	0
ODE-506	101	102	1	1	3	1	1	0
ODE-506	101	168	67	1	3	1	1	0
ODE-506	101	105	4	1	3	1	0	0
ODE-506	101	105	4	1	3	1	0	0
ODE-506	102	105	3	1	3	4	1	1
ODE-506	102	107	5	1	3	5	1	0
ODE-507	102	254	152	1	3	2	1	0
ODE-507	102	142	40	1	3	4	1	0
ODE-507	102	317	215	1	3	5	1	1
ODE-507	102	316	214	1	3	5	0	1
ODE-507	102	318	216	1	3	5	1	0
ODE-507	102	323	221	1	3	5	1	0
ODE-507	102	323	221	1	3	5	1	0
ODE-507	102	107	5	1	3	1	1	0
ODE-507	102	109	7	1	3	5	1	0
ODE-507	102	477	375	0	3	1	0	0
ODE-508	103	106	3	1	3	1	1	0
ODE-508	103	106	3	1	4	1	1	0
ODE-508	104	111	7	1	3	5	0	0
ODE-508	105	122	17	1	3	1	1	0
ODE-508	105	477	372	0	3	1	0	0
ODE-508	105	107	2	1	3	1	2	1
ODE-508	105	106	1	1	3	4	1	0
ODE-508	106	131	25	1	3	1	1	0
ODE-508	106	178	72	1	3	5	1	0
ODE-508	106	111	5	1	3	3	0	0
ODE-509	106	477	371	0	3	1	0	0
ODE-509	106	477	371	0	3	2	0	0
ODE-509	106	477	371	0	3	4	0	0
ODE-509	106	108	2	1	3	3	0	0
ODE-509	106	255	149	1	3	1	1	1
ODE-509	106	108	2	1	3	1	1	0
ODE-509	106	128	22	1	3	5	0	1
ODE-509	106	204	98	1	3	1	1	1
ODE-509	106	477	371	0	3	4	0	0
ODE-509	106	108	2	1	3	1	1	0
ODE-510	107	452	345	1	3	2	1	0
ODE-510	107	123	16	1	3	1	0	0
ODE-510	107	477	370	0	3	1	0	0
ODE-510	107	113	6	1	3	1	1	0
ODE-510	107	109	2	1	3	3	0	0
ODE-510	107	477	370	0	3	1	0	0
ODE-510	107	108	1	1	3	1	1	0
ODE-510	107	310	203	1	3	1	0	0
ODE-510	108	477	369	0	3	4	0	0
ODE-510	108	128	20	1	3	5	0	1
ODE-511	108	109	1	1	3	5	1	0
ODE-511	108	122	14	1	3	1	1	0
ODE-511	108	477	369	0	3	2	0	0
ODE-511	108	113	5	1	3	1	1	0
ODE-511	108	112	4	1	3	2	1	0
ODE-511	108	455	347	1	3	1	0	0
ODE-511	108	477	369	0	3	3	0	0
ODE-511	108	477	369	0	3	4	0	0
ODE-511	109	114	5	1	5	4	1	0
ODE-511	109	110	1	1	3	3	0	0
ODE-512	109	114	5	1	3	4	0	1
ODE-512	109	310	201	1	3	1	0	0
ODE-512	112	477	365	0	3	1	0	0
ODE-512	112	310	198	1	3	1	0	0
ODE-512	112	477	365	0	3	1	0	0
ODE-512	112	477	365	0	3	3	0	0
ODE-512	112	477	365	0	3	4	0	0
ODE-512	112	477	365	0	3	4	0	0
ODE-512	112	477	365	0	3	3	0	1
ODE-512	112	113	1	1	3	4	1	0
ODE-513	113	477	364	0	3	4	0	0
ODE-513	113	121	8	1	3	1	0	0
ODE-513	113	127	14	1	3	1	1	0
ODE-513	113	477	364	0	3	4	0	0
ODE-513	113	116	3	1	3	4	1	0
ODE-513	113	477	364	0	3	4	0	0
ODE-513	113	255	142	1	4	1	0	0
ODE-513	113	477	364	0	3	3	0	0
ODE-513	113	114	1	1	3	1	1	0
ODE-513	114	115	1	1	3	4	0	0
ODE-514	114	477	363	0	3	4	0	0
ODE-514	114	127	13	1	3	1	1	0
ODE-514	115	455	340	1	3	2	0	0
ODE-514	115	126	11	1	3	5	1	0
ODE-514	115	130	15	1	3	1	1	0
ODE-514	115	477	362	0	3	1	0	0
ODE-514	116	126	10	1	3	1	1	0
ODE-514	116	477	361	0	3	4	0	0
ODE-514	116	310	194	1	4	1	0	1
ODE-514	116	477	361	0	3	5	0	0
ODE-515	116	128	12	1	3	4	1	0
ODE-515	116	135	19	1	3	4	1	0
ODE-515	119	120	1	1	3	5	1	0
ODE-515	119	120	1	1	3	4	1	0
ODE-515	119	134	15	1	3	5	0	0
ODE-515	119	120	1	1	3	1	1	0
ODE-515	119	477	358	0	3	4	0	0
ODE-515	119	214	95	1	3	1	1	0
ODE-515	119	121	2	1	3	5	0	0
ODE-515	119	477	358	0	3	5	0	0
ODE-516	120	477	357	0	3	5	0	0
ODE-516	120	477	357	0	3	5	0	0
ODE-516	120	477	357	0	3	1	0	0
ODE-516	120	186	66	1	3	1	0	0
ODE-516	120	121	1	1	3	5	1	0
ODE-516	120	126	6	1	3	1	1	0
ODE-516	120	129	9	1	3	1	1	0
ODE-516	121	477	356	0	3	1	0	0
ODE-516	121	477	356	0	3	4	0	0
ODE-516	121	477	356	0	3	4	0	0
ODE-517	121	477	356	0	3	4	0	0
ODE-517	121	477	356	0	3	4	0	0
ODE-517	121	130	9	1	3	5	1	0
ODE-517	121	130	9	1	3	1	1	0
ODE-517	122	477	355	0	4	1	0	0
ODE-517	122	477	355	0	4	4	0	0
ODE-517	122	444	322	1	3	5	0	0
ODE-517	122	128	6	1	3	1	1	1
ODE-517	123	477	354	0	3	5	0	0
ODE-517	123	477	354	0	3	5	0	0
ODE-518	123	477	354	0	3	5	0	0
ODE-518	123	127	4	1	3	1	1	0
ODE-518	123	129	6	1	3	3	1	0
ODE-518	123	129	6	1	3	3	1	0
ODE-518	123	375	252	1	4	5	0	0
ODE-518	126	134	8	1	3	1	1	0
ODE-518	126	143	17	1	3	1	1	0
ODE-518	127	135	8	1	3	1	1	0
ODE-518	127	417	290	1	3	4	1	0
ODE-518	127	135	8	1	3	1	0	1
ODE-519	127	155	28	1	3	4	0	0
ODE-519	127	128	1	1	3	3	0	0
ODE-519	128	129	1	1	3	4	0	0
ODE-519	128	477	349	0	3	4	0	0
ODE-519	128	136	8	1	3	4	1	0
ODE-519	128	135	7	1	3	5	1	0
ODE-519	128	477	349	0	3	5	0	0
ODE-519	128	218	90	1	3	5	1	0
ODE-519	128	130	2	1	3	4	1	0
ODE-519	129	163	34	1	3	1	1	0
ODE-520	130	131	1	1	3	1	1	0
ODE-520	130	477	347	0	3	3	0	0
ODE-520	130	477	347	0	3	4	0	2
ODE-520	130	133	3	1	3	4	1	0
ODE-520	130	242	112	1	3	4	1	0
ODE-520	130	193	63	1	3	4	0	0
ODE-520	130	140	10	1	3	4	1	0
ODE-520	130	134	4	1	3	4	1	1
ODE-520	130	399	269	1	3	5	1	0
ODE-520	131	291	160	1	3	5	1	0
ODE-521	133	310	177	1	3	1	0	0
ODE-521	133	134	1	1	3	1	1	0
ODE-521	133	452	319	1	3	3	1	0
ODE-521	133	452	319	1	3	5	1	0
ODE-521	133	452	319	1	3	5	1	0
ODE-521	133	452	319	1	3	5	0	0
ODE-521	133	134	1	1	3	5	0	1
ODE-521	133	477	344	0	3	1	0	0
ODE-521	133	135	2	1	3	4	1	0
ODE-521	134	135	1	1	3	4	1	0
ODE-522	134	143	9	1	3	1	1	0
ODE-522	134	477	343	0	3	4	0	0
ODE-522	134	477	343	0	3	4	0	0
ODE-522	134	151	17	1	3	4	1	1
ODE-522	135	477	342	0	3	1	0	0
ODE-522	135	477	342	0	3	4	0	0
ODE-522	135	477	342	0	4	4	0	0
ODE-522	135	477	342	0	4	4	0	0
ODE-522	136	332	196	1	4	1	0	1
ODE-522	137	477	340	0	3	4	0	0
ODE-523	137	240	103	1	3	1	1	0
ODE-523	137	477	340	0	3	1	0	0
ODE-523	137	142	5	1	3	5	0	0
ODE-523	137	477	340	0	3	4	0	0
ODE-523	140	143	3	1	3	5	0	0
ODE-523	140	477	337	0	3	1	0	0
ODE-523	140	477	337	0	3	1	0	1
ODE-523	140	143	3	1	3	1	1	0
ODE-523	140	240	100	1	3	1	0	0
ODE-523	141	148	7	1	3	2	0	0
ODE-524	141	477	336	0	3	5	0	0
ODE-524	141	477	336	0	3	3	0	0
ODE-524	141	142	1	1	3	1	1	0
ODE-524	141	142	1	1	3	1	0	0
ODE-524	141	310	169	1	3	1	0	0
ODE-524	141	142	1	1	3	5	0	0
ODE-524	142	218	76	1	3	4	1	0
ODE-524	142	178	36	1	3	1	1	0
ODE-524	142	227	85	1	3	1	1	0
ODE-524	142	154	12	1	3	2	1	0
ODE-525	142	144	2	1	3	1	1	0
ODE-525	143	371	228	1	3	5	0	0
ODE-525	143	282	139	1	3	1	1	0
ODE-525	143	477	334	0	3	4	0	0
ODE-525	143	242	99	1	3	4	1	0
ODE-525	144	149	5	1	3	1	1	0
ODE-525	144	205	61	1	3	1	1	0
ODE-525	144	290	146	1	3	1	0	2
ODE-525	144	477	333	0	3	5	0	0
ODE-525	144	477	333	0	3	4	0	0
ODE-526	144	477	333	0	3	1	0	0
ODE-526	148	149	1	1	3	5	1	0
ODE-526	148	477	329	0	3	1	0	0
ODE-526	149	150	1	1	3	4	0	0
ODE-526	149	477	328	0	3	1	0	0
ODE-526	149	151	2	1	3	1	1	0
ODE-526	149	178	29	1	3	5	1	0
ODE-526	149	155	6	1	3	4	1	0
ODE-526	149	151	2	1	3	1	1	0
ODE-526	150	154	4	1	3	5	1	0
ODE-527	150	151	1	1	3	1	1	0
ODE-527	150	477	327	0	3	1	0	0
ODE-527	150	151	1	1	3	1	1	0
ODE-527	151	152	1	1	3	1	1	0
ODE-527	151	152	1	1	3	1	1	0
ODE-527	151	152	1	1	3	1	0	1
ODE-527	151	157	6	1	3	1	1	0
ODE-527	151	158	7	1	3	1	1	0
ODE-527	151	154	3	1	3	1	1	0
ODE-527	151	158	7	1	3	1	1	0
ODE-528	154	246	92	1	3	1	1	0
ODE-528	154	186	32	1	3	1	1	0
ODE-528	154	220	66	1	3	4	1	0
ODE-528	154	155	1	1	3	5	1	0
ODE-528	154	189	35	1	3	5	0	0
ODE-528	154	168	14	1	3	4	1	0
ODE-528	154	477	323	0	3	1	0	0
ODE-528	154	156	2	1	3	2	1	1
ODE-528	154	452	298	1	3	1	1	0
ODE-528	155	443	288	1	3	4	0	0
ODE-529	155	156	1	1	3	1	1	0
ODE-529	155	477	322	0	3	1	0	0
ODE-529	155	196	41	1	3	1	1	0
ODE-529	156	477	321	0	3	5	0	0
ODE-529	156	158	2	1	3	1	1	0
ODE-529	156	196	40	1	3	4	0	1
ODE-529	156	179	23	1	3	2	1	1
ODE-529	156	477	321	0	3	1	0	0
ODE-529	156	158	2	1	3	4	1	0
ODE-529	157	176	19	1	3	5	0	2
ODE-530	157	158	1	1	3	3	1	0
ODE-530	157	322	165	1	3	1	1	0
ODE-530	158	159	1	1	3	1	1	0
ODE-530	158	310	152	1	3	1	0	0
ODE-530	158	477	319	0	3	1	0	1
ODE-530	158	163	5	1	3	1	1	3
ODE-530	158	169	11	1	3	4	1	0
ODE-530	158	161	3	1	3	1	1	0
ODE-530	161	238	77	1	3	4	1	0
ODE-530	161	477	316	0	3	4	0	0
ODE-531	161	162	1	1	3	1	1	0
ODE-531	161	162	1	1	3	4	1	0
ODE-531	161	162	1	1	3	1	1	0
ODE-531	161	238	77	1	3	4	1	0
ODE-531	161	266	105	1	3	1	1	0
ODE-531	161	477	316	0	3	1	0	0
ODE-531	162	477	315	0	3	4	0	1
ODE-531	162	164	2	1	3	1	1	0
ODE-531	162	477	315	0	3	1	0	0
ODE-531	163	164	1	1	3	1	1	1
ODE-532	163	164	1	1	3	5	1	0
ODE-532	164	477	313	0	3	1	0	0
ODE-532	164	165	1	1	3	1	1	0
ODE-532	164	165	1	1	3	5	1	0
ODE-532	164	169	5	1	3	1	0	0
ODE-532	164	210	46	1	4	1	1	1
ODE-532	165	252	87	1	5	1	0	0
ODE-532	165	169	4	1	3	1	1	1
ODE-532	165	178	13	1	3	3	1	0
ODE-532	165	477	312	0	3	1	0	0
ODE-533	169	185	16	1	3	3	1	0
ODE-533	169	241	72	1	3	4	0	0
ODE-533	169	311	142	1	3	4	1	0
ODE-533	169	171	2	1	3	1	1	0
ODE-533	170	171	1	1	3	1	0	0
ODE-533	170	172	2	1	3	1	1	0
ODE-533	170	452	282	1	3	5	1	0
ODE-533	171	477	306	0	3	1	1	0
ODE-533	171	309	138	1	3	4	1	0
ODE-533	171	477	306	0	3	5	0	0
ODE-534	171	186	15	1	3	4	1	0
ODE-534	171	186	15	1	3	4	1	0
ODE-534	172	333	161	1	3	1	1	0
ODE-534	172	477	305	0	3	1	0	0
ODE-534	172	240	68	1	3	1	1	1
ODE-534	172	477	305	0	4	1	0	0
ODE-534	175	178	3	1	3	1	1	0
ODE-534	175	477	302	0	3	2	0	0
ODE-534	175	477	302	0	3	1	0	0
ODE-534	176	179	3	1	3	1	1	0
ODE-535	176	183	7	1	3	4	1	0
ODE-535	176	191	15	1	3	2	1	0
ODE-535	176	182	6	1	3	5	1	0
ODE-535	176	260	84	1	3	4	1	0
ODE-535	176	477	301	0	3	4	0	0
ODE-535	177	186	9	1	3	4	1	0
ODE-535	178	477	299	0	3	4	0	0
ODE-535	178	477	299	0	3	4	0	0
ODE-535	178	477	299	0	3	1	0	0
ODE-535	178	185	7	1	3	1	1	0
ODE-536	178	185	7	1	3	1	1	0
ODE-536	178	185	7	1	3	3	1	0
ODE-536	179	477	298	0	3	4	0	0
ODE-536	179	198	19	1	3	4	1	0
ODE-536	179	477	298	0	3	4	0	0
ODE-536	179	351	172	1	3	5	0	0
ODE-536	179	351	172	1	3	5	0	0
ODE-536	179	477	298	0	3	4	0	0
ODE-536	179	310	131	1	3	1	0	0
ODE-536	181	190	9	1	3	1	0	0
ODE-537	181	381	200	1	3	1	0	1
ODE-537	182	199	17	1	3	3	1	1
ODE-537	182	443	261	1	3	1	1	0
ODE-537	183	199	16	1	3	1	1	0
ODE-537	183	185	2	1	3	3	0	0
ODE-537	183	189	6	1	3	5	0	0
ODE-537	183	200	17	1	3	1	1	0
ODE-537	183	192	9	1	3	5	0	0
ODE-537	183	186	3	1	2	3	0	0
ODE-537	183	312	129	1	3	1	1	0
ODE-538	183	477	294	0	3	4	0	0
ODE-538	183	443	260	1	3	1	1	0
ODE-538	183	477	294	0	3	1	0	0
ODE-538	185	189	4	1	3	1	1	0
ODE-538	185	477	292	0	3	1	0	0
ODE-538	185	186	1	1	3	1	1	0
ODE-538	186	477	291	0	3	4	0	0
ODE-538	186	225	39	1	3	3	1	1
ODE-538	186	192	6	1	3	3	0	1
ODE-538	186	477	291	0	3	3	0	0
ODE-539	186	192	6	1	3	4	1	0
ODE-539	186	192	6	1	3	4	1	0
ODE-539	186	192	6	1	3	4	1	0
ODE-539	186	189	3	1	3	1	1	0
ODE-539	186	310	124	1	3	1	0	0
ODE-539	186	310	124	1	3	1	0	0
ODE-539	186	199	13	1	3	1	0	0
ODE-539	186	477	291	0	3	1	0	0
ODE-539	186	192	6	1	3	4	1	0
ODE-539	186	249	63	1	3	3	1	4
ODE-540	186	211	25	1	3	1	1	0
ODE-540	186	290	104	1	3	1	1	0
ODE-540	189	228	39	1	3	1	1	0
ODE-540	189	310	121	1	3	1	0	0
ODE-540	189	191	2	1	3	1	1	0
ODE-540	189	199	10	1	3	4	1	0
ODE-540	189	207	18	1	3	1	0	1
ODE-540	189	477	288	0	3	1	0	1
ODE-540	189	191	2	1	3	4	1	0
ODE-540	189	477	288	0	3	1	0	0
ODE-541	190	210	20	1	4	1	0	0
ODE-541	190	242	52	1	3	3	0	0
ODE-541	190	192	2	1	3	3	0	0
ODE-541	190	477	287	0	3	1	0	0
ODE-541	191	330	139	1	3	4	1	0
ODE-541	191	206	15	1	3	5	0	0
ODE-541	191	220	29	1	3	5	1	0
ODE-541	191	310	119	1	3	1	0	1
ODE-541	191	259	68	1	3	1	0	1
ODE-541	191	477	286	0	3	1	0	0
ODE-542	191	212	21	1	3	1	1	1
ODE-542	192	477	285	0	3	1	0	0
ODE-542	192	310	118	1	3	1	0	0
ODE-542	192	193	1	1	3	4	1	0
ODE-542	192	291	99	1	3	3	1	0
ODE-542	192	211	19	1	3	3	0	0
ODE-542	192	199	7	1	3	3	1	0
ODE-542	192	241	49	1	3	3	1	0
ODE-542	192	477	285	0	3	3	0	0
ODE-542	192	205	13	1	3	3	0	0
ODE-543	192	199	7	1	3	4	1	0
ODE-543	193	199	6	1	3	4	1	0
ODE-543	193	194	1	1	3	4	1	0
ODE-543	193	217	24	1	3	1	1	0
ODE-543	195	197	2	1	4	1	0	0
ODE-543	196	197	1	1	3	4	1	0
ODE-543	196	199	3	1	3	4	1	0
ODE-543	196	210	14	1	3	1	1	0
ODE-543	196	226	30	1	3	3	1	0
ODE-543	196	226	30	1	3	3	1	0
ODE-544	197	290	93	1	3	1	0	1
ODE-544	197	199	2	1	3	1	1	0
ODE-544	197	477	280	0	3	4	0	0
ODE-544	197	210	13	1	3	3	0	1
ODE-544	198	477	279	0	3	5	0	0
ODE-544	198	199	1	1	3	1	1	1
ODE-544	198	199	1	1	3	1	0	0
ODE-544	198	199	1	1	3	4	1	0
ODE-544	198	199	1	1	3	1	1	0
ODE-544	198	477	279	0	3	3	0	0
ODE-545	198	210	12	1	3	1	1	0
ODE-545	198	211	13	1	3	1	1	1
ODE-545	198	199	1	1	3	1	1	0
ODE-545	198	207	9	1	3	4	1	1
ODE-545	199	200	1	1	3	1	0	0
ODE-545	199	268	69	1	3	1	1	0
ODE-545	199	200	1	1	3	1	1	0
ODE-545	199	477	278	0	3	1	0	0
ODE-545	199	477	278	0	3	1	0	0
ODE-545	200	211	11	1	3	1	1	0
ODE-546	200	234	34	1	3	1	1	1
ODE-546	200	201	1	1	3	4	1	0
ODE-546	200	201	1	1	3	1	0	0
ODE-546	200	214	14	1	3	1	1	0
ODE-546	200	219	19	1	3	1	1	0
ODE-546	203	205	2	1	3	3	1	0
ODE-546	203	477	274	0	3	4	0	0
ODE-546	203	206	3	1	3	1	1	0
ODE-546	203	214	11	1	3	1	1	0
ODE-546	204	310	106	1	4	1	0	0
ODE-547	204	218	14	1	3	1	1	1
ODE-547	204	207	3	1	3	4	1	1
ODE-547	204	206	2	1	3	1	1	0
ODE-547	204	224	20	1	3	5	1	0
ODE-547	204	214	10	1	3	1	1	0
ODE-547	205	217	12	1	3	4	0	0
ODE-547	205	477	272	0	3	4	0	0
ODE-547	205	220	15	1	3	1	1	0
ODE-547	205	211	6	1	3	1	1	0
ODE-547	206	477	271	0	4	3	0	0
ODE-548	206	224	18	1	3	1	1	0
ODE-548	206	242	36	1	3	1	0	1
ODE-548	206	210	4	1	3	1	0	1
ODE-548	206	477	271	0	3	1	0	0
ODE-548	206	220	14	1	3	4	1	0
ODE-548	206	220	14	1	3	4	1	0
ODE-548	207	477	270	0	3	1	0	0
ODE-548	207	477	270	0	3	4	0	0
ODE-548	207	220	13	1	3	4	1	0
ODE-548	207	208	1	1	3	4	1	0
ODE-549	207	477	270	0	3	4	0	0
ODE-549	207	477	270	0	3	1	0	0
ODE-549	207	346	139	1	3	4	1	0
ODE-549	207	214	7	1	3	1	1	0
ODE-549	208	354	146	1	3	1	0	1
ODE-549	210	214	4	1	3	1	1	0
ODE-549	210	238	28	1	3	3	0	0
ODE-549	210	214	4	1	3	1	1	0
ODE-549	210	255	45	1	3	1	0	1
ODE-549	210	259	49	1	3	1	1	1
ODE-550	210	477	267	0	3	3	0	0
ODE-550	210	294	84	1	3	1	1	0
ODE-550	211	218	7	1	3	1	1	0
ODE-550	211	214	3	1	3	4	1	0
ODE-550	211	477	266	0	4	4	0	0
ODE-550	211	233	22	1	3	1	1	0
ODE-550	211	477	266	0	3	3	0	0
ODE-550	211	224	13	1	3	3	0	0
ODE-550	211	214	3	1	3	1	1	0
ODE-550	211	252	41	1	3	4	1	0
ODE-551	211	220	9	1	3	1	1	0
ODE-551	211	477	266	0	3	3	0	0
ODE-551	211	214	3	1	3	1	1	0
ODE-551	212	213	1	1	3	1	1	0
ODE-551	212	310	98	1	3	1	0	0
ODE-551	212	213	1	1	3	1	1	0
ODE-551	212	220	8	1	3	1	1	0
ODE-551	213	214	1	1	3	4	1	0
ODE-551	213	477	264	0	3	1	0	0
ODE-551	213	241	28	1	3	4	1	0
ODE-552	213	217	4	1	3	1	1	0
ODE-552	214	218	4	1	3	1	1	0
ODE-552	214	218	4	1	3	4	1	0
ODE-552	214	268	54	1	3	4	1	0
ODE-552	214	215	1	1	3	1	1	0
ODE-552	214	217	3	1	3	5	1	0
ODE-552	214	477	263	0	3	1	0	0
ODE-552	214	249	35	1	3	1	1	0
ODE-552	214	217	3	1	3	1	1	0
ODE-552	214	217	3	1	3	3	1	0
ODE-553	216	231	15	1	3	4	1	0
ODE-553	217	232	15	1	3	1	1	2
ODE-553	217	477	260	0	3	2	0	0
ODE-553	217	220	3	1	3	3	0	0
ODE-553	217	221	4	1	3	1	1	0
ODE-553	218	240	22	1	3	4	1	0
ODE-553	218	241	23	1	3	3	1	0
ODE-553	218	477	259	0	3	1	0	0
ODE-553	218	241	23	1	3	3	1	0
ODE-553	218	241	23	1	3	4	1	0
ODE-554	219	220	1	1	3	1	0	0
ODE-554	219	477	258	0	3	1	0	0
ODE-554	219	477	258	0	3	1	0	0
ODE-554	219	477	258	0	3	2	0	0
ODE-554	219	220	1	1	4	4	1	0
ODE-554	219	241	22	1	3	4	1	0
ODE-554	219	221	2	1	3	1	1	0
ODE-554	219	234	15	1	4	1	1	0
ODE-554	219	241	22	1	3	4	1	0
ODE-554	220	221	1	1	3	1	1	1
ODE-555	220	221	1	1	3	1	0	1
ODE-555	220	264	44	1	3	1	1	1
ODE-555	220	380	160	1	3	1	1	1
ODE-555	220	221	1	1	3	1	1	0
ODE-555	220	227	7	1	3	5	1	0
ODE-555	220	224	4	1	3	4	0	1
ODE-555	220	221	1	1	3	3	0	1
ODE-555	220	477	257	0	3	1	0	0
ODE-555	220	477	257	0	3	3	0	0
ODE-555	220	224	4	1	3	1	1	0
ODE-556	220	226	6	1	3	1	1	0
ODE-556	221	222	1	1	3	4	0	0
ODE-556	221	235	14	1	3	1	1	0
ODE-556	221	477	256	0	3	4	0	0
ODE-556	221	310	89	1	3	1	0	0
ODE-556	221	380	159	1	3	1	1	0
ODE-556	221	477	256	0	3	1	0	0
ODE-556	221	241	20	1	3	4	0	0
ODE-556	223	303	80	1	3	1	1	1
ODE-556	224	310	86	1	3	1	0	1
ODE-557	224	477	253	0	3	3	0	0
ODE-557	224	233	9	1	3	1	1	0
ODE-557	224	477	253	0	3	3	0	1
ODE-557	224	477	253	0	3	1	0	0
ODE-557	224	249	25	1	3	5	1	0
ODE-557	224	225	1	1	3	4	1	0
ODE-557	224	255	31	1	3	3	0	1
ODE-557	224	310	86	1	3	1	0	1
ODE-557	224	346	122	1	3	3	1	0
ODE-557	224	238	14	1	3	4	1	0
ODE-558	224	477	253	0	3	4	0	0
ODE-558	225	452	227	1	3	4	0	1
ODE-558	225	227	2	1	4	1	1	0
ODE-558	226	232	6	1	3	5	1	0
ODE-558	226	477	251	0	3	3	0	0
ODE-558	226	232	6	1	3	4	1	0
ODE-558	226	477	251	0	3	3	0	0
ODE-558	226	240	14	1	3	1	1	0
ODE-558	226	240	14	1	3	1	1	0
ODE-558	226	228	2	1	3	1	1	0
ODE-559	226	330	104	1	3	1	1	4
ODE-559	226	249	23	1	3	1	1	0
ODE-559	227	228	1	1	3	1	1	0
ODE-559	227	234	7	1	3	4	1	4
ODE-559	228	310	82	1	3	4	1	0
ODE-559	228	477	249	0	3	1	0	4
ODE-559	228	241	13	1	3	4	1	0
ODE-559	228	241	13	1	3	3	1	0
ODE-559	228	477	249	0	3	4	0	0
ODE-559	228	240	12	1	3	1	0	2
ODE-560	228	263	35	1	3	4	1	0
ODE-560	231	240	9	1	3	1	1	3
ODE-560	231	232	1	1	3	1	0	1
ODE-560	231	232	1	1	3	1	0	1
ODE-560	231	438	207	1	3	4	0	0
ODE-560	231	266	35	1	3	4	1	0
ODE-560	231	477	246	0	3	4	0	0
ODE-560	231	249	18	1	3	4	1	0
ODE-560	231	241	10	1	3	3	1	0
ODE-560	232	233	1	1	4	1	1	0
ODE-561	232	234	2	1	3	1	0	0
ODE-561	232	477	245	0	3	1	0	0
ODE-561	232	233	1	1	3	1	1	0
ODE-561	232	240	8	1	3	4	1	0
ODE-561	232	238	6	1	3	4	1	0
ODE-561	232	233	1	1	3	1	0	0
ODE-561	232	234	2	1	3	1	1	0
ODE-561	232	234	2	1	3	1	1	0
ODE-561	233	240	7	1	3	1	1	0
ODE-561	233	235	2	1	3	4	1	0
ODE-562	233	234	1	1	3	4	0	0
ODE-562	233	477	244	0	3	4	0	0
ODE-562	233	242	9	1	3	1	0	1
ODE-562	234	238	4	1	3	1	1	0
ODE-562	234	239	5	1	3	1	1	0
ODE-562	234	477	243	0	3	1	0	0
ODE-562	234	477	243	0	3	1	0	0
ODE-562	234	235	1	1	3	1	1	0
ODE-562	234	290	56	1	3	1	0	0
ODE-562	234	235	1	1	3	1	0	0
ODE-563	234	238	4	1	3	1	1	0
ODE-563	234	238	4	1	3	1	1	0
ODE-563	234	235	1	1	3	1	1	0
ODE-563	234	241	7	1	3	3	0	0
ODE-563	235	443	208	1	3	4	1	0
ODE-563	238	395	157	1	3	1	0	0
ODE-563	238	240	2	1	3	1	1	0
ODE-563	238	317	79	1	3	1	1	1
ODE-563	238	477	239	0	3	4	0	0
ODE-563	238	239	1	1	3	5	1	0
ODE-564	238	477	239	0	3	3	0	0
ODE-564	238	239	1	1	3	5	1	0
ODE-564	238	241	3	1	3	3	1	0
ODE-564	238	268	30	1	3	4	0	0
ODE-564	238	477	239	0	3	5	0	0
ODE-564	238	241	3	1	3	1	1	0
ODE-564	238	239	1	1	3	1	1	0
ODE-564	238	477	239	0	3	3	0	0
ODE-564	238	239	1	1	3	2	1	0
ODE-564	239	246	7	1	3	1	1	0
ODE-565	239	240	1	1	3	4	1	0
ODE-565	239	443	204	1	3	4	1	0
ODE-565	239	241	2	1	3	5	1	0
ODE-565	239	241	2	1	3	1	1	0
ODE-565	239	240	1	1	3	4	0	0
ODE-565	239	240	1	1	3	1	0	0
ODE-565	239	240	1	1	3	4	1	0
ODE-565	239	259	20	1	3	5	0	0
ODE-565	239	477	238	0	3	5	0	0
ODE-565	239	477	238	0	3	5	0	0
ODE-566	239	242	3	1	3	4	1	0
ODE-566	240	241	1	1	3	1	1	0
ODE-566	240	241	1	1	3	1	1	0
ODE-566	240	241	1	1	3	5	0	1
ODE-566	240	477	237	0	3	1	0	0
ODE-566	240	323	83	1	3	3	1	0
ODE-566	241	282	41	1	3	1	0	1
ODE-566	241	331	90	1	3	4	1	0
ODE-566	241	323	82	1	3	4	1	0
ODE-566	241	477	236	0	3	3	0	0
ODE-567	241	477	236	0	3	4	0	0
ODE-567	241	242	1	1	3	4	1	0
ODE-567	242	252	10	1	3	5	1	0
ODE-567	242	310	68	1	3	1	0	0
ODE-567	242	368	126	1	3	4	1	2
ODE-567	242	310	68	1	3	1	0	0
ODE-567	242	422	180	1	3	1	1	0
ODE-567	246	443	197	1	3	4	1	0
ODE-567	246	380	134	1	3	1	1	0
ODE-567	246	266	20	1	3	1	1	0
ODE-568	246	249	3	1	3	1	0	1
ODE-568	246	290	44	1	3	1	0	0
ODE-568	246	248	2	1	3	1	1	0
ODE-568	246	455	209	1	3	3	2	0
ODE-568	246	248	2	1	3	4	1	0
ODE-568	246	248	2	1	3	4	1	0
ODE-568	246	338	92	1	3	4	1	0
ODE-568	246	248	2	1	3	4	1	0
ODE-568	246	261	15	1	3	4	1	0
ODE-568	246	477	231	0	3	1	0	0
ODE-569	247	285	38	1	3	4	0	0
ODE-569	247	254	7	1	3	5	0	0
ODE-569	247	477	230	0	3	1	0	0
ODE-569	247	285	38	1	3	5	0	0
ODE-569	247	415	168	1	3	4	1	0
ODE-569	247	248	1	1	3	3	0	0
ODE-569	247	305	58	1	3	5	1	0
ODE-569	247	253	6	1	3	1	1	0
ODE-569	248	255	7	1	3	5	0	0
ODE-569	248	249	1	1	3	1	1	0
ODE-570	248	260	12	1	3	4	1	0
ODE-570	248	295	47	1	3	1	0	0
ODE-570	248	249	1	1	3	1	1	0
ODE-570	248	477	229	0	3	1	0	0
ODE-570	248	249	1	1	3	1	1	0
ODE-570	249	252	3	1	3	4	1	0
ODE-570	249	310	61	1	3	1	0	0
ODE-570	249	451	202	1	3	1	0	0
ODE-570	249	448	199	1	3	1	0	0
ODE-570	249	395	146	1	3	3	1	0
ODE-571	249	310	61	1	3	1	0	0
ODE-571	252	423	171	1	3	1	1	0
ODE-571	252	254	2	1	3	1	1	0
ODE-571	252	443	191	1	3	1	1	0
ODE-571	252	259	7	1	3	1	1	0
ODE-571	252	477	225	0	3	4	0	0
ODE-571	252	452	200	1	3	4	1	0
ODE-571	252	477	225	0	3	4	0	0
ODE-571	252	477	225	0	3	4	0	0
ODE-571	252	477	225	0	4	4	0	0
ODE-572	252	477	225	0	3	5	0	0
ODE-572	252	477	225	0	3	5	0	0
ODE-572	252	261	9	1	3	4	1	0
ODE-572	253	304	51	1	3	4	0	0
ODE-572	253	477	224	0	4	1	0	0
ODE-572	253	255	2	1	3	1	1	0
ODE-572	253	274	21	1	3	4	1	1
ODE-572	253	255	2	1	3	1	1	0
ODE-572	253	274	21	1	3	1	1	0
ODE-572	253	477	224	0	3	1	0	0
ODE-573	254	255	1	1	3	5	0	0
ODE-573	254	477	223	0	3	1	0	0
ODE-573	254	259	5	1	3	1	1	0
ODE-573	254	269	15	1	3	4	1	0
ODE-573	255	256	1	1	3	1	0	0
ODE-573	255	477	222	0	3	4	0	0
ODE-573	255	477	222	0	3	1	0	0
ODE-573	255	259	4	1	3	1	1	0
ODE-573	255	275	20	1	3	5	0	0
ODE-573	255	291	36	1	3	4	0	0
ODE-574	256	477	221	0	3	1	0	0
ODE-574	256	268	12	1	3	1	1	0
ODE-574	256	310	54	1	3	1	1	0
ODE-574	259	477	218	0	3	4	0	0
ODE-574	259	281	22	1	3	5	0	0
ODE-574	259	262	3	1	3	1	0	1
ODE-574	259	477	218	0	3	1	0	0
ODE-574	259	274	15	1	3	1	1	0
ODE-574	259	268	9	1	3	1	1	0
ODE-574	259	429	170	1	3	1	0	1
ODE-575	260	477	217	0	3	1	0	0
ODE-575	260	262	2	1	3	4	0	0
ODE-575	260	477	217	0	3	4	0	0
ODE-575	260	280	20	1	3	5	0	0
ODE-575	261	262	1	1	3	1	0	1
ODE-575	261	477	216	0	3	4	0	0
ODE-575	261	477	216	0	3	4	0	0
ODE-575	261	323	62	1	3	4	1	0
ODE-575	261	262	1	1	3	1	0	0
ODE-575	261	477	216	0	3	1	0	0
ODE-576	261	318	57	1	3	1	0	0
ODE-576	261	477	216	0	3	1	0	0
ODE-576	261	263	2	1	3	1	1	0
ODE-576	262	477	215	0	3	4	0	0
ODE-576	262	297	35	1	3	1	1	0
ODE-576	263	264	1	1	3	4	0	0
ODE-576	263	281	18	1	3	5	0	0
ODE-576	263	266	3	1	3	1	0	0
ODE-576	263	283	20	1	3	1	0	0
ODE-576	263	477	214	0	3	4	0	0
ODE-577	263	281	18	1	3	5	0	0
ODE-577	263	270	7	1	3	1	1	0
ODE-577	263	477	214	0	3	1	0	0
ODE-577	264	282	18	1	3	5	0	0
ODE-577	266	274	8	1	3	4	0	0
ODE-577	266	401	135	1	3	4	0	1
ODE-577	266	270	4	1	4	1	1	0
ODE-577	267	452	185	1	3	4	0	0
ODE-577	267	477	210	0	3	4	0	0
ODE-577	267	477	210	0	3	4	0	0
ODE-578	267	281	14	1	3	4	1	0
ODE-578	267	273	6	1	3	1	1	0
ODE-578	268	420	152	1	3	5	0	0
ODE-578	268	277	9	1	3	4	1	0
ODE-578	268	275	7	1	3	1	1	0
ODE-578	268	477	209	0	4	2	0	0
ODE-578	268	350	82	1	3	1	1	0
ODE-578	269	477	208	0	3	2	0	0
ODE-578	269	477	208	0	3	4	0	0
ODE-578	269	317	48	1	3	1	1	0
ODE-579	269	477	208	0	3	1	0	0
ODE-579	269	310	41	1	3	1	0	0
ODE-579	269	395	126	1	3	5	1	0
ODE-579	269	346	77	1	3	1	1	0
ODE-579	269	477	208	0	3	1	0	0
ODE-579	270	477	207	0	4	1	0	0
ODE-579	270	310	40	1	3	1	0	0
ODE-579	270	301	31	1	3	1	1	0
ODE-579	270	273	3	1	3	1	0	0
ODE-579	270	275	5	1	3	4	1	0
ODE-580	273	477	204	0	3	1	0	0
ODE-580	273	477	204	0	3	4	0	0
ODE-580	273	477	204	0	3	4	0	0
ODE-580	273	290	17	1	3	5	1	1
ODE-580	273	288	15	1	3	5	1	0
ODE-580	274	477	203	0	3	5	0	0
ODE-580	274	380	106	1	3	2	1	0
ODE-580	274	283	9	1	3	1	1	0
ODE-580	274	308	34	1	3	5	1	0
ODE-580	274	477	203	0	3	4	0	0
ODE-581	274	310	36	1	3	1	0	1
ODE-581	274	282	8	1	3	1	1	0
ODE-581	274	417	143	1	3	4	0	0
ODE-581	275	322	47	1	3	1	1	0
ODE-581	275	395	120	1	3	3	1	0
ODE-581	275	477	202	0	3	4	0	0
ODE-581	275	477	202	0	3	1	0	1
ODE-581	275	477	202	0	3	1	0	0
ODE-581	276	477	201	0	3	3	0	0
ODE-581	276	304	28	1	3	5	0	0
ODE-582	276	280	4	1	3	5	0	0
ODE-582	276	284	8	1	3	5	0	0
ODE-582	276	280	4	1	3	5	0	2
ODE-582	276	288	12	1	3	5	0	0
ODE-582	276	280	4	1	3	5	0	0
ODE-582	276	477	201	0	3	3	0	0
ODE-582	276	319	43	1	3	5	0	1
ODE-582	276	298	22	1	5	5	1	0
ODE-582	276	277	1	1	3	1	1	0
ODE-582	276	395	119	1	3	5	1	0
ODE-583	276	284	8	1	3	1	1	0
ODE-583	277	310	33	1	3	1	0	0
ODE-583	280	477	197	0	3	3	0	0
ODE-583	280	477	197	0	3	3	0	0
ODE-583	280	477	197	0	3	3	0	0
ODE-583	280	477	197	0	3	3	0	0
ODE-583	280	477	197	0	3	3	0	0
ODE-583	280	477	197	0	3	3	0	0
ODE-583	281	284	3	1	5	4	1	0
ODE-583	281	282	1	1	3	5	0	0
ODE-584	281	477	196	0	3	5	0	0
ODE-584	281	296	15	1	3	4	1	0
ODE-584	281	477	196	0	3	4	0	0
ODE-584	281	283	2	1	3	4	1	0
ODE-584	281	295	14	1	3	1	1	0
ODE-584	281	289	8	1	3	4	1	1
ODE-584	282	283	1	1	3	5	1	0
ODE-584	282	285	3	1	3	4	0	0
ODE-584	283	284	1	1	3	5	0	0
ODE-584	283	284	1	1	3	1	1	0
ODE-585	283	291	8	1	3	5	1	2
ODE-585	283	284	1	1	3	5	0	0
ODE-585	283	477	194	0	3	1	0	1
ODE-585	283	477	194	0	3	1	0	0
ODE-585	283	284	1	1	3	1	0	1
ODE-585	283	287	4	1	3	5	1	0
ODE-585	283	288	5	1	3	5	1	0
ODE-585	284	289	5	1	3	1	1	0
ODE-585	284	477	193	0	3	1	0	0
ODE-585	284	291	7	1	3	4	0	2
ODE-586	284	291	7	1	3	5	1	0
ODE-586	284	296	12	1	3	4	1	0
ODE-586	284	291	7	1	3	5	1	0
ODE-586	284	477	193	0	3	4	0	0
ODE-586	284	291	7	1	3	4	0	0
ODE-586	284	477	193	0	3	1	0	0
ODE-587	284	477	193	0	5	4	0	0
ODE-587	284	291	7	1	3	4	1	0
ODE-587	285	316	31	1	5	1	1	0
ODE-587	285	477	192	0	3	5	0	0
ODE-587	285	290	5	1	4	1	1	0
ODE-587	287	477	190	0	3	4	0	0
ODE-587	287	290	3	1	3	4	1	0
ODE-587	287	291	4	1	3	1	1	0
ODE-587	287	322	35	1	3	3	1	0
ODE-588	288	289	1	1	3	5	0	0
ODE-588	288	308	20	1	3	3	1	0
ODE-588	288	477	189	0	3	5	0	0
ODE-588	288	339	51	1	3	5	0	0
ODE-588	288	366	78	1	3	1	1	0
ODE-588	288	296	8	1	3	5	1	0
ODE-588	288	296	8	1	3	5	1	0
ODE-588	289	325	36	1	3	4	1	0
ODE-588	289	296	7	1	3	1	1	0
ODE-588	289	477	188	0	3	1	0	0
ODE-589	289	290	1	1	3	1	1	0
ODE-589	289	291	2	1	3	5	0	0
ODE-589	289	298	9	1	3	5	0	1
ODE-589	289	290	1	1	3	4	0	0
ODE-589	289	290	1	1	5	3	0	0
ODE-589	289	477	188	0	3	4	0	0
ODE-589	290	477	187	0	3	1	0	0
ODE-589	290	296	6	1	3	1	1	0
ODE-589	290	291	1	1	3	1	0	0
ODE-589	290	296	6	1	3	5	1	0
ODE-590	290	477	187	0	3	4	0	0
ODE-590	290	291	1	1	3	1	0	1
ODE-590	291	294	3	1	3	1	1	0
ODE-590	291	294	3	1	3	1	0	1
ODE-590	291	292	1	1	3	5	1	0
ODE-590	291	292	1	1	3	5	1	0
ODE-590	291	292	1	1	3	5	1	0
ODE-590	291	296	5	1	3	5	1	0
ODE-590	293	295	2	1	3	1	1	0
ODE-590	294	301	7	1	3	4	1	0
ODE-591	294	295	1	1	3	1	1	0
ODE-591	294	298	4	1	3	1	1	0
ODE-591	295	296	1	1	3	1	0	0
ODE-591	295	298	3	1	3	5	1	0
ODE-591	295	477	182	0	3	5	0	0
ODE-591	295	296	1	1	4	5	1	0
ODE-591	295	477	182	0	3	1	0	0
ODE-591	295	302	7	1	3	1	1	0
ODE-591	296	311	15	1	2	4	1	0
ODE-591	296	477	181	0	3	1	0	0
ODE-592	296	477	181	0	3	4	0	0
ODE-592	296	297	1	1	3	3	0	0
ODE-592	296	297	1	1	3	4	1	0
ODE-592	296	477	181	0	3	1	0	0
ODE-592	296	297	1	1	3	1	0	0
ODE-592	296	298	2	1	3	4	1	0
ODE-592	296	297	1	1	3	1	1	0
ODE-592	296	298	2	1	3	4	1	0
ODE-592	296	477	181	0	3	4	0	0
ODE-592	296	297	1	1	3	1	1	0
ODE-593	296	297	1	1	5	4	0	0
ODE-593	296	311	15	1	3	5	1	0
ODE-593	296	477	181	0	3	5	0	0
ODE-593	297	298	1	1	3	1	1	0
ODE-593	297	477	180	0	3	1	0	0
ODE-593	297	303	6	1	3	4	1	0
ODE-593	297	298	1	1	3	4	1	0
ODE-593	297	336	39	1	3	5	0	0
ODE-593	297	336	39	1	3	5	0	0
ODE-593	298	477	179	0	3	5	0	0
ODE-594	298	477	179	0	3	5	0	4
ODE-594	298	308	10	1	3	5	1	0
ODE-594	298	477	179	0	3	4	0	0
ODE-594	298	477	179	0	3	5	0	0
ODE-594	298	322	24	1	3	1	1	0
ODE-594	298	302	4	1	3	1	1	0
ODE-594	298	299	1	1	3	1	1	0
ODE-594	298	336	38	1	3	5	0	0
ODE-594	301	452	151	1	3	1	0	0
ODE-594	301	477	176	0	3	1	0	0
ODE-595	301	302	1	1	3	5	1	0
ODE-595	301	305	4	1	3	4	1	0
ODE-595	301	395	94	1	3	1	1	0
ODE-595	301	303	2	1	3	1	1	0
ODE-595	302	477	175	0	3	1	0	0
ODE-595	302	360	58	1	4	1	1	0
ODE-595	302	477	175	0	3	1	0	0
ODE-595	302	477	175	0	3	1	0	0
ODE-595	302	477	175	0	3	1	0	0
ODE-595	302	315	13	1	3	1	1	0
ODE-596	302	304	2	1	3	4	1	0
ODE-596	302	305	3	1	3	1	1	0
ODE-596	303	477	174	0	3	1	0	0
ODE-596	303	308	5	1	3	5	1	0
ODE-596	303	351	48	1	3	5	1	0
ODE-596	303	305	2	1	3	5	0	0
ODE-596	304	305	1	1	3	3	1	0
ODE-596	304	305	1	1	3	4	1	0
ODE-596	304	305	1	1	3	4	1	0
ODE-596	304	305	1	1	3	4	1	0
ODE-597	305	306	1	1	3	4	1	0
ODE-597	305	477	172	0	3	4	0	1
ODE-597	305	316	11	1	3	1	1	0
ODE-597	305	477	172	0	3	5	0	0
ODE-597	305	477	172	0	3	1	0	0
ODE-597	305	477	172	0	3	1	0	0
ODE-597	305	477	172	0	3	1	0	0
ODE-597	305	309	4	1	3	4	1	0
ODE-597	306	310	4	1	3	5	1	0
ODE-597	306	477	171	0	3	5	0	0
ODE-598	306	477	171	0	3	1	0	0
ODE-598	306	477	171	0	3	1	0	0
ODE-598	306	477	171	0	3	1	0	0
ODE-598	306	477	171	0	3	1	0	0
ODE-598	308	309	1	1	3	1	1	0
ODE-598	308	309	1	1	3	1	1	0
ODE-598	308	311	3	1	3	1	1	0
ODE-598	308	311	3	1	3	5	1	0
ODE-598	308	309	1	1	3	4	1	0
ODE-598	308	310	2	1	3	1	0	0
ODE-599	308	477	169	0	3	5	0	0
ODE-599	308	477	169	0	3	1	0	0
ODE-599	309	310	1	1	3	1	1	0
ODE-599	309	316	7	1	3	1	1	0
ODE-599	309	375	66	1	3	4	0	0
ODE-599	309	323	14	1	3	3	1	0
ODE-599	309	320	11	1	3	4	1	0
ODE-599	309	477	168	0	3	5	0	0
ODE-599	309	331	22	1	1	2	1	0
ODE-599	309	351	42	1	3	5	1	0
ODE-600	309	311	2	1	3	4	1	0
ODE-600	309	477	168	0	3	3	0	0
ODE-600	309	477	168	0	3	1	0	0
ODE-600	309	310	1	1	3	5	1	0
ODE-600	309	477	168	0	3	4	0	0
ODE-600	310	477	167	0	3	3	0	0
ODE-600	310	477	167	0	3	3	0	0
ODE-600	310	477	167	0	3	4	0	0
ODE-600	310	424	114	1	3	1	1	0
ODE-600	310	351	41	1	3	5	1	0
ODE-601	310	317	7	1	3	4	1	0
ODE-601	310	369	59	1	3	1	1	0
ODE-601	310	338	28	1	3	3	0	0
ODE-601	310	333	23	1	3	1	1	0
ODE-601	310	477	167	0	3	1	0	0
ODE-601	310	312	2	1	3	1	0	0
ODE-601	311	312	1	1	3	1	1	0
ODE-601	311	477	166	0	3	3	0	0
ODE-601	311	312	1	1	3	1	1	0
ODE-601	311	332	21	1	3	4	0	0
ODE-602	311	351	40	1	3	5	1	0
ODE-602	311	477	166	0	3	4	0	0
ODE-602	312	477	165	0	3	1	0	0
ODE-602	312	315	3	1	3	1	1	0
ODE-602	312	313	1	1	3	1	0	0
ODE-602	312	319	7	1	3	2	1	0
ODE-602	312	417	105	1	3	1	1	0
ODE-602	312	452	140	1	3	4	0	0
ODE-602	312	477	165	0	3	1	0	0
ODE-602	312	334	22	1	3	4	1	0
ODE-603	312	323	11	1	3	3	1	0
ODE-603	312	315	3	1	3	4	1	0
ODE-603	312	463	151	1	3	1	0	0
ODE-603	312	431	119	1	3	4	1	0
ODE-603	312	329	17	1	3	5	1	0
ODE-603	312	331	19	1	4	4	1	0
ODE-603	313	346	33	1	3	1	1	0
ODE-603	315	361	46	1	3	5	1	0
ODE-603	315	477	162	0	3	1	0	0
ODE-603	315	324	9	1	3	4	1	0
ODE-604	315	477	162	0	3	1	0	0
ODE-604	315	316	1	1	3	1	0	0
ODE-604	316	317	1	1	3	1	1	0
ODE-604	316	437	121	1	4	1	0	0
ODE-604	316	477	161	0	3	5	0	1
ODE-604	316	317	1	1	3	4	0	0
ODE-604	316	477	161	0	3	1	0	0
ODE-604	316	477	161	0	3	1	0	0
ODE-604	316	477	161	0	3	1	0	0
ODE-604	317	477	160	0	3	1	0	0
ODE-605	317	477	160	0	3	4	0	0
ODE-605	317	318	1	1	3	1	1	0
ODE-605	317	338	21	1	3	3	1	0
ODE-605	317	338	21	1	3	1	1	0
ODE-605	317	477	160	0	3	4	0	0
ODE-605	317	477	160	0	4	4	0	0
ODE-605	317	318	1	1	3	1	0	0
ODE-605	317	338	21	1	3	1	1	0
ODE-605	317	318	1	1	3	1	1	0
ODE-605	318	319	1	1	3	1	1	0
ODE-606	318	380	62	1	3	1	1	0
ODE-606	318	329	11	1	3	1	1	0
ODE-606	318	329	11	1	3	1	0	0
ODE-606	318	322	4	1	3	1	1	0
ODE-606	318	452	134	1	3	1	1	0
ODE-606	318	324	6	1	3	1	1	0
ODE-606	319	343	24	1	3	1	1	0
ODE-606	319	466	147	1	3	4	1	0
ODE-606	319	333	14	1	3	1	1	0
ODE-606	319	477	158	0	3	1	0	0
ODE-607	319	324	5	1	3	1	0	0
ODE-607	319	477	158	0	3	3	0	0
ODE-607	319	322	3	1	3	1	1	0
ODE-607	321	384	63	1	3	3	0	0
ODE-607	322	330	8	1	3	1	0	3
ODE-607	323	330	7	1	3	4	1	0
ODE-607	323	324	1	1	3	1	0	1
ODE-607	323	331	8	1	3	1	1	0
ODE-607	324	346	22	1	3	1	1	0
ODE-607	324	477	153	0	3	4	0	0
ODE-608	324	343	19	1	3	3	1	0
ODE-608	324	330	6	1	3	2	1	0
ODE-608	324	477	153	0	3	2	0	0
ODE-608	324	331	7	1	3	2	1	0
ODE-608	324	343	19	1	3	2	1	0
ODE-608	324	343	19	1	3	2	1	0
ODE-608	324	332	8	1	3	2	0	0
ODE-608	325	477	152	0	3	2	0	0
ODE-608	325	330	5	1	3	3	1	0
ODE-608	325	477	152	0	3	4	0	0
ODE-609	329	330	1	1	3	1	1	0
ODE-609	329	330	1	1	3	1	0	0
ODE-609	329	333	4	1	3	5	1	0
ODE-609	329	330	1	1	3	4	1	0
ODE-609	330	477	147	0	3	1	0	0
ODE-609	330	477	147	0	3	1	0	0
ODE-609	330	333	3	1	3	4	1	0
ODE-609	331	477	146	0	3	1	0	0
ODE-609	331	477	146	0	3	1	0	0
ODE-609	331	359	28	1	4	1	1	0
ODE-610	331	477	146	0	3	1	0	0
ODE-610	331	334	3	1	3	2	0	1
ODE-610	331	346	15	1	3	2	1	0
ODE-610	332	477	145	0	3	4	0	0
ODE-610	332	477	145	0	3	4	0	0
ODE-610	332	477	145	0	3	1	0	0
ODE-610	332	337	5	1	3	3	1	0
ODE-610	332	417	85	1	3	1	1	0
ODE-610	332	333	1	1	3	1	1	0
ODE-610	332	339	7	1	3	1	0	0
ODE-611	332	336	4	1	3	4	0	0
ODE-611	332	339	7	1	3	4	0	0
ODE-611	332	343	11	1	3	1	1	0
ODE-611	332	395	63	1	3	1	1	0
ODE-611	333	477	144	0	3	1	0	0
ODE-611	333	334	1	1	3	1	1	0
ODE-611	333	343	10	1	3	1	1	0
ODE-611	333	417	84	1	3	2	1	1
ODE-611	333	334	1	1	3	1	1	0
ODE-611	333	344	11	1	3	4	1	0
ODE-612	333	334	1	1	3	1	0	0
ODE-612	333	336	3	1	3	2	0	0
ODE-612	336	339	3	1	3	1	1	0
ODE-612	336	339	3	1	3	4	0	0
ODE-612	336	364	28	1	3	3	1	0
ODE-612	336	477	141	0	3	3	0	1
ODE-612	336	477	141	0	3	3	0	1
ODE-612	336	338	2	1	3	4	1	0
ODE-612	336	477	141	0	3	5	0	0
ODE-612	336	339	3	1	3	5	0	0
ODE-613	336	417	81	1	3	1	0	0
ODE-613	336	344	8	1	3	3	1	0
ODE-613	337	477	140	0	3	1	0	0
ODE-613	337	477	140	0	3	4	0	0
ODE-613	337	379	42	1	3	4	0	0
ODE-613	337	374	37	1	3	4	1	0
ODE-613	337	477	140	0	3	4	0	0
ODE-613	337	477	140	0	3	4	0	0
ODE-613	337	344	7	1	3	3	1	0
ODE-613	337	455	118	1	3	1	0	0
ODE-614	337	477	140	0	3	4	0	0
ODE-614	337	340	3	1	3	1	1	0
ODE-614	337	340	3	1	3	4	1	0
ODE-614	337	477	140	0	3	1	0	0
ODE-614	337	338	1	1	3	1	1	0
ODE-614	338	339	1	1	3	3	1	0
ODE-614	338	348	10	1	3	3	1	0
ODE-614	338	381	43	1	3	4	0	0
ODE-614	338	354	16	1	3	4	1	1
ODE-614	338	340	2	1	3	1	1	0
ODE-615	338	477	139	0	3	2	0	0
ODE-615	338	339	1	1	4	1	1	0
ODE-615	339	464	125	1	2	1	1	0
ODE-615	339	477	138	0	3	1	0	0
ODE-615	339	477	138	0	3	1	0	0
ODE-615	339	463	124	1	4	1	1	0
ODE-615	339	344	5	1	3	4	1	0
ODE-615	339	477	138	0	3	1	0	0
ODE-615	339	477	138	0	3	5	0	0
ODE-615	339	477	138	0	3	1	0	0
ODE-616	339	477	138	0	3	1	0	0
ODE-616	339	477	138	0	3	4	0	0
ODE-616	339	477	138	0	3	1	0	0
ODE-616	340	344	4	1	3	3	1	0
ODE-616	340	341	1	1	3	1	1	0
ODE-616	340	477	137	0	3	1	0	0
ODE-616	340	345	5	1	3	4	1	0
ODE-616	340	477	137	0	3	1	0	0
ODE-616	340	341	1	1	3	1	1	0
ODE-616	340	346	6	1	3	4	0	1
ODE-617	340	351	11	1	3	4	1	0
ODE-617	343	477	134	0	3	1	0	0
ODE-617	343	345	2	1	3	4	1	0
ODE-617	343	347	4	1	3	3	1	0
ODE-617	343	477	134	0	3	2	0	0
ODE-617	343	477	134	0	3	4	0	0
ODE-617	343	360	17	1	3	4	1	0
ODE-617	343	352	9	1	3	1	1	0
ODE-617	344	345	1	1	3	4	0	0
ODE-617	344	345	1	1	3	4	1	0
ODE-618	344	345	1	1	3	1	1	0
ODE-618	344	345	1	1	3	1	1	0
ODE-618	344	459	115	1	3	1	1	0
ODE-618	344	477	133	0	3	1	0	0
ODE-618	344	420	76	1	3	5	0	0
ODE-618	344	420	76	1	3	5	0	0
ODE-618	344	477	133	0	3	1	0	0
ODE-618	344	378	34	1	3	4	1	0
ODE-618	344	345	1	1	3	4	0	0
ODE-618	344	351	7	1	3	4	0	0
ODE-619	345	372	27	1	3	3	0	0
ODE-619	345	379	34	1	3	3	0	0
ODE-619	345	372	27	1	3	3	0	0
ODE-619	345	477	132	0	3	3	0	0
ODE-619	345	352	7	1	3	4	0	0
ODE-619	345	350	5	1	3	1	1	0
ODE-619	345	430	85	1	3	5	1	0
ODE-619	345	347	2	1	3	4	0	0
ODE-619	346	351	5	1	3	4	0	1
ODE-619	346	477	131	0	3	3	0	0
ODE-620	346	347	1	1	3	1	0	0
ODE-620	346	477	131	0	3	1	0	0
ODE-620	347	477	130	0	3	5	0	0
ODE-620	347	477	130	0	3	3	0	0
ODE-620	347	477	130	0	3	4	0	0
ODE-620	347	354	7	1	3	1	1	0
ODE-620	348	372	24	1	3	4	0	0
ODE-620	348	372	24	1	3	3	0	0
ODE-620	349	477	128	0	3	1	0	0
ODE-620	350	351	1	1	3	4	1	0
ODE-621	350	452	102	1	3	5	0	0
ODE-621	350	477	127	0	3	5	0	0
ODE-621	350	382	32	1	3	1	1	0
ODE-621	350	351	1	1	3	4	1	0
ODE-621	350	354	4	1	3	4	0	0
ODE-621	350	352	2	1	3	1	1	0
ODE-621	351	352	1	1	3	1	1	0
ODE-621	351	477	126	0	3	1	0	0
ODE-621	351	369	18	1	3	4	1	0
ODE-621	351	354	3	1	3	1	1	0
ODE-622	351	477	126	0	3	1	0	0
ODE-622	351	361	10	1	3	1	1	0
ODE-622	351	477	126	0	3	1	0	0
ODE-622	352	354	2	1	3	4	0	0
ODE-622	352	354	2	1	3	1	0	0
ODE-622	352	374	22	1	3	4	1	0
ODE-622	352	477	125	0	3	3	0	0
ODE-622	352	353	1	1	3	1	1	0
ODE-622	353	477	124	0	3	1	0	0
ODE-622	353	477	124	0	3	4	0	0
ODE-623	353	354	1	1	3	2	1	0
ODE-623	353	354	1	1	3	1	0	0
ODE-623	353	382	29	1	3	1	1	0
ODE-623	353	354	1	1	3	1	1	1
ODE-623	354	355	1	1	3	1	1	0
ODE-623	354	365	11	1	3	1	1	0
ODE-623	354	477	123	0	3	1	0	0
ODE-623	354	372	18	1	3	4	0	0
ODE-623	360	477	117	0	3	1	0	0
ODE-623	362	367	5	1	3	4	1	0
OMETRY-	97	110	13	1	3	3	0	0
OMETRY-1	155	260	105	1	4	4	0	0
OMETRY-1	155	401	246	1	3	5	1	3
OMETRY-1	173	256	83	1	4	3	0	0
OMETRY-1	249	477	228	0	4	3	1	0
OMETRY-1	249	350	101	1	3	2	1	2
OMETRY-1	256	267	11	1	4	3	0	0
OMETRY-1	259	477	218	0	3	3	1	1
OMETRY-1	259	294	35	1	3	4	0	1
OMETRY-1	259	260	1	1	4	3	0	0
OMETRY-1	262	477	215	0	2	1	1	0
OMETRY-	125	153	28	1	3	4	0	0
OMETRY-2	264	265	1	1	4	3	0	0
OMETRY-2	265	477	212	0	4	3	1	1
OMETRY-2	267	477	210	0	4	5	1	0
OMETRY-2	290	313	23	1	3	4	1	0
OMETRY-2	345	477	132	0	3	4	0	2
OMETRY-2	348	477	129	0	3	3	1	1
OMETRY-2	348	405	57	1	4	5	0	0
OMETRY-2	348	407	59	1	3	5	0	1
OMETRY-2	348	412	64	1	3	4	0	3
OMETRY-2	348	477	129	0	3	4	0	0
OMETRY-	141	201	60	1	4	4	0	0
OMETRY-3	349	477	128	0	3	5	0	0
OMETRY-3	349	356	7	1	3	3	0	0
OMETRY-3	349	477	128	0	3	4	0	3
OMETRY-3	349	477	128	0	3	4	0	2
OMETRY-3	349	477	128	0	3	4	0	3
OMETRY-3	350	477	127	0	3	5	1	1
OMETRY-3	350	477	127	0	3	3	0	0
OMETRY-3	357	358	1	1	1	2	0	0
OMETRY-	141	201	60	1	4	3	0	0
OMETRY-	141	158	17	1	5	3	0	0
OMETRY-	141	142	1	1	5	3	0	0
OMETRY-	141	202	61	1	3	2	0	0
OMETRY-	153	259	106	1	3	3	0	1
OMETRY-	155	256	101	1	4	5	0	0
RONIMODEVTOOLS-81	4	477	473	0	2	5	0	0
RAPH-116	9	136	127	1	4	4	0	0
RAPH-116	12	81	69	1	4	2	0	0
RAPH-116	30	81	51	1	3	2	0	0
RAPH-116	42	136	94	1	5	4	0	0
RAPH-117	43	81	38	1	4	4	0	0
RAPH-117	46	136	90	1	4	4	0	0
RAPH-117	52	477	425	0	3	4	1	0
RAPH-117	57	477	420	0	3	1	1	0
RAPH-117	67	136	69	1	4	2	0	0
RAPH-117	71	81	10	1	3	1	0	0
RAPH-117	78	150	72	1	4	1	0	0
RAPH-117	78	477	399	0	4	1	0	0
RAPH-117	78	477	399	0	4	1	0	0
RAPH-117	78	477	399	0	3	1	0	0
RAPH-118	78	477	399	0	3	4	0	2
RAPH-118	80	136	56	1	3	4	0	0
RAPH-118	80	136	56	1	4	4	0	0
RAPH-118	85	136	51	1	5	4	0	0
RAPH-118	94	136	42	1	4	4	0	0
RAPH-118	95	136	41	1	3	4	0	0
RAPH-118	99	477	378	0	3	1	0	0
RAPH-118	104	477	373	0	2	1	0	0
RAPH-118	106	477	371	0	3	4	0	0
RAPH-118	114	477	363	0	3	4	0	0
RAPH-119	115	477	362	0	3	4	0	0
RAPH-119	121	136	15	1	5	4	0	0
RAPH-119	122	136	14	1	5	4	0	0
RAPH-119	137	145	8	1	3	1	0	0
RAPH-119	137	296	159	1	3	4	0	0
RAPH-119	149	296	147	1	3	1	0	0
RAPH-119	150	477	327	0	3	4	0	0
RAPH-119	190	210	20	1	4	4	0	0
RAPH-119	206	477	271	0	3	3	1	0
RAPH-119	210	477	267	0	5	4	0	0
RAPH-120	257	477	220	0	4	4	0	0
RAPH-120	260	477	217	0	3	1	0	0
RAPH-120	261	477	216	0	4	2	0	0
RAPH-120	277	477	200	0	4	4	0	0
RAPH-120	280	477	197	0	4	4	0	0
RAPH-120	287	477	190	0	4	4	0	0
RAPH-120	290	296	6	1	4	1	0	0
RAPH-120	291	312	21	1	3	4	0	1
RAPH-120	292	296	4	1	4	4	0	0
RAPH-120	292	477	185	0	4	4	0	0
RAPH-121	296	477	181	0	3	4	0	0
RAPH-121	310	477	167	0	3	2	0	0
RAPH-121	329	477	148	0	4	1	0	0
RAPH-121	332	477	145	0	3	1	0	0
RAPH-121	337	477	140	0	3	4	0	0
RAPH-121	338	477	139	0	4	1	0	0
RAPH-121	340	477	137	0	4	4	0	0
BBLIN-35	1	2	1	1	3	1	1	0
BBLIN-35	1	2	1	1	3	1	1	0
BBLIN-35	2	207	205	1	3	3	1	0
BBLIN-35	3	5	2	1	3	1	1	0
BBLIN-35	4	5	1	1	3	1	1	0
BBLIN-35	5	6	1	1	3	1	1	0
BBLIN-35	5	10	5	1	3	1	1	0
BBLIN-36	5	8	3	1	3	1	1	0
BBLIN-36	8	22	14	1	3	4	1	0
BBLIN-36	8	11	3	1	3	4	1	0
BBLIN-36	8	9	1	1	3	1	1	0
BBLIN-36	9	10	1	1	3	3	1	0
BBLIN-36	9	79	70	1	3	4	1	0
BBLIN-36	9	477	468	0	3	1	0	0
BBLIN-36	10	477	467	0	3	3	0	0
BBLIN-36	10	477	467	0	3	1	1	0
BBLIN-36	10	11	1	1	3	1	1	0
BBLIN-37	11	35	24	1	4	4	1	0
BBLIN-37	12	44	32	1	3	1	1	0
BBLIN-37	15	43	28	1	3	1	1	0
BBLIN-37	15	477	462	0	3	3	0	0
BBLIN-37	15	333	318	1	3	1	1	0
BBLIN-37	16	477	461	0	3	2	1	0
BBLIN-37	16	21	5	1	3	2	1	0
BBLIN-37	16	43	27	1	3	3	1	0
BBLIN-37	17	52	35	1	3	1	1	0
BBLIN-37	17	38	21	1	3	4	1	0
BBLIN-38	18	333	315	1	3	3	1	0
BBLIN-38	21	79	58	1	3	4	1	0
BBLIN-38	22	23	1	1	3	4	1	0
BBLIN-38	22	477	455	0	3	1	0	0
BBLIN-38	22	24	2	1	3	4	1	0
BBLIN-38	22	477	455	0	3	2	0	0
BBLIN-38	22	477	455	0	3	4	0	0
BBLIN-38	23	35	12	1	3	4	1	0
BBLIN-38	24	25	1	1	3	4	1	0
BBLIN-38	24	477	453	0	3	1	0	0
BBLIN-39	24	25	1	1	3	4	1	0
BBLIN-39	24	25	1	1	3	4	1	0
BBLIN-39	28	29	1	1	3	1	1	0
BBLIN-39	29	477	448	0	3	1	0	0
BBLIN-39	29	477	448	0	3	1	0	0
BBLIN-39	29	30	1	1	3	3	1	0
BBLIN-39	30	38	8	1	3	2	1	0
BBLIN-39	30	31	1	1	3	4	1	0
BBLIN-39	30	31	1	1	3	4	1	0
BBLIN-39	30	31	1	1	3	4	1	0
BBLIN-40	31	477	446	0	3	4	0	0
BBLIN-40	31	32	1	1	3	1	1	0
BBLIN-40	32	33	1	1	3	4	1	0
BBLIN-40	32	36	4	1	3	1	1	0
BBLIN-40	35	36	1	1	3	4	1	0
BBLIN-40	37	38	1	1	3	1	1	0
BBLIN-40	38	40	2	1	3	2	1	0
BBLIN-40	42	43	1	1	3	1	1	0
BBLIN-40	43	50	7	1	3	4	1	0
BBLIN-40	43	44	1	1	3	1	1	0
BBLIN-41	45	50	5	1	3	4	1	0
BBLIN-41	46	47	1	1	3	1	1	0
BBLIN-41	46	165	119	1	4	1	1	0
BBLIN-41	47	51	4	1	4	1	1	0
BBLIN-41	49	59	10	1	3	4	1	0
BBLIN-41	51	52	1	1	4	1	1	0
BBLIN-41	52	56	4	1	3	4	1	0
BBLIN-41	56	57	1	1	3	1	1	0
BBLIN-41	57	60	3	1	4	1	1	0
BBLIN-41	57	58	1	1	3	4	1	0
BBLIN-42	60	477	417	0	4	4	1	0
BBLIN-42	62	63	1	1	3	4	1	0
BBLIN-42	63	64	1	1	3	1	1	0
BBLIN-42	66	80	14	1	3	4	1	0
BBLIN-42	67	70	3	1	3	1	1	0
BBLIN-42	70	477	407	0	4	4	0	0
BBLIN-42	71	72	1	1	3	1	1	0
BBLIN-42	73	77	4	1	3	1	1	0
BBLIN-42	74	75	1	1	3	1	1	0
BBLIN-42	74	75	1	1	3	4	1	0
BBLIN-43	78	80	2	1	3	3	1	0
BBLIN-43	79	80	1	1	3	3	1	0
BBLIN-43	79	80	1	1	3	4	1	0
BBLIN-43	79	123	44	1	4	1	1	0
BBLIN-43	79	80	1	1	3	4	1	0
BBLIN-43	80	81	1	1	3	3	1	0
BBLIN-43	81	82	1	1	3	4	1	0
BBLIN-43	81	477	396	0	3	5	0	0
BBLIN-43	81	82	1	1	3	5	1	0
BBLIN-43	81	82	1	1	3	5	1	0
BBLIN-44	81	82	1	1	3	1	1	0
BBLIN-44	81	477	396	0	3	5	0	0
BBLIN-44	81	477	396	0	3	3	0	0
BBLIN-44	82	477	395	0	3	5	1	0
BBLIN-44	83	86	3	1	3	5	1	0
BBLIN-44	84	85	1	1	3	4	1	0
BBLIN-44	84	87	3	1	3	4	1	0
BBLIN-44	85	86	1	1	3	1	1	0
BBLIN-44	85	86	1	1	3	4	1	0
BBLIN-44	85	477	392	0	3	5	0	0
BBLIN-45	86	477	391	0	3	4	0	0
BBLIN-45	87	88	1	1	3	1	1	0
BBLIN-45	87	164	77	1	5	4	1	0
BBLIN-45	87	164	77	1	4	4	1	0
BBLIN-45	87	93	6	1	3	4	1	0
BBLIN-45	87	123	36	1	4	1	1	0
BBLIN-45	88	98	10	1	3	4	1	0
BBLIN-45	90	477	387	0	3	4	1	0
BBLIN-45	93	135	42	1	3	4	1	0
BBLIN-45	94	98	4	1	3	4	1	0
BBLIN-46	95	98	3	1	3	1	1	0
BBLIN-46	95	98	3	1	3	3	1	0
BBLIN-46	99	477	378	0	3	2	1	0
BBLIN-46	99	106	7	1	3	4	1	0
BBLIN-46	101	110	9	1	3	4	1	0
BBLIN-46	102	121	19	1	1	2	1	0
BBLIN-46	102	103	1	1	3	4	1	0
BBLIN-46	105	106	1	1	3	1	1	0
BBLIN-46	107	108	1	1	3	1	1	0
BBLIN-46	109	119	10	1	3	3	1	0
BBLIN-47	109	110	1	1	3	4	1	0
BBLIN-47	112	113	1	1	3	4	1	0
BBLIN-47	113	477	364	0	4	1	0	0
BBLIN-47	113	114	1	1	3	4	1	0
BBLIN-47	113	477	364	0	3	4	1	0
BBLIN-47	114	477	363	0	4	4	0	0
BBLIN-47	114	115	1	1	3	4	1	0
BBLIN-47	115	477	362	0	4	1	1	0
BBLIN-47	115	116	1	1	3	1	1	0
BBLIN-47	117	121	4	1	3	1	1	0
BBLIN-48	118	120	2	1	3	4	1	0
BBLIN-48	119	123	4	1	1	1	1	0
BBLIN-48	120	123	3	1	3	3	1	0
BBLIN-48	121	122	1	1	3	1	1	0
BBLIN-48	121	122	1	1	3	4	1	0
BBLIN-48	122	123	1	1	3	1	1	1
BBLIN-48	123	124	1	1	3	4	1	0
BBLIN-48	123	477	354	0	3	3	0	0
BBLIN-48	123	126	3	1	3	3	1	0
BBLIN-48	127	162	35	1	3	3	1	0
BBLIN-49	129	165	36	1	3	2	1	0
BBLIN-49	130	155	25	1	3	2	1	0
BBLIN-49	134	135	1	1	3	4	1	0
BBLIN-49	134	135	1	1	3	3	1	0
BBLIN-49	135	170	35	1	3	2	1	0
BBLIN-49	136	137	1	1	3	1	1	0
BBLIN-49	136	137	1	1	3	1	1	0
BBLIN-49	140	141	1	1	3	1	1	0
BBLIN-49	141	477	336	0	3	4	0	0
BBLIN-49	141	142	1	1	3	3	1	0
BBLIN-50	143	477	334	0	4	1	0	0
BBLIN-50	143	144	1	1	3	1	1	0
BBLIN-50	143	144	1	1	3	4	1	0
BBLIN-50	143	144	1	1	3	1	1	0
BBLIN-50	143	144	1	1	3	1	1	0
BBLIN-50	144	161	17	1	3	2	1	0
BBLIN-50	148	154	6	1	3	2	1	0
BBLIN-50	154	156	2	1	3	4	1	0
BBLIN-50	155	156	1	1	3	4	1	0
BBLIN-50	155	156	1	1	3	4	1	0
BBLIN-51	156	157	1	1	3	2	1	0
BBLIN-51	156	157	1	1	3	4	1	0
BBLIN-51	158	164	6	1	2	4	1	0
BBLIN-51	158	161	3	1	3	3	1	0
BBLIN-51	162	164	2	1	3	1	1	1
BBLIN-51	171	477	306	0	3	3	0	0
BBLIN-51	171	175	4	1	3	4	1	0
BBLIN-51	176	177	1	1	3	1	1	0
BBLIN-51	177	226	49	1	3	5	1	0
BBLIN-51	177	477	300	0	3	1	0	0
BBLIN-52	177	178	1	1	3	2	1	0
BBLIN-52	178	189	11	1	3	3	1	0
BBLIN-52	179	180	1	1	3	1	1	0
BBLIN-52	182	477	295	0	3	1	1	0
BBLIN-52	184	333	149	1	3	1	1	0
BBLIN-52	184	333	149	1	3	1	1	0
BBLIN-52	184	333	149	1	3	1	1	0
BBLIN-52	184	333	149	1	3	1	1	0
BBLIN-52	189	210	21	1	3	4	1	0
BBLIN-52	190	191	1	1	3	3	1	0
BBLIN-53	191	221	30	1	3	1	1	0
BBLIN-53	192	477	285	0	3	1	0	0
BBLIN-53	192	193	1	1	3	2	1	0
BBLIN-53	193	194	1	1	3	4	1	0
BBLIN-53	193	196	3	1	3	4	1	0
BBLIN-53	194	195	1	1	3	2	1	0
BBLIN-53	196	197	1	1	3	2	1	0
BBLIN-53	197	198	1	1	3	3	1	0
BBLIN-53	197	250	53	1	3	4	1	0
BBLIN-53	197	199	2	1	3	4	1	0
BBLIN-54	198	477	279	0	3	1	0	0
BBLIN-54	198	477	279	0	3	2	0	0
BBLIN-54	204	205	1	1	3	4	1	0
BBLIN-54	207	477	270	0	3	3	0	0
BBLIN-54	207	477	270	0	3	3	1	0
BBLIN-54	210	211	1	1	3	1	1	0
BBLIN-54	211	212	1	1	3	1	1	0
BBLIN-54	211	212	1	1	3	4	1	0
BBLIN-54	212	213	1	1	4	1	1	0
BBLIN-54	212	213	1	1	4	4	1	0
BBLIN-55	212	213	1	1	3	1	1	0
BBLIN-55	212	213	1	1	3	1	1	0
BBLIN-55	213	224	11	1	3	4	1	0
BBLIN-55	213	214	1	1	3	3	1	0
BBLIN-55	213	220	7	1	3	4	1	0
BBLIN-55	214	477	263	0	3	1	0	0
BBLIN-55	214	215	1	1	3	1	1	0
BBLIN-55	217	218	1	1	3	4	1	0
BBLIN-55	218	224	6	1	3	1	1	0
BBLIN-55	219	229	10	1	3	4	1	0
BBLIN-56	221	477	256	0	4	4	0	0
BBLIN-56	224	232	8	1	3	4	1	0
BBLIN-56	224	226	2	1	3	4	1	0
BBLIN-56	226	227	1	1	3	3	1	0
BBLIN-56	227	241	14	1	3	3	1	0
BBLIN-56	227	333	106	1	3	3	1	0
BBLIN-56	232	234	2	1	3	1	1	0
BBLIN-56	233	253	20	1	3	1	1	0
BBLIN-56	236	477	241	0	3	4	0	0
BBLIN-56	238	246	8	1	4	1	1	0
BBLIN-57	238	477	239	0	4	1	0	0
BBLIN-57	239	477	238	0	2	1	1	0
BBLIN-57	239	240	1	1	3	2	1	0
BBLIN-57	241	242	1	1	4	4	1	0
BBLIN-57	247	248	1	1	3	1	1	0
BBLIN-57	247	248	1	1	3	4	1	0
BBLIN-57	248	253	5	1	3	3	1	0
BBLIN-57	248	252	4	1	4	1	1	0
BBLIN-57	248	250	2	1	4	1	1	0
BBLIN-57	249	477	228	0	3	4	0	0
BBLIN-58	250	261	11	1	3	1	1	0
BBLIN-58	252	477	225	0	4	1	0	0
BBLIN-58	252	274	22	1	3	4	1	0
BBLIN-58	253	477	224	0	3	3	0	0
BBLIN-58	254	255	1	1	3	4	1	0
BBLIN-58	254	255	1	1	3	3	1	0
BBLIN-58	254	260	6	1	4	2	1	0
BBLIN-58	254	256	2	1	3	3	1	0
BBLIN-58	255	256	1	1	4	4	1	0
BBLIN-58	255	259	4	1	3	4	1	0
BBLIN-59	259	274	15	1	3	4	1	0
BBLIN-59	260	261	1	1	3	4	1	0
BBLIN-59	261	267	6	1	3	4	1	0
BBLIN-59	261	346	85	1	3	1	1	0
BBLIN-59	263	477	214	0	3	4	0	0
BBLIN-59	267	477	210	0	3	4	0	0
BBLIN-59	269	333	64	1	3	1	1	0
BBLIN-59	270	274	4	1	3	4	1	0
BBLIN-59	273	294	21	1	3	4	1	0
BBLIN-59	273	288	15	1	3	1	1	0
BBLIN-60	274	275	1	1	3	4	1	0
BBLIN-60	275	280	5	1	3	4	1	0
BBLIN-60	277	280	3	1	3	4	1	0
BBLIN-60	277	280	3	1	3	4	1	0
BBLIN-60	279	283	4	1	3	4	1	0
BBLIN-60	280	281	1	1	4	1	1	0
BBLIN-60	280	282	2	1	3	1	1	0
BBLIN-60	281	282	1	1	3	3	1	0
BBLIN-60	281	282	1	1	3	4	1	0
BBLIN-60	281	282	1	1	3	1	1	0
BBLIN-61	283	287	4	1	3	4	1	0
BBLIN-61	283	284	1	1	3	1	1	0
BBLIN-61	284	285	1	1	5	1	1	0
BBLIN-61	289	477	188	0	3	2	0	0
BBLIN-61	290	295	5	1	3	4	1	0
BBLIN-61	291	294	3	1	2	4	1	0
BBLIN-61	291	294	3	1	3	4	1	0
BBLIN-61	295	296	1	1	3	4	1	0
BBLIN-61	296	297	1	1	3	4	1	0
BBLIN-61	297	298	1	1	3	4	1	0
BBLIN-62	297	298	1	1	3	4	1	0
BBLIN-62	298	299	1	1	3	3	1	0
BBLIN-62	299	300	1	1	3	4	1	0
BBLIN-62	301	477	176	0	4	4	0	0
BBLIN-62	303	308	5	1	3	4	1	0
BBLIN-62	308	309	1	1	3	4	1	0
BBLIN-62	308	309	1	1	3	1	1	0
BBLIN-62	309	310	1	1	3	4	1	0
BBLIN-62	310	396	86	1	3	3	1	0
BBLIN-62	316	317	1	1	3	1	1	0
BBLIN-63	316	337	21	1	3	2	1	0
BBLIN-63	317	318	1	1	4	4	1	0
BBLIN-63	318	319	1	1	4	3	1	0
BBLIN-63	323	324	1	1	3	4	1	0
BBLIN-63	323	330	7	1	3	2	1	0
BBLIN-63	328	329	1	1	3	4	1	0
BBLIN-63	328	330	2	1	3	4	1	0
BBLIN-63	329	330	1	1	3	1	1	0
BBLIN-63	330	331	1	1	3	4	1	0
BBLIN-63	330	331	1	1	3	4	1	0
BBLIN-64	331	332	1	1	3	3	1	0
BBLIN-64	333	477	144	0	3	3	0	0
BBLIN-64	333	340	7	1	3	4	1	0
BBLIN-64	336	337	1	1	3	1	1	0
BBLIN-64	338	339	1	1	3	4	1	0
BBLIN-64	338	339	1	1	3	4	1	0
BBLIN-64	339	340	1	1	3	4	1	0
BBLIN-64	340	341	1	1	3	4	1	0
BBLIN-64	342	477	135	0	3	1	0	0
BBLIN-64	343	344	1	1	3	4	1	0
BBLIN-65	344	345	1	1	5	4	1	0
BBLIN-65	344	345	1	1	3	4	1	0
BBLIN-65	344	345	1	1	3	4	1	0
BBLIN-65	344	345	1	1	3	4	1	0
BBLIN-65	345	347	2	1	4	1	1	0
BBLIN-65	347	348	1	1	3	4	1	0
BBLIN-65	350	477	127	0	3	4	0	0
BBLIN-65	353	477	124	0	3	2	0	0
BBLIN-65	354	355	1	1	4	4	1	0
BBLIN-65	355	368	13	1	3	4	1	0
RA-53	10	442	432	1	4	4	1	0
RA-53	43	50	7	1	3	4	1	0
RA-53	50	477	427	0	3	2	1	0
RA-53	57	477	420	0	4	4	1	0
RA-53	59	406	347	1	3	1	1	0
RA-53	62	280	218	1	3	2	1	0
RA-53	71	141	70	1	4	3	1	0
RA-53	72	477	405	0	3	4	1	0
RA-53	81	477	396	0	3	1	0	0
RA-53	101	477	376	0	3	4	1	0
RA-54	217	314	97	1	4	2	1	0
RA-54	252	477	225	0	4	4	0	0
RA-54	256	477	221	0	3	3	0	0
RA-54	262	339	77	1	3	3	1	0
RA-54	264	477	213	0	3	3	0	0
RA-54	265	448	183	1	3	1	1	0
RA-54	314	477	163	0	3	2	0	0
RA-54	323	339	16	1	3	4	1	0
RA-54	328	455	127	1	3	2	1	0
RA-54	328	462	134	1	3	3	1	0
IFFIN-10	44	102	58	1	4	4	0	0
IFFIN-10	56	63	7	1	3	1	1	0
IFFIN-10	56	260	204	1	3	1	0	0
IFFIN-10	56	135	79	1	3	3	1	0
IFFIN-10	56	260	204	1	3	2	0	0
IFFIN-10	58	477	419	0	3	3	0	0
IFFIN-10	67	102	35	1	3	1	0	0
IFFIN-10	79	260	181	1	3	2	0	0
IFFIN-10	84	102	18	1	3	3	0	0
IFFIN-10	86	260	174	1	3	2	0	0
IFFIN-11	86	260	174	1	3	2	0	0
IFFIN-11	88	98	10	1	3	4	1	0
IFFIN-11	88	260	172	1	3	3	0	0
IFFIN-11	88	260	172	1	3	3	0	0
IFFIN-11	88	260	172	1	3	3	0	0
IFFIN-11	88	260	172	1	3	3	0	0
IFFIN-11	88	260	172	1	3	3	0	0
IFFIN-11	88	129	41	1	3	2	1	0
IFFIN-11	88	477	389	0	3	4	0	0
IFFIN-11	88	477	389	0	3	4	0	0
IFFIN-12	88	477	389	0	3	2	0	0
IFFIN-12	88	98	10	1	3	2	1	0
IFFIN-12	88	260	172	1	3	2	0	0
IFFIN-12	88	151	63	1	3	4	0	0
IFFIN-12	88	260	172	1	3	4	0	0
IFFIN-12	88	477	389	0	4	2	0	0
IFFIN-12	91	109	18	1	3	3	0	0
IFFIN-12	91	109	18	1	3	3	0	0
IFFIN-12	91	116	25	1	3	3	0	0
IFFIN-12	91	477	386	0	3	3	0	0
IFFIN-13	91	109	18	1	3	3	0	0
IFFIN-13	91	260	169	1	3	3	0	0
IFFIN-13	91	102	11	1	3	3	0	0
IFFIN-13	91	204	113	1	3	3	0	0
IFFIN-13	93	477	384	0	3	3	0	0
IFFIN-13	93	99	6	1	3	2	1	0
IFFIN-13	93	109	16	1	3	3	0	0
IFFIN-13	93	260	167	1	3	3	0	0
IFFIN-13	97	98	1	1	3	3	0	0
IFFIN-13	98	477	379	0	3	2	1	0
IFFIN-14	98	477	379	0	3	2	1	0
IFFIN-14	98	477	379	0	3	3	1	0
IFFIN-14	100	260	160	1	3	4	0	0
IFFIN-14	102	116	14	1	3	3	1	0
IFFIN-14	102	260	158	1	4	4	1	0
IFFIN-14	102	260	158	1	3	3	0	0
IFFIN-14	102	241	139	1	3	3	0	0
IFFIN-14	102	477	375	0	3	3	0	0
IFFIN-14	102	123	21	1	3	3	0	0
IFFIN-14	102	477	375	0	3	3	0	0
IFFIN-15	108	116	8	1	3	1	0	0
IFFIN-15	109	110	1	1	3	4	1	0
IFFIN-15	113	115	2	1	3	1	0	0
IFFIN-15	115	121	6	1	3	1	1	0
IFFIN-15	115	116	1	1	3	1	1	0
IFFIN-15	115	116	1	1	3	2	0	0
IFFIN-15	116	130	14	1	3	3	0	0
IFFIN-15	122	123	1	1	3	4	1	0
IFFIN-15	122	151	29	1	3	4	1	0
IFFIN-15	123	151	28	1	3	3	1	0
IFFIN-16	130	477	347	0	3	2	0	0
IFFIN-16	130	477	347	0	3	3	0	0
IFFIN-16	130	477	347	0	3	3	0	0
IFFIN-16	130	136	6	1	3	3	1	0
IFFIN-16	130	241	111	1	4	4	1	0
IFFIN-16	133	477	344	0	3	4	0	0
IFFIN-16	136	141	5	1	3	4	1	0
IFFIN-16	154	161	7	1	5	3	0	0
IFFIN-16	165	186	21	1	3	1	0	0
IFFIN-16	166	260	94	1	4	1	0	0
IFFIN-17	172	260	88	1	3	3	1	0
IFFIN-17	177	186	9	1	3	4	0	0
IFFIN-17	183	241	58	1	4	3	0	0
IFFIN-17	184	477	293	0	3	3	1	0
IFFIN-17	190	191	1	1	5	4	1	0
IFFIN-17	190	193	3	1	3	1	0	0
IFFIN-17	191	477	286	0	3	3	0	0
IFFIN-17	191	192	1	1	3	1	1	0
IFFIN-17	191	192	1	1	3	1	1	0
IFFIN-17	193	477	284	0	4	5	0	0
IFFIN-18	193	203	10	1	3	1	0	0
IFFIN-18	194	203	9	1	3	4	0	0
IFFIN-18	196	203	7	1	3	4	0	0
IFFIN-18	197	198	1	1	3	3	1	0
IFFIN-18	200	241	41	1	3	2	0	0
IFFIN-18	202	233	31	1	3	2	1	0
IFFIN-18	212	241	29	1	4	4	0	0
IFFIN-18	212	241	29	1	4	2	1	0
IFFIN-18	232	477	245	0	5	3	0	0
IFFIN-18	246	247	1	1	3	1	0	0
IFFIN-19	247	477	230	0	3	1	0	0
IFFIN-19	257	477	220	0	5	1	0	0
IFFIN-19	257	477	220	0	5	1	0	0
IFFIN-19	261	320	59	1	3	4	1	0
IFFIN-19	261	320	59	1	4	5	1	0
IFFIN-19	261	280	19	1	3	5	2	0
IFFIN-19	261	280	19	1	3	5	1	0
IFFIN-19	263	296	33	1	4	1	0	0
IFFIN-19	263	334	71	1	3	1	1	0
IFFIN-19	267	280	13	1	4	1	0	0
IFFIN-20	268	312	44	1	4	2	1	0
IFFIN-20	279	286	7	1	3	1	0	0
IFFIN-20	280	287	7	1	4	4	1	0
IFFIN-20	280	320	40	1	3	2	1	0
IFFIN-20	281	287	6	1	4	1	1	0
IFFIN-20	281	301	20	1	3	4	0	0
IFFIN-20	282	287	5	1	3	1	1	0
IFFIN-20	292	297	5	1	3	1	1	0
IFFIN-20	294	320	26	1	3	1	0	0
IFFIN-20	316	317	1	1	3	1	1	0
IFFIN-21	318	477	159	0	3	5	0	0
IFFIN-21	319	320	1	1	3	1	0	0
IFFIN-21	319	322	3	1	3	3	1	0
IFFIN-21	320	332	12	1	4	4	1	0
IFFIN-21	323	477	154	0	3	4	0	0
IFFIN-21	329	477	148	0	3	1	1	0
IFFIN-21	330	477	147	0	3	4	0	0
IFFIN-21	331	477	146	0	3	4	0	0
IFFIN-21	333	337	4	1	3	1	1	0
IFFIN-21	337	477	140	0	3	1	0	0
IFFIN-22	340	398	58	1	4	4	0	0
IFFIN-22	341	477	136	0	3	4	0	0
IFFIN-22	341	477	136	0	3	4	0	0
IFFIN-22	344	477	133	0	3	1	1	0
IFFIN-22	348	349	1	1	1	1	0	0
IFFIN-8	2	21	19	1	3	4	1	0
IFFIN-8	2	15	13	1	3	4	1	0
IFFIN-8	10	56	46	1	3	4	1	0
IFFIN-8	10	16	6	1	3	5	1	0
IFFIN-8	10	29	19	1	3	5	1	0
IFFIN-8	10	56	46	1	3	5	1	0
IFFIN-8	10	22	12	1	3	3	0	0
IFFIN-8	10	63	53	1	3	3	1	0
IFFIN-8	10	16	6	1	3	1	0	0
IFFIN-8	10	29	19	1	3	4	1	0
IFFIN-9	10	21	11	1	3	4	1	0
IFFIN-9	10	151	141	1	3	4	1	0
IFFIN-9	10	16	6	1	3	4	0	0
IFFIN-9	22	24	2	1	3	1	1	0
IFFIN-9	22	25	3	1	3	1	1	0
IFFIN-9	23	56	33	1	3	1	1	0
IFFIN-9	23	24	1	1	3	2	0	0
IFFIN-9	36	63	27	1	3	3	1	0
IFFIN-9	36	151	115	1	3	2	0	0
IFFIN-9	43	113	70	1	2	1	1	0
OOVY-842	0	1	1	1	4	4	4	0
OOVY-842	0	2	2	1	3	1	1	0
OOVY-843	1	3	2	1	3	1	1	0
OOVY-843	2	477	475	0	3	5	0	0
OOVY-843	4	6	2	1	3	1	4	0
OOVY-843	4	477	473	0	3	1	0	0
OOVY-843	7	381	374	1	3	1	0	1
OOVY-843	7	8	1	1	3	1	1	0
OOVY-843	8	9	1	1	3	1	3	0
OOVY-843	8	9	1	1	3	4	1	0
OOVY-843	8	9	1	1	3	1	1	0
OOVY-843	9	68	59	1	1	1	4	0
OOVY-844	9	23	14	1	3	4	1	0
OOVY-844	9	477	468	0	3	1	0	0
OOVY-844	10	477	467	0	3	1	0	0
OOVY-844	10	477	467	0	3	4	0	0
OOVY-844	10	477	467	0	4	4	0	0
OOVY-844	11	32	21	1	3	1	4	0
OOVY-844	11	477	466	0	3	1	0	0
OOVY-844	11	13	2	1	3	1	2	0
OOVY-844	14	477	463	0	3	1	0	0
OOVY-844	14	477	463	0	3	1	0	0
OOVY-845	14	477	463	0	4	4	0	0
OOVY-845	15	477	462	0	3	4	0	1
OOVY-845	17	477	460	0	3	1	0	0
OOVY-845	18	22	4	1	3	1	1	0
OOVY-845	19	20	1	1	3	1	0	0
OOVY-845	21	22	1	1	3	1	1	0
OOVY-845	21	22	1	1	3	1	1	0
OOVY-845	21	477	456	0	3	1	0	0
OOVY-845	25	125	100	1	1	1	0	0
OOVY-845	25	477	452	0	4	1	0	0
OOVY-846	25	287	262	1	3	1	0	0
OOVY-846	27	477	450	0	3	3	0	0
OOVY-846	28	477	449	0	3	1	0	0
OOVY-846	28	29	1	1	3	1	0	2
OOVY-846	29	30	1	1	3	4	3	0
OOVY-846	30	31	1	1	3	4	1	0
OOVY-846	30	47	17	1	3	4	2	0
OOVY-846	32	477	445	0	3	1	0	0
OOVY-846	32	477	445	0	2	1	0	0
OOVY-846	33	420	387	1	3	1	0	0
OOVY-847	35	67	32	1	3	1	4	0
OOVY-847	36	46	10	1	3	1	3	0
OOVY-847	37	119	82	1	3	4	1	1
OOVY-847	37	47	10	1	3	4	0	0
OOVY-847	38	47	9	1	2	1	4	0
OOVY-847	40	63	23	1	3	1	1	1
OOVY-847	42	50	8	1	3	1	0	1
OOVY-847	43	46	3	1	3	4	1	0
OOVY-847	43	477	434	0	3	1	0	0
OOVY-847	52	231	179	1	3	1	0	0
OOVY-848	52	64	12	1	3	4	1	0
OOVY-848	53	477	424	0	3	5	0	0
OOVY-848	56	57	1	1	3	1	1	1
OOVY-848	56	61	5	1	1	1	2	1
OOVY-848	58	59	1	1	3	1	1	0
OOVY-848	58	84	26	1	3	1	0	0
OOVY-848	60	61	1	1	3	1	3	0
OOVY-848	60	477	417	0	3	4	0	0
OOVY-848	60	477	417	0	3	1	0	0
OOVY-848	61	62	1	1	3	1	1	1
OOVY-849	62	111	49	1	3	4	3	1
OOVY-849	62	477	415	0	3	2	0	1
OOVY-849	64	65	1	1	3	4	2	0
OOVY-849	64	66	2	1	3	1	2	0
OOVY-849	65	80	15	1	1	1	1	2
OOVY-849	65	283	218	1	2	1	1	4
OOVY-849	65	257	192	1	3	1	1	1
OOVY-849	65	257	192	1	3	1	1	1
OOVY-849	65	66	1	1	3	2	2	2
OOVY-849	65	477	412	0	3	1	0	0
OOVY-850	66	67	1	1	3	2	3	0
OOVY-850	66	67	1	1	3	3	1	0
OOVY-850	67	477	410	0	3	3	0	0
OOVY-850	68	477	409	0	3	5	0	0
OOVY-850	69	70	1	1	3	5	3	0
OOVY-850	70	171	101	1	3	1	2	2
OOVY-850	70	477	407	0	4	1	0	0
OOVY-850	71	477	406	0	3	1	0	0
OOVY-850	71	80	9	1	1	1	0	1
OOVY-850	72	137	65	1	3	1	3	0
OOVY-851	72	73	1	1	4	4	3	0
OOVY-851	72	78	6	1	3	1	0	0
OOVY-851	73	74	1	1	3	1	0	0
OOVY-851	75	81	6	1	3	1	0	1
OOVY-851	75	80	5	1	3	1	1	0
OOVY-851	78	94	16	1	3	1	3	0
OOVY-851	80	81	1	1	3	2	3	0
OOVY-851	80	477	397	0	4	4	0	0
OOVY-851	81	82	1	1	3	2	3	0
OOVY-851	83	477	394	0	3	3	0	0
OOVY-852	83	137	54	1	3	4	1	4
OOVY-852	83	118	35	1	3	4	1	1
OOVY-852	85	86	1	1	3	3	1	0
OOVY-852	86	92	6	1	3	1	1	0
OOVY-852	88	89	1	1	4	4	2	0
OOVY-852	88	89	1	1	3	3	1	1
OOVY-852	93	477	384	0	3	3	0	0
OOVY-852	93	477	384	0	3	2	0	0
OOVY-852	93	94	1	1	3	3	1	0
OOVY-852	93	119	26	1	3	3	1	0
OOVY-853	94	95	1	1	3	5	0	1
OOVY-853	94	95	1	1	3	1	4	0
OOVY-853	95	96	1	1	3	5	1	0
OOVY-853	95	96	1	1	3	5	3	0
OOVY-853	95	96	1	1	3	5	3	0
OOVY-853	95	396	301	1	3	4	2	0
OOVY-853	95	477	382	0	3	1	0	0
OOVY-853	97	100	3	1	3	1	4	0
OOVY-853	98	154	56	1	3	1	1	0
OOVY-853	99	101	2	1	3	1	1	0
OOVY-854	99	100	1	1	3	5	2	0
OOVY-854	99	100	1	1	1	1	2	0
OOVY-854	101	102	1	1	3	2	2	0
OOVY-854	101	128	27	1	3	2	0	0
OOVY-854	103	105	2	1	4	1	0	0
OOVY-854	104	105	1	1	3	1	1	0
OOVY-854	105	106	1	1	3	1	2	0
OOVY-854	105	477	372	0	4	4	0	0
OOVY-854	105	106	1	1	3	4	1	0
OOVY-854	106	283	177	1	3	1	2	1
OOVY-855	106	227	121	1	3	1	0	0
OOVY-855	107	130	23	1	4	4	0	0
OOVY-855	108	477	369	0	3	4	0	1
OOVY-855	108	477	369	0	4	1	0	0
OOVY-855	109	477	368	0	3	1	0	0
OOVY-855	109	477	368	0	3	1	0	0
OOVY-855	112	138	26	1	3	5	1	2
OOVY-855	112	138	26	1	3	3	1	2
OOVY-855	113	114	1	1	4	2	3	0
OOVY-855	114	119	5	1	3	2	1	1
OOVY-856	114	477	363	0	4	1	0	0
OOVY-856	115	130	15	1	3	2	0	0
OOVY-856	116	143	27	1	3	1	1	0
OOVY-856	117	477	360	0	4	1	0	0
OOVY-856	118	477	359	0	3	2	0	0
OOVY-856	119	477	358	0	4	2	0	0
OOVY-856	120	477	357	0	3	4	0	0
OOVY-856	122	136	14	1	3	4	1	1
OOVY-856	123	477	354	0	3	1	0	0
OOVY-856	123	137	14	1	3	4	1	0
OOVY-857	124	477	353	0	3	2	0	0
OOVY-857	125	477	352	0	3	1	0	0
OOVY-857	126	477	351	0	3	1	0	0
OOVY-857	127	166	39	1	4	4	0	0
OOVY-857	127	166	39	1	4	4	0	0
OOVY-857	127	128	1	1	4	1	0	0
OOVY-857	129	130	1	1	3	4	2	0
OOVY-857	129	137	8	1	3	4	1	2
OOVY-857	132	477	345	0	3	4	0	1
OOVY-857	133	138	5	1	3	1	1	0
OOVY-858	133	477	344	0	1	2	1	2
OOVY-858	133	477	344	0	3	2	1	2
OOVY-858	133	156	23	1	4	1	3	0
OOVY-858	133	477	344	0	3	4	1	0
OOVY-858	133	134	1	1	2	1	0	0
OOVY-858	133	258	125	1	4	4	2	1
OOVY-858	135	477	342	0	3	1	0	0
OOVY-858	137	138	1	1	3	3	1	1
OOVY-858	137	138	1	1	3	1	1	1
OOVY-859	139	142	3	1	3	1	3	1
OOVY-859	140	477	337	0	3	4	0	0
OOVY-859	141	145	4	1	3	4	1	4
OOVY-859	141	143	2	1	3	4	1	1
OOVY-859	141	143	2	1	3	4	2	1
OOVY-859	141	151	10	1	3	1	3	1
OOVY-859	141	143	2	1	3	4	1	1
OOVY-859	141	143	2	1	3	4	2	1
OOVY-859	142	143	1	1	3	1	2	0
OOVY-859	142	143	1	1	3	5	2	0
OOVY-860	142	143	1	1	3	1	2	0
OOVY-860	143	145	2	1	3	4	1	0
OOVY-860	143	248	105	1	4	1	0	0
OOVY-860	143	477	334	0	3	1	0	0
OOVY-860	143	144	1	1	3	4	3	0
OOVY-860	143	145	2	1	3	4	1	2
OOVY-860	144	477	333	0	3	4	0	0
OOVY-860	145	146	1	1	3	4	1	0
OOVY-860	145	146	1	1	3	5	1	0
OOVY-860	146	147	1	1	3	1	3	0
OOVY-861	146	147	1	1	4	1	3	0
OOVY-861	147	477	330	0	3	4	0	0
OOVY-861	147	477	330	0	3	1	0	0
OOVY-861	147	151	4	1	2	1	2	0
OOVY-861	148	169	21	1	4	1	2	0
OOVY-861	149	150	1	1	3	4	1	0
OOVY-861	149	150	1	1	3	1	1	0
OOVY-861	150	477	327	0	3	1	0	0
OOVY-861	150	151	1	1	3	3	3	1
OOVY-861	150	151	1	1	3	3	3	1
OOVY-862	150	151	1	1	3	3	3	2
OOVY-862	150	152	2	1	3	4	3	2
OOVY-862	150	192	42	1	4	4	1	0
OOVY-862	150	189	39	1	3	4	2	0
OOVY-862	151	152	1	1	3	1	3	0
OOVY-862	151	477	326	0	3	1	0	0
OOVY-862	151	477	326	0	3	2	0	0
OOVY-862	151	171	20	1	3	1	1	0
OOVY-862	153	158	5	1	3	1	3	0
OOVY-862	154	155	1	1	3	1	3	0
OOVY-863	154	155	1	1	3	4	3	0
OOVY-863	154	192	38	1	3	1	1	0
OOVY-863	154	165	11	1	3	1	1	0
OOVY-863	154	477	323	0	3	1	0	1
OOVY-863	154	477	323	0	4	1	0	0
OOVY-863	156	175	19	1	4	4	2	0
OOVY-863	156	157	1	1	3	5	3	0
OOVY-863	157	171	14	1	2	1	1	0
OOVY-863	157	477	320	0	3	1	0	0
OOVY-863	160	205	45	1	4	4	1	0
OOVY-864	162	477	315	0	4	1	0	0
OOVY-864	163	184	21	1	3	1	2	1
OOVY-864	163	477	314	0	3	1	0	0
OOVY-864	164	477	313	0	4	1	0	0
OOVY-864	164	192	28	1	2	1	1	1
OOVY-864	164	477	313	0	4	1	0	0
OOVY-864	165	186	21	1	3	5	1	0
OOVY-864	166	477	311	0	3	3	0	0
OOVY-864	166	477	311	0	3	1	0	0
OOVY-864	168	175	7	1	1	1	0	0
OOVY-865	168	477	309	0	3	1	0	0
OOVY-865	168	477	309	0	4	1	0	0
OOVY-865	169	477	308	0	4	1	0	0
OOVY-865	170	171	1	1	3	1	0	0
OOVY-865	170	171	1	1	5	1	1	0
OOVY-865	170	477	307	0	4	1	0	1
OOVY-865	171	477	306	0	3	1	0	0
OOVY-865	171	477	306	0	3	1	0	0
OOVY-865	171	477	306	0	3	1	0	1
OOVY-865	172	477	305	0	3	5	0	0
OOVY-866	172	477	305	0	3	1	0	0
OOVY-866	173	174	1	1	3	5	3	0
OOVY-866	173	477	304	0	4	4	0	1
OOVY-866	174	477	303	0	3	4	0	0
OOVY-866	175	183	8	1	3	4	2	0
OOVY-866	175	176	1	1	3	4	0	0
OOVY-866	176	181	5	1	2	1	1	0
OOVY-866	176	477	301	0	4	1	0	0
OOVY-866	176	477	301	0	3	4	0	0
OOVY-866	177	230	53	1	3	1	2	0
OOVY-867	181	183	2	1	3	4	1	0
OOVY-867	181	182	1	1	3	4	1	0
OOVY-867	181	182	1	1	4	5	1	0
OOVY-867	181	182	1	1	4	5	1	0
OOVY-867	181	183	2	1	4	5	1	1
OOVY-867	181	183	2	1	3	1	3	0
OOVY-867	182	183	1	1	3	5	1	1
OOVY-867	182	183	1	1	3	5	1	0
OOVY-867	183	477	294	0	3	1	1	0
OOVY-867	183	184	1	1	3	4	2	0
OOVY-868	184	185	1	1	3	1	2	0
OOVY-868	184	185	1	1	3	4	2	0
OOVY-868	184	185	1	1	4	5	2	0
OOVY-868	185	477	292	0	3	1	0	1
OOVY-868	185	186	1	1	3	1	0	0
OOVY-868	185	186	1	1	4	5	0	0
OOVY-868	185	477	292	0	4	1	0	0
OOVY-868	185	477	292	0	4	4	0	0
OOVY-868	186	187	1	1	3	1	1	0
OOVY-868	186	477	291	0	3	1	0	0
OOVY-869	186	190	4	1	3	5	1	0
OOVY-869	189	190	1	1	3	3	1	0
OOVY-869	189	192	3	1	3	3	1	0
OOVY-869	189	477	288	0	3	1	0	0
OOVY-869	190	191	1	1	3	1	1	0
OOVY-869	191	477	286	0	3	1	0	0
OOVY-869	191	205	14	1	3	1	1	0
OOVY-869	192	477	285	0	4	4	0	1
OOVY-869	193	477	284	0	3	1	0	0
OOVY-869	194	477	283	0	3	5	0	0
OOVY-870	195	196	1	1	3	5	1	0
OOVY-870	196	477	281	0	4	1	0	0
OOVY-870	196	477	281	0	3	4	0	0
OOVY-870	196	255	59	1	3	1	2	0
OOVY-870	198	388	190	1	4	4	1	0
OOVY-870	199	477	278	0	4	4	0	1
OOVY-870	200	477	277	0	4	4	0	0
OOVY-870	200	477	277	0	4	1	0	0
OOVY-870	200	477	277	0	3	1	0	0
OOVY-870	202	477	275	0	3	1	0	0
OOVY-871	204	209	5	1	3	4	1	0
OOVY-871	205	206	1	1	4	1	1	0
OOVY-871	205	206	1	1	3	1	1	0
OOVY-871	205	211	6	1	3	1	1	0
OOVY-871	205	477	272	0	4	5	0	0
OOVY-871	205	477	272	0	3	1	0	0
OOVY-871	206	210	4	1	3	1	0	0
OOVY-871	207	477	270	0	3	2	0	0
OOVY-871	208	245	37	1	3	1	1	0
OOVY-871	209	396	187	1	4	4	2	0
OOVY-872	209	477	268	0	4	1	0	0
OOVY-872	209	477	268	0	3	1	0	0
OOVY-872	210	217	7	1	3	1	1	0
OOVY-872	211	212	1	1	3	1	1	0
OOVY-872	211	477	266	0	3	1	0	0
OOVY-872	212	477	265	0	3	1	0	0
OOVY-872	212	477	265	0	3	4	0	0
OOVY-872	213	246	33	1	3	1	2	1
OOVY-872	214	217	3	1	4	1	1	0
OOVY-872	214	477	263	0	3	4	0	0
OOVY-873	215	216	1	1	3	1	1	0
OOVY-873	215	216	1	1	3	1	1	0
OOVY-873	217	221	4	1	3	1	2	0
OOVY-873	218	219	1	1	3	4	1	0
OOVY-873	219	477	258	0	3	1	0	0
OOVY-873	219	222	3	1	3	4	0	1
OOVY-873	219	477	258	0	3	4	0	0
OOVY-873	220	477	257	0	3	1	0	0
OOVY-873	220	221	1	1	3	5	1	0
OOVY-873	220	477	257	0	4	1	0	0
OOVY-874	220	221	1	1	3	1	2	1
OOVY-874	221	229	8	1	3	1	1	0
OOVY-874	221	343	122	1	3	1	3	1
OOVY-874	221	222	1	1	3	1	2	1
OOVY-874	222	224	2	1	3	5	2	0
OOVY-874	222	225	3	1	3	5	2	0
OOVY-874	222	225	3	1	3	5	2	0
OOVY-874	223	224	1	1	3	1	2	0
OOVY-874	223	225	2	1	3	4	2	0
OOVY-874	224	477	253	0	3	1	0	0
OOVY-875	224	225	1	1	3	1	4	0
OOVY-875	224	225	1	1	4	5	0	0
OOVY-875	225	227	2	1	3	1	0	0
OOVY-875	228	232	4	1	2	1	2	0
OOVY-875	229	230	1	1	3	1	2	0
OOVY-875	229	230	1	1	3	4	2	0
OOVY-875	231	477	246	0	3	5	0	0
OOVY-875	231	237	6	1	2	1	3	0
OOVY-875	231	234	3	1	3	1	2	0
OOVY-875	232	233	1	1	3	5	1	1
OOVY-876	232	477	245	0	3	1	0	0
OOVY-876	232	233	1	1	3	1	1	0
OOVY-876	232	477	245	0	3	1	0	0
OOVY-876	233	477	244	0	4	1	0	0
OOVY-876	233	282	49	1	3	1	2	0
OOVY-876	237	274	37	1	3	2	2	0
OOVY-876	238	310	72	1	2	1	2	0
OOVY-876	239	240	1	1	3	5	2	0
OOVY-876	239	240	1	1	3	1	1	0
OOVY-876	239	240	1	1	3	1	0	0
OOVY-877	240	477	237	0	3	1	0	0
OOVY-877	242	244	2	1	3	5	0	0
OOVY-877	245	349	104	1	2	1	2	0
OOVY-877	246	247	1	1	3	5	2	1
OOVY-877	247	477	230	0	3	1	0	0
OOVY-877	248	477	229	0	3	1	0	0
OOVY-877	248	349	101	1	4	1	2	2
OOVY-877	248	349	101	1	4	1	2	2
OOVY-877	249	250	1	1	3	1	1	0
OOVY-877	249	254	5	1	3	1	2	0
OOVY-878	250	251	1	1	4	4	2	0
OOVY-878	250	477	227	0	3	1	0	0
OOVY-878	252	477	225	0	4	1	0	0
OOVY-878	254	255	1	1	3	4	2	0
OOVY-878	254	255	1	1	3	4	2	0
OOVY-878	255	256	1	1	3	5	2	1
OOVY-878	255	256	1	1	3	5	1	0
OOVY-878	255	477	222	0	3	1	0	1
OOVY-878	255	477	222	0	3	1	0	1
OOVY-878	255	256	1	1	3	5	2	0
OOVY-879	256	257	1	1	4	5	2	0
OOVY-879	256	257	1	1	3	1	0	0
OOVY-879	256	477	221	0	3	1	0	0
OOVY-879	256	257	1	1	3	4	1	0
OOVY-879	257	263	6	1	3	2	1	0
OOVY-879	257	477	220	0	3	1	0	0
OOVY-879	257	477	220	0	3	1	0	0
OOVY-879	257	258	1	1	4	1	2	0
OOVY-879	259	477	218	0	3	3	0	0
OOVY-879	259	477	218	0	3	1	0	0
OOVY-880	260	277	17	1	3	1	2	1
OOVY-880	260	477	217	0	3	1	0	0
OOVY-880	262	263	1	1	3	5	2	0
OOVY-880	262	477	215	0	4	1	0	0
OOVY-880	262	477	215	0	4	1	0	0
OOVY-880	263	278	15	1	3	1	1	0
OOVY-880	263	276	13	1	3	1	2	0
OOVY-880	263	264	1	1	3	5	2	0
OOVY-880	264	265	1	1	3	2	2	0
OOVY-880	266	267	1	1	3	5	1	0
OOVY-881	267	477	210	0	3	1	0	0
OOVY-881	268	477	209	0	3	1	0	0
OOVY-881	268	269	1	1	3	4	2	0
OOVY-881	268	269	1	1	3	5	1	0
OOVY-881	268	477	209	0	3	1	0	0
OOVY-881	269	477	208	0	3	1	0	0
OOVY-881	270	276	6	1	4	1	2	0
OOVY-881	272	275	3	1	3	1	0	1
OOVY-881	272	273	1	1	3	5	2	0
OOVY-881	272	279	7	1	4	1	2	0
OOVY-882	273	477	204	0	3	1	0	0
OOVY-882	274	477	203	0	4	1	0	0
OOVY-882	276	277	1	1	3	1	2	1
OOVY-882	276	277	1	1	4	5	2	0
OOVY-882	277	477	200	0	3	1	0	1
OOVY-882	277	477	200	0	3	1	0	1
OOVY-882	277	477	200	0	3	1	0	0
OOVY-882	278	279	1	1	3	4	2	0
OOVY-882	278	477	199	0	3	1	0	0
OOVY-882	278	279	1	1	3	5	2	0
OOVY-883	278	279	1	1	3	5	2	0
OOVY-883	278	346	68	1	3	4	0	0
OOVY-883	278	477	199	0	3	5	0	0
OOVY-883	279	280	1	1	2	1	2	0
OOVY-883	280	358	78	1	3	5	0	0
OOVY-883	281	283	2	1	4	1	2	0
OOVY-883	281	282	1	1	1	1	0	1
OOVY-883	281	477	196	0	3	1	0	0
OOVY-883	282	349	67	1	3	1	0	0
OOVY-883	282	283	1	1	3	1	1	0
OOVY-884	283	477	194	0	3	1	0	1
OOVY-884	284	285	1	1	3	1	0	0
OOVY-884	284	285	1	1	3	2	1	0
OOVY-884	287	360	73	1	3	5	1	0
OOVY-884	287	477	190	0	3	1	0	0
OOVY-884	287	477	190	0	3	1	0	0
OOVY-884	288	477	189	0	3	1	0	0
OOVY-884	288	477	189	0	4	4	0	0
OOVY-884	288	289	1	1	4	5	2	0
OOVY-884	289	322	33	1	4	2	0	0
OOVY-885	290	477	187	0	3	1	0	0
OOVY-885	292	293	1	1	4	4	1	0
OOVY-885	292	293	1	1	3	4	0	0
OOVY-885	292	293	1	1	3	1	1	0
OOVY-885	295	477	182	0	3	1	0	0
OOVY-885	295	477	182	0	5	1	0	0
OOVY-885	296	299	3	1	1	1	0	0
OOVY-885	298	477	179	0	4	4	0	0
OOVY-885	299	300	1	1	3	4	2	0
OOVY-885	299	477	178	0	4	5	0	0
OOVY-886	300	308	8	1	3	1	0	0
OOVY-886	300	305	5	1	3	4	1	0
OOVY-886	300	301	1	1	3	5	2	0
OOVY-886	301	477	176	0	3	1	0	0
OOVY-886	303	305	2	1	3	3	2	0
OOVY-886	303	305	2	1	3	1	2	0
OOVY-886	304	330	26	1	3	2	0	0
OOVY-886	305	306	1	1	3	5	1	0
OOVY-886	309	319	10	1	2	1	2	0
OOVY-886	309	477	168	0	4	1	0	0
OOVY-887	309	310	1	1	4	5	2	0
OOVY-887	310	311	1	1	2	1	2	0
OOVY-887	311	313	2	1	3	4	2	0
OOVY-887	312	385	73	1	3	1	2	1
OOVY-887	314	330	16	1	3	4	0	0
OOVY-887	315	477	162	0	3	1	1	0
OOVY-887	316	322	6	1	4	1	3	0
OOVY-887	316	477	161	0	4	1	0	0
OOVY-887	316	319	3	1	3	4	0	0
OOVY-887	316	477	161	0	3	1	0	0
OOVY-888	316	321	5	1	3	4	2	2
OOVY-888	316	319	3	1	3	1	2	0
OOVY-888	319	328	9	1	4	1	2	0
OOVY-888	319	320	1	1	3	5	1	0
OOVY-888	319	320	1	1	3	5	1	0
OOVY-888	319	320	1	1	3	5	1	0
OOVY-888	319	477	158	0	3	5	0	0
OOVY-888	320	321	1	1	3	4	1	0
OOVY-888	321	477	156	0	3	4	0	0
OOVY-888	321	477	156	0	3	1	0	0
OOVY-889	321	346	25	1	3	4	1	0
OOVY-889	321	322	1	1	3	1	0	2
OOVY-889	321	322	1	1	3	1	2	2
OOVY-889	321	477	156	0	3	1	0	0
OOVY-889	322	323	1	1	3	4	2	0
OOVY-889	323	324	1	1	3	1	2	1
OOVY-889	323	477	154	0	3	1	0	0
OOVY-889	324	477	153	0	3	4	0	0
OOVY-889	325	338	13	1	3	1	2	0
OOVY-889	325	330	5	1	3	4	0	0
OOVY-890	325	326	1	1	3	4	1	0
OOVY-890	326	330	4	1	3	4	0	0
OOVY-890	327	330	3	1	3	4	0	0
OOVY-890	329	426	97	1	3	4	2	0
OOVY-890	330	331	1	1	3	5	2	0
OOVY-890	330	477	147	0	3	1	0	0
OOVY-890	332	477	145	0	3	1	0	0
OOVY-890	333	477	144	0	4	1	0	0
OOVY-890	336	430	94	1	3	5	1	0
OOVY-890	338	477	139	0	3	1	0	0
OOVY-891	339	340	1	1	3	4	1	0
OOVY-891	339	477	138	0	3	1	0	0
OOVY-891	339	477	138	0	3	1	0	1
OOVY-891	339	404	65	1	3	1	1	0
OOVY-891	340	350	10	1	4	1	2	0
OOVY-891	341	342	1	1	3	4	1	0
OOVY-891	343	345	2	1	4	1	1	0
OOVY-891	343	344	1	1	3	1	1	0
OOVY-891	344	363	19	1	3	1	0	1
OOVY-891	344	345	1	1	3	1	0	0
OOVY-892	345	346	1	1	3	1	1	0
OOVY-892	345	346	1	1	3	5	1	0
OOVY-892	345	346	1	1	3	5	1	0
OOVY-892	345	346	1	1	3	5	1	0
OOVY-892	345	346	1	1	3	5	1	0
OOVY-892	345	346	1	1	3	5	1	0
OOVY-892	346	477	131	0	3	4	0	0
OOVY-892	347	348	1	1	3	4	2	0
OOVY-892	349	350	1	1	3	5	1	0
OOVY-892	350	477	127	0	3	1	0	0
OOVY-893	351	477	126	0	3	1	0	0
OOVY-893	351	352	1	1	3	1	2	0
OOVY-893	351	477	126	0	3	1	0	0
OOVY-893	352	477	125	0	2	1	0	0
OOVY-893	353	477	124	0	3	1	0	0
OOVY-893	355	359	4	1	3	2	1	0
OOVY-893	355	356	1	1	3	1	1	0
OOVY-893	356	357	1	1	3	5	1	0
OOVY-893	357	359	2	1	2	1	0	0
OOVY-893	359	360	1	1	4	4	1	0
OOVY-894	360	477	117	0	4	1	0	0
OOVY-894	361	477	116	0	3	1	0	0
ACAMOLE-47	1	237	236	1	3	4	1	2
ACAMOLE-47	2	38	36	1	3	3	1	0
ACAMOLE-47	3	4	1	1	3	1	0	0
ACAMOLE-47	3	477	474	0	5	5	0	0
ACAMOLE-47	3	477	474	0	4	2	0	0
ACAMOLE-47	3	16	13	1	3	2	0	1
ACAMOLE-47	3	37	34	1	5	1	0	2
ACAMOLE-47	6	7	1	1	5	1	0	0
ACAMOLE-47	6	477	471	0	4	1	0	0
ACAMOLE-47	7	477	470	0	5	4	0	0
ACAMOLE-48	7	37	30	1	4	1	0	1
ACAMOLE-48	8	28	20	1	4	4	1	0
ACAMOLE-48	11	106	95	1	5	1	1	0
ACAMOLE-48	17	37	20	1	4	1	0	0
ACAMOLE-48	17	21	4	1	4	1	1	2
ACAMOLE-48	18	37	19	1	4	1	1	0
ACAMOLE-48	21	22	1	1	4	1	0	0
ACAMOLE-48	21	22	1	1	4	1	0	0
ACAMOLE-48	22	26	4	1	4	2	0	1
ACAMOLE-48	25	27	2	1	5	1	1	1
ACAMOLE-49	26	27	1	1	4	1	1	1
ACAMOLE-49	30	31	1	1	3	1	0	1
ACAMOLE-49	31	32	1	1	2	1	1	2
ACAMOLE-49	31	32	1	1	4	4	1	1
ACAMOLE-49	31	32	1	1	4	4	1	0
ACAMOLE-49	31	32	1	1	4	4	1	0
ACAMOLE-49	31	32	1	1	4	1	0	0
ACAMOLE-49	31	32	1	1	3	3	1	0
ACAMOLE-49	32	33	1	1	4	1	0	0
ACAMOLE-49	34	35	1	1	5	4	1	0
ACAMOLE-50	36	37	1	1	4	1	1	0
ACAMOLE-50	36	38	2	1	4	2	0	0
ACAMOLE-50	37	38	1	1	3	1	1	1
ACAMOLE-50	37	477	440	0	5	1	0	0
ACAMOLE-50	38	45	7	1	4	4	1	1
ACAMOLE-50	39	71	32	1	1	1	1	1
ACAMOLE-50	39	477	438	0	4	1	0	0
ACAMOLE-50	44	45	1	1	1	1	0	0
ACAMOLE-50	44	62	18	1	3	4	1	1
ACAMOLE-50	46	47	1	1	4	1	0	0
ACAMOLE-51	50	371	321	1	5	1	1	2
ACAMOLE-51	50	51	1	1	4	1	0	0
ACAMOLE-51	51	53	2	1	4	1	0	0
ACAMOLE-51	52	477	425	0	4	2	0	0
ACAMOLE-51	52	477	425	0	4	4	0	0
ACAMOLE-51	57	58	1	1	4	1	0	1
ACAMOLE-51	61	477	416	0	4	4	0	0
ACAMOLE-51	63	64	1	1	5	1	1	0
ACAMOLE-51	64	477	413	0	4	1	0	2
ACAMOLE-51	65	477	412	0	4	4	0	4
ACAMOLE-52	65	477	412	0	4	1	0	2
ACAMOLE-52	65	66	1	1	4	1	0	0
ACAMOLE-52	65	477	412	0	4	2	0	0
ACAMOLE-52	66	67	1	1	4	4	1	0
ACAMOLE-52	66	387	321	1	4	4	1	2
ACAMOLE-52	70	75	5	1	3	1	1	0
ACAMOLE-52	72	338	266	1	1	4	1	1
ACAMOLE-52	75	289	214	1	3	2	1	0
ACAMOLE-52	77	78	1	1	3	1	0	0
ACAMOLE-52	78	91	13	1	3	1	1	1
ACAMOLE-53	79	112	33	1	5	4	1	2
ACAMOLE-53	80	477	397	0	4	4	0	1
ACAMOLE-53	81	83	2	1	4	4	0	1
ACAMOLE-53	91	100	9	1	3	4	1	0
ACAMOLE-53	91	92	1	1	4	1	0	0
ACAMOLE-53	94	95	1	1	5	1	0	0
ACAMOLE-53	94	477	383	0	4	4	0	0
ACAMOLE-53	94	477	383	0	4	4	0	1
ACAMOLE-53	94	477	383	0	4	4	0	1
ACAMOLE-53	100	103	3	1	3	5	0	0
ACAMOLE-54	101	199	98	1	4	1	1	0
ACAMOLE-54	101	106	5	1	4	1	1	1
ACAMOLE-54	101	106	5	1	3	4	1	1
ACAMOLE-54	101	103	2	1	4	1	0	0
ACAMOLE-54	103	477	374	0	4	4	0	0
ACAMOLE-54	105	106	1	1	3	1	0	0
ACAMOLE-54	105	477	372	0	4	4	0	0
ACAMOLE-54	105	477	372	0	4	2	1	0
ACAMOLE-54	108	115	7	1	3	4	1	0
ACAMOLE-55	109	477	368	0	5	2	0	0
ACAMOLE-55	109	114	5	1	4	1	0	2
ACAMOLE-55	109	110	1	1	4	4	0	0
ACAMOLE-55	109	112	3	1	4	4	1	0
ACAMOLE-55	112	113	1	1	5	4	0	0
ACAMOLE-55	113	149	36	1	4	4	0	0
ACAMOLE-55	114	477	363	0	4	1	0	2
ACAMOLE-55	119	477	358	0	5	4	0	0
ACAMOLE-55	119	477	358	0	4	4	0	2
ACAMOLE-55	122	211	89	1	2	4	1	0
ACAMOLE-56	122	477	355	0	5	5	0	0
ACAMOLE-56	122	477	355	0	4	4	0	0
ACAMOLE-56	124	249	125	1	4	4	0	1
ACAMOLE-56	125	126	1	1	2	1	0	1
ACAMOLE-56	135	147	12	1	4	4	1	1
ACAMOLE-56	135	232	97	1	4	2	1	1
ACAMOLE-56	143	151	8	1	3	2	1	1
ACAMOLE-56	146	249	103	1	3	4	1	0
ACAMOLE-56	153	154	1	1	2	1	0	0
ACAMOLE-56	156	427	271	1	4	4	1	0
ACAMOLE-57	156	289	133	1	3	3	1	0
ACAMOLE-57	157	158	1	1	4	1	1	0
ACAMOLE-57	166	168	2	1	5	1	1	0
ACAMOLE-57	167	210	43	1	3	4	1	3
ACAMOLE-57	167	477	310	0	3	2	1	0
ACAMOLE-57	169	170	1	1	3	1	0	0
ACAMOLE-57	170	171	1	1	2	1	0	0
ACAMOLE-57	171	477	306	0	4	4	0	2
ACAMOLE-57	171	172	1	1	4	1	0	0
ACAMOLE-57	171	477	306	0	5	4	1	0
ACAMOLE-58	172	175	3	1	4	1	1	1
ACAMOLE-58	175	477	302	0	4	2	0	2
ACAMOLE-58	176	178	2	1	4	1	1	0
ACAMOLE-58	178	477	299	0	4	1	0	0
ACAMOLE-58	179	180	1	1	3	1	0	0
ACAMOLE-58	180	181	1	1	4	1	1	0
ACAMOLE-58	180	181	1	1	4	1	0	0
ACAMOLE-58	185	186	1	1	1	1	1	1
ACAMOLE-58	197	198	1	1	3	1	0	1
ACAMOLE-58	198	199	1	1	3	1	0	0
ACAMOLE-59	204	205	1	1	4	1	0	1
ACAMOLE-59	206	477	271	0	4	2	0	0
ACAMOLE-59	206	207	1	1	4	3	0	0
ACAMOLE-59	206	211	5	1	4	5	1	1
ACAMOLE-59	206	477	271	0	4	1	0	0
ACAMOLE-59	206	433	227	1	4	1	0	1
ACAMOLE-59	207	208	1	1	2	1	0	0
ACAMOLE-59	207	302	95	1	3	2	1	1
ACAMOLE-59	207	339	132	1	3	4	1	2
ACAMOLE-59	208	209	1	1	3	4	0	0
ACAMOLE-60	208	477	269	0	4	2	0	0
ACAMOLE-60	210	370	160	1	4	1	0	1
ACAMOLE-60	210	433	223	1	4	4	0	0
ACAMOLE-60	210	477	267	0	4	4	0	0
ACAMOLE-60	211	477	266	0	4	2	0	0
ACAMOLE-60	211	477	266	0	4	2	0	1
ACAMOLE-60	214	215	1	1	4	4	0	0
ACAMOLE-60	219	477	258	0	4	4	0	1
ACAMOLE-60	220	262	42	1	4	1	0	1
ACAMOLE-60	225	477	252	0	4	4	0	0
ACAMOLE-61	229	302	73	1	4	4	1	0
ACAMOLE-61	229	313	84	1	4	4	1	1
ACAMOLE-61	230	477	247	0	4	4	0	0
ACAMOLE-61	231	477	246	0	4	4	0	1
ACAMOLE-61	234	477	243	0	4	1	0	1
ACAMOLE-61	235	477	242	0	4	1	0	0
ACAMOLE-61	235	236	1	1	3	1	0	0
ACAMOLE-61	236	477	241	0	4	4	0	1
ACAMOLE-61	245	246	1	1	3	1	0	0
ACAMOLE-61	251	432	181	1	4	1	0	0
ACAMOLE-62	251	367	116	1	4	1	0	0
ACAMOLE-62	253	477	224	0	4	1	0	0
ACAMOLE-62	253	313	60	1	5	4	1	0
ACAMOLE-62	253	477	224	0	4	2	1	0
ACAMOLE-62	253	302	49	1	5	4	1	0
ACAMOLE-62	263	477	214	0	4	4	0	0
ACAMOLE-62	263	397	134	1	4	2	1	0
ACAMOLE-62	263	264	1	1	4	1	0	0
ACAMOLE-62	263	264	1	1	5	1	1	0
ACAMOLE-62	267	477	210	0	3	4	1	2
ACAMOLE-63	267	477	210	0	5	2	1	3
ACAMOLE-63	267	268	1	1	4	4	0	1
ACAMOLE-63	267	275	8	1	4	4	1	0
ACAMOLE-63	269	270	1	1	3	1	0	0
ACAMOLE-63	271	272	1	1	4	2	0	0
ACAMOLE-63	271	272	1	1	3	4	1	2
ACAMOLE-63	271	272	1	1	3	3	0	1
ACAMOLE-63	273	464	191	1	4	1	1	1
ACAMOLE-63	273	340	67	1	4	1	1	0
ACAMOLE-63	273	298	25	1	4	4	1	0
ACAMOLE-64	276	277	1	1	3	1	0	0
ACAMOLE-64	280	477	197	0	4	2	0	3
ACAMOLE-64	281	282	1	1	4	4	0	0
ACAMOLE-64	284	477	193	0	4	5	0	0
ACAMOLE-64	286	287	1	1	3	1	0	0
ACAMOLE-64	289	290	1	1	4	2	0	0
ACAMOLE-64	294	295	1	1	2	4	0	0
ACAMOLE-64	298	299	1	1	2	1	0	0
ACAMOLE-64	300	301	1	1	4	5	0	0
ACAMOLE-64	302	477	175	0	5	4	1	0
ACAMOLE-65	307	308	1	1	1	1	0	0
ACAMOLE-65	307	308	1	1	3	1	0	0
ACAMOLE-65	307	308	1	1	3	4	0	0
ACAMOLE-65	308	309	1	1	3	1	0	0
ACAMOLE-65	310	311	1	1	4	4	0	1
ACAMOLE-65	310	367	57	1	4	4	0	1
ACAMOLE-65	312	313	1	1	1	1	1	1
ACAMOLE-65	312	477	165	0	4	1	0	0
ACAMOLE-65	313	314	1	1	4	2	0	0
ACAMOLE-65	314	315	1	1	3	1	0	1
ACAMOLE-66	317	477	160	0	4	2	0	0
ACAMOLE-66	319	371	52	1	4	4	1	2
ACAMOLE-66	319	371	52	1	3	1	1	2
ACAMOLE-66	320	477	157	0	4	1	0	0
ACAMOLE-66	323	433	110	1	4	1	0	1
ACAMOLE-66	323	477	154	0	4	2	0	0
ACAMOLE-66	329	477	148	0	4	1	0	0
ACAMOLE-66	329	477	148	0	4	4	0	0
ACAMOLE-66	330	331	1	1	3	5	0	0
ACAMOLE-66	332	337	5	1	3	1	0	1
ACAMOLE-67	335	336	1	1	1	1	1	0
ACAMOLE-67	335	338	3	1	1	1	0	1
ACAMOLE-67	336	337	1	1	3	1	0	1
ACAMOLE-67	337	339	2	1	4	4	0	0
ACAMOLE-67	340	341	1	1	4	4	1	2
ACAMOLE-67	340	341	1	1	4	1	0	0
ACAMOLE-67	344	477	133	0	5	4	0	0
ACAMOLE-67	347	348	1	1	3	1	0	0
ACAMOLE-67	348	448	100	1	5	4	0	1
ACAMOLE-67	348	477	129	0	4	2	0	2
ACAMOLE-68	349	477	128	0	4	4	0	3
ACAMOLE-68	349	357	8	1	2	1	0	1
ACAMOLE-68	354	357	3	1	4	4	1	1
ACAMOLE-68	361	397	36	1	4	4	1	0
DOOP-1515	1	2	1	1	5	1	1	0
DOOP-1515	1	71	70	1	3	1	0	2
DOOP-1515	1	137	136	1	4	4	1	0
DOOP-1515	1	2	1	1	4	1	1	0
DOOP-1515	2	7	5	1	3	5	1	1
DOOP-1515	3	15	12	1	4	4	1	0
DOOP-1515	4	309	305	1	3	5	0	0
DOOP-1515	4	477	473	0	5	1	0	0
DOOP-1516	4	477	473	0	4	1	0	0
DOOP-1516	4	8	4	1	3	5	1	1
DOOP-1516	5	9	4	1	3	1	0	0
DOOP-1516	7	9	2	1	4	1	1	0
DOOP-1516	7	8	1	1	3	2	0	0
DOOP-1516	10	19	9	1	3	1	1	1
DOOP-1516	10	477	467	0	3	1	0	0
DOOP-1516	10	32	22	1	4	4	1	0
DOOP-1516	11	477	466	0	3	1	0	1
DOOP-1517	11	32	21	1	4	4	1	0
DOOP-1517	12	477	465	0	1	1	0	1
DOOP-1517	13	14	1	1	4	1	1	0
DOOP-1517	16	45	29	1	1	5	1	4
DOOP-1517	16	17	1	1	1	3	4	1
DOOP-1517	16	57	41	1	3	4	1	1
DOOP-1518	8	107	99	1	4	1	3	0
DOOP-1518	17	21	4	1	5	1	4	0
DOOP-1518	17	21	4	1	4	1	0	0
DOOP-1518	18	477	459	0	1	5	0	4
DOOP-1518	21	477	456	0	3	4	0	0
DOOP-1518	22	23	1	1	3	4	1	0
DOOP-1518	22	28	6	1	3	4	1	0
DOOP-1518	22	42	20	1	3	4	1	0
DOOP-1518	22	477	455	0	4	1	0	1
DOOP-1518	23	27	4	1	1	4	3	1
DOOP-1519	23	477	454	0	4	4	0	0
DOOP-1519	24	51	27	1	3	5	0	3
DOOP-1519	24	25	1	1	4	4	1	2
DOOP-1519	24	280	256	1	3	5	1	1
DOOP-1519	25	477	452	0	3	4	0	0
DOOP-1519	25	43	18	1	3	4	1	0
DOOP-1519	30	477	447	0	3	1	0	0
DOOP-1519	30	31	1	1	3	3	2	0
DOOP-1519	30	32	2	1	3	1	1	0
DOOP-1519	30	477	447	0	3	1	0	0
DOOP-1520	30	477	447	0	2	1	0	1
DOOP-1520	30	49	19	1	4	5	0	1
DOOP-1520	30	477	447	0	3	2	0	1
DOOP-1520	30	477	447	0	3	2	0	1
DOOP-1520	31	44	13	1	4	4	2	0
DOOP-1520	31	401	370	1	3	1	2	0
DOOP-1520	31	46	15	1	3	1	4	0
DOOP-1520	35	80	45	1	3	2	0	3
DOOP-1520	35	73	38	1	3	4	1	4
DOOP-1521	35	50	15	1	4	5	0	0
DOOP-1521	35	161	126	1	4	1	0	0
DOOP-1521	36	37	1	1	3	4	4	1
DOOP-1521	37	43	6	1	4	4	0	0
DOOP-1521	37	38	1	1	4	5	1	3
DOOP-1521	38	183	145	1	4	5	1	0
DOOP-1521	38	49	11	1	3	5	0	2
DOOP-1521	38	156	118	1	3	1	3	0
DOOP-1521	38	477	439	0	3	4	0	2
DOOP-1521	39	477	438	0	3	1	0	0
DOOP-1522	42	259	217	1	3	1	1	4
DOOP-1522	42	477	435	0	3	4	0	0
DOOP-1522	42	477	435	0	3	1	0	2
DOOP-1522	43	48	5	1	4	1	1	0
DOOP-1522	43	477	434	0	4	5	0	1
DOOP-1522	43	394	351	1	4	1	0	1
DOOP-1522	43	259	216	1	3	4	1	3
DOOP-1522	43	44	1	1	1	5	0	0
DOOP-1522	43	477	434	0	4	5	0	0
DOOP-1522	43	400	357	1	3	2	1	4
DOOP-1523	44	477	433	0	3	1	0	4
DOOP-1523	44	477	433	0	4	2	0	0
DOOP-1523	44	191	147	1	4	5	0	2
DOOP-1523	44	477	433	0	3	1	0	0
DOOP-1523	44	74	30	1	3	1	1	0
DOOP-1523	44	51	7	1	3	4	2	1
DOOP-1523	45	53	8	1	5	1	2	0
DOOP-1523	45	477	432	0	4	1	0	0
DOOP-1523	45	46	1	1	3	4	0	1
DOOP-1523	45	119	74	1	5	5	1	1
DOOP-1524	45	206	161	1	3	5	0	0
DOOP-1524	45	49	4	1	4	5	0	0
DOOP-1524	45	462	417	1	5	3	1	0
DOOP-1524	46	477	431	0	4	5	0	0
DOOP-1524	46	225	179	1	4	5	0	0
DOOP-1524	46	477	431	0	3	5	0	0
DOOP-1524	48	477	429	0	5	4	0	0
DOOP-1524	49	51	2	1	4	5	2	0
DOOP-1524	51	52	1	1	4	1	0	0
DOOP-1524	51	477	426	0	4	5	0	0
DOOP-1525	51	136	85	1	2	4	2	0
DOOP-1525	52	57	5	1	3	1	2	4
DOOP-1525	52	61	9	1	3	4	2	0
DOOP-1525	53	477	424	0	4	4	0	0
DOOP-1525	53	54	1	1	4	1	1	0
DOOP-1525	53	54	1	1	3	4	1	1
DOOP-1525	53	339	286	1	3	5	0	0
DOOP-1525	53	386	333	1	3	5	0	0
DOOP-1525	53	386	333	1	3	5	0	0
DOOP-1525	53	386	333	1	3	5	0	0
DOOP-1526	53	477	424	0	3	1	0	0
DOOP-1526	56	60	4	1	3	1	1	2
DOOP-1526	56	77	21	1	3	5	4	1
DOOP-1526	56	58	2	1	4	4	2	3
DOOP-1526	56	58	2	1	1	5	2	1
DOOP-1526	56	57	1	1	3	1	1	0
DOOP-1526	56	57	1	1	3	4	1	1
DOOP-1526	57	65	8	1	2	5	3	0
DOOP-1526	57	58	1	1	3	5	0	0
DOOP-1526	57	59	2	1	2	5	0	0
DOOP-1527	58	63	5	1	3	5	1	0
DOOP-1527	58	462	404	1	3	5	0	4
DOOP-1527	58	66	8	1	2	1	2	3
DOOP-1527	58	59	1	1	4	5	1	1
DOOP-1527	58	59	1	1	4	1	4	0
DOOP-1527	58	59	1	1	3	1	1	1
DOOP-1527	59	67	8	1	4	5	2	0
DOOP-1527	59	72	13	1	3	5	1	0
DOOP-1527	59	60	1	1	4	4	4	1
DOOP-1528	59	66	7	1	3	1	1	1
DOOP-1528	60	413	353	1	3	4	3	4
DOOP-1528	60	62	2	1	3	4	1	1
DOOP-1528	60	62	2	1	3	1	4	0
DOOP-1528	61	477	416	0	3	1	0	0
DOOP-1528	61	62	1	1	4	1	2	0
DOOP-1528	63	64	1	1	3	5	1	1
DOOP-1528	63	64	1	1	2	1	1	1
DOOP-1528	63	64	1	1	2	1	2	2
DOOP-1529	63	64	1	1	4	1	0	0
DOOP-1529	64	65	1	1	3	5	1	2
DOOP-1529	64	66	2	1	4	1	1	4
DOOP-1529	64	67	3	1	3	5	1	0
DOOP-1529	65	72	7	1	3	5	1	2
DOOP-1529	65	82	17	1	3	4	1	1
DOOP-1529	65	66	1	1	4	1	2	0
DOOP-1529	65	70	5	1	1	5	1	2
DOOP-1529	66	477	411	0	4	5	0	0
DOOP-1529	66	84	18	1	3	1	1	2
DOOP-1530	66	477	411	0	3	1	0	1
DOOP-1530	67	207	140	1	4	5	0	2
DOOP-1530	67	477	410	0	3	4	0	0
DOOP-1530	67	477	410	0	4	5	0	0
DOOP-1530	68	260	192	1	3	5	1	4
DOOP-1530	68	73	5	1	4	1	1	1
DOOP-1530	69	70	1	1	5	1	0	0
DOOP-1530	70	162	92	1	3	1	1	1
DOOP-1530	70	72	2	1	3	5	4	1
DOOP-1530	70	243	173	1	5	1	0	0
DOOP-1531	70	71	1	1	3	4	0	0
DOOP-1531	71	72	1	1	3	4	2	1
DOOP-1531	71	85	14	1	3	4	3	1
DOOP-1531	71	84	13	1	3	5	3	0
DOOP-1531	72	477	405	0	3	5	0	0
DOOP-1531	72	73	1	1	3	1	0	1
DOOP-1531	72	192	120	1	5	1	1	0
DOOP-1531	73	92	19	1	3	1	4	1
DOOP-1531	74	477	403	0	3	1	0	0
DOOP-1532	74	86	12	1	3	1	2	1
DOOP-1532	75	477	402	0	3	4	0	0
DOOP-1532	75	477	402	0	3	4	0	0
DOOP-1532	77	367	290	1	3	5	4	0
DOOP-1532	77	477	400	0	3	4	0	0
DOOP-1532	77	88	11	1	3	4	0	3
DOOP-1532	77	477	400	0	3	1	0	0
DOOP-1532	77	477	400	0	3	5	0	0
DOOP-1532	78	98	20	1	4	1	1	0
DOOP-1532	78	477	399	0	3	3	0	0
DOOP-1533	78	79	1	1	4	4	2	0
DOOP-1533	79	80	1	1	3	1	2	1
DOOP-1533	79	80	1	1	4	4	2	0
DOOP-1533	79	477	398	0	3	4	0	0
DOOP-1533	79	80	1	1	3	4	4	1
DOOP-1533	80	477	397	0	3	4	0	0
DOOP-1533	80	477	397	0	3	1	0	0
DOOP-1533	81	477	396	0	3	4	0	4
DOOP-1533	81	305	224	1	3	4	1	0
DOOP-1534	81	99	18	1	3	1	1	0
DOOP-1534	81	477	396	0	4	5	0	0
DOOP-1534	82	87	5	1	3	4	3	1
DOOP-1534	84	85	1	1	3	4	0	2
DOOP-1534	84	477	393	0	4	1	0	0
DOOP-1534	85	86	1	1	3	4	1	2
DOOP-1534	85	100	15	1	3	5	1	1
DOOP-1534	85	477	392	0	4	5	0	1
DOOP-1534	85	477	392	0	4	5	0	0
DOOP-1534	86	193	107	1	3	5	2	2
DOOP-1535	86	101	15	1	3	5	1	0
DOOP-1535	86	477	391	0	3	4	0	1
DOOP-1535	87	88	1	1	4	1	1	0
DOOP-1535	87	89	2	1	3	4	0	0
DOOP-1535	87	129	42	1	3	4	1	0
DOOP-1535	88	92	4	1	3	1	4	1
DOOP-1535	89	128	39	1	3	4	2	1
DOOP-1535	91	99	8	1	3	1	4	1
DOOP-1535	92	326	234	1	2	1	1	0
DOOP-1535	92	477	385	0	3	1	0	1
DOOP-1536	93	94	1	1	3	4	0	0
DOOP-1536	93	477	384	0	3	4	0	0
DOOP-1536	93	477	384	0	4	4	0	0
DOOP-1536	93	211	118	1	3	5	0	0
DOOP-1536	93	407	314	1	3	5	1	4
DOOP-1536	94	97	3	1	3	5	0	1
DOOP-1536	94	96	2	1	4	1	2	0
DOOP-1536	94	95	1	1	3	5	0	0
DOOP-1536	94	95	1	1	3	3	1	0
DOOP-1536	95	105	10	1	3	1	1	1
DOOP-1537	95	331	236	1	5	5	1	0
DOOP-1537	95	477	382	0	4	1	0	0
DOOP-1537	96	477	381	0	4	1	0	1
DOOP-1537	97	297	200	1	4	1	0	0
DOOP-1537	98	99	1	1	3	1	2	0
DOOP-1537	98	99	1	1	3	1	2	0
DOOP-1537	99	100	1	1	4	5	2	1
DOOP-1537	99	121	22	1	4	4	1	0
DOOP-1537	99	477	378	0	2	1	0	2
DOOP-1537	100	102	2	1	4	1	2	0
DOOP-1538	100	477	377	0	3	1	0	1
DOOP-1538	100	477	377	0	3	1	0	0
DOOP-1538	101	122	21	1	4	4	1	0
DOOP-1538	101	477	376	0	4	5	0	0
DOOP-1538	102	190	88	1	3	5	1	0
DOOP-1538	104	114	10	1	2	1	3	1
DOOP-1538	105	477	372	0	4	1	0	0
DOOP-1538	105	477	372	0	3	2	0	2
DOOP-1538	105	477	372	0	3	1	0	1
DOOP-1538	105	106	1	1	1	1	0	1
DOOP-1539	105	112	7	1	2	1	4	1
DOOP-1539	106	107	1	1	3	1	2	0
DOOP-1539	106	206	100	1	3	5	0	2
DOOP-1539	106	107	1	1	3	4	1	1
DOOP-1539	106	107	1	1	4	4	3	1
DOOP-1539	106	205	99	1	3	1	1	2
DOOP-1539	107	108	1	1	4	1	4	0
DOOP-1539	107	477	370	0	3	1	1	0
DOOP-1539	107	429	322	1	3	1	0	1
DOOP-1539	107	108	1	1	3	1	0	0
DOOP-1540	108	219	111	1	4	5	1	1
DOOP-1540	109	110	1	1	3	1	0	2
DOOP-1540	109	114	5	1	3	1	1	1
DOOP-1540	112	114	2	1	3	5	1	1
DOOP-1540	112	477	365	0	4	5	0	0
DOOP-1540	112	121	9	1	3	1	3	1
DOOP-1540	112	267	155	1	1	2	1	2
DOOP-1540	113	126	13	1	1	1	0	1
DOOP-1540	113	342	229	1	4	5	0	2
DOOP-1541	113	477	364	0	3	1	0	0
DOOP-1541	113	115	2	1	2	1	3	3
DOOP-1541	114	115	1	1	3	1	0	1
DOOP-1541	114	477	363	0	3	4	0	1
DOOP-1541	115	477	362	0	3	1	0	0
DOOP-1541	115	477	362	0	4	1	0	0
DOOP-1541	115	175	60	1	4	5	1	1
DOOP-1541	115	116	1	1	3	1	0	0
DOOP-1541	116	291	175	1	3	1	1	2
DOOP-1541	116	477	361	0	3	1	0	0
DOOP-1542	116	128	12	1	4	5	1	1
DOOP-1542	116	477	361	0	3	5	0	2
DOOP-1542	116	143	27	1	4	5	0	1
DOOP-1542	116	175	59	1	4	5	1	1
DOOP-1542	116	477	361	0	3	1	0	0
DOOP-1542	116	477	361	0	3	1	0	0
DOOP-1542	116	255	139	1	1	5	1	4
DOOP-1542	117	178	61	1	4	4	0	0
DOOP-1542	117	345	228	1	3	5	1	1
DOOP-1542	119	477	358	0	4	1	0	0
DOOP-1543	119	477	358	0	4	5	0	0
DOOP-1543	120	126	6	1	1	1	0	1
DOOP-1543	120	190	70	1	3	5	0	1
DOOP-1543	120	190	70	1	3	5	0	1
DOOP-1543	120	122	2	1	3	1	1	1
DOOP-1543	120	190	70	1	3	5	0	1
DOOP-1543	120	190	70	1	3	5	0	1
DOOP-1543	120	190	70	1	3	5	0	1
DOOP-1543	120	190	70	1	3	5	0	1
DOOP-1543	121	477	356	0	4	5	0	0
DOOP-1544	121	477	356	0	3	4	0	0
DOOP-1544	121	131	10	1	4	4	4	1
DOOP-1544	121	134	13	1	3	1	1	0
DOOP-1544	121	127	6	1	3	1	0	0
DOOP-1544	122	123	1	1	3	5	1	1
DOOP-1544	122	477	355	0	3	1	0	1
DOOP-1544	122	129	7	1	3	1	4	0
DOOP-1544	123	477	354	0	3	1	0	0
DOOP-1544	124	477	353	0	3	1	0	0
DOOP-1544	126	147	21	1	2	4	4	0
DOOP-1545	126	141	15	1	1	1	4	2
DOOP-1545	128	477	349	0	3	1	0	0
DOOP-1545	129	477	348	0	3	1	0	0
DOOP-1545	129	130	1	1	3	5	4	1
DOOP-1545	129	148	19	1	5	1	1	0
DOOP-1545	129	226	97	1	3	5	0	1
DOOP-1545	112	142	30	1	3	4	1	0
DOOP-1545	130	175	45	1	4	5	4	1
DOOP-1545	133	136	3	1	2	1	0	0
DOOP-1546	133	477	344	0	3	5	0	2
DOOP-1546	133	477	344	0	3	2	0	1
DOOP-1546	130	477	347	0	3	5	0	0
DOOP-1546	130	477	347	0	3	5	0	0
DOOP-1546	130	477	347	0	3	5	0	0
DOOP-1546	133	158	25	1	3	5	1	1
DOOP-1546	133	134	1	1	3	1	1	0
DOOP-1546	133	136	3	1	4	5	0	2
DOOP-1546	134	135	1	1	4	1	1	0
DOOP-1546	134	136	2	1	3	5	1	0
DOOP-1547	134	214	80	1	4	5	0	1
DOOP-1547	93	477	384	0	3	1	1	0
DOOP-1547	134	135	1	1	3	1	0	0
DOOP-1547	113	144	31	1	2	1	4	4
DOOP-1547	136	141	5	1	3	1	1	1
DOOP-1547	136	477	341	0	4	5	0	4
DOOP-1547	136	212	76	1	3	4	2	1
DOOP-1547	137	147	10	1	5	4	1	0
DOOP-1547	137	140	3	1	3	1	2	0
DOOP-1547	137	477	340	0	4	5	0	0
DOOP-1548	137	149	12	1	3	5	1	0
DOOP-1548	137	375	238	1	3	4	4	1
DOOP-1548	138	158	20	1	3	3	1	2
DOOP-1548	138	176	38	1	3	3	2	2
DOOP-1548	138	163	25	1	3	3	0	0
DOOP-1548	140	477	337	0	3	5	0	0
DOOP-1548	140	142	2	1	3	4	4	1
DOOP-1548	141	477	336	0	3	1	0	1
DOOP-1548	141	477	336	0	3	1	0	0
DOOP-1548	141	477	336	0	4	5	0	1
DOOP-1549	141	150	9	1	4	1	1	0
DOOP-1549	143	477	334	0	3	5	0	0
DOOP-1549	143	477	334	0	2	4	0	1
DOOP-1549	144	145	1	1	4	5	1	1
DOOP-1549	144	178	34	1	3	4	1	4
DOOP-1549	146	148	2	1	4	5	0	3
DOOP-1549	146	148	2	1	4	5	4	1
DOOP-1549	146	147	1	1	4	5	4	1
DOOP-1549	148	161	13	1	3	4	3	0
DOOP-1550	148	477	329	0	4	3	0	0
DOOP-1550	142	477	335	0	3	3	0	4
DOOP-1550	148	477	329	0	1	1	0	2
DOOP-1550	149	477	328	0	4	5	0	0
DOOP-1550	149	165	16	1	3	1	1	1
DOOP-1550	149	477	328	0	4	4	0	0
DOOP-1550	150	161	11	1	4	5	4	2
DOOP-1550	150	155	5	1	3	4	1	0
DOOP-1550	152	477	325	0	3	5	0	0
DOOP-1550	152	203	51	1	3	3	1	4
DOOP-1551	154	155	1	1	3	5	0	0
DOOP-1551	154	157	3	1	4	4	1	1
DOOP-1551	155	156	1	1	3	5	1	1
DOOP-1551	155	156	1	1	3	5	2	1
DOOP-1551	81	477	396	0	3	1	0	0
DOOP-1551	156	157	1	1	4	5	2	2
DOOP-1551	157	477	320	0	3	1	0	2
DOOP-1551	157	228	71	1	2	1	0	1
DOOP-1552	157	159	2	1	4	5	1	0
DOOP-1552	157	161	4	1	4	4	0	1
DOOP-1552	158	161	3	1	3	5	1	1
DOOP-1552	158	167	9	1	3	1	4	2
DOOP-1552	158	477	319	0	3	1	0	0
DOOP-1552	158	477	319	0	3	1	0	3
DOOP-1552	159	160	1	1	5	1	0	0
DOOP-1552	161	163	2	1	3	1	2	1
DOOP-1552	161	477	316	0	3	5	0	3
DOOP-1552	161	162	1	1	4	5	4	3
DOOP-1553	162	477	315	0	3	1	0	1
DOOP-1553	162	193	31	1	3	4	1	1
DOOP-1553	162	163	1	1	4	5	4	2
DOOP-1553	162	168	6	1	5	5	4	1
DOOP-1553	163	427	264	1	3	1	0	1
DOOP-1553	163	179	16	1	3	5	1	1
DOOP-1553	163	165	2	1	4	5	1	1
DOOP-1553	164	477	313	0	3	1	0	2
DOOP-1553	164	477	313	0	3	4	0	0
DOOP-1554	164	165	1	1	3	5	1	4
DOOP-1554	164	191	27	1	3	1	1	2
DOOP-1554	165	166	1	1	4	4	0	3
DOOP-1554	165	477	312	0	3	1	0	0
DOOP-1554	165	477	312	0	3	5	0	0
DOOP-1554	165	185	20	1	4	5	0	1
DOOP-1554	165	219	54	1	3	5	1	2
DOOP-1554	168	246	78	1	3	4	2	0
DOOP-1554	170	179	9	1	4	1	4	0
DOOP-1554	170	171	1	1	3	1	1	2
DOOP-1555	170	175	5	1	4	1	2	1
DOOP-1555	170	171	1	1	3	4	1	0
DOOP-1555	170	226	56	1	3	5	1	0
DOOP-1555	171	477	306	0	4	2	0	0
DOOP-1555	171	182	11	1	4	4	3	2
DOOP-1555	172	477	305	0	3	5	0	2
DOOP-1555	172	199	27	1	3	5	0	2
DOOP-1555	172	477	305	0	3	4	0	3
DOOP-1555	175	477	302	0	3	2	0	0
DOOP-1555	176	177	1	1	4	4	0	1
DOOP-1556	176	183	7	1	3	5	1	0
DOOP-1556	176	477	301	0	5	4	0	0
DOOP-1556	176	477	301	0	4	4	0	0
DOOP-1556	176	477	301	0	3	5	0	2
DOOP-1556	176	477	301	0	3	4	0	0
DOOP-1556	177	477	300	0	3	1	0	0
DOOP-1556	177	477	300	0	3	4	0	4
DOOP-1556	178	477	299	0	3	4	0	2
DOOP-1556	178	189	11	1	5	4	1	0
DOOP-1556	178	190	12	1	4	5	0	2
DOOP-1557	178	477	299	0	4	5	0	0
DOOP-1557	178	186	8	1	2	1	3	4
DOOP-1557	179	204	25	1	3	5	0	4
DOOP-1557	179	399	220	1	4	5	1	1
DOOP-1557	178	181	3	1	3	1	2	0
DOOP-1557	182	477	295	0	3	5	0	0
DOOP-1557	182	223	41	1	1	5	1	4
DOOP-1557	182	183	1	1	3	4	0	1
DOOP-1557	183	477	294	0	3	5	0	0
DOOP-1557	183	199	16	1	3	5	0	1
DOOP-1558	184	189	5	1	3	4	1	0
DOOP-1558	185	424	239	1	3	5	0	1
DOOP-1558	185	220	35	1	1	5	1	4
DOOP-1558	185	254	69	1	4	4	1	0
DOOP-1558	185	477	292	0	3	4	0	0
DOOP-1558	187	203	16	1	4	4	2	0
DOOP-1558	189	477	288	0	3	5	0	0
DOOP-1558	189	477	288	0	3	5	0	0
DOOP-1559	189	477	288	0	3	1	0	0
DOOP-1559	183	189	6	1	4	4	1	0
DOOP-1559	189	205	16	1	4	5	0	1
DOOP-1559	189	206	17	1	1	1	2	4
DOOP-1559	190	191	1	1	3	1	1	1
DOOP-1559	190	191	1	1	3	1	0	0
DOOP-1559	190	201	11	1	4	4	1	1
DOOP-1559	190	191	1	1	2	1	0	0
DOOP-1559	191	196	5	1	3	4	3	1
DOOP-1559	191	477	286	0	4	1	0	0
DOOP-1560	191	477	286	0	3	5	0	0
DOOP-1560	191	477	286	0	3	5	0	0
DOOP-1560	192	477	285	0	3	4	0	0
DOOP-1560	192	477	285	0	4	5	0	1
DOOP-1560	193	477	284	0	3	5	0	4
DOOP-1560	194	477	283	0	3	4	0	3
DOOP-1560	196	295	99	1	2	5	4	1
DOOP-1560	196	477	281	0	3	1	0	0
DOOP-1560	196	205	9	1	3	4	3	0
DOOP-1561	196	199	3	1	2	1	3	1
DOOP-1561	197	206	9	1	4	4	1	0
DOOP-1561	197	205	8	1	3	4	3	0
DOOP-1561	197	477	280	0	3	1	0	1
DOOP-1561	197	199	2	1	3	1	4	2
DOOP-1561	198	199	1	1	4	1	0	0
DOOP-1561	198	477	279	0	3	2	0	0
DOOP-1561	198	381	183	1	3	4	2	1
DOOP-1561	199	203	4	1	4	1	0	1
DOOP-1561	199	477	278	0	3	4	0	2
DOOP-1562	199	477	278	0	3	4	0	4
DOOP-1562	199	275	76	1	3	5	1	4
DOOP-1562	200	477	277	0	3	1	0	1
DOOP-1562	200	309	109	1	3	5	0	0
DOOP-1562	203	477	274	0	3	3	0	0
DOOP-1562	203	437	234	1	3	5	2	4
DOOP-1562	203	214	11	1	1	5	1	1
DOOP-1562	203	205	2	1	3	5	0	1
DOOP-1562	204	477	273	0	4	5	0	0
DOOP-1562	205	207	2	1	4	5	0	1
DOOP-1563	205	477	272	0	3	5	0	3
DOOP-1563	206	477	271	0	3	1	0	0
DOOP-1563	206	238	32	1	3	1	1	2
DOOP-1563	206	207	1	1	1	1	0	0
DOOP-1563	206	254	48	1	4	5	1	0
DOOP-1563	206	208	2	1	4	5	1	2
DOOP-1563	206	211	5	1	4	1	4	1
DOOP-1563	207	224	17	1	3	1	3	1
DOOP-1563	209	477	268	0	3	1	0	0
DOOP-1564	210	211	1	1	4	4	0	0
DOOP-1564	210	477	267	0	3	1	0	0
DOOP-1564	210	227	17	1	1	5	1	4
DOOP-1564	210	477	267	0	3	5	0	0
DOOP-1564	211	212	1	1	2	1	3	2
DOOP-1564	212	224	12	1	1	5	1	0
DOOP-1564	212	477	265	0	2	1	0	0
DOOP-1564	212	243	31	1	3	4	0	0
DOOP-1564	213	477	264	0	4	4	0	0
DOOP-1564	213	477	264	0	3	1	0	0
DOOP-1565	214	477	263	0	4	5	0	3
DOOP-1565	214	477	263	0	3	5	0	0
DOOP-1565	215	452	237	1	5	1	1	0
DOOP-1565	216	217	1	1	3	2	0	1
DOOP-1565	218	477	259	0	4	1	0	0
DOOP-1565	218	228	10	1	2	1	2	0
DOOP-1565	220	234	14	1	3	4	0	0
DOOP-1565	220	248	28	1	3	4	3	1
DOOP-1565	220	477	257	0	3	5	0	0
DOOP-1565	220	222	2	1	3	5	1	0
DOOP-1566	220	229	9	1	3	5	1	1
DOOP-1566	220	233	13	1	3	5	1	1
DOOP-1566	220	375	155	1	3	5	1	0
DOOP-1566	220	242	22	1	3	5	1	0
DOOP-1566	220	243	23	1	3	5	1	1
DOOP-1566	220	246	26	1	3	5	0	0
DOOP-1566	221	241	20	1	3	5	1	0
DOOP-1566	221	309	88	1	3	1	0	0
DOOP-1566	221	227	6	1	3	5	1	1
DOOP-1567	224	227	3	1	4	1	0	0
DOOP-1567	225	267	42	1	3	5	4	4
DOOP-1567	225	477	252	0	4	5	0	1
DOOP-1567	226	259	33	1	3	5	0	0
DOOP-1567	226	228	2	1	3	1	4	2
DOOP-1567	220	477	257	0	4	1	0	2
DOOP-1567	226	283	57	1	4	4	1	2
DOOP-1567	226	252	26	1	3	2	1	0
DOOP-1567	227	477	250	0	3	1	0	0
DOOP-1567	227	283	56	1	3	1	4	3
DOOP-1568	227	241	14	1	3	1	1	0
DOOP-1568	227	477	250	0	4	1	0	0
DOOP-1568	227	235	8	1	3	5	1	0
DOOP-1568	227	228	1	1	2	4	0	1
DOOP-1568	229	261	32	1	2	1	3	3
DOOP-1568	231	477	246	0	3	4	0	0
DOOP-1568	231	477	246	0	3	1	0	0
DOOP-1568	232	306	74	1	5	4	2	0
DOOP-1568	232	234	2	1	3	5	1	0
DOOP-1568	233	234	1	1	3	4	3	0
DOOP-1569	233	477	244	0	3	1	0	0
DOOP-1569	234	477	243	0	3	2	0	4
DOOP-1569	234	240	6	1	3	5	1	1
DOOP-1569	235	268	33	1	5	1	1	0
DOOP-1569	235	254	19	1	3	5	1	0
DOOP-1569	236	477	241	0	3	4	0	0
DOOP-1569	238	247	9	1	1	1	3	2
DOOP-1569	238	477	239	0	3	1	0	0
DOOP-1569	238	241	3	1	3	1	3	1
DOOP-1569	238	239	1	1	3	5	2	0
DOOP-1570	239	247	8	1	3	5	0	0
DOOP-1570	239	477	238	0	3	1	0	0
DOOP-1570	239	477	238	0	3	5	1	0
DOOP-1570	240	248	8	1	3	5	1	0
DOOP-1570	240	262	22	1	3	5	1	0
DOOP-1570	240	241	1	1	4	1	3	0
DOOP-1570	240	241	1	1	5	1	3	0
DOOP-1570	241	247	6	1	3	2	1	0
DOOP-1570	242	283	41	1	4	1	1	1
DOOP-1570	242	249	7	1	4	5	1	0
DOOP-1571	242	477	235	0	3	5	0	0
DOOP-1571	242	404	162	1	2	3	1	4
DOOP-1571	245	477	232	0	4	4	0	0
DOOP-1571	245	477	232	0	4	1	0	0
DOOP-1571	245	260	15	1	3	5	1	1
DOOP-1571	245	260	15	1	4	5	1	0
DOOP-1571	245	477	232	0	3	1	0	0
DOOP-1571	246	283	37	1	3	4	1	0
DOOP-1571	246	362	116	1	4	1	0	0
DOOP-1571	246	260	14	1	3	5	1	0
DOOP-1572	247	477	230	0	3	1	0	0
DOOP-1572	247	477	230	0	4	1	0	0
DOOP-1572	247	477	230	0	3	1	0	3
DOOP-1572	247	267	20	1	3	5	1	0
DOOP-1572	248	477	229	0	3	5	0	0
DOOP-1572	248	252	4	1	3	1	0	0
DOOP-1572	248	261	13	1	3	4	4	1
DOOP-1572	248	477	229	0	3	1	0	0
DOOP-1572	248	249	1	1	3	5	1	0
DOOP-1572	249	477	228	0	3	5	0	0
DOOP-1573	249	250	1	1	3	5	4	0
DOOP-1573	250	477	227	0	3	1	0	0
DOOP-1573	250	256	6	1	3	1	2	0
DOOP-1573	252	263	11	1	5	1	1	1
DOOP-1573	252	262	10	1	3	1	3	0
DOOP-1573	252	477	225	0	4	5	0	0
DOOP-1573	252	253	1	1	4	1	0	1
DOOP-1573	252	267	15	1	3	5	1	0
DOOP-1574	253	254	1	1	4	5	1	0
DOOP-1574	253	260	7	1	4	5	1	2
DOOP-1574	253	260	7	1	4	4	1	0
DOOP-1574	253	477	224	0	3	1	0	1
DOOP-1574	253	260	7	1	4	5	1	1
DOOP-1574	253	254	1	1	3	5	1	0
DOOP-1574	254	255	1	1	3	1	0	1
DOOP-1574	254	477	223	0	3	5	0	1
DOOP-1574	254	262	8	1	3	5	4	1
DOOP-1574	254	477	223	0	3	1	0	2
DOOP-1575	254	255	1	1	3	5	1	1
DOOP-1575	254	477	223	0	4	5	0	1
DOOP-1575	254	255	1	1	3	1	0	1
DOOP-1575	255	256	1	1	3	5	1	0
DOOP-1575	255	259	4	1	4	5	1	0
DOOP-1575	256	260	4	1	3	1	4	0
DOOP-1575	256	262	6	1	3	5	1	0
DOOP-1575	256	257	1	1	3	5	1	0
DOOP-1575	256	277	21	1	3	1	0	1
DOOP-1575	259	260	1	1	3	5	4	3
DOOP-1576	259	477	218	0	3	4	0	0
DOOP-1576	259	477	218	0	4	5	0	0
DOOP-1576	259	477	218	0	3	4	0	1
DOOP-1576	259	477	218	0	3	4	0	1
DOOP-1576	260	270	10	1	3	5	1	1
DOOP-1576	260	477	217	0	3	1	0	0
DOOP-1576	260	275	15	1	3	5	1	1
DOOP-1576	260	477	217	0	4	1	0	0
DOOP-1576	260	261	1	1	3	5	1	0
DOOP-1577	260	262	2	1	3	5	0	0
DOOP-1577	261	262	1	1	4	4	0	0
DOOP-1577	259	261	2	1	3	1	4	0
DOOP-1577	261	262	1	1	3	5	1	0
DOOP-1577	261	477	216	0	3	2	0	3
DOOP-1577	262	281	19	1	2	5	1	3
DOOP-1577	262	477	215	0	3	1	0	0
DOOP-1577	262	477	215	0	3	2	0	3
DOOP-1577	262	263	1	1	4	5	1	0
DOOP-1577	263	477	214	0	3	5	0	3
DOOP-1578	263	452	189	1	3	5	0	1
DOOP-1578	264	388	124	1	3	1	2	1
DOOP-1578	266	477	211	0	3	5	0	1
DOOP-1578	267	268	1	1	3	5	1	0
DOOP-1578	267	477	210	0	3	1	0	0
DOOP-1578	267	283	16	1	3	5	1	2
DOOP-1578	267	477	210	0	3	5	0	0
DOOP-1578	267	386	119	1	3	5	1	0
DOOP-1578	267	477	210	0	3	4	0	4
DOOP-1579	267	277	10	1	3	1	1	0
DOOP-1579	267	274	7	1	4	5	1	0
DOOP-1579	268	274	6	1	4	5	1	0
DOOP-1579	268	477	209	0	3	1	0	0
DOOP-1579	268	275	7	1	3	5	1	0
DOOP-1579	269	347	78	1	3	5	0	0
DOOP-1579	269	271	2	1	3	1	0	0
DOOP-1579	269	331	62	1	3	5	1	1
DOOP-1579	269	326	57	1	3	5	0	0
DOOP-1580	269	477	208	0	3	5	0	0
DOOP-1580	270	274	4	1	3	5	1	0
DOOP-1580	271	289	18	1	4	1	2	1
DOOP-1580	271	477	206	0	3	1	0	0
DOOP-1580	271	291	20	1	3	4	4	1
DOOP-1580	272	274	2	1	3	1	0	0
DOOP-1580	273	382	109	1	3	5	1	1
DOOP-1580	273	477	204	0	4	5	0	0
DOOP-1580	273	344	71	1	3	4	2	3
DOOP-1580	273	277	4	1	3	5	1	0
DOOP-1581	274	477	203	0	3	4	0	0
DOOP-1581	274	477	203	0	3	1	0	1
DOOP-1581	274	312	38	1	3	5	1	1
DOOP-1581	274	416	142	1	3	1	4	0
DOOP-1581	274	275	1	1	3	1	2	1
DOOP-1581	275	298	23	1	3	3	4	4
DOOP-1581	275	277	2	1	3	3	4	1
DOOP-1581	275	276	1	1	3	1	4	0
DOOP-1581	276	281	5	1	4	1	2	0
DOOP-1581	276	360	84	1	2	1	0	0
DOOP-1582	276	277	1	1	1	1	4	2
DOOP-1582	276	293	17	1	3	4	1	3
DOOP-1582	277	296	19	1	3	1	4	1
DOOP-1582	277	296	19	1	3	5	1	0
DOOP-1582	278	477	199	0	4	1	0	0
DOOP-1582	280	281	1	1	3	5	1	0
DOOP-1582	280	288	8	1	4	5	1	0
DOOP-1582	280	281	1	1	1	5	1	3
DOOP-1582	280	477	197	0	4	4	0	0
DOOP-1582	280	477	197	0	4	4	0	0
DOOP-1583	280	477	197	0	4	4	0	0
DOOP-1583	280	284	4	1	4	4	1	1
DOOP-1583	281	282	1	1	3	4	1	4
DOOP-1583	281	414	133	1	4	5	0	2
DOOP-1583	281	477	196	0	3	5	0	1
DOOP-1583	281	282	1	1	3	1	3	1
DOOP-1583	281	477	196	0	4	4	1	3
DOOP-1583	281	284	3	1	3	5	4	1
DOOP-1583	282	477	195	0	3	1	1	0
DOOP-1583	282	289	7	1	4	5	2	1
DOOP-1584	282	477	195	0	4	4	0	1
DOOP-1584	283	345	62	1	3	5	0	0
DOOP-1584	283	477	194	0	4	1	0	1
DOOP-1584	283	414	131	1	4	5	1	1
DOOP-1584	283	477	194	0	4	5	0	0
DOOP-1584	283	344	61	1	3	5	0	2
DOOP-1584	283	311	28	1	3	5	1	0
DOOP-1584	283	477	194	0	3	5	0	0
DOOP-1584	284	288	4	1	3	5	1	0
DOOP-1584	284	286	2	1	3	4	1	0
DOOP-1585	285	291	6	1	2	1	4	2
DOOP-1585	287	288	1	1	3	3	1	1
DOOP-1585	287	477	190	0	4	4	1	0
DOOP-1585	287	288	1	1	3	1	1	1
DOOP-1585	287	289	2	1	5	4	1	0
DOOP-1585	287	302	15	1	4	4	2	0
DOOP-1585	288	296	8	1	1	1	1	1
DOOP-1585	288	289	1	1	1	1	1	0
DOOP-1585	288	289	1	1	4	1	0	0
DOOP-1585	288	289	1	1	1	1	4	2
DOOP-1586	288	366	78	1	3	5	1	0
DOOP-1586	289	290	1	1	1	1	3	1
DOOP-1586	289	477	188	0	3	5	0	3
DOOP-1586	291	477	186	0	2	1	4	2
DOOP-1586	291	477	186	0	3	1	0	0
DOOP-1586	291	294	3	1	1	1	4	1
DOOP-1586	294	298	4	1	3	5	4	3
DOOP-1586	294	316	22	1	3	1	3	0
DOOP-1587	294	477	183	0	3	5	0	2
DOOP-1587	294	477	183	0	3	1	0	1
DOOP-1587	294	326	32	1	3	5	1	2
DOOP-1587	295	296	1	1	3	1	1	2
DOOP-1587	295	296	1	1	1	1	0	2
DOOP-1587	295	477	182	0	4	5	0	0
DOOP-1587	296	316	20	1	4	5	1	1
DOOP-1587	296	477	181	0	3	4	0	1
DOOP-1587	296	302	6	1	4	3	0	0
DOOP-1587	296	297	1	1	3	3	0	1
DOOP-1588	297	477	180	0	4	1	0	0
DOOP-1588	297	477	180	0	3	5	0	0
DOOP-1588	297	298	1	1	3	3	4	1
DOOP-1588	300	424	124	1	3	1	0	1
DOOP-1588	301	305	4	1	4	2	1	2
DOOP-1588	302	303	1	1	3	1	1	1
DOOP-1588	302	477	175	0	3	4	0	0
DOOP-1588	302	477	175	0	3	5	0	0
DOOP-1588	302	423	121	1	3	2	0	1
DOOP-1589	302	444	142	1	3	5	1	3
DOOP-1589	273	477	204	0	3	2	0	0
DOOP-1589	303	307	4	1	4	5	0	0
DOOP-1589	303	477	174	0	3	1	0	1
DOOP-1589	303	477	174	0	4	5	0	2
DOOP-1589	304	305	1	1	3	5	1	1
DOOP-1589	305	306	1	1	3	1	0	0
DOOP-1589	305	477	172	0	3	1	0	0
DOOP-1589	306	477	171	0	3	4	1	0
DOOP-1589	308	309	1	1	3	1	4	1
DOOP-1590	308	309	1	1	3	1	4	1
DOOP-1590	308	477	169	0	3	1	0	0
DOOP-1590	308	309	1	1	3	5	1	0
DOOP-1590	308	311	3	1	3	1	1	1
DOOP-1590	309	310	1	1	3	5	1	0
DOOP-1590	309	339	30	1	3	5	0	1
DOOP-1590	309	310	1	1	5	4	1	0
DOOP-1590	309	477	168	0	4	1	0	1
DOOP-1590	310	374	64	1	3	4	1	1
DOOP-1591	311	477	166	0	5	1	0	0
DOOP-1591	311	477	166	0	3	1	0	0
DOOP-1591	311	316	5	1	3	1	3	1
DOOP-1591	311	477	166	0	2	1	0	2
DOOP-1591	311	477	166	0	3	4	0	0
DOOP-1591	311	477	166	0	3	5	0	0
DOOP-1591	312	313	1	1	1	1	4	3
DOOP-1591	312	317	5	1	3	5	4	0
DOOP-1591	206	477	271	0	3	4	0	0
DOOP-1591	313	322	9	1	3	4	4	1
DOOP-1592	315	477	162	0	3	5	0	2
DOOP-1592	315	477	162	0	3	5	0	1
DOOP-1592	315	387	72	1	3	1	3	1
DOOP-1592	315	316	1	1	1	1	4	0
DOOP-1592	316	317	1	1	3	5	0	2
DOOP-1592	316	319	3	1	3	1	4	0
DOOP-1592	316	318	2	1	4	4	2	1
DOOP-1592	316	477	161	0	3	4	0	0
DOOP-1592	316	477	161	0	3	5	0	0
DOOP-1593	317	318	1	1	2	1	4	0
DOOP-1593	317	477	160	0	3	4	0	0
DOOP-1593	317	330	13	1	2	5	3	1
DOOP-1593	317	373	56	1	3	5	0	0
DOOP-1593	318	353	35	1	3	5	1	0
DOOP-1593	318	319	1	1	3	5	1	0
DOOP-1593	318	371	53	1	3	5	1	0
DOOP-1593	319	400	81	1	3	5	1	0
DOOP-1593	319	323	4	1	4	1	1	0
DOOP-1594	319	330	11	1	3	5	1	0
DOOP-1594	319	380	61	1	3	5	1	1
DOOP-1594	322	477	155	0	3	4	0	0
DOOP-1594	322	326	4	1	3	4	4	0
DOOP-1594	322	477	155	0	4	5	0	0
DOOP-1594	323	324	1	1	3	5	1	0
DOOP-1594	325	477	152	0	3	4	0	0
DOOP-1594	328	331	3	1	3	1	1	2
DOOP-1594	254	329	75	1	4	1	4	0
DOOP-1594	329	477	148	0	4	1	0	1
DOOP-1595	329	336	7	1	3	2	4	1
DOOP-1595	329	477	148	0	3	4	0	0
DOOP-1595	330	477	147	0	4	4	0	0
DOOP-1595	330	345	15	1	3	4	0	0
DOOP-1595	330	400	70	1	3	5	2	1
DOOP-1595	331	477	146	0	5	5	0	0
DOOP-1595	331	477	146	0	5	4	0	0
DOOP-1595	332	333	1	1	3	4	1	0
DOOP-1595	332	477	145	0	2	1	0	2
DOOP-1595	332	371	39	1	4	4	4	4
DOOP-1596	332	477	145	0	2	1	1	4
DOOP-1596	332	477	145	0	4	5	0	1
DOOP-1596	333	361	28	1	4	4	1	0
DOOP-1596	336	477	141	0	3	5	0	2
DOOP-1596	336	477	141	0	3	5	0	2
DOOP-1596	336	353	17	1	3	4	1	2
DOOP-1596	336	337	1	1	3	1	3	1
DOOP-1596	336	414	78	1	3	4	1	3
DOOP-1596	336	337	1	1	3	5	1	0
DOOP-1596	336	350	14	1	3	5	2	0
DOOP-1597	337	338	1	1	3	1	4	0
DOOP-1597	337	477	140	0	2	3	0	1
DOOP-1597	337	350	13	1	3	5	2	0
DOOP-1597	337	353	16	1	2	1	4	2
DOOP-1597	295	337	42	1	3	1	4	4
DOOP-1597	338	375	37	1	3	5	1	0
DOOP-1597	338	477	139	0	3	4	0	0
DOOP-1597	338	477	139	0	3	4	0	1
DOOP-1597	338	477	139	0	3	5	0	0
DOOP-1597	338	477	139	0	3	5	0	0
DOOP-1598	338	477	139	0	3	5	0	0
DOOP-1598	338	477	139	0	3	5	0	0
DOOP-1598	339	477	138	0	4	4	0	0
DOOP-1598	339	477	138	0	3	5	0	0
DOOP-1598	339	477	138	0	2	4	0	1
DOOP-1598	339	477	138	0	4	4	0	0
DOOP-1598	340	477	137	0	3	4	0	0
DOOP-1598	340	344	4	1	3	5	0	0
DOOP-1598	340	345	5	1	3	5	1	0
DOOP-1598	342	477	135	0	3	1	0	0
DOOP-1599	342	477	135	0	3	5	0	2
DOOP-1599	343	399	56	1	4	1	2	1
DOOP-1599	343	369	26	1	1	1	4	3
DOOP-1599	343	477	134	0	3	4	0	1
DOOP-1599	343	376	33	1	3	4	2	3
DOOP-1599	343	345	2	1	3	1	1	0
DOOP-1599	343	368	25	1	3	2	3	4
DOOP-1599	344	368	24	1	1	1	3	1
DOOP-1599	344	477	133	0	1	4	1	0
DOOP-1599	345	451	106	1	3	5	1	4
DOOP-1600	345	348	3	1	3	4	1	3
DOOP-1600	343	477	134	0	3	1	0	0
DOOP-1600	346	363	17	1	3	3	0	1
DOOP-1600	346	350	4	1	3	5	2	0
DOOP-1600	347	477	130	0	3	5	0	0
DOOP-1600	347	477	130	0	3	1	0	0
DOOP-1600	347	353	6	1	1	1	0	2
DOOP-1600	348	351	3	1	4	1	2	2
DOOP-1600	348	363	15	1	3	5	4	0
DOOP-1601	348	363	15	1	3	5	0	0
DOOP-1601	348	457	109	1	3	1	1	0
DOOP-1601	349	350	1	1	3	1	0	1
DOOP-1601	351	375	24	1	3	1	2	0
DOOP-1601	352	354	2	1	3	4	1	0
DOOP-1601	352	353	1	1	3	5	1	0
DOOP-1601	352	375	23	1	3	1	4	2
DOOP-1601	353	477	124	0	4	5	0	0
DOOP-1601	353	422	69	1	3	1	4	2
DOOP-1601	354	379	25	1	4	4	2	0
DOOP-1602	360	361	1	1	4	2	0	0
DOOP-1602	360	366	6	1	4	1	0	1
DOOP-1602	360	477	117	0	4	4	0	0
DOOP-1602	363	477	114	0	3	4	0	2
DOOP-1602	362	368	6	1	3	1	1	0
DOOP-1611	46	413	367	1	5	1	1	0
MA-100	47	61	14	1	4	4	0	0
MA-100	68	477	409	0	4	4	0	0
WQ-157	1	175	174	1	3	5	1	1
WQ-157	1	175	174	1	3	5	1	1
WQ-157	2	98	96	1	3	1	1	0
WQ-157	14	15	1	1	3	1	1	0
WQ-158	17	30	13	1	3	4	1	0
WQ-158	23	37	14	1	3	1	1	0
WQ-158	23	29	6	1	3	1	1	0
WQ-158	23	200	177	1	3	5	1	0
WQ-158	30	37	7	1	3	4	1	0
WQ-158	37	38	1	1	4	1	1	0
WQ-158	38	57	19	1	3	3	1	0
WQ-158	40	41	1	1	3	1	1	0
WQ-158	50	477	427	0	3	4	0	0
WQ-158	50	51	1	1	4	1	1	0
WQ-159	51	52	1	1	4	1	1	0
WQ-159	56	200	144	1	3	5	1	0
WQ-159	71	205	134	1	3	5	1	0
WQ-159	71	205	134	1	3	5	1	0
WQ-159	72	100	28	1	3	1	2	0
WQ-159	72	77	5	1	3	3	1	0
WQ-159	72	77	5	1	3	3	1	0
WQ-159	72	200	128	1	3	2	1	0
WQ-159	74	204	130	1	3	5	1	0
WQ-159	83	151	68	1	3	2	1	0
WQ-160	85	204	119	1	3	5	1	0
WQ-160	85	204	119	1	3	5	1	0
WQ-160	85	204	119	1	3	5	1	0
WQ-160	93	200	107	1	3	5	1	0
WQ-160	97	101	4	1	3	5	1	0
WQ-160	97	249	152	1	3	4	1	0
WQ-160	101	123	22	1	3	5	1	0
WQ-160	101	128	27	1	3	5	1	0
WQ-160	105	134	29	1	3	5	1	0
WQ-160	106	204	98	1	3	5	1	0
WQ-161	112	477	365	0	3	5	0	0
WQ-161	115	477	362	0	3	5	0	0
WQ-161	127	477	350	0	3	5	0	0
WQ-161	128	204	76	1	3	5	1	0
WQ-161	135	477	342	0	3	1	0	0
WQ-161	140	143	3	1	3	1	1	0
WQ-161	143	147	4	1	3	1	1	0
WQ-161	144	477	333	0	3	1	0	0
WQ-161	149	200	51	1	3	1	1	0
WQ-161	149	204	55	1	3	5	1	0
WQ-162	149	150	1	1	3	1	1	0
WQ-162	150	151	1	1	3	4	1	0
WQ-162	151	206	55	1	3	4	1	1
WQ-162	151	477	326	0	3	2	0	0
WQ-162	165	477	312	0	4	4	0	1
WQ-162	165	477	312	0	4	4	0	0
WQ-162	165	477	312	0	4	4	0	1
WQ-162	170	190	20	1	3	4	1	0
WQ-162	175	477	302	0	3	5	1	0
WQ-162	175	477	302	0	3	5	1	2
WQ-163	175	477	302	0	3	5	1	0
WQ-163	175	477	302	0	3	5	1	0
WQ-163	175	477	302	0	3	5	1	0
WQ-163	179	200	21	1	3	4	1	0
WQ-163	182	477	295	0	3	1	0	0
WQ-163	182	186	4	1	3	4	1	1
WQ-163	185	186	1	1	3	1	1	0
WQ-163	185	186	1	1	3	1	1	0
WQ-163	186	193	7	1	3	1	1	0
WQ-163	189	477	288	0	3	1	1	0
WQ-164	189	477	288	0	3	1	1	0
WQ-164	203	477	274	0	3	3	0	0
WQ-164	203	477	274	0	3	5	1	0
WQ-164	204	477	273	0	3	3	0	0
WQ-164	211	477	266	0	3	4	0	0
WQ-164	214	477	263	0	3	4	1	0
WQ-164	218	477	259	0	3	1	0	0
WQ-164	219	477	258	0	3	3	0	0
WQ-164	224	227	3	1	3	4	1	0
WQ-165	224	227	3	1	3	1	1	0
WQ-165	227	235	8	1	3	1	1	0
WQ-165	229	231	2	1	3	4	1	0
WQ-165	230	477	247	0	3	1	0	0
WQ-165	230	231	1	1	3	1	1	0
WQ-165	231	477	246	0	4	1	0	0
WQ-165	237	477	240	0	3	1	0	0
WQ-165	247	248	1	1	1	1	1	0
WQ-165	247	477	230	0	4	4	0	0
WQ-165	255	477	222	0	3	3	0	0
WQ-166	262	477	215	0	4	4	1	0
WQ-166	265	267	2	1	3	1	1	0
WQ-166	291	477	186	0	3	5	0	0
WQ-166	291	477	186	0	3	5	0	0
WQ-166	291	477	186	0	3	5	0	0
WQ-166	291	477	186	0	3	5	0	0
WQ-166	291	477	186	0	3	5	0	0
WQ-166	291	477	186	0	3	5	0	0
WQ-166	291	477	186	0	3	5	0	0
WQ-166	291	477	186	0	3	5	0	0
WQ-167	291	477	186	0	3	5	0	0
WQ-167	307	315	8	1	3	5	1	0
WQ-167	311	477	166	0	3	4	1	0
WQ-167	311	477	166	0	3	5	1	0
WQ-167	345	477	132	0	3	1	0	0
WQ-167	361	362	1	1	3	3	1	0
ASE-1968	0	477	477	0	3	1	0	0
ASE-1968	0	304	304	1	4	4	2	1
ASE-1968	0	1	1	1	5	4	2	0
ASE-1968	1	7	6	1	5	4	4	0
ASE-1968	1	10	9	1	3	1	4	0
ASE-1968	1	2	1	1	3	5	2	0
ASE-1968	1	2	1	1	3	5	2	0
ASE-1968	1	3	2	1	4	1	2	1
ASE-1968	1	2	1	1	3	1	0	1
ASE-1969	1	2	1	1	3	1	0	0
ASE-1969	1	3	2	1	2	1	3	0
ASE-1969	2	477	475	0	3	2	0	0
ASE-1969	2	477	475	0	3	2	0	0
ASE-1969	2	11	9	1	2	1	2	3
ASE-1969	2	382	380	1	3	5	4	0
ASE-1969	2	6	4	1	2	1	2	0
ASE-1969	2	3	1	1	3	5	2	0
ASE-1969	2	477	475	0	3	5	0	0
ASE-1969	2	477	475	0	3	4	1	0
ASE-1970	2	477	475	0	3	1	0	0
ASE-1970	3	477	474	0	2	1	1	0
ASE-1970	3	8	5	1	4	4	2	0
ASE-1970	3	35	32	1	3	1	2	1
ASE-1970	3	477	474	0	3	1	0	0
ASE-1970	3	477	474	0	3	1	0	1
ASE-1970	3	5	2	1	2	1	2	1
ASE-1970	3	4	1	1	3	5	2	0
ASE-1970	3	4	1	1	4	1	3	0
ASE-1970	3	4	1	1	2	1	2	1
ASE-1971	4	45	41	1	2	1	0	0
ASE-1971	4	5	1	1	3	5	2	0
ASE-1971	4	7	3	1	3	1	2	0
ASE-1971	4	74	70	1	2	1	1	1
ASE-1971	4	5	1	1	2	1	2	0
ASE-1971	4	421	417	1	3	1	0	0
ASE-1971	4	16	12	1	3	1	2	0
ASE-1971	5	8	3	1	3	1	2	0
ASE-1971	5	144	139	1	5	1	1	0
ASE-1971	5	6	1	1	3	5	2	0
ASE-1972	5	32	27	1	3	3	1	0
ASE-1972	5	6	1	1	3	1	2	0
ASE-1972	5	379	374	1	2	5	4	4
ASE-1972	5	6	1	1	5	4	1	0
ASE-1972	6	151	145	1	4	5	3	0
ASE-1972	6	28	22	1	1	5	2	0
ASE-1972	6	34	28	1	3	1	2	0
ASE-1972	6	7	1	1	3	1	0	0
ASE-1972	7	54	47	1	3	1	4	0
ASE-1972	7	9	2	1	3	1	2	0
ASE-1973	7	8	1	1	3	1	1	0
ASE-1973	7	8	1	1	2	5	2	1
ASE-1973	7	14	7	1	2	1	2	0
ASE-1973	7	9	2	1	3	1	0	0
ASE-1973	7	9	2	1	2	1	2	1
ASE-1973	8	168	160	1	3	2	2	1
ASE-1973	8	16	8	1	4	4	2	0
ASE-1973	8	67	59	1	3	3	1	1
ASE-1973	8	477	469	0	4	4	1	1
ASE-1973	8	15	7	1	4	4	2	0
ASE-1974	8	10	2	1	4	1	2	0
ASE-1974	8	477	469	0	4	1	0	1
ASE-1974	8	477	469	0	3	1	0	0
ASE-1974	8	9	1	1	3	5	2	0
ASE-1974	9	10	1	1	3	1	2	0
ASE-1974	9	477	468	0	3	1	0	0
ASE-1974	9	10	1	1	2	5	1	0
ASE-1974	9	18	9	1	3	5	1	1
ASE-1974	9	10	1	1	3	1	2	0
ASE-1974	9	10	1	1	3	1	2	0
ASE-1975	9	477	468	0	4	4	0	0
ASE-1975	9	10	1	1	3	4	2	1
ASE-1975	9	11	2	1	3	1	3	0
ASE-1975	9	477	468	0	3	1	0	0
ASE-1975	9	21	12	1	4	1	0	1
ASE-1975	9	10	1	1	4	1	2	0
ASE-1975	9	24	15	1	3	1	3	1
ASE-1975	9	18	9	1	2	1	3	2
ASE-1975	10	11	1	1	3	4	2	0
ASE-1975	10	477	467	0	4	5	0	0
ASE-1976	10	477	467	0	4	5	0	0
ASE-1976	10	152	142	1	4	5	2	0
ASE-1976	10	465	455	1	4	5	1	0
ASE-1976	10	477	467	0	4	5	0	0
ASE-1976	10	174	164	1	4	5	3	0
ASE-1976	10	27	17	1	4	5	1	0
ASE-1976	10	477	467	0	2	1	0	0
ASE-1976	10	52	42	1	3	1	2	0
ASE-1976	10	13	3	1	2	1	2	0
ASE-1976	10	11	1	1	2	1	3	0
ASE-1977	10	23	13	1	2	4	3	3
ASE-1977	10	11	1	1	4	1	2	0
ASE-1977	10	13	3	1	3	5	2	0
ASE-1977	10	11	1	1	4	1	2	0
ASE-1977	10	21	11	1	3	1	2	0
ASE-1977	10	11	1	1	3	1	2	1
ASE-1977	10	11	1	1	3	1	0	1
ASE-1977	10	477	467	0	3	1	0	0
ASE-1977	11	477	466	0	4	5	0	0
ASE-1977	11	16	5	1	4	5	2	0
ASE-1978	11	22	11	1	3	1	2	1
ASE-1978	11	23	12	1	3	5	1	0
ASE-1978	11	112	101	1	3	5	1	0
ASE-1978	11	12	1	1	4	1	2	0
ASE-1978	11	16	5	1	4	1	2	0
ASE-1978	11	477	466	0	3	5	0	3
ASE-1978	11	71	60	1	3	5	1	0
ASE-1978	11	12	1	1	2	5	2	3
ASE-1978	11	477	466	0	3	1	0	1
ASE-1978	11	15	4	1	3	4	4	0
ASE-1979	12	13	1	1	1	1	1	0
ASE-1979	12	37	25	1	2	5	2	1
ASE-1979	12	16	4	1	3	1	2	1
ASE-1979	12	14	2	1	3	5	2	0
ASE-1979	12	20	8	1	2	1	2	3
ASE-1979	13	14	1	1	3	5	2	0
ASE-1979	13	16	3	1	3	1	2	0
ASE-1979	14	15	1	1	3	1	2	1
ASE-1979	14	477	463	0	4	1	0	0
ASE-1979	14	18	4	1	3	2	2	1
ASE-1980	15	128	113	1	3	1	0	1
ASE-1980	15	16	1	1	3	1	0	1
ASE-1980	15	71	56	1	4	1	4	1
ASE-1980	15	35	20	1	3	5	2	4
ASE-1980	15	477	462	0	3	4	0	0
ASE-1980	15	343	328	1	2	1	0	0
ASE-1980	15	17	2	1	5	1	2	0
ASE-1980	16	477	461	0	3	1	1	0
ASE-1980	16	17	1	1	3	1	2	1
ASE-1980	16	17	1	1	3	5	2	0
ASE-1981	16	17	1	1	3	5	2	0
ASE-1981	16	28	12	1	3	5	2	1
ASE-1981	16	17	1	1	3	1	2	0
ASE-1981	16	57	41	1	3	1	0	0
ASE-1981	16	65	49	1	1	1	1	0
ASE-1981	16	17	1	1	3	1	2	0
ASE-1981	16	17	1	1	3	1	4	0
ASE-1981	16	17	1	1	3	4	0	0
ASE-1981	17	25	8	1	3	1	2	0
ASE-1981	17	477	460	0	3	4	0	0
ASE-1982	17	18	1	1	3	4	2	0
ASE-1982	17	18	1	1	4	1	2	0
ASE-1982	17	18	1	1	3	1	2	0
ASE-1982	17	18	1	1	4	4	2	0
ASE-1982	17	36	19	1	3	1	0	2
ASE-1982	17	18	1	1	3	1	2	0
ASE-1982	18	463	445	1	3	4	1	2
ASE-1982	18	19	1	1	3	5	2	0
ASE-1982	18	19	1	1	3	1	1	2
ASE-1982	18	19	1	1	4	1	2	0
ASE-1983	18	477	459	0	3	1	0	1
ASE-1983	18	477	459	0	3	5	1	4
ASE-1983	19	21	2	1	4	5	2	0
ASE-1983	19	477	458	0	3	5	0	0
ASE-1983	19	21	2	1	3	5	2	2
ASE-1983	20	477	457	0	4	1	0	0
ASE-1983	21	22	1	1	3	1	2	1
ASE-1983	21	35	14	1	3	5	2	1
ASE-1983	21	23	2	1	2	1	2	1
ASE-1983	21	31	10	1	3	5	2	1
ASE-1984	21	37	16	1	3	5	2	2
ASE-1984	21	36	15	1	3	5	2	1
ASE-1984	22	477	455	0	3	2	0	1
ASE-1984	22	99	77	1	3	5	1	1
ASE-1984	22	43	21	1	4	2	2	1
ASE-1984	22	23	1	1	3	5	2	0
ASE-1984	22	24	2	1	3	5	2	0
ASE-1984	22	23	1	1	3	5	2	0
ASE-1984	22	32	10	1	3	1	0	0
ASE-1984	22	477	455	0	3	1	0	0
ASE-1985	22	107	85	1	3	1	1	0
ASE-1985	22	477	455	0	2	4	0	1
ASE-1985	22	161	139	1	3	4	2	0
ASE-1985	22	23	1	1	4	1	2	0
ASE-1985	23	42	19	1	4	1	0	0
ASE-1985	23	477	454	0	3	5	0	0
ASE-1985	23	477	454	0	3	1	0	1
ASE-1985	23	25	2	1	3	5	1	0
ASE-1985	23	143	120	1	3	3	1	4
ASE-1985	24	54	30	1	3	3	0	1
ASE-1986	24	25	1	1	4	4	0	0
ASE-1986	24	25	1	1	3	4	2	0
ASE-1986	24	25	1	1	3	5	2	1
ASE-1986	24	58	34	1	3	1	3	1
ASE-1986	25	26	1	1	3	5	1	0
ASE-1986	25	128	103	1	3	5	1	0
ASE-1986	25	28	3	1	3	5	2	1
ASE-1986	25	26	1	1	3	5	2	1
ASE-1986	25	35	10	1	3	5	2	1
ASE-1986	25	27	2	1	5	5	1	0
ASE-1987	25	28	3	1	3	5	2	0
ASE-1987	25	28	3	1	3	1	4	0
ASE-1987	26	29	3	1	3	1	0	0
ASE-1987	26	28	2	1	3	5	2	1
ASE-1987	27	29	2	1	3	1	0	0
ASE-1987	27	477	450	0	3	1	0	0
ASE-1987	27	43	16	1	2	1	4	1
ASE-1987	27	28	1	1	2	5	4	0
ASE-1987	28	50	22	1	3	5	0	4
ASE-1987	28	29	1	1	3	5	2	1
ASE-1988	28	29	1	1	3	5	2	1
ASE-1988	28	29	1	1	3	5	2	1
ASE-1988	28	29	1	1	3	5	2	1
ASE-1988	28	477	449	0	2	1	0	0
ASE-1988	28	31	3	1	3	1	2	1
ASE-1988	28	29	1	1	3	5	2	1
ASE-1988	28	36	8	1	3	2	3	0
ASE-1988	28	30	2	1	3	5	2	0
ASE-1988	28	29	1	1	3	5	0	0
ASE-1988	28	409	381	1	3	5	4	0
ASE-1989	29	93	64	1	2	1	1	0
ASE-1989	29	30	1	1	3	5	2	0
ASE-1989	29	30	1	1	3	1	3	0
ASE-1989	29	201	172	1	2	1	1	0
ASE-1989	29	463	434	1	3	5	0	0
ASE-1989	29	32	3	1	3	5	2	0
ASE-1989	29	32	3	1	3	5	2	0
ASE-1989	29	31	2	1	4	2	2	0
ASE-1989	29	477	448	0	5	1	0	0
ASE-1989	29	30	1	1	3	4	2	0
ASE-1990	29	37	8	1	2	1	4	1
ASE-1990	30	32	2	1	3	1	4	0
ASE-1990	30	50	20	1	3	1	0	0
ASE-1990	30	45	15	1	3	5	2	1
ASE-1990	30	33	3	1	3	4	2	1
ASE-1990	30	34	4	1	3	1	4	0
ASE-1990	30	31	1	1	3	1	2	1
ASE-1990	30	35	5	1	3	1	2	1
ASE-1990	31	35	4	1	3	5	2	1
ASE-1990	31	35	4	1	3	5	2	1
ASE-1991	31	35	4	1	3	5	2	1
ASE-1991	31	32	1	1	3	5	2	1
ASE-1991	31	32	1	1	4	4	2	0
ASE-1991	31	32	1	1	3	5	2	0
ASE-1991	31	35	4	1	3	5	2	0
ASE-1991	31	35	4	1	3	4	2	2
ASE-1991	32	35	3	1	3	5	2	1
ASE-1991	32	35	3	1	4	4	3	0
ASE-1991	32	33	1	1	3	5	2	1
ASE-1991	32	33	1	1	3	1	2	0
ASE-1992	32	51	19	1	3	1	2	0
ASE-1992	32	33	1	1	3	5	1	1
ASE-1992	32	35	3	1	3	3	2	0
ASE-1992	33	67	34	1	3	1	2	0
ASE-1992	33	115	82	1	3	1	4	1
ASE-1992	33	477	444	0	2	1	0	1
ASE-1992	33	35	2	1	3	1	2	1
ASE-1992	33	37	4	1	3	5	2	1
ASE-1992	33	34	1	1	3	5	2	0
ASE-1992	34	38	4	1	3	1	2	1
ASE-1993	34	477	443	0	3	1	0	0
ASE-1993	34	35	1	1	3	5	2	0
ASE-1993	34	35	1	1	3	5	1	0
ASE-1993	35	477	442	0	4	4	0	0
ASE-1993	35	36	1	1	3	1	3	1
ASE-1993	35	38	3	1	3	5	1	0
ASE-1993	35	36	1	1	3	5	2	0
ASE-1993	35	39	4	1	3	1	3	0
ASE-1993	35	42	7	1	3	5	1	0
ASE-1993	35	36	1	1	3	1	2	0
ASE-1994	35	42	7	1	3	5	2	0
ASE-1994	36	37	1	1	3	1	2	0
ASE-1994	36	40	4	1	3	5	2	0
ASE-1994	36	60	24	1	3	5	1	0
ASE-1994	36	37	1	1	3	5	2	0
ASE-1994	36	43	7	1	3	5	0	0
ASE-1994	36	37	1	1	3	3	2	0
ASE-1994	36	37	1	1	2	3	2	1
ASE-1994	36	43	7	1	3	5	2	0
ASE-1994	36	37	1	1	3	5	3	0
ASE-1995	37	49	12	1	4	2	1	2
ASE-1995	37	38	1	1	3	5	2	0
ASE-1995	37	477	440	0	3	1	1	0
ASE-1995	37	51	14	1	2	1	2	2
ASE-1995	37	50	13	1	3	1	2	3
ASE-1995	37	40	3	1	3	5	0	0
ASE-1995	38	39	1	1	3	5	2	0
ASE-1995	38	39	1	1	3	5	1	0
ASE-1995	38	39	1	1	3	5	1	0
ASE-1995	38	477	439	0	4	5	0	0
ASE-1996	38	43	5	1	3	5	2	0
ASE-1996	38	39	1	1	3	5	0	0
ASE-1996	38	39	1	1	3	1	0	0
ASE-1996	38	105	67	1	3	3	1	2
ASE-1996	39	40	1	1	3	1	2	0
ASE-1996	39	44	5	1	2	5	2	0
ASE-1996	39	40	1	1	3	1	2	0
ASE-1996	39	477	438	0	3	4	0	1
ASE-1996	39	42	3	1	3	1	2	0
ASE-1996	39	68	29	1	3	5	1	0
ASE-1997	40	477	437	0	4	3	0	2
ASE-1997	41	148	107	1	3	1	0	0
ASE-1997	41	42	1	1	2	1	3	1
ASE-1997	41	66	25	1	3	5	1	0
ASE-1997	42	56	14	1	3	1	2	0
ASE-1997	42	477	435	0	3	4	0	0
ASE-1997	42	50	8	1	2	5	2	2
ASE-1997	42	43	1	1	3	1	2	0
ASE-1997	42	50	8	1	3	5	2	0
ASE-1997	42	43	1	1	3	1	4	0
ASE-1998	42	46	4	1	3	1	2	0
ASE-1998	42	43	1	1	3	1	3	0
ASE-1998	42	477	435	0	3	4	0	0
ASE-1998	42	81	39	1	3	5	1	0
ASE-1998	42	477	435	0	3	5	0	0
ASE-1998	42	61	19	1	5	1	1	0
ASE-1998	42	43	1	1	3	1	2	0
ASE-1998	42	66	24	1	3	1	1	0
ASE-1998	43	46	3	1	4	4	2	1
ASE-1998	43	58	15	1	3	1	2	0
ASE-1999	43	45	2	1	3	5	1	0
ASE-1999	43	51	8	1	3	1	2	0
ASE-1999	43	477	434	0	3	1	0	0
ASE-1999	43	477	434	0	3	1	0	0
ASE-1999	43	106	63	1	3	4	1	0
ASE-1999	43	450	407	1	3	1	0	0
ASE-1999	44	45	1	1	3	1	4	1
ASE-1999	44	179	135	1	1	5	1	4
ASE-1999	44	46	2	1	3	1	2	1
ASE-1999	44	71	27	1	3	5	1	0
ASE-2000	44	45	1	1	3	5	2	0
ASE-2000	45	57	12	1	3	1	3	0
ASE-2000	45	46	1	1	3	5	2	0
ASE-2000	45	477	432	0	3	2	0	0
ASE-2000	45	129	84	1	4	1	4	0
ASE-2000	45	60	15	1	3	1	0	0
ASE-2000	46	109	63	1	2	1	3	0
ASE-2000	46	477	431	0	4	1	0	1
ASE-2000	46	51	5	1	3	5	1	0
ASE-2000	46	58	12	1	4	5	0	0
ASE-2001	46	477	431	0	3	1	0	0
ASE-2001	46	47	1	1	3	5	2	0
ASE-2001	47	477	430	0	3	2	0	0
ASE-2001	47	50	3	1	3	5	2	0
ASE-2001	47	50	3	1	3	5	2	0
ASE-2001	47	50	3	1	3	5	2	0
ASE-2001	48	52	4	1	4	1	3	1
ASE-2001	48	51	3	1	1	1	2	1
ASE-2001	48	477	429	0	3	2	0	0
ASE-2001	49	56	7	1	4	5	1	0
ASE-2002	50	51	1	1	2	1	2	1
ASE-2002	50	51	1	1	3	5	2	1
ASE-2002	50	477	427	0	3	1	0	0
ASE-2002	50	51	1	1	5	1	2	0
ASE-2002	50	70	20	1	3	1	1	1
ASE-2002	50	51	1	1	3	1	0	1
ASE-2002	50	477	427	0	2	3	1	0
ASE-2002	50	51	1	1	3	1	2	2
ASE-2002	50	51	1	1	3	1	0	0
ASE-2002	50	51	1	1	3	5	2	1
ASE-2003	50	477	427	0	3	1	0	1
ASE-2003	50	51	1	1	3	5	2	1
ASE-2003	50	51	1	1	4	1	2	1
ASE-2003	51	477	426	0	3	5	0	0
ASE-2003	51	477	426	0	3	4	0	0
ASE-2003	51	52	1	1	3	5	2	0
ASE-2003	51	56	5	1	3	5	1	0
ASE-2003	51	52	1	1	1	1	2	1
ASE-2003	51	52	1	1	3	5	2	0
ASE-2003	51	52	1	1	3	5	2	0
ASE-2004	51	179	128	1	4	4	2	0
ASE-2004	51	52	1	1	3	5	2	0
ASE-2004	51	52	1	1	3	5	0	0
ASE-2004	51	55	4	1	3	1	2	0
ASE-2004	51	52	1	1	3	5	1	0
ASE-2004	52	477	425	0	3	2	0	0
ASE-2004	52	98	46	1	3	2	2	3
ASE-2004	52	80	28	1	4	4	4	0
ASE-2004	52	53	1	1	1	5	3	0
ASE-2004	52	53	1	1	3	1	2	0
ASE-2005	52	60	8	1	3	5	2	0
ASE-2005	52	53	1	1	5	1	2	0
ASE-2005	52	58	6	1	3	5	3	0
ASE-2005	52	406	354	1	4	5	0	0
ASE-2005	52	54	2	1	3	1	1	0
ASE-2005	53	59	6	1	4	4	2	0
ASE-2005	53	58	5	1	4	1	1	1
ASE-2005	53	477	424	0	5	4	0	0
ASE-2005	53	70	17	1	4	1	2	0
ASE-2005	53	108	55	1	2	5	1	2
ASE-2006	53	477	424	0	2	5	1	1
ASE-2006	53	54	1	1	3	1	4	0
ASE-2006	53	54	1	1	1	1	4	0
ASE-2006	53	77	24	1	3	3	0	1
ASE-2006	53	477	424	0	3	4	1	0
ASE-2006	54	55	1	1	3	4	2	0
ASE-2006	54	57	3	1	2	1	2	0
ASE-2006	54	60	6	1	2	5	1	0
ASE-2006	54	100	46	1	3	1	4	0
ASE-2006	54	58	4	1	2	5	2	1
ASE-2007	54	62	8	1	1	1	2	2
ASE-2007	54	55	1	1	3	3	0	0
ASE-2007	54	64	10	1	3	3	1	0
ASE-2007	54	55	1	1	3	3	1	0
ASE-2007	54	56	2	1	3	1	2	1
ASE-2007	54	66	12	1	4	3	4	2
ASE-2007	54	98	44	1	2	1	0	1
ASE-2007	55	99	44	1	4	2	0	1
ASE-2007	55	72	17	1	3	1	1	0
ASE-2007	55	145	90	1	5	5	0	0
ASE-2008	55	477	422	0	3	4	0	0
ASE-2008	55	145	90	1	3	5	0	0
ASE-2008	56	57	1	1	3	5	2	1
ASE-2008	56	57	1	1	3	5	2	0
ASE-2008	56	58	2	1	4	3	1	0
ASE-2008	56	477	421	0	4	4	0	0
ASE-2008	56	57	1	1	3	1	2	0
ASE-2008	56	58	2	1	3	4	1	1
ASE-2008	56	57	1	1	4	3	3	0
ASE-2008	56	57	1	1	4	3	3	0
ASE-2009	56	79	23	1	3	1	1	0
ASE-2009	56	57	1	1	5	1	1	0
ASE-2009	57	58	1	1	4	3	1	1
ASE-2009	57	59	2	1	3	3	1	0
ASE-2009	57	79	22	1	3	5	0	0
ASE-2009	57	178	121	1	2	4	2	1
ASE-2009	57	58	1	1	4	1	0	0
ASE-2009	57	58	1	1	4	3	1	0
ASE-2009	57	58	1	1	4	3	1	0
ASE-2009	57	477	420	0	3	4	1	1
ASE-2010	57	59	2	1	3	5	2	1
ASE-2010	57	477	420	0	3	2	0	0
ASE-2010	57	58	1	1	4	1	1	1
ASE-2010	58	477	419	0	2	1	1	1
ASE-2010	58	71	13	1	3	1	2	0
ASE-2010	58	477	419	0	3	2	1	0
ASE-2010	58	59	1	1	3	1	4	0
ASE-2010	58	59	1	1	4	5	2	0
ASE-2010	58	65	7	1	2	1	1	0
ASE-2010	58	60	2	1	4	4	1	1
ASE-2011	59	60	1	1	3	1	2	0
ASE-2011	59	85	26	1	2	1	1	1
ASE-2011	59	102	43	1	2	3	4	1
ASE-2011	59	60	1	1	3	5	2	0
ASE-2011	60	66	6	1	3	1	1	0
ASE-2011	60	63	3	1	3	5	2	0
ASE-2011	60	80	20	1	3	5	2	0
ASE-2011	60	72	12	1	3	5	2	0
ASE-2011	60	477	417	0	2	5	1	3
ASE-2011	60	77	17	1	4	3	1	1
ASE-2012	60	68	8	1	4	4	2	0
ASE-2012	61	64	3	1	4	1	1	0
ASE-2012	61	62	1	1	3	3	0	0
ASE-2012	61	87	26	1	3	1	0	1
ASE-2012	62	70	8	1	3	1	1	0
ASE-2012	62	65	3	1	3	5	2	1
ASE-2012	62	64	2	1	3	5	1	1
ASE-2012	62	84	22	1	3	5	2	0
ASE-2012	62	106	44	1	3	5	2	0
ASE-2012	62	64	2	1	3	5	2	0
ASE-2013	62	86	24	1	2	1	1	3
ASE-2013	62	71	9	1	2	5	1	0
ASE-2013	62	87	25	1	4	3	1	1
ASE-2013	63	68	5	1	4	4	1	0
ASE-2013	63	65	2	1	4	1	4	0
ASE-2013	63	81	18	1	4	4	1	0
ASE-2013	63	356	293	1	4	5	4	2
ASE-2013	64	80	16	1	3	1	0	1
ASE-2013	64	84	20	1	3	5	2	0
ASE-2013	64	65	1	1	4	1	2	0
ASE-2014	64	477	413	0	4	4	0	0
ASE-2014	64	74	10	1	3	1	3	0
ASE-2014	64	119	55	1	3	5	1	0
ASE-2014	64	71	7	1	3	5	0	0
ASE-2014	65	66	1	1	3	1	1	1
ASE-2014	65	477	412	0	3	1	0	0
ASE-2014	65	73	8	1	2	1	4	2
ASE-2014	65	81	16	1	3	5	2	0
ASE-2014	65	68	3	1	3	5	2	0
ASE-2014	65	99	34	1	2	5	1	1
ASE-2015	65	66	1	1	3	5	0	0
ASE-2015	65	477	412	0	3	1	3	1
ASE-2015	65	298	233	1	3	5	4	1
ASE-2015	66	71	5	1	3	1	2	0
ASE-2015	66	477	411	0	3	3	0	1
ASE-2015	66	79	13	1	3	5	1	0
ASE-2015	66	477	411	0	3	2	0	0
ASE-2015	66	67	1	1	3	1	1	1
ASE-2015	66	477	411	0	3	2	0	0
ASE-2015	66	93	27	1	3	2	2	2
ASE-2016	66	67	1	1	3	1	1	0
ASE-2016	66	67	1	1	3	3	1	0
ASE-2016	67	68	1	1	2	1	4	0
ASE-2016	67	102	35	1	3	5	1	0
ASE-2016	67	68	1	1	3	1	4	0
ASE-2016	67	71	4	1	3	5	1	0
ASE-2016	67	477	410	0	3	5	0	0
ASE-2016	67	70	3	1	3	5	2	0
ASE-2016	67	477	410	0	3	5	0	0
ASE-2016	68	121	53	1	2	1	2	1
ASE-2017	68	477	409	0	3	5	0	0
ASE-2017	68	70	2	1	4	3	1	0
ASE-2017	69	477	408	0	3	1	1	1
ASE-2017	69	71	2	1	2	5	1	1
ASE-2017	70	71	1	1	3	1	2	0
ASE-2017	70	242	172	1	3	1	1	1
ASE-2017	70	71	1	1	4	5	1	0
ASE-2017	70	71	1	1	4	1	1	0
ASE-2017	70	72	2	1	3	5	1	1
ASE-2017	70	477	407	0	2	5	1	0
ASE-2018	71	73	2	1	3	5	1	0
ASE-2018	71	72	1	1	5	4	1	0
ASE-2018	71	100	29	1	1	1	1	0
ASE-2018	71	477	406	0	3	5	0	0
ASE-2018	71	477	406	0	3	5	0	0
ASE-2018	71	73	2	1	3	1	1	2
ASE-2018	71	72	1	1	4	4	3	0
ASE-2018	71	72	1	1	1	1	1	0
ASE-2018	71	477	406	0	1	5	2	4
ASE-2018	71	72	1	1	5	1	4	0
ASE-2019	72	73	1	1	2	5	1	0
ASE-2019	72	85	13	1	3	5	2	0
ASE-2019	72	81	9	1	3	1	0	0
ASE-2019	72	183	111	1	2	5	2	2
ASE-2019	72	176	104	1	2	5	2	1
ASE-2019	72	73	1	1	3	3	0	0
ASE-2019	72	77	5	1	3	4	1	0
ASE-2019	72	88	16	1	4	4	2	1
ASE-2019	72	477	405	0	3	1	0	0
ASE-2019	72	86	14	1	2	3	1	1
ASE-2020	72	73	1	1	3	1	1	0
ASE-2020	72	77	5	1	1	1	1	3
ASE-2020	72	79	7	1	2	5	1	1
ASE-2020	72	95	23	1	2	1	1	0
ASE-2020	72	128	56	1	3	1	3	0
ASE-2020	73	477	404	0	3	5	0	0
ASE-2020	73	77	4	1	3	5	2	0
ASE-2020	73	143	70	1	4	4	1	0
ASE-2020	73	477	404	0	4	4	0	0
ASE-2020	73	380	307	1	5	4	3	0
ASE-2021	73	74	1	1	3	1	1	0
ASE-2021	73	477	404	0	4	1	0	1
ASE-2021	74	80	6	1	2	3	1	1
ASE-2021	74	75	1	1	3	1	1	0
ASE-2021	74	477	403	0	4	4	0	0
ASE-2021	74	389	315	1	5	4	2	1
ASE-2021	74	77	3	1	3	4	1	1
ASE-2021	75	76	1	1	2	5	0	0
ASE-2021	76	477	401	0	4	4	0	0
ASE-2021	77	100	23	1	2	1	1	1
ASE-2022	77	378	301	1	3	1	4	0
ASE-2022	77	78	1	1	1	3	1	1
ASE-2022	77	78	1	1	1	3	1	0
ASE-2022	77	85	8	1	1	3	1	1
ASE-2022	77	128	51	1	1	1	1	4
ASE-2022	78	477	399	0	2	1	0	0
ASE-2022	78	477	399	0	4	4	0	1
ASE-2022	78	82	4	1	3	5	2	0
ASE-2022	78	100	22	1	1	5	1	0
ASE-2022	78	87	9	1	3	1	1	0
ASE-2023	78	203	125	1	4	1	2	0
ASE-2023	78	93	15	1	3	1	4	0
ASE-2023	78	79	1	1	3	5	1	0
ASE-2023	78	103	25	1	5	1	1	0
ASE-2023	78	477	399	0	3	5	0	0
ASE-2023	79	477	398	0	3	1	0	0
ASE-2023	79	477	398	0	3	5	0	0
ASE-2023	79	80	1	1	2	1	1	0
ASE-2023	79	477	398	0	3	1	0	0
ASE-2023	79	103	24	1	3	5	0	1
ASE-2024	79	80	1	1	3	5	2	1
ASE-2024	79	80	1	1	2	5	1	0
ASE-2024	79	80	1	1	3	5	2	0
ASE-2024	79	101	22	1	4	4	1	0
ASE-2024	79	183	104	1	1	5	3	3
ASE-2024	79	81	2	1	3	5	1	1
ASE-2024	79	80	1	1	1	3	1	1
ASE-2024	79	80	1	1	3	5	1	0
ASE-2024	79	100	21	1	1	5	1	0
ASE-2024	80	477	397	0	2	1	2	1
ASE-2025	80	477	397	0	4	1	0	0
ASE-2025	80	477	397	0	3	1	0	0
ASE-2025	80	477	397	0	3	1	2	0
ASE-2025	80	100	20	1	4	5	2	0
ASE-2025	80	84	4	1	4	5	1	0
ASE-2025	80	477	397	0	1	5	1	0
ASE-2025	80	93	13	1	3	5	1	0
ASE-2025	80	224	144	1	4	3	1	1
ASE-2025	80	95	15	1	3	5	1	0
ASE-2025	80	92	12	1	2	1	1	1
ASE-2026	80	86	6	1	2	1	2	1
ASE-2026	81	87	6	1	4	1	3	1
ASE-2026	81	477	396	0	3	4	0	0
ASE-2026	81	477	396	0	3	3	0	1
ASE-2026	81	82	1	1	2	3	1	3
ASE-2026	81	477	396	0	2	4	0	0
ASE-2026	81	477	396	0	2	1	2	2
ASE-2026	81	82	1	1	4	1	0	0
ASE-2026	81	477	396	0	3	4	0	0
ASE-2026	81	82	1	1	3	1	0	0
ASE-2027	81	179	98	1	3	3	2	0
ASE-2027	82	83	1	1	3	5	2	0
ASE-2027	82	84	2	1	3	5	1	1
ASE-2027	82	87	5	1	3	5	1	0
ASE-2027	82	477	395	0	3	5	0	0
ASE-2027	82	106	24	1	3	5	1	0
ASE-2027	82	109	27	1	1	5	2	4
ASE-2027	82	477	395	0	3	5	0	0
ASE-2027	82	477	395	0	2	5	0	0
ASE-2027	82	477	395	0	2	5	0	0
ASE-2028	82	100	18	1	3	1	2	0
ASE-2028	82	477	395	0	2	5	2	1
ASE-2028	82	88	6	1	3	1	1	0
ASE-2028	82	477	395	0	3	1	0	0
ASE-2028	83	477	394	0	3	5	0	0
ASE-2028	84	85	1	1	3	5	2	0
ASE-2028	84	95	11	1	4	4	2	1
ASE-2028	84	96	12	1	4	5	2	0
ASE-2028	84	85	1	1	1	5	1	0
ASE-2028	84	85	1	1	4	1	1	0
ASE-2029	84	86	2	1	5	1	1	0
ASE-2029	85	102	17	1	4	1	1	0
ASE-2029	85	86	1	1	5	1	4	0
ASE-2029	85	109	24	1	4	1	3	0
ASE-2029	85	103	18	1	3	5	2	1
ASE-2029	85	96	11	1	3	1	1	1
ASE-2029	85	90	5	1	3	5	2	0
ASE-2029	85	477	392	0	5	4	0	0
ASE-2029	85	93	8	1	2	5	1	0
ASE-2029	86	92	6	1	4	3	1	0
ASE-2030	86	477	391	0	3	3	2	0
ASE-2030	86	93	7	1	4	1	1	0
ASE-2030	86	87	1	1	3	1	3	0
ASE-2030	86	477	391	0	3	4	1	0
ASE-2030	86	87	1	1	1	1	0	2
ASE-2030	86	477	391	0	4	4	3	0
ASE-2030	86	477	391	0	3	1	0	0
ASE-2030	86	249	163	1	4	4	4	0
ASE-2030	86	87	1	1	1	1	1	0
ASE-2030	86	477	391	0	3	1	1	0
ASE-2031	86	100	14	1	3	1	1	0
ASE-2031	87	477	390	0	4	1	0	0
ASE-2031	87	477	390	0	3	2	1	0
ASE-2031	87	89	2	1	3	1	1	0
ASE-2031	87	88	1	1	3	1	1	0
ASE-2031	87	477	390	0	2	3	1	1
ASE-2031	87	114	27	1	3	5	2	0
ASE-2031	87	238	151	1	3	5	3	1
ASE-2031	87	88	1	1	5	3	0	0
ASE-2031	87	119	32	1	3	5	1	0
ASE-2032	87	477	390	0	5	4	0	0
ASE-2032	88	477	389	0	5	4	0	0
ASE-2032	88	92	4	1	3	1	2	2
ASE-2032	89	90	1	1	4	3	1	0
ASE-2032	89	477	388	0	2	1	1	0
ASE-2032	91	477	386	0	2	1	0	0
ASE-2032	91	121	30	1	4	4	3	1
ASE-2032	91	93	2	1	4	1	1	0
ASE-2032	91	101	10	1	2	5	1	0
ASE-2033	92	100	8	1	3	1	1	0
ASE-2033	92	294	202	1	2	5	1	0
ASE-2033	92	168	76	1	2	5	2	1
ASE-2033	92	168	76	1	2	5	2	0
ASE-2033	92	168	76	1	3	5	2	1
ASE-2033	92	103	11	1	2	1	4	1
ASE-2033	92	189	97	1	1	1	0	2
ASE-2033	92	93	1	1	3	5	1	1
ASE-2033	92	101	9	1	3	1	3	0
ASE-2033	93	94	1	1	3	1	0	0
ASE-2034	93	477	384	0	4	1	0	0
ASE-2034	93	106	13	1	2	1	0	0
ASE-2034	93	477	384	0	3	1	0	0
ASE-2034	93	95	2	1	2	1	1	0
ASE-2034	93	102	9	1	4	4	1	0
ASE-2034	93	96	3	1	1	1	0	1
ASE-2034	93	94	1	1	2	5	1	0
ASE-2034	93	101	8	1	2	5	1	0
ASE-2034	93	94	1	1	3	5	1	1
ASE-2034	93	101	8	1	2	5	1	1
ASE-2035	93	100	7	1	1	1	1	0
ASE-2035	94	101	7	1	3	1	1	0
ASE-2035	94	100	6	1	3	4	2	3
ASE-2035	94	95	1	1	1	1	1	1
ASE-2035	94	95	1	1	1	5	1	1
ASE-2035	94	95	1	1	4	1	1	0
ASE-2035	95	101	6	1	2	1	2	2
ASE-2035	95	179	84	1	3	4	2	0
ASE-2035	95	100	5	1	4	1	1	0
ASE-2035	96	477	381	0	4	4	0	0
ASE-2036	96	144	48	1	3	5	2	1
ASE-2036	96	97	1	1	3	1	1	0
ASE-2036	97	98	1	1	3	1	1	0
ASE-2036	97	98	1	1	3	1	1	0
ASE-2036	98	104	6	1	2	1	4	0
ASE-2036	98	99	1	1	2	3	1	1
ASE-2036	98	477	379	0	2	1	0	0
ASE-2036	98	100	2	1	3	5	2	0
ASE-2036	98	477	379	0	3	1	0	0
ASE-2036	98	169	71	1	2	1	1	0
ASE-2037	98	106	8	1	3	5	1	0
ASE-2037	98	99	1	1	4	3	1	0
ASE-2037	98	100	2	1	4	3	1	0
ASE-2037	98	477	379	0	3	1	0	1
ASE-2037	98	477	379	0	3	1	0	0
ASE-2037	98	100	2	1	3	1	1	0
ASE-2037	99	101	2	1	4	1	2	0
ASE-2037	99	102	3	1	3	5	2	0
ASE-2037	99	123	24	1	3	5	2	0
ASE-2037	99	102	3	1	3	4	4	0
ASE-2038	99	100	1	1	3	5	1	0
ASE-2038	99	100	1	1	1	1	0	0
ASE-2038	99	100	1	1	3	1	1	0
ASE-2038	99	477	378	0	3	1	2	0
ASE-2038	99	100	1	1	4	1	1	0
ASE-2038	99	100	1	1	4	1	1	0
ASE-2038	100	101	1	1	4	3	1	0
ASE-2038	100	228	128	1	2	4	4	0
ASE-2038	100	114	14	1	3	4	1	0
ASE-2038	100	103	3	1	4	4	3	0
ASE-2039	100	150	50	1	3	5	0	0
ASE-2039	100	102	2	1	4	3	1	0
ASE-2039	100	101	1	1	4	3	0	0
ASE-2039	101	171	70	1	3	5	1	1
ASE-2039	101	102	1	1	4	1	1	0
ASE-2039	101	477	376	0	3	4	0	0
ASE-2039	101	189	88	1	3	4	2	0
ASE-2039	101	102	1	1	5	1	1	0
ASE-2039	101	106	5	1	3	1	1	0
ASE-2039	101	106	5	1	4	1	1	0
ASE-2040	101	102	1	1	4	4	0	1
ASE-2040	101	427	326	1	4	4	4	3
ASE-2040	101	477	376	0	3	4	0	0
ASE-2040	101	175	74	1	3	1	3	1
ASE-2040	101	106	5	1	3	1	4	0
ASE-2040	102	477	375	0	4	3	0	0
ASE-2040	102	109	7	1	3	4	3	0
ASE-2040	102	226	124	1	4	4	0	1
ASE-2040	102	477	375	0	3	2	0	2
ASE-2040	102	104	2	1	5	4	2	1
ASE-2041	102	103	1	1	2	1	2	1
ASE-2041	102	131	29	1	3	1	1	2
ASE-2041	102	477	375	0	3	1	0	0
ASE-2041	102	477	375	0	2	1	2	0
ASE-2041	102	121	19	1	3	5	3	0
ASE-2041	103	104	1	1	3	3	2	0
ASE-2041	103	477	374	0	3	1	0	2
ASE-2041	103	105	2	1	3	5	2	0
ASE-2041	104	477	373	0	5	3	0	0
ASE-2041	104	105	1	1	3	1	2	0
ASE-2042	104	477	373	0	3	1	0	0
ASE-2042	105	107	2	1	3	1	1	0
ASE-2042	105	477	372	0	3	5	1	1
ASE-2042	105	477	372	0	3	5	0	0
ASE-2042	105	143	38	1	3	5	1	1
ASE-2042	105	113	8	1	3	5	1	0
ASE-2042	105	122	17	1	3	5	1	0
ASE-2042	105	112	7	1	3	1	2	0
ASE-2042	105	106	1	1	4	1	0	0
ASE-2042	105	477	372	0	3	5	0	1
ASE-2043	105	477	372	0	3	5	0	0
ASE-2043	105	477	372	0	3	5	0	2
ASE-2043	106	122	16	1	3	5	1	1
ASE-2043	106	477	371	0	3	1	0	1
ASE-2043	106	114	8	1	3	5	1	0
ASE-2043	106	477	371	0	4	3	0	0
ASE-2043	106	107	1	1	3	1	0	0
ASE-2043	106	477	371	0	3	4	0	0
ASE-2043	106	109	3	1	2	4	2	0
ASE-2043	106	109	3	1	4	1	2	0
ASE-2044	106	109	3	1	3	1	2	0
ASE-2044	106	109	3	1	3	3	2	0
ASE-2044	106	109	3	1	3	1	2	1
ASE-2044	106	109	3	1	3	3	2	1
ASE-2044	106	150	44	1	3	4	3	0
ASE-2044	106	477	371	0	3	4	0	0
ASE-2044	106	248	142	1	4	4	1	0
ASE-2044	107	134	27	1	3	1	3	1
ASE-2044	107	477	370	0	1	4	1	0
ASE-2044	107	108	1	1	4	4	1	0
ASE-2045	107	182	75	1	3	4	3	0
ASE-2045	107	477	370	0	3	1	0	1
ASE-2045	107	108	1	1	4	4	1	0
ASE-2045	107	108	1	1	3	1	0	0
ASE-2045	107	108	1	1	3	5	1	0
ASE-2045	108	477	369	0	3	5	2	0
ASE-2045	108	113	5	1	3	5	1	0
ASE-2045	108	134	26	1	3	1	2	4
ASE-2045	108	115	7	1	3	5	1	0
ASE-2045	108	111	3	1	2	4	2	0
ASE-2046	108	477	369	0	2	1	1	2
ASE-2046	109	477	368	0	3	5	0	0
ASE-2046	109	110	1	1	3	5	0	0
ASE-2046	109	110	1	1	1	1	1	1
ASE-2046	109	110	1	1	3	1	1	1
ASE-2046	109	111	2	1	3	1	1	0
ASE-2046	109	112	3	1	3	1	1	0
ASE-2046	109	115	6	1	4	1	1	0
ASE-2046	109	113	4	1	2	1	0	1
ASE-2046	109	227	118	1	4	4	4	0
ASE-2047	109	111	2	1	3	1	0	0
ASE-2047	110	477	367	0	3	3	0	2
ASE-2047	110	275	165	1	2	1	1	1
ASE-2047	112	113	1	1	4	1	0	0
ASE-2047	112	184	72	1	3	4	3	0
ASE-2047	112	129	17	1	3	1	2	0
ASE-2047	112	121	9	1	3	1	3	0
ASE-2047	112	477	365	0	3	3	1	0
ASE-2047	112	148	36	1	4	4	2	0
ASE-2047	113	477	364	0	3	5	0	0
ASE-2048	113	477	364	0	3	5	0	0
ASE-2048	113	123	10	1	3	5	2	0
ASE-2048	113	242	129	1	4	3	4	0
ASE-2048	113	159	46	1	3	5	1	1
ASE-2048	114	121	7	1	5	4	3	0
ASE-2048	114	400	286	1	4	1	3	0
ASE-2048	114	141	27	1	3	3	1	0
ASE-2048	114	116	2	1	3	1	1	0
ASE-2048	114	136	22	1	4	4	2	0
ASE-2048	114	179	65	1	4	5	2	0
ASE-2049	114	477	363	0	3	1	0	0
ASE-2049	114	477	363	0	4	3	0	0
ASE-2049	114	120	6	1	2	1	3	0
ASE-2049	114	115	1	1	4	3	1	1
ASE-2049	115	477	362	0	3	4	0	0
ASE-2049	115	477	362	0	3	5	0	0
ASE-2049	115	151	36	1	4	1	0	1
ASE-2049	116	117	1	1	3	1	2	0
ASE-2049	116	122	6	1	2	5	1	0
ASE-2049	116	119	3	1	4	4	1	0
ASE-2050	116	127	11	1	3	1	3	1
ASE-2050	116	150	34	1	1	3	3	1
ASE-2050	116	184	68	1	1	5	1	2
ASE-2050	116	477	361	0	3	1	0	2
ASE-2050	116	477	361	0	4	1	0	0
ASE-2050	116	127	11	1	4	5	4	1
ASE-2050	117	120	3	1	4	1	3	0
ASE-2050	118	122	4	1	3	4	3	1
ASE-2050	118	126	8	1	4	5	1	0
ASE-2050	119	477	358	0	5	4	0	0
ASE-2051	119	122	3	1	3	3	1	0
ASE-2051	120	477	357	0	3	4	1	1
ASE-2051	120	222	102	1	2	3	2	0
ASE-2051	120	124	4	1	4	5	4	1
ASE-2051	120	121	1	1	3	1	1	0
ASE-2051	120	477	357	0	3	3	0	0
ASE-2051	120	477	357	0	3	3	1	1
ASE-2051	121	124	3	1	3	1	4	2
ASE-2051	121	144	23	1	3	5	2	0
ASE-2051	121	477	356	0	3	5	0	0
ASE-2052	121	135	14	1	3	5	1	0
ASE-2052	122	127	5	1	3	1	3	1
ASE-2052	122	123	1	1	3	1	0	0
ASE-2052	122	126	4	1	4	4	4	0
ASE-2052	122	123	1	1	4	1	2	0
ASE-2052	122	477	355	0	2	5	1	0
ASE-2052	122	477	355	0	4	4	1	0
ASE-2052	122	124	2	1	5	4	3	0
ASE-2052	122	477	355	0	4	4	1	0
ASE-2052	123	477	354	0	3	5	0	0
ASE-2053	123	135	12	1	2	1	1	1
ASE-2053	123	125	2	1	3	1	1	1
ASE-2053	123	171	48	1	5	4	1	0
ASE-2053	124	149	25	1	3	1	3	0
ASE-2053	125	128	3	1	2	1	0	1
ASE-2053	126	127	1	1	3	1	0	1
ASE-2053	126	127	1	1	4	4	2	0
ASE-2053	126	127	1	1	3	1	0	0
ASE-2053	126	209	83	1	2	1	4	3
ASE-2053	127	128	1	1	4	5	1	0
ASE-2054	127	296	169	1	3	5	4	1
ASE-2054	127	477	350	0	3	5	0	0
ASE-2054	127	392	265	1	3	5	2	0
ASE-2054	127	128	1	1	3	1	2	0
ASE-2054	127	133	6	1	1	1	3	2
ASE-2054	127	135	8	1	3	4	4	1
ASE-2054	127	477	350	0	3	4	0	0
ASE-2054	128	135	7	1	3	1	1	1
ASE-2054	128	143	15	1	3	4	4	1
ASE-2054	128	477	349	0	3	1	1	0
ASE-2055	128	212	84	1	4	4	1	0
ASE-2055	128	130	2	1	3	1	0	1
ASE-2055	128	477	349	0	2	1	0	0
ASE-2055	128	477	349	0	3	5	2	1
ASE-2055	128	129	1	1	5	1	4	0
ASE-2055	128	203	75	1	3	5	1	0
ASE-2055	128	162	34	1	3	5	1	0
ASE-2055	128	189	61	1	3	5	2	0
ASE-2055	128	200	72	1	3	5	2	0
ASE-2055	128	203	75	1	3	5	2	0
ASE-2056	129	137	8	1	3	1	2	0
ASE-2056	129	163	34	1	3	1	2	0
ASE-2056	129	477	348	0	3	5	0	0
ASE-2056	129	477	348	0	3	5	1	0
ASE-2056	129	135	6	1	3	5	1	2
ASE-2056	129	204	75	1	3	1	4	1
ASE-2056	129	132	3	1	3	1	1	2
ASE-2056	130	135	5	1	3	4	3	1
ASE-2056	130	143	13	1	3	5	1	1
ASE-2056	130	162	32	1	3	5	1	2
ASE-2057	130	131	1	1	3	2	1	2
ASE-2057	130	135	5	1	3	1	4	0
ASE-2057	130	477	347	0	1	1	0	2
ASE-2057	131	150	19	1	3	1	0	1
ASE-2057	131	477	346	0	3	4	0	0
ASE-2057	131	179	48	1	3	1	2	1
ASE-2057	131	134	3	1	3	5	1	0
ASE-2057	132	156	24	1	3	4	1	2
ASE-2057	132	477	345	0	3	4	1	0
ASE-2057	133	153	20	1	4	4	2	0
ASE-2058	133	134	1	1	3	1	0	1
ASE-2058	133	136	3	1	2	1	1	0
ASE-2058	133	149	16	1	3	1	2	2
ASE-2058	134	137	3	1	3	1	2	1
ASE-2058	134	135	1	1	3	1	0	0
ASE-2058	134	135	1	1	3	1	2	1
ASE-2058	134	477	343	0	3	4	3	1
ASE-2058	134	417	283	1	3	1	3	1
ASE-2058	134	143	9	1	3	1	3	0
ASE-2058	135	143	8	1	3	1	1	0
ASE-2059	135	157	22	1	2	1	4	0
ASE-2059	135	141	6	1	2	1	4	3
ASE-2059	135	151	16	1	4	2	3	2
ASE-2059	135	136	1	1	3	3	1	0
ASE-2059	135	149	14	1	3	4	2	1
ASE-2059	135	142	7	1	3	3	4	2
ASE-2059	136	137	1	1	3	1	0	0
ASE-2059	136	148	12	1	4	1	4	0
ASE-2059	136	477	341	0	3	1	1	1
ASE-2059	136	137	1	1	2	1	0	1
ASE-2060	136	137	1	1	2	1	0	0
ASE-2060	137	143	6	1	4	1	2	0
ASE-2060	137	151	14	1	4	1	3	0
ASE-2060	137	477	340	0	4	1	0	0
ASE-2060	137	311	174	1	2	1	4	0
ASE-2060	138	156	18	1	3	4	3	2
ASE-2060	140	142	2	1	3	1	0	1
ASE-2060	140	477	337	0	3	1	0	0
ASE-2060	140	141	1	1	3	3	1	1
ASE-2060	140	141	1	1	4	1	1	0
ASE-2061	141	477	336	0	3	5	1	0
ASE-2061	141	477	336	0	3	1	0	1
ASE-2061	141	148	7	1	3	1	2	0
ASE-2061	141	477	336	0	3	1	0	0
ASE-2061	141	233	92	1	4	1	4	0
ASE-2061	141	168	27	1	3	5	2	2
ASE-2061	141	143	2	1	3	1	1	0
ASE-2061	141	191	50	1	4	4	2	0
ASE-2061	141	477	336	0	4	2	3	0
ASE-2061	141	142	1	1	5	5	2	0
ASE-2062	141	142	1	1	3	5	1	1
ASE-2062	141	477	336	0	3	1	0	0
ASE-2062	142	477	335	0	4	3	0	0
ASE-2062	142	477	335	0	4	3	2	0
ASE-2062	142	143	1	1	3	1	2	0
ASE-2062	142	164	22	1	4	4	2	0
ASE-2062	142	477	335	0	3	4	0	1
ASE-2062	142	143	1	1	3	1	2	0
ASE-2062	142	154	12	1	2	5	3	1
ASE-2062	142	143	1	1	3	1	0	0
ASE-2063	142	164	22	1	3	2	1	1
ASE-2063	142	477	335	0	3	2	0	1
ASE-2063	142	477	335	0	2	1	0	0
ASE-2063	143	148	5	1	3	1	3	0
ASE-2063	143	154	11	1	2	1	3	1
ASE-2063	143	175	32	1	3	1	2	0
ASE-2063	143	263	120	1	3	2	2	4
ASE-2063	143	162	19	1	3	5	1	0
ASE-2063	143	144	1	1	3	1	4	0
ASE-2063	143	477	334	0	3	1	0	0
ASE-2064	143	149	6	1	2	4	3	1
ASE-2064	143	477	334	0	4	5	0	0
ASE-2064	143	171	28	1	3	1	3	1
ASE-2064	143	477	334	0	3	4	2	0
ASE-2064	143	477	334	0	2	1	0	0
ASE-2064	144	148	4	1	3	1	3	0
ASE-2064	144	149	5	1	5	5	4	0
ASE-2064	144	145	1	1	3	5	2	0
ASE-2064	144	233	89	1	3	1	3	0
ASE-2064	144	239	95	1	4	2	4	1
ASE-2065	144	477	333	0	3	5	1	0
ASE-2065	144	217	73	1	4	4	3	0
ASE-2065	146	148	2	1	4	4	1	0
ASE-2065	146	150	4	1	3	1	1	0
ASE-2065	146	264	118	1	3	4	0	0
ASE-2065	147	155	8	1	3	1	0	0
ASE-2065	147	161	14	1	3	2	3	0
ASE-2065	148	477	329	0	2	1	2	2
ASE-2065	149	477	328	0	3	1	0	2
ASE-2065	149	150	1	1	3	1	2	0
ASE-2066	149	150	1	1	3	5	1	0
ASE-2066	149	150	1	1	3	1	1	0
ASE-2066	149	450	301	1	3	1	4	4
ASE-2066	150	477	327	0	3	1	0	0
ASE-2066	150	151	1	1	3	1	4	0
ASE-2066	150	157	7	1	4	3	4	0
ASE-2066	150	233	83	1	4	1	2	1
ASE-2066	150	152	2	1	5	5	4	0
ASE-2066	151	152	1	1	3	1	1	0
ASE-2066	151	152	1	1	3	1	3	0
ASE-2067	151	154	3	1	4	1	4	0
ASE-2067	151	297	146	1	3	1	0	1
ASE-2067	151	199	48	1	4	4	4	0
ASE-2067	151	477	326	0	3	5	0	1
ASE-2067	152	477	325	0	3	1	0	0
ASE-2067	152	161	9	1	3	1	0	0
ASE-2067	152	477	325	0	3	3	0	0
ASE-2067	153	154	1	1	3	3	2	0
ASE-2067	154	155	1	1	4	1	1	0
ASE-2067	154	477	323	0	3	2	1	0
ASE-2068	154	164	10	1	2	1	0	0
ASE-2068	154	165	11	1	3	1	3	0
ASE-2068	155	477	322	0	2	5	1	1
ASE-2068	155	156	1	1	2	1	3	0
ASE-2068	155	156	1	1	5	1	3	0
ASE-2068	155	477	322	0	3	1	0	1
ASE-2068	155	477	322	0	3	5	0	0
ASE-2068	155	477	322	0	3	4	0	0
ASE-2068	156	477	321	0	3	1	0	0
ASE-2068	156	162	6	1	1	1	4	0
ASE-2069	156	477	321	0	3	1	0	2
ASE-2069	156	185	29	1	1	1	3	4
ASE-2069	156	477	321	0	3	5	0	0
ASE-2069	156	477	321	0	4	4	1	2
ASE-2069	156	477	321	0	4	4	0	1
ASE-2069	156	165	9	1	4	4	1	0
ASE-2069	157	158	1	1	3	1	0	0
ASE-2069	157	192	35	1	3	1	4	1
ASE-2069	157	160	3	1	3	1	1	0
ASE-2069	157	158	1	1	3	1	3	0
ASE-2070	157	162	5	1	2	5	3	1
ASE-2070	157	176	19	1	5	4	2	0
ASE-2070	157	158	1	1	3	5	1	0
ASE-2070	157	477	320	0	3	4	0	0
ASE-2070	157	263	106	1	2	1	4	3
ASE-2070	157	232	75	1	3	1	4	1
ASE-2070	158	170	12	1	2	5	3	0
ASE-2070	158	161	3	1	3	1	2	0
ASE-2070	159	169	10	1	1	1	2	4
ASE-2070	159	477	318	0	4	4	0	0
ASE-2071	159	174	15	1	4	5	3	1
ASE-2071	159	477	318	0	4	5	0	0
ASE-2071	159	477	318	0	4	1	1	0
ASE-2071	161	477	316	0	3	1	0	0
ASE-2071	161	477	316	0	3	3	0	0
ASE-2071	161	477	316	0	4	3	0	0
ASE-2071	161	290	129	1	2	5	4	0
ASE-2071	162	477	315	0	3	5	0	0
ASE-2071	162	477	315	0	3	5	0	0
ASE-2071	162	477	315	0	4	1	1	0
ASE-2072	162	163	1	1	3	3	1	1
ASE-2072	162	163	1	1	3	5	1	0
ASE-2072	163	164	1	1	3	5	2	2
ASE-2072	163	167	4	1	2	1	3	1
ASE-2072	163	423	260	1	2	1	3	1
ASE-2072	163	164	1	1	3	5	1	0
ASE-2072	163	164	1	1	3	5	1	0
ASE-2072	163	269	106	1	3	2	1	0
ASE-2072	163	477	314	0	4	1	0	0
ASE-2072	163	212	49	1	3	1	1	1
ASE-2073	164	165	1	1	3	5	1	0
ASE-2073	164	210	46	1	4	1	1	0
ASE-2073	164	178	14	1	4	1	4	0
ASE-2073	164	165	1	1	4	4	4	0
ASE-2073	164	427	263	1	3	4	4	4
ASE-2073	164	477	313	0	3	1	0	0
ASE-2073	165	477	312	0	3	1	0	0
ASE-2073	165	170	5	1	5	4	2	0
ASE-2073	165	477	312	0	4	1	0	0
ASE-2073	165	170	5	1	3	4	2	1
ASE-2074	165	172	7	1	3	4	1	0
ASE-2074	165	248	83	1	3	1	3	0
ASE-2074	165	170	5	1	3	1	2	1
ASE-2074	166	477	311	0	4	1	0	0
ASE-2074	166	203	37	1	3	1	1	0
ASE-2074	166	170	4	1	3	5	1	0
ASE-2074	167	205	38	1	3	5	0	1
ASE-2074	167	172	5	1	3	5	0	2
ASE-2074	168	477	309	0	3	4	0	0
ASE-2074	168	242	74	1	4	4	3	1
ASE-2075	168	477	309	0	3	4	0	0
ASE-2075	169	176	7	1	3	5	1	0
ASE-2075	169	173	4	1	3	1	3	4
ASE-2075	170	221	51	1	2	1	1	0
ASE-2075	170	429	259	1	3	1	1	0
ASE-2075	170	451	281	1	4	1	1	0
ASE-2075	170	477	307	0	4	1	1	0
ASE-2075	170	477	307	0	4	3	0	0
ASE-2075	170	171	1	1	3	1	0	0
ASE-2075	170	171	1	1	3	1	1	0
ASE-2076	170	420	250	1	3	3	0	0
ASE-2076	170	477	307	0	3	1	0	0
ASE-2076	170	175	5	1	3	1	0	0
ASE-2076	170	453	283	1	3	3	1	0
ASE-2076	170	281	111	1	2	1	4	0
ASE-2076	170	171	1	1	5	1	1	0
ASE-2076	171	268	97	1	5	1	4	0
ASE-2076	171	172	1	1	3	1	3	0
ASE-2076	171	477	306	0	3	4	0	0
ASE-2076	171	179	8	1	3	1	4	1
ASE-2077	171	175	4	1	2	1	4	0
ASE-2077	171	189	18	1	3	1	3	0
ASE-2077	171	236	65	1	3	1	4	0
ASE-2077	171	477	306	0	4	1	0	0
ASE-2077	171	477	306	0	3	1	0	1
ASE-2077	172	174	2	1	3	1	2	1
ASE-2077	172	173	1	1	3	5	1	0
ASE-2077	172	176	4	1	3	1	3	0
ASE-2077	172	174	2	1	3	1	3	0
ASE-2077	173	477	304	0	3	1	0	1
ASE-2078	174	175	1	1	3	5	3	0
ASE-2078	174	178	4	1	3	5	3	0
ASE-2078	174	477	303	0	4	4	0	0
ASE-2078	175	177	2	1	3	5	1	0
ASE-2078	175	190	15	1	4	1	2	1
ASE-2078	175	177	2	1	3	1	4	0
ASE-2078	175	477	302	0	3	5	0	0
ASE-2078	176	190	14	1	4	5	1	0
ASE-2078	176	178	2	1	1	5	1	0
ASE-2078	176	184	8	1	3	1	4	4
ASE-2079	176	177	1	1	3	5	1	0
ASE-2079	176	178	2	1	3	1	2	0
ASE-2079	176	182	6	1	1	1	2	3
ASE-2079	176	477	301	0	3	1	0	0
ASE-2079	176	212	36	1	3	1	4	0
ASE-2079	176	177	1	1	3	1	3	1
ASE-2079	176	477	301	0	3	1	1	0
ASE-2079	177	477	300	0	2	1	0	0
ASE-2079	177	178	1	1	4	4	1	0
ASE-2079	177	178	1	1	3	1	0	0
ASE-2080	177	477	300	0	3	5	0	0
ASE-2080	178	179	1	1	3	5	1	0
ASE-2080	178	477	299	0	3	5	0	0
ASE-2080	178	477	299	0	3	5	0	0
ASE-2080	178	477	299	0	3	5	1	0
ASE-2080	178	477	299	0	3	5	0	0
ASE-2080	178	189	11	1	4	4	4	0
ASE-2080	178	477	299	0	3	5	0	0
ASE-2080	178	186	8	1	4	1	4	0
ASE-2080	178	477	299	0	3	4	0	0
ASE-2081	178	179	1	1	3	4	3	0
ASE-2081	178	477	299	0	4	5	0	0
ASE-2081	178	183	5	1	3	1	3	0
ASE-2081	178	219	41	1	4	5	4	0
ASE-2081	178	477	299	0	3	5	0	0
ASE-2081	178	477	299	0	4	1	0	0
ASE-2081	179	182	3	1	3	5	0	0
ASE-2081	179	182	3	1	1	1	3	3
ASE-2081	179	477	298	0	4	4	0	0
ASE-2081	179	477	298	0	4	4	0	0
ASE-2082	179	477	298	0	3	1	0	1
ASE-2082	179	477	298	0	3	1	0	0
ASE-2082	179	189	10	1	3	1	3	0
ASE-2082	179	199	20	1	5	4	1	0
ASE-2082	179	477	298	0	3	1	0	0
ASE-2082	179	183	4	1	3	1	3	0
ASE-2082	179	183	4	1	3	4	4	3
ASE-2082	180	477	297	0	3	1	0	0
ASE-2082	181	477	296	0	3	5	0	0
ASE-2082	181	215	34	1	3	1	3	0
ASE-2083	182	183	1	1	3	5	1	0
ASE-2083	182	185	3	1	1	5	1	2
ASE-2083	182	190	8	1	3	5	1	0
ASE-2083	182	189	7	1	3	2	3	0
ASE-2083	182	211	29	1	3	1	0	0
ASE-2083	182	477	295	0	2	3	1	0
ASE-2083	182	189	7	1	3	5	1	0
ASE-2083	182	281	99	1	4	4	0	0
ASE-2083	183	192	9	1	3	5	3	1
ASE-2083	183	184	1	1	1	5	3	2
ASE-2084	183	185	2	1	3	1	1	0
ASE-2084	184	185	1	1	3	5	1	2
ASE-2084	184	189	5	1	3	1	1	0
ASE-2084	184	185	1	1	3	5	1	1
ASE-2084	184	196	12	1	3	1	0	1
ASE-2084	184	218	34	1	3	4	3	0
ASE-2084	184	203	19	1	3	5	3	2
ASE-2084	185	192	7	1	3	5	4	2
ASE-2084	185	189	4	1	3	5	0	0
ASE-2084	185	186	1	1	3	5	1	0
ASE-2085	185	190	5	1	3	5	0	0
ASE-2085	185	477	292	0	4	1	0	0
ASE-2085	185	186	1	1	3	1	0	0
ASE-2085	186	199	13	1	3	5	4	0
ASE-2085	186	380	194	1	4	1	3	0
ASE-2085	186	199	13	1	3	1	1	1
ASE-2085	186	212	26	1	4	4	4	2
ASE-2085	186	270	84	1	3	4	4	0
ASE-2085	186	189	3	1	4	4	3	0
ASE-2085	187	191	4	1	3	1	1	1
ASE-2086	189	197	8	1	3	5	4	0
ASE-2086	189	204	15	1	3	1	0	0
ASE-2086	189	190	1	1	1	3	1	1
ASE-2086	190	199	9	1	3	5	0	0
ASE-2086	190	200	10	1	3	5	0	2
ASE-2086	190	193	3	1	3	1	3	0
ASE-2086	190	196	6	1	2	1	1	0
ASE-2086	190	205	15	1	3	5	4	0
ASE-2086	190	191	1	1	4	5	1	0
ASE-2086	191	199	8	1	3	1	4	1
ASE-2087	191	200	9	1	4	1	4	0
ASE-2087	191	215	24	1	2	1	1	1
ASE-2087	191	192	1	1	3	1	0	0
ASE-2087	191	205	14	1	4	4	4	2
ASE-2087	192	477	285	0	4	5	0	0
ASE-2087	192	199	7	1	3	5	4	0
ASE-2087	192	198	6	1	4	4	1	0
ASE-2087	192	193	1	1	3	1	0	1
ASE-2087	192	204	12	1	2	5	4	0
ASE-2087	192	193	1	1	3	1	1	0
ASE-2088	192	193	1	1	4	1	1	0
ASE-2088	193	237	44	1	3	5	2	4
ASE-2088	193	194	1	1	3	5	0	0
ASE-2088	193	477	284	0	3	4	0	0
ASE-2088	193	196	3	1	3	3	4	1
ASE-2088	193	214	21	1	4	5	4	0
ASE-2088	194	427	233	1	2	2	2	2
ASE-2088	194	195	1	1	3	5	1	0
ASE-2088	195	477	282	0	3	1	0	0
ASE-2088	195	196	1	1	3	1	2	0
ASE-2089	195	238	43	1	4	1	4	0
ASE-2089	195	477	282	0	3	1	0	0
ASE-2089	195	247	52	1	3	1	4	0
ASE-2089	196	212	16	1	3	5	4	1
ASE-2089	196	213	17	1	3	3	1	1
ASE-2089	196	208	12	1	3	1	3	2
ASE-2089	196	215	19	1	3	5	1	0
ASE-2089	196	477	281	0	3	5	2	0
ASE-2089	197	477	280	0	3	5	0	1
ASE-2089	197	477	280	0	3	5	0	0
ASE-2090	197	477	280	0	3	5	0	0
ASE-2090	197	199	2	1	3	1	2	0
ASE-2090	197	477	280	0	3	1	0	0
ASE-2090	197	199	2	1	3	1	1	1
ASE-2090	197	477	280	0	3	2	0	0
ASE-2090	197	198	1	1	3	3	3	1
ASE-2090	197	477	280	0	4	1	0	0
ASE-2090	198	199	1	1	3	5	4	0
ASE-2090	198	203	5	1	3	1	4	0
ASE-2090	199	200	1	1	3	5	1	0
ASE-2091	199	477	278	0	3	1	0	0
ASE-2091	199	457	258	1	3	1	4	0
ASE-2091	199	459	260	1	3	1	4	1
ASE-2091	199	477	278	0	4	4	0	1
ASE-2091	199	200	1	1	3	5	4	1
ASE-2091	200	202	2	1	3	3	1	0
ASE-2091	200	477	277	0	3	1	0	0
ASE-2091	201	379	178	1	3	1	4	1
ASE-2091	202	431	229	1	4	1	2	1
ASE-2091	202	477	275	0	3	1	0	0
ASE-2092	203	477	274	0	2	5	0	2
ASE-2092	203	207	4	1	3	5	4	1
ASE-2092	203	477	274	0	3	1	0	1
ASE-2092	203	204	1	1	3	3	0	0
ASE-2092	203	216	13	1	3	1	1	1
ASE-2092	203	477	274	0	3	4	0	0
ASE-2092	203	477	274	0	3	1	3	0
ASE-2092	203	206	3	1	3	1	2	0
ASE-2092	204	205	1	1	4	1	2	0
ASE-2092	204	477	273	0	4	4	0	0
ASE-2093	204	210	6	1	4	4	3	0
ASE-2093	204	205	1	1	5	3	3	1
ASE-2093	204	205	1	1	3	1	1	1
ASE-2093	205	477	272	0	3	1	0	2
ASE-2093	205	464	259	1	2	1	1	3
ASE-2093	205	211	6	1	4	4	4	1
ASE-2093	205	477	272	0	3	1	0	1
ASE-2093	205	477	272	0	3	3	1	1
ASE-2093	205	206	1	1	3	5	1	0
ASE-2093	205	207	2	1	2	5	4	2
ASE-2094	205	239	34	1	3	1	4	4
ASE-2094	205	238	33	1	3	5	4	0
ASE-2094	205	239	34	1	3	3	4	4
ASE-2094	205	477	272	0	4	4	0	0
ASE-2094	206	207	1	1	2	5	0	0
ASE-2094	206	477	271	0	3	4	0	3
ASE-2094	206	477	271	0	3	4	0	2
ASE-2094	206	477	271	0	3	4	0	1
ASE-2094	206	477	271	0	3	4	0	0
ASE-2094	206	207	1	1	3	5	0	1
ASE-2095	206	211	5	1	3	5	2	0
ASE-2095	206	477	271	0	3	2	0	2
ASE-2095	206	477	271	0	3	4	0	3
ASE-2095	206	477	271	0	3	5	0	0
ASE-2095	206	477	271	0	3	5	0	0
ASE-2095	206	477	271	0	3	5	0	0
ASE-2095	206	477	271	0	3	5	0	0
ASE-2095	206	477	271	0	3	5	0	1
ASE-2095	206	477	271	0	3	5	0	0
ASE-2095	206	477	271	0	3	5	0	0
ASE-2096	206	477	271	0	3	5	0	0
ASE-2096	206	477	271	0	3	5	0	0
ASE-2096	206	477	271	0	3	5	0	0
ASE-2096	206	477	271	0	3	5	0	0
ASE-2096	207	208	1	1	5	5	0	0
ASE-2096	207	220	13	1	3	4	3	1
ASE-2096	207	208	1	1	3	1	1	1
ASE-2096	208	421	213	1	3	1	0	0
ASE-2096	208	239	31	1	3	1	4	1
ASE-2096	208	214	6	1	3	5	0	1
ASE-2097	209	477	268	0	3	1	2	1
ASE-2097	210	477	267	0	3	2	0	0
ASE-2097	210	220	10	1	3	1	0	0
ASE-2097	210	298	88	1	2	5	4	0
ASE-2097	210	211	1	1	3	5	3	1
ASE-2097	210	224	14	1	3	5	4	0
ASE-2097	210	477	267	0	3	5	0	1
ASE-2097	210	211	1	1	5	4	1	0
ASE-2097	210	236	26	1	2	1	4	0
ASE-2097	210	225	15	1	4	4	4	0
ASE-2098	210	211	1	1	2	2	0	1
ASE-2098	210	222	12	1	3	1	3	1
ASE-2098	210	477	267	0	3	1	0	3
ASE-2098	210	211	1	1	3	3	0	0
ASE-2098	210	477	267	0	4	1	0	0
ASE-2098	211	224	13	1	3	4	3	0
ASE-2098	211	218	7	1	3	4	3	0
ASE-2098	211	222	11	1	3	1	1	2
ASE-2098	211	232	21	1	3	5	0	1
ASE-2098	211	212	1	1	5	3	3	0
ASE-2099	212	477	265	0	3	5	0	0
ASE-2099	212	477	265	0	3	5	0	0
ASE-2099	212	477	265	0	3	5	0	0
ASE-2099	213	477	264	0	2	1	3	3
ASE-2099	213	262	49	1	5	1	0	0
ASE-2099	213	262	49	1	5	4	0	0
ASE-2099	213	214	1	1	3	1	1	1
ASE-2099	213	217	4	1	3	1	3	1
ASE-2099	213	477	264	0	3	5	0	0
ASE-2099	213	477	264	0	3	5	1	0
ASE-2100	214	282	68	1	4	4	1	0
ASE-2100	214	250	36	1	3	1	4	1
ASE-2100	214	303	89	1	4	5	1	0
ASE-2100	214	477	263	0	3	1	0	0
ASE-2100	214	215	1	1	3	5	1	0
ASE-2100	214	225	11	1	4	1	4	4
ASE-2100	214	231	17	1	3	1	0	2
ASE-2100	214	218	4	1	2	1	4	0
ASE-2100	214	477	263	0	2	1	0	2
ASE-2100	214	215	1	1	3	5	1	0
ASE-2101	215	477	262	0	3	2	0	0
ASE-2101	215	228	13	1	4	4	0	0
ASE-2101	217	222	5	1	2	5	4	0
ASE-2101	217	465	248	1	2	5	0	0
ASE-2101	217	477	260	0	3	4	0	4
ASE-2101	217	237	20	1	3	1	0	0
ASE-2101	217	427	210	1	3	5	0	1
ASE-2101	217	239	22	1	3	5	2	2
ASE-2101	218	222	4	1	2	1	3	0
ASE-2101	218	477	259	0	3	4	0	1
ASE-2102	218	386	168	1	3	5	1	2
ASE-2102	218	253	35	1	3	1	3	0
ASE-2102	218	219	1	1	3	3	0	1
ASE-2102	218	261	43	1	3	5	3	1
ASE-2102	219	477	258	0	4	4	0	0
ASE-2102	219	224	5	1	3	5	4	1
ASE-2102	219	220	1	1	4	1	1	0
ASE-2102	219	242	23	1	3	3	1	1
ASE-2102	220	225	5	1	4	4	1	0
ASE-2102	220	224	4	1	3	1	2	1
ASE-2103	220	239	19	1	4	1	4	0
ASE-2103	220	233	13	1	3	1	4	1
ASE-2103	220	232	12	1	3	1	3	0
ASE-2103	220	477	257	0	4	4	0	0
ASE-2103	221	383	162	1	3	5	2	1
ASE-2103	221	477	256	0	3	5	0	2
ASE-2103	221	222	1	1	3	5	0	1
ASE-2103	221	275	54	1	4	1	0	0
ASE-2103	223	224	1	1	3	1	1	0
ASE-2103	223	477	254	0	3	5	0	0
ASE-2104	223	226	3	1	4	1	1	0
ASE-2104	224	233	9	1	3	1	4	0
ASE-2104	225	229	4	1	3	1	3	0
ASE-2104	225	231	6	1	3	1	0	1
ASE-2104	225	226	1	1	3	5	2	0
ASE-2104	225	244	19	1	3	1	1	1
ASE-2104	225	226	1	1	3	5	1	0
ASE-2104	225	227	2	1	3	1	4	2
ASE-2104	225	477	252	0	3	1	0	1
ASE-2104	225	226	1	1	3	1	0	0
ASE-2105	225	226	1	1	3	5	3	0
ASE-2105	225	234	9	1	3	5	0	1
ASE-2105	225	251	26	1	3	1	2	0
ASE-2105	225	238	13	1	3	1	0	0
ASE-2105	225	240	15	1	3	5	1	0
ASE-2105	226	290	64	1	3	1	4	0
ASE-2105	226	229	3	1	4	1	1	0
ASE-2105	226	420	194	1	4	3	4	0
ASE-2105	226	232	6	1	3	1	4	0
ASE-2105	226	248	22	1	2	1	1	1
ASE-2106	226	231	5	1	4	5	2	2
ASE-2106	226	248	22	1	2	5	3	1
ASE-2106	226	228	2	1	3	1	4	1
ASE-2106	227	228	1	1	3	1	0	1
ASE-2106	227	394	167	1	3	5	0	0
ASE-2106	227	477	250	0	3	4	0	0
ASE-2106	228	229	1	1	4	4	0	0
ASE-2106	228	271	43	1	3	1	1	0
ASE-2106	228	229	1	1	2	3	0	0
ASE-2106	228	232	4	1	3	1	2	2
ASE-2107	228	477	249	0	2	1	3	1
ASE-2107	228	238	10	1	3	4	2	0
ASE-2107	230	238	8	1	3	5	4	0
ASE-2107	230	295	65	1	3	5	4	0
ASE-2107	231	232	1	1	3	1	4	1
ASE-2107	231	291	60	1	1	5	2	2
ASE-2107	231	234	3	1	3	5	4	4
ASE-2107	231	232	1	1	3	1	1	1
ASE-2107	231	235	4	1	3	1	4	2
ASE-2107	231	232	1	1	3	1	0	0
ASE-2108	232	233	1	1	3	1	0	1
ASE-2108	232	477	245	0	3	1	0	2
ASE-2108	232	424	192	1	2	5	3	1
ASE-2108	232	240	8	1	3	5	4	2
ASE-2108	232	239	7	1	3	1	2	0
ASE-2108	232	234	2	1	3	5	0	0
ASE-2108	232	233	1	1	3	1	0	2
ASE-2108	232	477	245	0	4	2	0	0
ASE-2108	232	239	7	1	3	1	4	0
ASE-2108	232	233	1	1	4	3	1	0
ASE-2109	232	477	245	0	4	4	1	0
ASE-2109	232	372	140	1	3	4	1	1
ASE-2109	233	477	244	0	3	1	0	0
ASE-2109	233	427	194	1	3	5	4	0
ASE-2109	233	427	194	1	3	5	4	0
ASE-2109	233	237	4	1	2	5	2	2
ASE-2109	233	477	244	0	3	1	0	0
ASE-2109	233	257	24	1	3	5	4	0
ASE-2109	233	284	51	1	3	4	3	1
ASE-2109	233	234	1	1	4	1	0	1
ASE-2110	234	477	243	0	3	1	0	1
ASE-2110	234	235	1	1	3	1	4	1
ASE-2110	234	263	29	1	3	1	2	0
ASE-2110	234	283	49	1	3	4	4	0
ASE-2110	234	243	9	1	3	1	2	0
ASE-2110	234	274	40	1	3	1	0	2
ASE-2110	234	477	243	0	4	4	0	0
ASE-2110	234	247	13	1	4	4	2	1
ASE-2110	234	235	1	1	3	1	0	4
ASE-2110	235	236	1	1	3	1	0	0
ASE-2111	235	477	242	0	3	3	1	0
ASE-2111	235	236	1	1	2	1	0	2
ASE-2111	235	477	242	0	2	1	2	1
ASE-2111	235	236	1	1	3	1	4	1
ASE-2111	235	287	52	1	3	3	1	0
ASE-2111	235	477	242	0	3	4	0	0
ASE-2111	235	477	242	0	3	4	0	0
ASE-2111	236	274	38	1	3	1	1	1
ASE-2111	236	477	241	0	3	2	0	0
ASE-2111	237	238	1	1	3	3	1	0
ASE-2112	238	239	1	1	3	1	2	0
ASE-2112	238	477	239	0	3	4	0	0
ASE-2112	238	477	239	0	3	4	0	0
ASE-2112	238	244	6	1	3	5	1	0
ASE-2112	239	477	238	0	3	1	0	0
ASE-2112	239	254	15	1	3	3	1	4
ASE-2112	240	246	6	1	4	4	3	3
ASE-2112	240	247	7	1	3	1	4	0
ASE-2112	240	241	1	1	3	1	2	1
ASE-2112	240	248	8	1	4	4	2	2
ASE-2113	240	241	1	1	2	1	0	1
ASE-2113	240	388	148	1	4	1	0	0
ASE-2113	241	244	3	1	3	1	4	0
ASE-2113	241	477	236	0	3	1	0	0
ASE-2113	241	477	236	0	2	1	0	0
ASE-2113	242	451	209	1	3	1	4	1
ASE-2113	242	244	2	1	3	1	2	3
ASE-2113	242	249	7	1	3	5	4	1
ASE-2113	244	245	1	1	3	1	0	1
ASE-2114	244	477	233	0	3	1	1	2
ASE-2114	244	319	75	1	3	5	1	0
ASE-2114	245	477	232	0	3	5	0	0
ASE-2114	245	252	7	1	3	1	4	1
ASE-2114	245	252	7	1	3	1	4	0
ASE-2114	246	291	45	1	4	4	1	1
ASE-2114	246	339	93	1	4	4	1	1
ASE-2114	246	247	1	1	4	4	1	1
ASE-2114	246	462	216	1	4	4	1	0
ASE-2114	246	296	50	1	2	5	0	1
ASE-2115	246	247	1	1	4	4	0	1
ASE-2115	246	477	231	0	2	3	0	0
ASE-2115	247	477	230	0	3	4	0	0
ASE-2115	247	248	1	1	3	4	3	2
ASE-2115	247	329	82	1	3	4	1	1
ASE-2115	247	249	2	1	5	4	3	0
ASE-2115	248	261	13	1	2	5	3	1
ASE-2115	248	249	1	1	4	4	4	0
ASE-2115	248	284	36	1	2	1	4	1
ASE-2115	248	372	124	1	3	5	2	0
ASE-2116	248	259	11	1	5	5	1	0
ASE-2116	248	249	1	1	4	5	3	0
ASE-2116	248	253	5	1	2	1	1	0
ASE-2116	248	477	229	0	2	4	1	1
ASE-2116	248	267	19	1	4	4	4	1
ASE-2116	248	477	229	0	3	1	0	0
ASE-2116	248	249	1	1	3	1	3	0
ASE-2116	249	477	228	0	3	1	0	0
ASE-2116	249	254	5	1	5	3	4	0
ASE-2116	249	261	12	1	3	5	3	0
ASE-2117	249	477	228	0	3	1	0	1
ASE-2117	250	251	1	1	3	1	3	0
ASE-2117	250	258	8	1	3	5	4	0
ASE-2117	250	253	3	1	4	1	4	1
ASE-2117	251	254	3	1	3	1	4	1
ASE-2117	252	298	46	1	4	5	1	0
ASE-2117	252	253	1	1	3	1	0	0
ASE-2117	252	477	225	0	3	3	1	0
ASE-2117	252	293	41	1	2	1	4	2
ASE-2117	252	255	3	1	3	1	4	0
ASE-2118	252	301	49	1	4	3	0	0
ASE-2118	253	254	1	1	3	1	4	0
ASE-2118	253	256	3	1	3	1	3	1
ASE-2118	253	477	224	0	3	1	0	0
ASE-2118	253	477	224	0	3	3	0	0
ASE-2118	253	283	30	1	4	4	4	0
ASE-2118	254	477	223	0	4	4	0	0
ASE-2118	254	477	223	0	3	1	0	0
ASE-2118	254	270	16	1	3	5	2	0
ASE-2118	254	255	1	1	4	5	4	0
ASE-2119	254	255	1	1	3	5	4	0
ASE-2119	254	303	49	1	3	5	4	0
ASE-2119	254	295	41	1	3	5	4	0
ASE-2119	254	266	12	1	3	1	0	0
ASE-2119	254	292	38	1	4	5	1	0
ASE-2119	255	477	222	0	3	2	0	0
ASE-2119	255	271	16	1	2	1	4	0
ASE-2119	256	477	221	0	3	1	0	0
ASE-2119	256	289	33	1	3	3	4	0
ASE-2119	258	264	6	1	2	5	2	1
ASE-2120	259	291	32	1	2	1	4	1
ASE-2120	259	405	146	1	3	4	4	1
ASE-2120	259	477	218	0	3	5	0	0
ASE-2120	259	263	4	1	4	1	4	0
ASE-2120	260	262	2	1	3	4	3	0
ASE-2120	260	261	1	1	4	2	0	0
ASE-2120	260	262	2	1	2	1	4	0
ASE-2120	260	272	12	1	4	4	3	1
ASE-2120	260	267	7	1	2	1	4	1
ASE-2120	260	261	1	1	3	5	0	0
ASE-2121	261	262	1	1	3	5	1	0
ASE-2121	261	477	216	0	2	1	0	0
ASE-2121	262	268	6	1	4	1	4	0
ASE-2121	262	276	14	1	3	1	1	0
ASE-2121	262	263	1	1	3	5	3	0
ASE-2121	262	297	35	1	3	5	4	2
ASE-2121	262	297	35	1	3	5	1	0
ASE-2121	263	267	4	1	2	5	2	4
ASE-2121	263	269	6	1	3	1	0	1
ASE-2121	263	278	15	1	3	1	1	1
ASE-2122	263	436	173	1	3	5	0	0
ASE-2122	264	275	11	1	4	5	1	0
ASE-2122	265	275	10	1	3	1	0	0
ASE-2122	266	267	1	1	2	1	4	0
ASE-2122	267	477	210	0	4	4	0	0
ASE-2122	267	379	112	1	3	1	4	3
ASE-2122	267	477	210	0	3	5	0	1
ASE-2122	267	269	2	1	3	5	2	1
ASE-2122	267	269	2	1	2	1	4	1
ASE-2122	267	477	210	0	3	4	0	0
ASE-2123	267	280	13	1	4	1	1	0
ASE-2123	267	477	210	0	3	3	1	0
ASE-2123	268	269	1	1	3	1	3	0
ASE-2123	268	270	2	1	3	5	4	1
ASE-2123	268	371	103	1	2	1	0	0
ASE-2123	268	281	13	1	3	5	0	1
ASE-2123	268	477	209	0	3	5	0	0
ASE-2123	268	302	34	1	1	5	2	1
ASE-2123	268	287	19	1	4	1	1	0
ASE-2123	268	477	209	0	3	1	1	0
ASE-2124	268	477	209	0	4	4	0	0
ASE-2124	268	269	1	1	3	3	1	0
ASE-2124	269	292	23	1	4	1	2	1
ASE-2124	269	477	208	0	5	4	1	0
ASE-2124	269	270	1	1	3	5	2	2
ASE-2124	269	272	3	1	3	5	1	0
ASE-2124	269	346	77	1	3	5	1	0
ASE-2124	269	309	40	1	3	1	3	1
ASE-2124	270	271	1	1	3	1	3	0
ASE-2124	270	271	1	1	3	5	4	0
ASE-2125	270	279	9	1	3	5	4	0
ASE-2125	270	285	15	1	3	4	4	0
ASE-2125	270	271	1	1	3	5	0	0
ASE-2125	270	477	207	0	3	1	0	1
ASE-2125	271	284	13	1	2	5	4	2
ASE-2125	271	427	156	1	3	4	2	3
ASE-2125	271	287	16	1	3	4	3	0
ASE-2125	271	477	206	0	5	1	0	1
ASE-2125	271	273	2	1	3	5	3	1
ASE-2125	271	285	14	1	2	1	2	0
ASE-2126	272	287	15	1	3	1	4	0
ASE-2126	272	274	2	1	5	5	4	0
ASE-2126	273	477	204	0	3	5	2	0
ASE-2126	274	288	14	1	4	4	4	0
ASE-2126	275	477	202	0	2	1	0	0
ASE-2126	275	333	58	1	4	3	3	1
ASE-2126	275	288	13	1	3	1	4	1
ASE-2126	276	477	201	0	4	5	0	0
ASE-2126	276	283	7	1	3	5	1	0
ASE-2126	276	290	14	1	3	5	2	0
ASE-2127	277	477	200	0	3	1	0	0
ASE-2127	277	285	8	1	3	1	2	0
ASE-2127	277	278	1	1	4	5	1	0
ASE-2127	277	280	3	1	3	3	1	0
ASE-2127	278	477	199	0	3	5	0	0
ASE-2127	278	290	12	1	4	1	2	0
ASE-2127	280	477	197	0	3	1	0	0
ASE-2127	280	282	2	1	3	5	1	0
ASE-2127	280	288	8	1	2	5	2	1
ASE-2127	280	290	10	1	3	5	1	1
ASE-2128	281	282	1	1	5	1	4	0
ASE-2128	281	292	11	1	3	3	2	2
ASE-2128	281	283	2	1	3	3	3	1
ASE-2128	281	343	62	1	4	4	3	0
ASE-2128	282	477	195	0	3	5	0	0
ASE-2128	282	477	195	0	4	4	0	0
ASE-2128	282	477	195	0	4	4	0	0
ASE-2128	282	283	1	1	3	3	4	0
ASE-2128	283	290	7	1	3	5	2	0
ASE-2128	283	284	1	1	4	4	4	0
ASE-2129	283	288	5	1	3	4	4	0
ASE-2129	283	290	7	1	3	1	4	1
ASE-2129	283	290	7	1	3	1	4	0
ASE-2129	283	284	1	1	3	3	1	1
ASE-2129	283	294	11	1	3	3	1	1
ASE-2129	283	379	96	1	4	4	1	1
ASE-2129	283	399	116	1	3	3	0	1
ASE-2129	283	374	91	1	4	4	4	0
ASE-2129	283	477	194	0	3	4	0	0
ASE-2129	284	285	1	1	3	4	3	0
ASE-2130	284	332	48	1	3	1	4	0
ASE-2130	284	477	193	0	3	4	1	0
ASE-2130	284	294	10	1	3	3	1	0
ASE-2130	284	285	1	1	3	4	4	0
ASE-2130	284	477	193	0	4	1	0	0
ASE-2130	284	285	1	1	3	3	0	1
ASE-2130	284	477	193	0	3	3	0	0
ASE-2130	284	290	6	1	2	1	1	0
ASE-2130	285	477	192	0	3	5	2	0
ASE-2130	285	287	2	1	3	5	4	0
ASE-2131	285	289	4	1	3	5	4	0
ASE-2131	285	289	4	1	3	5	4	0
ASE-2131	286	477	191	0	4	4	0	0
ASE-2131	287	477	190	0	3	5	0	0
ASE-2131	287	309	22	1	3	5	4	0
ASE-2131	287	288	1	1	3	5	4	0
ASE-2131	287	477	190	0	3	1	0	0
ASE-2131	287	288	1	1	3	1	1	0
ASE-2131	288	296	8	1	4	4	3	0
ASE-2131	288	477	189	0	3	4	0	0
ASE-2132	288	289	1	1	3	1	3	0
ASE-2132	288	295	7	1	2	5	2	1
ASE-2132	288	302	14	1	2	5	4	1
ASE-2132	288	291	3	1	3	5	4	1
ASE-2132	288	289	1	1	3	1	0	0
ASE-2132	289	301	12	1	3	4	3	1
ASE-2132	289	290	1	1	3	1	0	0
ASE-2132	289	290	1	1	5	1	4	0
ASE-2132	289	309	20	1	4	4	3	0
ASE-2132	289	477	188	0	3	5	0	0
ASE-2133	289	290	1	1	3	5	2	0
ASE-2133	289	477	188	0	3	1	0	0
ASE-2133	289	295	6	1	4	1	0	0
ASE-2133	289	477	188	0	3	5	0	0
ASE-2133	290	294	4	1	3	1	4	1
ASE-2133	290	291	1	1	2	1	4	1
ASE-2133	290	294	4	1	3	5	4	1
ASE-2133	290	291	1	1	3	1	0	0
ASE-2133	290	295	5	1	3	5	4	1
ASE-2133	290	477	187	0	4	3	0	0
ASE-2134	290	477	187	0	4	3	0	0
ASE-2134	290	477	187	0	3	1	1	0
ASE-2134	290	295	5	1	3	1	4	3
ASE-2134	290	291	1	1	3	1	0	0
ASE-2134	290	297	7	1	3	1	1	0
ASE-2134	291	292	1	1	3	1	2	0
ASE-2134	291	477	186	0	3	3	0	0
ASE-2134	291	309	18	1	2	5	3	0
ASE-2134	292	293	1	1	3	1	2	0
ASE-2134	292	295	3	1	4	1	4	0
ASE-2135	292	477	185	0	3	5	2	0
ASE-2135	292	306	14	1	2	5	4	0
ASE-2135	292	477	185	0	3	5	2	0
ASE-2135	292	295	3	1	3	5	1	0
ASE-2135	293	295	2	1	3	5	4	2
ASE-2135	293	294	1	1	1	1	4	1
ASE-2135	293	295	2	1	3	1	4	0
ASE-2135	294	296	2	1	2	1	3	0
ASE-2135	294	477	183	0	3	1	0	0
ASE-2135	294	333	39	1	5	1	2	0
ASE-2136	295	372	77	1	4	4	2	0
ASE-2136	295	371	76	1	4	5	2	0
ASE-2136	295	371	76	1	4	5	2	0
ASE-2136	295	296	1	1	3	5	4	1
ASE-2136	295	297	2	1	1	5	4	2
ASE-2136	295	298	3	1	4	4	1	0
ASE-2136	295	477	182	0	4	4	0	0
ASE-2136	295	477	182	0	4	4	0	0
ASE-2136	295	477	182	0	3	1	0	0
ASE-2136	295	477	182	0	3	3	0	0
ASE-2137	295	477	182	0	3	3	0	0
ASE-2137	295	301	6	1	3	1	4	2
ASE-2137	295	296	1	1	3	5	4	0
ASE-2137	295	311	16	1	3	4	2	1
ASE-2137	295	408	113	1	3	5	4	2
ASE-2137	296	301	5	1	3	5	4	1
ASE-2137	296	313	17	1	3	5	4	1
ASE-2137	296	322	26	1	3	5	4	0
ASE-2137	296	301	5	1	3	1	1	0
ASE-2137	296	358	62	1	3	1	0	1
ASE-2138	296	298	2	1	3	1	1	1
ASE-2138	296	309	13	1	3	3	1	0
ASE-2138	296	477	181	0	3	1	0	1
ASE-2138	296	298	2	1	3	1	1	1
ASE-2138	297	298	1	1	1	5	4	1
ASE-2138	297	298	1	1	3	4	4	0
ASE-2138	297	298	1	1	3	5	0	0
ASE-2138	297	327	30	1	3	1	4	2
ASE-2138	298	304	6	1	3	4	4	0
ASE-2138	298	302	4	1	3	5	1	0
ASE-2139	298	318	20	1	3	4	0	1
ASE-2139	298	299	1	1	3	1	3	0
ASE-2139	298	477	179	0	3	4	0	0
ASE-2139	298	477	179	0	3	5	0	1
ASE-2139	298	324	26	1	3	4	3	0
ASE-2139	298	308	10	1	3	5	2	1
ASE-2139	298	309	11	1	3	3	1	0
ASE-2139	298	299	1	1	3	5	1	0
ASE-2139	298	299	1	1	3	5	1	0
ASE-2139	298	306	8	1	3	5	1	0
ASE-2140	299	477	178	0	5	1	0	0
ASE-2140	299	354	55	1	2	5	4	2
ASE-2140	301	396	95	1	3	5	2	1
ASE-2140	301	477	176	0	5	5	0	0
ASE-2140	301	395	94	1	4	1	1	0
ASE-2140	302	477	175	0	4	4	0	1
ASE-2140	302	477	175	0	4	4	0	1
ASE-2140	302	305	3	1	4	1	4	0
ASE-2140	302	477	175	0	3	4	0	0
ASE-2140	302	477	175	0	3	1	0	0
ASE-2141	302	427	125	1	3	4	3	0
ASE-2141	302	311	9	1	3	4	1	0
ASE-2141	303	477	174	0	3	1	0	0
ASE-2141	303	340	37	1	3	4	4	1
ASE-2141	303	339	36	1	4	4	1	0
ASE-2141	303	477	174	0	5	4	0	0
ASE-2141	303	431	128	1	4	5	2	0
ASE-2141	304	305	1	1	2	1	4	0
ASE-2141	304	477	173	0	4	4	0	0
ASE-2141	304	311	7	1	3	5	1	0
ASE-2142	304	308	4	1	3	5	1	0
ASE-2142	304	309	5	1	3	5	4	1
ASE-2142	304	305	1	1	3	1	2	0
ASE-2142	304	315	11	1	3	5	2	1
ASE-2142	304	305	1	1	3	1	4	1
ASE-2142	304	306	2	1	2	1	4	1
ASE-2142	305	477	172	0	3	1	0	0
ASE-2142	305	477	172	0	3	4	0	1
ASE-2142	305	477	172	0	3	1	0	0
ASE-2142	305	306	1	1	4	1	1	0
ASE-2143	305	309	4	1	3	1	2	1
ASE-2143	307	308	1	1	1	1	1	0
ASE-2143	307	414	107	1	3	3	1	0
ASE-2143	307	423	116	1	3	3	1	0
ASE-2143	308	309	1	1	3	1	1	0
ASE-2143	308	309	1	1	4	5	1	0
ASE-2143	308	477	169	0	3	4	0	0
ASE-2143	308	312	4	1	3	1	4	0
ASE-2143	308	309	1	1	3	1	4	0
ASE-2143	308	311	3	1	3	1	4	0
ASE-2144	309	321	12	1	3	1	2	0
ASE-2144	309	310	1	1	3	5	1	0
ASE-2144	309	310	1	1	3	5	1	0
ASE-2144	309	310	1	1	3	5	2	0
ASE-2144	310	477	167	0	3	1	0	0
ASE-2144	310	313	3	1	3	1	4	0
ASE-2144	310	311	1	1	3	1	1	0
ASE-2144	310	477	167	0	3	4	0	1
ASE-2144	310	311	1	1	3	1	1	0
ASE-2144	310	477	167	0	3	1	0	0
ASE-2145	310	423	113	1	3	1	1	1
ASE-2145	311	312	1	1	3	5	1	0
ASE-2145	311	317	6	1	3	1	2	0
ASE-2145	311	344	33	1	3	1	3	0
ASE-2145	311	477	166	0	3	1	2	0
ASE-2145	311	477	166	0	3	1	1	0
ASE-2145	311	457	146	1	3	5	1	0
ASE-2145	311	372	61	1	3	1	1	2
ASE-2145	311	477	166	0	3	1	0	0
ASE-2145	312	358	46	1	3	5	0	0
ASE-2146	312	318	6	1	3	4	1	1
ASE-2146	312	477	165	0	4	2	0	0
ASE-2146	312	477	165	0	4	4	0	0
ASE-2146	312	316	4	1	2	5	2	2
ASE-2146	312	338	26	1	1	1	1	1
ASE-2146	314	333	19	1	3	5	2	0
ASE-2146	314	316	2	1	3	1	2	0
ASE-2146	314	477	163	0	4	1	0	0
ASE-2146	315	317	2	1	3	1	2	1
ASE-2146	315	477	162	0	3	1	0	2
ASE-2147	315	477	162	0	3	3	0	1
ASE-2147	315	477	162	0	3	5	0	0
ASE-2147	316	318	2	1	3	5	2	0
ASE-2147	316	317	1	1	3	5	4	1
ASE-2147	316	477	161	0	3	5	0	1
ASE-2147	316	388	72	1	3	1	4	0
ASE-2147	316	477	161	0	3	2	0	0
ASE-2147	317	477	160	0	3	1	0	1
ASE-2147	317	477	160	0	4	4	0	0
ASE-2147	317	334	17	1	3	1	3	0
ASE-2148	318	322	4	1	3	4	4	1
ASE-2148	318	424	106	1	3	4	3	0
ASE-2148	318	477	159	0	3	1	0	0
ASE-2148	318	319	1	1	3	1	1	0
ASE-2148	318	319	1	1	3	1	1	0
ASE-2148	319	320	1	1	3	4	3	0
ASE-2148	319	334	15	1	2	5	1	0
ASE-2148	319	425	106	1	3	1	3	1
ASE-2148	319	477	158	0	3	5	2	0
ASE-2148	319	321	2	1	3	5	2	1
ASE-2149	319	322	3	1	3	5	4	0
ASE-2149	319	320	1	1	5	4	1	0
ASE-2149	319	330	11	1	2	1	4	0
ASE-2149	320	335	15	1	3	3	1	0
ASE-2149	320	322	2	1	3	5	1	0
ASE-2149	321	336	15	1	3	3	1	2
ASE-2149	321	322	1	1	3	5	1	0
ASE-2149	321	322	1	1	3	5	1	0
ASE-2149	322	352	30	1	3	1	4	0
ASE-2149	322	323	1	1	3	5	1	0
ASE-2150	323	477	154	0	4	1	1	1
ASE-2150	323	329	6	1	3	4	0	0
ASE-2150	323	477	154	0	5	3	0	1
ASE-2150	323	324	1	1	1	1	4	1
ASE-2150	324	333	9	1	2	1	4	0
ASE-2150	324	420	96	1	3	1	2	0
ASE-2150	324	325	1	1	4	4	0	0
ASE-2150	326	330	4	1	3	1	4	0
ASE-2150	326	329	3	1	3	5	2	1
ASE-2150	327	477	150	0	4	1	0	2
ASE-2151	327	477	150	0	3	1	1	0
ASE-2151	327	329	2	1	4	4	4	1
ASE-2151	328	477	149	0	3	5	1	0
ASE-2151	329	477	148	0	3	1	0	0
ASE-2151	329	352	23	1	3	4	2	1
ASE-2151	330	334	4	1	3	5	1	0
ASE-2151	330	337	7	1	3	5	1	0
ASE-2151	330	331	1	1	3	3	4	0
ASE-2151	330	334	4	1	3	1	4	0
ASE-2151	330	477	147	0	2	1	0	0
ASE-2152	331	348	17	1	3	4	4	2
ASE-2152	332	477	145	0	3	4	0	0
ASE-2152	332	477	145	0	3	1	0	0
ASE-2152	332	333	1	1	3	4	1	0
ASE-2152	332	333	1	1	3	4	3	1
ASE-2152	332	455	123	1	4	1	0	1
ASE-2152	332	344	12	1	3	5	1	0
ASE-2152	332	333	1	1	3	4	1	1
ASE-2152	332	477	145	0	4	3	0	0
ASE-2152	332	477	145	0	3	1	0	0
ASE-2153	332	477	145	0	4	4	0	0
ASE-2153	332	337	5	1	3	1	0	1
ASE-2153	333	477	144	0	4	1	0	0
ASE-2153	333	477	144	0	3	3	1	1
ASE-2153	333	339	6	1	3	3	2	1
ASE-2153	333	394	61	1	2	1	4	1
ASE-2153	333	477	144	0	5	3	0	0
ASE-2153	334	378	44	1	3	5	1	0
ASE-2153	334	369	35	1	3	5	1	0
ASE-2153	334	477	143	0	3	5	0	0
ASE-2154	335	477	142	0	3	1	4	0
ASE-2154	336	337	1	1	3	3	2	0
ASE-2154	336	337	1	1	3	5	0	0
ASE-2154	336	337	1	1	3	5	1	0
ASE-2154	336	338	2	1	3	1	1	2
ASE-2154	337	357	20	1	3	1	4	1
ASE-2154	337	338	1	1	3	1	2	0
ASE-2154	337	366	29	1	3	1	4	0
ASE-2154	337	477	140	0	3	4	1	1
ASE-2154	338	346	8	1	3	4	3	0
ASE-2155	338	339	1	1	3	1	2	0
ASE-2155	338	340	2	1	1	1	4	1
ASE-2155	339	477	138	0	3	4	0	0
ASE-2155	339	344	5	1	2	1	3	1
ASE-2155	339	346	7	1	4	4	3	0
ASE-2155	339	371	32	1	3	3	0	2
ASE-2155	339	373	34	1	3	3	1	3
ASE-2155	339	340	1	1	3	5	1	0
ASE-2155	339	340	1	1	3	5	0	0
ASE-2155	339	340	1	1	3	1	4	2
ASE-2156	339	341	2	1	3	4	2	1
ASE-2156	339	386	47	1	4	5	3	1
ASE-2156	339	340	1	1	3	1	1	0
ASE-2156	339	477	138	0	3	1	0	1
ASE-2156	340	477	137	0	2	1	0	0
ASE-2156	340	427	87	1	2	1	2	1
ASE-2156	340	341	1	1	3	5	2	1
ASE-2156	340	343	3	1	3	4	4	0
ASE-2156	340	344	4	1	3	1	4	0
ASE-2156	341	477	136	0	3	5	0	0
ASE-2157	342	344	2	1	3	5	4	1
ASE-2157	343	385	42	1	3	1	0	1
ASE-2157	343	477	134	0	3	1	1	0
ASE-2157	343	477	134	0	2	5	0	0
ASE-2157	343	477	134	0	3	1	0	0
ASE-2157	343	346	3	1	4	1	3	0
ASE-2157	344	387	43	1	3	1	0	0
ASE-2157	344	477	133	0	2	4	0	0
ASE-2157	344	347	3	1	3	5	2	1
ASE-2157	344	366	22	1	3	5	1	0
ASE-2158	344	375	31	1	3	5	4	0
ASE-2158	344	345	1	1	4	4	0	0
ASE-2158	344	346	2	1	3	1	4	0
ASE-2158	344	477	133	0	3	1	0	0
ASE-2158	344	477	133	0	3	3	0	0
ASE-2158	344	408	64	1	3	5	1	0
ASE-2158	344	477	133	0	5	4	0	0
ASE-2158	344	477	133	0	3	4	0	0
ASE-2158	345	427	82	1	3	5	2	1
ASE-2158	345	350	5	1	1	1	4	0
ASE-2159	345	379	34	1	2	4	4	0
ASE-2159	345	477	132	0	5	4	0	0
ASE-2159	346	351	5	1	3	1	4	0
ASE-2159	346	477	131	0	4	1	0	0
ASE-2159	346	477	131	0	3	1	0	0
ASE-2159	346	381	35	1	4	4	3	0
ASE-2159	346	477	131	0	4	1	0	0
ASE-2159	346	477	131	0	3	1	0	1
ASE-2159	346	477	131	0	3	1	0	0
ASE-2159	346	367	21	1	5	1	1	0
ASE-2160	346	477	131	0	5	3	1	0
ASE-2160	347	477	130	0	2	1	0	2
ASE-2160	347	477	130	0	3	3	0	0
ASE-2160	347	389	42	1	3	5	0	0
ASE-2160	347	477	130	0	3	4	0	0
ASE-2160	347	477	130	0	2	3	0	1
ASE-2160	347	477	130	0	2	3	0	1
ASE-2160	347	477	130	0	3	1	0	0
ASE-2160	348	350	2	1	3	1	0	1
ASE-2160	348	477	129	0	1	1	0	0
ASE-2161	350	354	4	1	4	1	4	0
ASE-2161	350	477	127	0	3	1	0	0
ASE-2161	351	380	29	1	4	5	4	0
ASE-2161	351	477	126	0	3	1	0	0
ASE-2161	351	373	22	1	2	1	2	0
ASE-2161	352	353	1	1	3	5	0	1
ASE-2161	352	380	28	1	3	5	1	3
ASE-2161	352	477	125	0	3	1	0	0
ASE-2161	352	373	21	1	2	1	4	0
ASE-2161	352	448	96	1	5	1	4	0
ASE-2162	352	354	2	1	3	1	4	0
ASE-2162	352	356	4	1	2	1	4	0
ASE-2162	352	477	125	0	5	1	0	0
ASE-2162	352	477	125	0	2	1	0	0
ASE-2162	353	477	124	0	3	4	0	0
ASE-2162	353	406	53	1	2	1	0	0
ASE-2162	353	386	33	1	3	1	1	0
ASE-2162	353	477	124	0	3	1	0	0
ASE-2162	354	477	123	0	3	1	0	0
ASE-2162	354	357	3	1	3	1	4	0
ASE-2163	354	368	14	1	5	1	4	0
ASE-2163	354	357	3	1	4	4	4	1
ASE-2163	354	358	4	1	3	5	2	0
ASE-2163	355	356	1	1	3	1	0	0
ASE-2163	356	395	39	1	4	4	4	0
ASE-2163	356	357	1	1	3	4	4	0
ASE-2163	356	406	50	1	3	4	4	0
ASE-2163	356	357	1	1	4	1	1	1
ASE-2163	356	477	121	0	4	5	0	0
ASE-2163	357	379	22	1	4	1	4	0
ASE-2164	358	359	1	1	3	4	4	0
ASE-2164	359	477	118	0	4	4	0	0
ASE-2164	359	360	1	1	3	4	2	2
ASE-2164	359	360	1	1	3	4	2	0
ASE-2164	359	395	36	1	2	1	4	2
ASE-2164	359	373	14	1	4	4	4	0
ASE-2164	360	361	1	1	3	1	4	1
ASE-2164	360	380	20	1	3	5	2	0
ASE-2164	360	477	117	0	3	1	0	0
ASE-2164	360	477	117	0	3	5	2	0
ASE-2165	360	361	1	1	3	5	2	1
ASE-2165	360	385	25	1	2	1	0	1
ASE-2165	360	374	14	1	3	5	2	1
ASE-2165	361	477	116	0	3	1	0	1
ASE-2165	361	477	116	0	3	5	0	1
ASE-2165	361	477	116	0	3	5	0	0
ASE-2165	361	477	116	0	3	1	0	1
ASE-2165	361	380	19	1	3	1	2	3
ASE-2165	361	477	116	0	2	4	0	0
ASE-2165	362	366	4	1	4	4	3	0
ASE-2166	362	365	3	1	3	1	2	0
ASE-2166	362	373	11	1	3	5	2	0
ASE-2166	362	367	5	1	3	4	4	0
DS-	114	126	12	1	3	4	1	2
DS-1	116	276	160	1	3	5	1	3
DS-10	142	158	16	1	3	5	1	1
DS-10	142	299	157	1	3	5	1	0
DS-10	142	356	214	1	3	5	0	1
DS-10	142	301	159	1	3	5	0	2
DS-10	142	477	335	0	3	5	0	0
DS-10	142	477	335	0	3	5	0	0
DS-10	103	156	53	1	3	5	1	0
DS-10	142	240	98	1	3	1	1	0
DS-10	142	163	21	1	3	1	1	0
DS-1	118	119	1	1	3	1	1	1
DS-11	142	143	1	1	3	1	1	0
DS-11	142	162	20	1	3	3	1	0
DS-11	142	150	8	1	3	3	1	0
DS-11	142	144	2	1	3	3	1	0
DS-11	142	148	6	1	1	1	1	0
DS-11	142	346	204	1	3	5	0	4
DS-11	142	150	8	1	3	5	1	0
DS-11	142	477	335	0	3	4	0	0
DS-11	143	477	334	0	3	1	0	0
DS-11	143	228	85	1	3	1	1	1
DS-1	119	127	8	1	3	4	1	1
DS-12	143	319	176	1	3	2	1	1
DS-12	143	477	334	0	3	1	0	2
DS-12	143	261	118	1	3	1	0	2
DS-12	144	156	12	1	3	5	1	2
DS-12	145	219	74	1	3	4	1	1
DS-12	145	148	3	1	3	5	1	0
DS-12	147	154	7	1	3	1	1	0
DS-12	147	157	10	1	3	1	1	0
DS-12	147	149	2	1	3	5	1	0
DS-12	147	155	8	1	3	5	1	0
DS-1	119	120	1	1	3	4	1	0
DS-13	147	162	15	1	4	1	1	0
DS-13	148	199	51	1	3	1	1	0
DS-13	149	240	91	1	1	1	1	0
DS-13	149	161	12	1	3	5	1	2
DS-13	150	424	274	1	3	5	1	3
DS-13	150	317	167	1	3	5	0	0
DS-13	150	161	11	1	3	5	1	2
DS-13	150	151	1	1	3	5	1	0
DS-13	150	261	111	1	1	1	0	1
DS-13	150	450	300	1	3	4	1	0
DS-1	79	261	182	1	3	4	0	0
DS-14	151	157	6	1	3	5	1	0
DS-14	151	168	17	1	3	1	1	0
DS-14	118	151	33	1	3	1	1	2
DS-14	151	152	1	1	3	4	1	0
DS-14	151	152	1	1	3	5	1	0
DS-14	152	154	2	1	1	5	1	0
DS-14	152	164	12	1	3	4	1	0
DS-14	154	157	3	1	3	4	1	1
DS-14	155	156	1	1	3	5	1	0
DS-14	155	477	322	0	3	1	0	0
DS-1	120	121	1	1	3	4	1	0
DS-15	155	477	322	0	3	5	0	0
DS-15	155	477	322	0	3	2	0	1
DS-15	155	317	162	1	3	5	0	1
DS-15	155	477	322	0	3	5	0	0
DS-15	155	261	106	1	3	4	0	2
DS-15	156	165	9	1	3	5	1	1
DS-15	157	164	7	1	3	5	1	2
DS-15	158	159	1	1	3	4	1	1
DS-15	159	162	3	1	3	1	1	0
DS-15	160	163	3	1	3	3	1	0
DS-16	161	165	4	1	3	5	1	1
DS-16	162	164	2	1	3	1	1	0
DS-16	162	163	1	1	3	1	1	0
DS-16	163	164	1	1	3	5	1	0
DS-16	164	323	159	1	3	5	1	0
DS-16	164	477	313	0	3	5	0	0
DS-16	164	174	10	1	3	3	1	0
DS-16	164	186	22	1	3	3	1	3
DS-16	164	477	313	0	3	4	0	0
DS-16	165	179	14	1	3	5	1	2
DS-1	123	131	8	1	3	4	1	0
DS-17	165	177	12	1	3	5	1	0
DS-17	165	477	312	0	3	5	0	1
DS-17	165	166	1	1	4	4	1	0
DS-17	165	178	13	1	3	5	1	1
DS-17	165	261	96	1	1	4	1	0
DS-17	165	183	18	1	3	1	1	0
DS-17	165	183	18	1	3	5	1	1
DS-17	168	174	6	1	3	4	1	0
DS-17	169	178	9	1	3	3	1	0
DS-17	169	227	58	1	3	1	1	1
DS-1	100	129	29	1	3	4	1	0
DS-18	169	170	1	1	3	1	1	1
DS-18	169	203	34	1	3	1	1	1
DS-18	171	186	15	1	3	5	1	2
DS-18	171	178	7	1	3	5	1	0
DS-18	172	173	1	1	3	4	1	1
DS-18	172	178	6	1	3	5	1	0
DS-18	172	177	5	1	3	1	1	0
DS-18	172	193	21	1	3	1	1	0
DS-18	172	296	124	1	3	4	0	2
DS-18	172	175	3	1	3	4	1	1
DS-1	105	133	28	1	1	1	1	0
DS-19	172	249	77	1	1	4	1	0
DS-19	173	175	2	1	3	4	1	0
DS-19	173	176	3	1	3	2	1	0
DS-19	175	177	2	1	3	4	1	0
DS-19	175	177	2	1	3	4	1	0
DS-19	176	178	2	1	3	4	1	0
DS-19	176	477	301	0	1	1	0	0
DS-19	177	219	42	1	1	1	1	1
DS-19	177	183	6	1	3	2	1	0
DS-19	177	203	26	1	3	4	1	1
DS-	113	248	135	1	2	3	1	2
DS-2	63	128	65	1	3	4	1	0
DS-20	177	477	300	0	3	1	0	0
DS-20	178	206	28	1	4	4	1	0
DS-20	178	205	27	1	3	2	1	0
DS-20	178	186	8	1	3	5	1	0
DS-20	179	183	4	1	3	5	1	1
DS-20	179	182	3	1	3	1	1	0
DS-20	179	198	19	1	3	1	1	0
DS-20	182	190	8	1	3	1	1	0
DS-20	182	199	17	1	3	1	1	0
DS-2	63	131	68	1	3	4	1	0
DS-21	182	193	11	1	3	1	1	0
DS-21	183	186	3	1	3	5	1	0
DS-21	183	184	1	1	3	4	1	0
DS-21	183	189	6	1	3	5	1	1
DS-21	183	273	90	1	3	2	1	1
DS-21	183	187	4	1	3	5	0	0
DS-21	183	477	294	0	3	1	0	1
DS-21	184	188	4	1	3	4	1	0
DS-21	184	228	44	1	4	5	1	0
DS-21	184	220	36	1	3	5	1	0
DS-2	123	261	138	1	3	4	0	0
DS-22	184	477	293	0	3	4	0	1
DS-22	184	477	293	0	3	4	0	0
DS-22	184	253	69	1	3	5	1	0
DS-22	184	318	134	1	3	4	1	0
DS-22	184	189	5	1	3	4	1	0
DS-22	185	477	292	0	3	4	0	0
DS-22	185	212	27	1	3	1	1	0
DS-22	185	238	53	1	3	1	1	0
DS-22	185	192	7	1	3	4	1	1
DS-22	185	186	1	1	1	5	1	0
DS-2	123	127	4	1	3	5	1	0
DS-23	185	218	33	1	2	1	1	1
DS-23	185	477	292	0	3	4	0	0
DS-23	185	193	8	1	3	4	1	2
DS-23	186	255	69	1	3	1	1	0
DS-23	186	192	6	1	3	1	1	0
DS-23	186	188	2	1	3	5	1	0
DS-23	186	193	7	1	3	1	1	1
DS-23	186	187	1	1	3	5	1	0
DS-23	188	193	5	1	3	4	1	0
DS-23	188	200	12	1	3	1	1	0
DS-2	126	477	351	0	3	4	0	0
DS-24	189	190	1	1	3	4	1	0
DS-24	189	198	9	1	3	1	1	1
DS-24	189	191	2	1	3	4	1	1
DS-24	189	261	72	1	3	4	0	0
DS-24	190	228	38	1	1	1	1	1
DS-24	190	220	30	1	3	4	1	3
DS-24	190	208	18	1	1	1	1	0
DS-24	190	239	49	1	1	1	1	1
DS-24	190	208	18	1	3	4	1	0
DS-24	190	201	11	1	3	4	1	1
DS-2	126	130	4	1	3	4	1	0
DS-25	190	200	10	1	3	4	1	0
DS-25	191	195	4	1	3	1	1	0
DS-25	192	477	285	0	3	4	0	0
DS-25	193	194	1	1	3	1	1	0
DS-25	193	195	2	1	3	1	1	0
DS-25	193	198	5	1	4	5	1	0
DS-25	193	200	7	1	3	1	1	1
DS-25	193	200	7	1	3	1	1	0
DS-25	198	204	6	1	3	4	1	0
DS-25	198	200	2	1	3	4	1	0
DS-2	126	477	351	0	3	5	0	0
DS-26	198	200	2	1	3	5	1	0
DS-26	198	199	1	1	4	1	0	0
DS-26	198	204	6	1	3	1	1	0
DS-26	199	245	46	1	1	1	1	3
DS-26	199	200	1	1	4	1	1	0
DS-26	199	233	34	1	3	1	1	0
DS-26	199	205	6	1	3	1	1	1
DS-26	199	219	20	1	3	1	1	1
DS-26	199	247	48	1	1	1	1	0
DS-26	199	200	1	1	3	4	1	1
DS-2	126	127	1	1	3	5	1	0
DS-27	199	207	8	1	3	4	1	0
DS-27	200	211	11	1	3	4	1	1
DS-27	200	204	4	1	3	1	1	0
DS-27	200	208	8	1	2	1	1	0
DS-27	200	422	222	1	3	4	0	0
DS-27	200	201	1	1	4	1	1	0
DS-27	200	235	35	1	4	1	1	0
DS-27	200	206	6	1	1	1	1	0
DS-27	200	214	14	1	3	1	0	1
DS-27	201	211	10	1	3	1	1	0
DS-2	126	128	2	1	3	1	1	0
DS-28	203	240	37	1	3	1	1	0
DS-28	203	477	274	0	4	4	0	0
DS-28	203	204	1	1	3	1	1	0
DS-28	203	477	274	0	1	1	0	0
DS-28	203	331	128	1	3	4	1	0
DS-28	203	205	2	1	3	4	1	1
DS-28	204	214	10	1	3	1	1	0
DS-28	204	210	6	1	3	4	1	0
DS-28	204	205	1	1	3	1	1	0
DS-28	204	270	66	1	3	1	1	0
DS-2	126	133	7	1	3	5	1	0
DS-29	204	213	9	1	3	1	1	0
DS-29	205	206	1	1	4	1	1	0
DS-29	205	206	1	1	3	1	1	0
DS-29	205	210	5	1	3	4	1	0
DS-29	206	457	251	1	3	1	0	0
DS-29	206	225	19	1	3	1	1	1
DS-29	206	248	42	1	2	1	1	0
DS-29	207	248	41	1	3	1	1	1
DS-29	207	225	18	1	2	4	1	0
DS-29	207	477	270	0	3	4	0	0
DS-	100	136	36	1	3	3	1	1
DS-3	126	129	3	1	3	5	1	0
DS-30	208	214	6	1	3	4	1	0
DS-30	210	218	8	1	3	1	1	0
DS-30	210	211	1	1	3	1	1	0
DS-30	210	247	37	1	3	4	1	0
DS-30	210	213	3	1	3	4	1	0
DS-30	210	211	1	1	3	4	1	0
DS-30	211	285	74	1	3	1	0	0
DS-30	211	218	7	1	1	1	1	0
DS-30	212	224	12	1	3	1	1	0
DS-30	212	217	5	1	4	1	0	0
DS-3	126	129	3	1	3	5	1	0
DS-31	212	213	1	1	3	1	1	0
DS-31	212	477	265	0	3	1	0	0
DS-31	213	214	1	1	4	4	1	0
DS-31	213	238	25	1	3	1	1	0
DS-31	213	248	35	1	2	1	1	0
DS-31	213	247	34	1	3	1	1	0
DS-31	213	477	264	0	3	4	0	0
DS-31	213	235	22	1	3	4	1	0
DS-31	213	282	69	1	1	1	0	2
DS-31	213	477	264	0	3	1	0	0
DS-3	127	131	4	1	3	5	1	0
DS-32	214	261	47	1	4	1	0	0
DS-32	214	249	35	1	1	1	1	0
DS-32	214	221	7	1	3	1	1	0
DS-32	214	477	263	0	3	4	0	0
DS-32	216	224	8	1	3	1	1	0
DS-32	217	273	56	1	3	1	1	0
DS-32	217	252	35	1	2	4	1	0
DS-32	217	221	4	1	3	1	1	0
DS-32	217	234	17	1	2	4	1	1
DS-32	58	477	419	0	3	2	0	0
DS-3	105	128	23	1	3	5	1	0
DS-33	218	219	1	1	3	1	0	0
DS-33	218	239	21	1	3	1	1	1
DS-33	218	247	29	1	3	4	1	0
DS-33	219	238	19	1	4	1	1	1
DS-33	219	220	1	1	3	1	0	0
DS-33	219	245	26	1	3	4	1	0
DS-33	219	242	23	1	3	1	1	0
DS-33	219	477	258	0	2	1	0	0
DS-33	219	221	2	1	3	1	1	0
DS-3	127	130	3	1	3	5	1	0
DS-34	219	477	258	0	3	1	0	0
DS-34	219	477	258	0	1	1	0	1
DS-34	220	233	13	1	4	4	1	0
DS-34	220	245	25	1	1	1	1	0
DS-34	220	221	1	1	5	1	1	0
DS-34	221	225	4	1	3	4	1	1
DS-34	221	224	3	1	4	1	1	0
DS-34	221	226	5	1	3	1	1	1
DS-34	223	280	57	1	3	1	0	1
DS-34	224	235	11	1	3	1	1	0
DS-35	227	233	6	1	3	1	1	1
DS-35	227	249	22	1	3	1	1	3
DS-35	227	260	33	1	3	4	1	0
DS-35	227	231	4	1	3	5	1	0
DS-35	227	277	50	1	3	1	1	0
DS-35	227	228	1	1	3	1	1	0
DS-35	227	234	7	1	3	1	1	0
DS-35	227	244	17	1	3	1	1	0
DS-35	227	247	20	1	3	1	1	0
DS-35	227	239	12	1	3	1	1	0
DS-3	128	129	1	1	3	1	1	0
DS-36	227	407	180	1	3	1	1	0
DS-36	227	477	250	0	3	1	0	0
DS-36	227	259	32	1	3	3	1	1
DS-36	228	235	7	1	4	4	1	0
DS-36	228	235	7	1	3	2	1	1
DS-36	231	240	9	1	3	1	1	0
DS-36	231	260	29	1	3	3	1	3
DS-36	232	233	1	1	5	1	0	1
DS-36	233	477	244	0	2	1	0	0
DS-36	233	246	13	1	3	4	1	1
DS-3	128	130	2	1	3	1	1	0
DS-37	233	267	34	1	3	2	1	1
DS-37	234	477	243	0	3	1	0	0
DS-37	234	463	229	1	3	4	1	1
DS-37	235	477	242	0	3	4	0	0
DS-37	235	238	3	1	3	4	1	0
DS-37	235	238	3	1	3	2	1	0
DS-37	235	239	4	1	3	4	1	1
DS-37	238	239	1	1	3	4	1	0
DS-37	238	288	50	1	3	4	2	2
DS-37	238	243	5	1	3	4	1	0
DS-3	128	136	8	1	3	1	1	0
DS-38	239	240	1	1	3	1	1	1
DS-38	239	240	1	1	3	1	1	0
DS-38	239	240	1	1	3	1	1	1
DS-38	239	247	8	1	3	1	1	1
DS-38	239	477	238	0	3	2	0	0
DS-38	241	451	210	1	3	1	0	0
DS-38	241	477	236	0	3	1	0	0
DS-38	241	477	236	0	3	1	0	0
DS-38	242	243	1	1	5	1	1	0
DS-38	242	256	14	1	3	1	1	0
DS-3	92	130	38	1	3	4	1	0
DS-39	242	477	235	0	3	4	0	0
DS-39	242	270	28	1	3	4	1	1
DS-39	242	243	1	1	5	4	1	0
DS-39	242	366	124	1	3	2	1	2
DS-39	243	262	19	1	3	1	1	3
DS-39	245	254	9	1	3	1	1	0
DS-39	245	246	1	1	3	1	1	0
DS-39	245	248	3	1	3	1	1	0
DS-39	245	249	4	1	4	4	1	0
DS-39	246	259	13	1	1	1	1	1
DS-	52	477	425	0	3	2	0	1
DS-4	129	130	1	1	3	4	1	0
DS-40	246	249	3	1	1	1	1	0
DS-40	246	269	23	1	3	1	1	1
DS-40	246	248	2	1	3	5	0	0
DS-40	247	252	5	1	1	1	1	0
DS-40	248	249	1	1	3	4	1	0
DS-40	248	249	1	1	2	1	1	0
DS-40	248	249	1	1	3	1	1	0
DS-40	248	289	41	1	3	1	0	0
DS-40	248	249	1	1	1	1	1	0
DS-40	248	257	9	1	3	1	1	0
DS-41	249	251	2	1	4	1	1	0
DS-41	249	254	5	1	5	4	0	0
DS-41	249	250	1	1	3	1	1	0
DS-41	249	254	5	1	3	1	1	0
DS-41	249	255	6	1	3	1	1	0
DS-41	249	255	6	1	1	1	1	1
DS-41	249	253	4	1	3	1	1	0
DS-41	249	252	3	1	3	4	1	0
DS-41	250	477	227	0	3	1	0	0
DS-41	251	256	5	1	1	1	1	1
DS-4	129	130	1	1	3	4	1	0
DS-42	251	255	4	1	1	1	1	2
DS-42	251	252	1	1	3	1	1	0
DS-42	252	295	43	1	3	1	0	0
DS-42	252	255	3	1	4	1	1	2
DS-42	252	253	1	1	3	1	1	0
DS-42	252	254	2	1	4	4	1	0
DS-42	252	477	225	0	3	4	0	0
DS-42	252	477	225	0	3	1	0	0
DS-42	253	254	1	1	3	4	1	0
DS-42	253	256	3	1	1	4	1	1
DS-4	129	130	1	1	5	1	1	0
DS-43	253	254	1	1	3	1	1	1
DS-43	253	254	1	1	3	1	1	0
DS-43	253	254	1	1	2	1	1	0
DS-43	253	254	1	1	1	1	1	0
DS-43	254	304	50	1	3	2	2	0
DS-43	254	259	5	1	1	4	1	0
DS-43	254	255	1	1	3	4	1	0
DS-43	254	255	1	1	3	4	0	1
DS-43	254	256	2	1	3	4	1	0
DS-43	255	288	33	1	1	4	2	0
DS-4	91	142	51	1	3	1	1	0
DS-44	255	260	5	1	1	1	1	0
DS-44	255	266	11	1	3	5	1	1
DS-44	255	289	34	1	3	1	0	0
DS-44	255	282	27	1	3	4	1	0
DS-44	255	267	12	1	3	5	1	0
DS-44	255	284	29	1	3	5	2	0
DS-44	255	256	1	1	3	4	1	1
DS-44	255	266	11	1	3	4	1	2
DS-44	255	270	15	1	3	4	1	0
DS-44	255	257	2	1	4	4	1	0
DS-45	255	281	26	1	3	1	2	0
DS-45	255	422	167	1	1	1	0	2
DS-45	255	256	1	1	1	1	1	1
DS-45	255	427	172	1	3	4	0	0
DS-45	255	256	1	1	3	4	1	0
DS-45	255	270	15	1	4	4	1	0
DS-45	255	256	1	1	3	1	1	0
DS-45	255	477	222	0	3	1	0	0
DS-45	255	261	6	1	4	1	0	0
DS-45	256	271	15	1	3	4	0	0
DS-4	105	261	156	1	3	5	0	0
DS-46	256	261	5	1	3	1	1	0
DS-46	256	261	5	1	3	1	1	1
DS-46	256	257	1	1	3	4	1	1
DS-46	256	259	3	1	1	1	1	0
DS-46	256	260	4	1	3	5	1	2
DS-46	256	257	1	1	4	1	1	1
DS-46	256	257	1	1	3	1	1	0
DS-46	256	260	4	1	3	5	0	1
DS-46	256	260	4	1	3	4	1	1
DS-46	256	258	2	1	1	4	1	0
DS-4	130	131	1	1	3	5	1	0
DS-47	257	258	1	1	1	1	1	0
DS-47	257	261	4	1	3	3	1	0
DS-47	257	260	3	1	1	5	0	3
DS-47	257	258	1	1	1	5	0	3
DS-47	257	261	4	1	1	5	0	2
DS-47	258	259	1	1	1	1	0	2
DS-47	258	261	3	1	1	1	1	0
DS-47	258	297	39	1	3	1	0	0
DS-47	259	281	22	1	3	1	1	0
DS-47	259	277	18	1	4	5	1	1
DS-4	130	189	59	1	3	4	1	0
DS-48	259	477	218	0	3	4	0	0
DS-48	259	260	1	1	2	1	1	0
DS-48	259	366	107	1	3	1	1	0
DS-48	259	260	1	1	3	1	1	3
DS-48	259	260	1	1	3	1	0	0
DS-48	259	260	1	1	3	1	0	1
DS-48	259	260	1	1	3	1	0	1
DS-48	259	260	1	1	1	1	1	0
DS-48	259	261	2	1	3	3	1	1
DS-48	260	477	217	0	3	1	0	1
DS-4	131	142	11	1	3	1	1	0
DS-49	260	287	27	1	3	1	2	0
DS-49	260	261	1	1	5	1	1	0
DS-49	260	261	1	1	3	1	0	1
DS-49	260	261	1	1	3	1	0	0
DS-49	260	458	198	1	3	1	1	1
DS-49	260	261	1	1	3	1	1	0
DS-49	260	261	1	1	3	1	1	0
DS-49	260	261	1	1	1	1	1	1
DS-49	260	261	1	1	3	1	0	1
DS-49	260	477	217	0	4	1	0	0
DS-	113	133	20	1	3	5	1	1
DS-5	131	477	346	0	3	1	0	0
DS-50	260	261	1	1	3	1	1	0
DS-50	260	261	1	1	1	1	1	0
DS-50	260	261	1	1	1	1	1	0
DS-50	260	261	1	1	1	1	1	0
DS-50	260	261	1	1	3	1	0	1
DS-50	260	477	217	0	3	2	0	2
DS-50	260	261	1	1	1	1	0	0
DS-50	261	262	1	1	3	1	1	1
DS-50	261	277	16	1	3	4	0	0
DS-50	261	262	1	1	3	1	1	0
DS-5	131	132	1	1	3	5	1	0
DS-51	261	477	216	0	3	1	0	0
DS-51	261	262	1	1	3	5	0	0
DS-51	261	277	16	1	3	5	1	0
DS-51	261	262	1	1	3	1	1	0
DS-51	261	262	1	1	4	1	1	0
DS-51	262	287	25	1	3	5	0	0
DS-51	262	296	34	1	3	5	2	0
DS-51	262	282	20	1	3	5	1	0
DS-51	262	285	23	1	3	5	1	0
DS-51	262	286	24	1	3	5	1	0
DS-5	131	132	1	1	3	5	1	0
DS-52	262	275	13	1	3	5	1	0
DS-52	262	280	18	1	3	5	1	0
DS-52	262	284	22	1	3	5	2	1
DS-52	262	287	25	1	3	5	0	0
DS-52	262	308	46	1	3	1	0	0
DS-52	262	273	11	1	3	5	1	0
DS-52	262	275	13	1	3	4	1	1
DS-52	262	289	27	1	3	4	1	0
DS-52	262	318	56	1	3	4	1	0
DS-52	263	477	214	0	1	1	0	0
DS-5	131	132	1	1	3	5	1	0
DS-53	263	427	164	1	1	1	0	0
DS-53	263	477	214	0	3	1	0	0
DS-53	263	393	130	1	3	1	0	1
DS-53	263	477	214	0	3	1	0	0
DS-53	263	477	214	0	3	1	0	0
DS-53	264	477	213	0	3	1	0	0
DS-53	264	477	213	0	3	1	0	0
DS-53	264	477	213	0	3	1	0	0
DS-53	264	477	213	0	3	1	0	0
DS-53	264	351	87	1	3	1	1	0
DS-54	264	374	110	1	3	5	0	1
DS-54	265	477	212	0	3	1	0	0
DS-54	266	477	211	0	3	1	0	0
DS-54	266	297	31	1	2	1	0	1
DS-54	266	294	28	1	1	1	2	0
DS-54	266	477	211	0	2	1	0	0
DS-54	266	267	1	1	3	5	0	1
DS-54	266	273	7	1	3	5	0	0
DS-54	267	270	3	1	3	5	0	0
DS-54	267	395	128	1	3	4	1	0
DS-5	133	134	1	1	4	1	0	0
DS-55	267	284	17	1	3	1	1	1
DS-55	267	269	2	1	3	1	1	0
DS-55	267	280	13	1	3	1	0	0
DS-55	267	268	1	1	3	1	0	0
DS-55	267	268	1	1	3	4	1	0
DS-55	268	284	16	1	3	1	1	1
DS-55	268	288	20	1	3	1	0	0
DS-55	268	273	5	1	3	4	1	0
DS-55	268	274	6	1	3	1	0	0
DS-55	268	281	13	1	3	1	1	0
DS-5	133	134	1	1	4	5	0	0
DS-56	268	274	6	1	3	5	1	0
DS-56	269	275	6	1	3	4	1	0
DS-56	271	273	2	1	3	5	1	0
DS-56	273	289	16	1	3	5	1	0
DS-56	273	281	8	1	3	5	0	0
DS-56	273	277	4	1	4	1	1	0
DS-56	273	274	1	1	3	5	0	0
DS-56	274	275	1	1	3	4	1	0
DS-56	275	282	7	1	1	1	1	1
DS-56	276	477	201	0	3	4	0	0
DS-5	133	140	7	1	4	5	1	0
DS-57	276	277	1	1	3	4	0	1
DS-57	276	277	1	1	3	4	1	1
DS-57	276	277	1	1	3	5	1	0
DS-57	276	301	25	1	3	5	2	0
DS-57	276	477	201	0	3	5	0	1
DS-57	277	278	1	1	3	1	1	0
DS-57	277	315	38	1	3	1	1	0
DS-57	277	281	4	1	3	5	2	0
DS-57	277	278	1	1	3	1	1	1
DS-57	277	286	9	1	3	1	1	0
DS-58	277	318	41	1	3	5	0	3
DS-58	277	407	130	1	3	5	0	3
DS-58	277	422	145	1	3	1	1	0
DS-58	277	280	3	1	3	1	2	0
DS-58	280	477	197	0	3	1	0	0
DS-58	280	281	1	1	3	5	2	0
DS-58	280	281	1	1	3	1	0	0
DS-58	280	284	4	1	3	1	2	0
DS-58	280	281	1	1	4	5	1	0
DS-58	280	477	197	0	3	5	0	0
DS-5	133	261	128	1	1	1	1	0
DS-59	280	281	1	1	3	1	2	0
DS-59	280	282	2	1	3	5	1	0
DS-59	280	310	30	1	3	5	1	1
DS-59	280	389	109	1	3	5	0	0
DS-59	280	430	150	1	3	5	1	4
DS-59	280	438	158	1	3	5	0	2
DS-59	280	434	154	1	3	5	1	1
DS-59	280	375	95	1	3	5	0	2
DS-59	280	281	1	1	1	1	0	1
DS-59	281	282	1	1	3	3	2	1
DS-	113	128	15	1	3	5	1	1
DS-6	105	214	109	1	3	1	1	0
DS-60	281	438	157	1	1	1	0	0
DS-60	281	283	2	1	3	1	2	1
DS-60	281	325	44	1	1	3	0	1
DS-60	281	285	4	1	3	1	2	0
DS-60	281	282	1	1	4	1	1	1
DS-60	281	282	1	1	3	1	0	1
DS-60	281	284	3	1	3	5	2	1
DS-60	281	477	196	0	3	5	0	0
DS-60	281	282	1	1	3	1	2	2
DS-60	281	284	3	1	3	1	2	0
DS-6	105	261	156	1	3	1	0	0
DS-61	281	282	1	1	3	1	0	1
DS-61	281	423	142	1	3	1	0	1
DS-61	282	291	9	1	3	1	1	0
DS-61	282	285	3	1	3	5	2	0
DS-61	282	283	1	1	3	1	0	2
DS-61	282	421	139	1	3	1	1	1
DS-61	282	285	3	1	3	4	1	0
DS-61	282	283	1	1	3	1	1	1
DS-61	282	477	195	0	3	4	0	0
DS-61	282	283	1	1	3	4	1	0
DS-62	282	302	20	1	3	4	2	0
DS-62	282	291	9	1	3	4	2	0
DS-62	282	477	195	0	2	1	0	0
DS-62	282	427	145	1	3	1	1	1
DS-62	283	284	1	1	3	1	2	0
DS-62	283	284	1	1	1	1	1	1
DS-62	283	288	5	1	3	1	0	0
DS-62	283	284	1	1	3	1	2	0
DS-62	283	284	1	1	4	1	2	0
DS-62	283	287	4	1	3	1	2	0
DS-63	283	284	1	1	4	1	1	0
DS-63	283	400	117	1	1	1	1	0
DS-63	283	477	194	0	3	4	0	0
DS-63	283	284	1	1	3	1	2	0
DS-63	283	284	1	1	3	1	0	1
DS-63	283	284	1	1	3	1	2	0
DS-63	284	287	3	1	3	1	0	0
DS-63	284	294	10	1	1	1	2	0
DS-63	284	285	1	1	1	1	2	0
DS-64	284	477	193	0	3	1	0	0
DS-64	284	285	1	1	3	1	2	0
DS-64	284	332	48	1	3	1	1	0
DS-64	284	297	13	1	3	5	1	0
DS-64	284	285	1	1	4	1	2	1
DS-64	284	285	1	1	1	4	2	0
DS-64	284	285	1	1	3	1	2	0
DS-64	284	285	1	1	3	1	0	1
DS-64	284	477	193	0	3	1	0	0
DS-64	284	477	193	0	3	1	0	0
DS-65	284	423	139	1	3	1	0	0
DS-65	284	289	5	1	1	4	2	0
DS-65	284	477	193	0	3	1	0	0
DS-65	285	286	1	1	3	1	2	0
DS-65	285	286	1	1	3	4	2	0
DS-65	285	287	2	1	3	5	0	0
DS-65	286	289	3	1	3	1	1	0
DS-65	287	288	1	1	3	5	2	0
DS-65	287	318	31	1	3	5	1	0
DS-65	287	303	16	1	1	5	1	1
DS-66	287	477	190	0	3	1	0	0
DS-66	287	289	2	1	3	1	2	0
DS-66	287	289	2	1	3	1	1	0
DS-66	287	290	3	1	3	3	0	0
DS-66	287	477	190	0	3	1	0	1
DS-66	287	288	1	1	3	3	2	2
DS-66	287	288	1	1	3	3	0	2
DS-66	288	289	1	1	3	1	2	0
DS-66	288	477	189	0	3	1	0	0
DS-66	288	477	189	0	3	4	0	1
DS-67	288	290	2	1	1	1	1	0
DS-67	288	477	189	0	3	1	0	0
DS-67	288	291	3	1	3	1	2	1
DS-67	288	290	2	1	3	1	2	0
DS-67	289	423	134	1	3	1	0	0
DS-67	289	316	27	1	3	1	0	0
DS-67	289	295	6	1	3	1	2	0
DS-67	289	303	14	1	2	5	2	0
DS-67	289	290	1	1	3	5	2	0
DS-67	289	291	2	1	3	5	2	0
DS-68	289	291	2	1	3	5	2	0
DS-68	289	477	188	0	3	4	0	0
DS-68	289	298	9	1	3	1	1	1
DS-68	289	290	1	1	3	5	2	0
DS-68	289	296	7	1	3	5	0	0
DS-68	289	477	188	0	3	4	0	1
DS-68	289	423	134	1	1	4	0	0
DS-68	290	291	1	1	1	1	1	0
DS-68	290	303	13	1	3	1	0	0
DS-68	290	297	7	1	3	1	0	1
DS-69	290	291	1	1	3	1	2	0
DS-69	290	311	21	1	3	1	0	0
DS-69	290	323	33	1	3	1	0	0
DS-69	290	296	6	1	3	5	2	0
DS-69	290	298	8	1	3	1	1	0
DS-69	290	295	5	1	1	4	1	1
DS-69	290	330	40	1	3	5	0	3
DS-69	291	304	13	1	3	1	1	0
DS-69	291	477	186	0	3	2	0	0
DS-69	291	441	150	1	3	5	1	0
DS-	113	137	24	1	3	5	1	0
DS-7	133	141	8	1	3	5	1	3
DS-70	291	477	186	0	3	5	0	0
DS-70	291	292	1	1	3	5	2	0
DS-70	291	297	6	1	3	4	1	1
DS-70	291	297	6	1	3	1	1	0
DS-70	291	292	1	1	3	5	0	0
DS-70	291	294	3	1	3	5	2	0
DS-70	291	296	5	1	3	1	0	0
DS-70	293	294	1	1	1	4	2	0
DS-70	294	295	1	1	3	1	2	0
DS-70	294	315	21	1	3	1	1	0
DS-7	134	140	6	1	3	5	1	0
DS-71	294	477	183	0	2	4	0	0
DS-71	294	477	183	0	3	3	0	0
DS-71	294	303	9	1	3	5	1	1
DS-71	295	477	182	0	3	1	0	0
DS-71	295	307	12	1	3	1	1	0
DS-71	295	296	1	1	3	1	0	1
DS-71	295	296	1	1	3	1	2	1
DS-71	295	477	182	0	3	5	0	0
DS-71	295	322	27	1	1	4	1	1
DS-71	295	296	1	1	3	4	2	2
DS-7	134	161	27	1	3	1	1	0
DS-72	295	477	182	0	2	5	0	1
DS-72	296	302	6	1	2	1	1	0
DS-72	296	307	11	1	2	1	0	2
DS-72	296	477	181	0	3	1	0	0
DS-72	296	297	1	1	4	1	0	1
DS-72	296	428	132	1	1	1	1	0
DS-72	296	424	128	1	3	5	1	1
DS-72	296	301	5	1	3	1	2	0
DS-72	296	301	5	1	3	1	2	0
DS-72	296	477	181	0	3	1	0	0
DS-7	134	136	2	1	3	5	1	0
DS-73	296	477	181	0	3	1	0	0
DS-73	296	477	181	0	3	1	0	0
DS-73	296	324	28	1	3	5	0	0
DS-73	297	312	15	1	3	4	1	1
DS-73	297	316	19	1	3	4	0	2
DS-73	297	316	19	1	3	4	0	1
DS-73	297	477	180	0	3	1	0	0
DS-73	297	311	14	1	3	4	1	1
DS-73	297	477	180	0	3	4	0	0
DS-73	298	299	1	1	3	5	2	0
DS-7	134	141	7	1	3	1	1	1
DS-74	298	477	179	0	1	1	0	0
DS-74	298	302	4	1	3	5	0	1
DS-74	298	301	3	1	3	5	2	0
DS-74	299	300	1	1	5	1	1	0
DS-74	299	477	178	0	3	5	0	0
DS-74	299	477	178	0	3	4	0	0
DS-74	301	442	141	1	3	5	0	1
DS-74	301	335	34	1	3	4	1	3
DS-74	301	302	1	1	3	4	1	0
DS-75	301	477	176	0	3	5	0	1
DS-75	301	305	4	1	2	4	1	0
DS-75	301	477	176	0	3	5	0	1
DS-75	301	304	3	1	3	5	0	3
DS-75	301	303	2	1	1	1	2	0
DS-75	301	303	2	1	3	4	1	0
DS-75	301	477	176	0	3	5	0	2
DS-75	301	477	176	0	3	5	0	1
DS-75	301	477	176	0	3	4	0	0
DS-75	302	303	1	1	3	4	1	0
DS-7	135	137	2	1	3	1	1	0
DS-76	302	303	1	1	3	5	0	1
DS-76	302	438	136	1	3	5	2	1
DS-76	302	303	1	1	1	1	2	1
DS-76	302	424	122	1	3	2	1	0
DS-76	302	387	85	1	3	5	1	0
DS-76	302	477	175	0	4	1	0	0
DS-76	302	325	23	1	3	1	0	1
DS-76	303	315	12	1	4	1	0	0
DS-76	303	477	174	0	4	1	0	0
DS-7	135	136	1	1	3	1	1	0
DS-77	303	477	174	0	3	1	0	0
DS-77	303	304	1	1	1	1	2	0
DS-77	303	427	124	1	2	1	1	0
DS-77	303	304	1	1	3	5	2	0
DS-77	303	317	14	1	3	4	1	0
DS-77	303	304	1	1	3	1	1	0
DS-77	303	400	97	1	2	4	1	0
DS-77	303	304	1	1	4	5	2	1
DS-77	303	311	8	1	3	5	1	0
DS-77	303	304	1	1	4	1	0	2
DS-7	135	145	10	1	3	1	1	0
DS-78	303	477	174	0	3	1	0	0
DS-78	303	477	174	0	3	1	0	0
DS-78	303	477	174	0	3	1	0	0
DS-78	303	306	3	1	1	1	1	3
DS-78	303	477	174	0	3	1	0	0
DS-78	303	477	174	0	3	1	0	0
DS-78	304	305	1	1	3	1	2	1
DS-78	304	477	173	0	3	5	1	0
DS-78	304	305	1	1	4	5	2	0
DS-78	304	477	173	0	3	4	0	0
DS-7	135	141	6	1	3	5	1	0
DS-79	305	401	96	1	3	5	1	0
DS-79	305	324	19	1	3	5	1	0
DS-79	305	477	172	0	3	5	0	1
DS-79	305	389	84	1	3	2	0	2
DS-79	305	308	3	1	3	4	2	0
DS-79	305	324	19	1	3	4	0	1
DS-79	305	308	3	1	3	1	1	0
DS-79	305	308	3	1	1	1	2	0
DS-79	305	309	4	1	3	5	2	0
DS-79	303	308	5	1	1	1	2	1
DS-	116	318	202	1	3	5	1	3
DS-8	135	143	8	1	3	5	1	0
DS-80	307	477	170	0	3	1	0	0
DS-80	307	319	12	1	3	4	1	1
DS-80	308	311	3	1	3	1	1	0
DS-80	308	309	1	1	4	4	0	1
DS-80	308	332	24	1	3	5	0	3
DS-80	308	353	45	1	3	5	0	2
DS-80	308	311	3	1	1	1	2	2
DS-80	308	435	127	1	2	4	1	0
DS-80	309	332	23	1	4	4	0	1
DS-80	309	310	1	1	3	4	1	0
DS-8	135	148	13	1	3	5	1	0
DS-81	309	310	1	1	4	5	1	0
DS-81	309	310	1	1	3	1	1	1
DS-81	309	312	3	1	3	1	2	0
DS-81	309	331	22	1	3	1	0	4
DS-81	309	325	16	1	3	4	0	0
DS-81	309	477	168	0	3	4	0	0
DS-81	310	324	14	1	3	1	1	0
DS-81	310	323	13	1	3	1	1	1
DS-81	310	477	167	0	3	1	0	2
DS-81	310	318	8	1	3	1	1	0
DS-8	136	140	4	1	3	5	1	0
DS-82	311	326	15	1	3	5	1	0
DS-82	311	318	7	1	3	5	1	0
DS-82	311	312	1	1	3	4	0	1
DS-82	311	312	1	1	1	1	2	0
DS-82	311	312	1	1	1	1	1	2
DS-82	312	319	7	1	3	1	1	0
DS-82	312	313	1	1	3	4	1	0
DS-82	315	318	3	1	3	4	1	0
DS-82	315	318	3	1	4	1	1	0
DS-82	315	424	109	1	3	4	0	1
DS-8	136	137	1	1	4	1	1	0
DS-83	315	477	162	0	3	1	0	1
DS-83	315	316	1	1	3	1	1	0
DS-83	315	317	2	1	1	1	1	0
DS-83	316	477	161	0	4	4	0	0
DS-83	316	317	1	1	3	1	2	0
DS-83	316	323	7	1	3	4	1	0
DS-83	316	317	1	1	3	5	1	1
DS-83	317	322	5	1	3	4	1	0
DS-83	317	318	1	1	3	1	0	0
DS-83	318	331	13	1	3	5	1	1
DS-8	136	142	6	1	3	1	1	0
DS-84	318	319	1	1	3	3	0	1
DS-84	318	325	7	1	3	3	0	1
DS-84	318	319	1	1	3	3	0	1
DS-84	318	319	1	1	3	3	0	1
DS-84	318	322	4	1	3	1	1	0
DS-84	319	322	3	1	3	1	1	0
DS-84	319	331	12	1	3	5	1	0
DS-84	319	322	3	1	3	1	1	0
DS-84	319	336	17	1	3	1	1	1
DS-84	322	323	1	1	3	1	1	0
DS-8	137	142	5	1	3	1	1	0
DS-85	322	332	10	1	3	1	1	0
DS-85	322	477	155	0	3	1	0	2
DS-85	322	325	3	1	3	4	0	0
DS-85	322	324	2	1	3	4	1	0
DS-85	322	325	3	1	3	1	1	1
DS-85	322	324	2	1	3	1	1	0
DS-85	323	477	154	0	3	4	0	0
DS-85	323	477	154	0	4	5	0	0
DS-85	323	340	17	1	3	5	0	1
DS-85	323	438	115	1	4	1	0	0
DS-8	137	220	83	1	3	1	0	0
DS-86	324	325	1	1	3	1	1	0
DS-86	324	325	1	1	3	1	1	1
DS-86	324	477	153	0	3	1	0	0
DS-86	324	325	1	1	3	1	0	1
DS-86	324	339	15	1	3	4	1	1
DS-86	324	325	1	1	4	1	1	0
DS-86	324	325	1	1	3	1	1	1
DS-86	324	477	153	0	3	1	0	0
DS-86	324	330	6	1	3	4	1	0
DS-86	325	326	1	1	3	1	1	0
DS-8	137	140	3	1	3	5	1	0
DS-87	325	341	16	1	3	4	1	1
DS-87	327	340	13	1	3	1	1	1
DS-87	329	344	15	1	3	5	1	0
DS-87	329	330	1	1	3	5	0	0
DS-87	330	477	147	0	3	1	0	0
DS-87	330	477	147	0	3	4	0	0
DS-87	330	346	16	1	3	1	1	0
DS-87	330	332	2	1	3	5	1	0
DS-87	331	477	146	0	3	1	0	0
DS-87	331	343	12	1	3	5	1	4
DS-8	137	149	12	1	3	1	1	0
DS-88	331	339	8	1	1	1	0	0
DS-88	331	353	22	1	3	5	1	2
DS-88	332	335	3	1	4	4	1	0
DS-88	332	477	145	0	3	4	0	0
DS-88	332	333	1	1	4	5	0	0
DS-88	332	336	4	1	3	1	1	0
DS-88	333	334	1	1	3	1	1	0
DS-88	333	335	2	1	3	4	1	0
DS-88	333	421	88	1	3	1	0	0
DS-88	333	345	12	1	3	5	1	2
DS-8	137	141	4	1	3	1	1	0
DS-89	335	337	2	1	3	4	1	0
DS-89	336	415	79	1	3	4	0	0
DS-89	336	339	3	1	3	5	1	0
DS-89	336	352	16	1	3	1	1	0
DS-89	336	337	1	1	3	5	1	0
DS-89	336	477	141	0	3	4	0	0
DS-89	336	368	32	1	3	4	1	0
DS-89	336	477	141	0	3	1	0	0
DS-89	336	381	45	1	3	5	1	0
DS-89	337	477	140	0	4	4	0	0
DS-	116	324	208	1	3	5	0	1
DS-9	137	144	7	1	3	5	1	0
DS-90	337	477	140	0	3	1	0	0
DS-90	337	371	34	1	3	5	1	2
DS-90	337	371	34	1	3	5	1	2
DS-90	338	477	139	0	3	5	0	0
DS-90	339	477	138	0	3	1	0	0
DS-90	339	410	71	1	3	5	1	0
DS-90	339	389	50	1	3	4	1	0
DS-90	339	388	49	1	3	4	0	1
DS-90	340	350	10	1	3	1	1	0
DS-90	340	341	1	1	3	2	1	0
DS-9	139	142	3	1	3	1	1	0
DS-91	340	351	11	1	3	1	0	1
DS-91	343	351	8	1	3	4	1	0
DS-91	344	351	7	1	3	1	1	0
DS-91	344	386	42	1	3	1	0	0
DS-91	344	351	7	1	3	2	1	0
DS-91	344	368	24	1	3	5	1	2
DS-91	345	371	26	1	3	5	1	3
DS-91	345	437	92	1	3	1	1	2
DS-91	345	445	100	1	3	1	1	1
DS-91	345	428	83	1	3	1	0	0
DS-9	140	144	4	1	3	5	1	0
DS-92	345	436	91	1	3	1	0	0
DS-92	345	357	12	1	3	1	1	0
DS-92	345	402	57	1	3	4	0	0
DS-92	345	477	132	0	3	2	0	0
DS-92	345	372	27	1	3	5	1	1
DS-92	346	351	5	1	3	4	1	0
DS-92	346	372	26	1	3	3	1	0
DS-92	346	477	131	0	3	2	0	1
DS-92	347	352	5	1	3	5	1	0
DS-92	347	352	5	1	3	5	0	0
DS-9	141	477	336	0	3	1	0	0
DS-93	348	371	23	1	3	5	1	1
DS-93	349	371	22	1	3	5	1	0
DS-93	350	387	37	1	3	1	0	0
DS-93	351	352	1	1	3	2	1	0
DS-93	351	353	2	1	3	1	1	0
DS-93	351	428	77	1	3	4	1	0
DS-93	351	408	57	1	3	1	1	2
DS-93	351	354	3	1	3	5	1	1
DS-93	351	368	17	1	3	5	1	1
DS-93	351	449	98	1	1	1	2	0
DS-9	141	177	36	1	3	1	1	1
DS-94	352	353	1	1	3	4	1	0
DS-94	352	374	22	1	3	4	1	0
DS-94	352	373	21	1	3	5	0	0
DS-94	352	382	30	1	3	5	0	0
DS-94	352	353	1	1	3	4	0	0
DS-94	352	368	16	1	3	5	1	0
DS-94	352	371	19	1	3	4	1	1
DS-94	353	375	22	1	3	5	0	1
DS-94	353	388	35	1	3	5	1	1
DS-94	354	366	12	1	3	4	1	0
DS-9	141	261	120	1	3	1	1	0
DS-95	354	477	123	0	3	4	0	0
DS-95	358	360	2	1	3	3	1	0
DS-9	142	144	2	1	3	2	1	2
DS-9	142	161	19	1	3	5	1	1
DS-9	142	246	104	1	3	5	1	2
DS-9	142	350	208	1	3	2	1	1
FS-1297	0	477	477	0	3	1	0	0
FS-1297	0	12	12	1	3	5	2	1
FS-1297	0	18	18	1	3	5	2	1
FS-1297	1	28	27	1	4	1	3	0
FS-1297	1	79	78	1	3	5	2	0
FS-1297	1	191	190	1	3	5	2	4
FS-1297	1	79	78	1	3	5	2	2
FS-1297	1	150	149	1	3	5	3	0
FS-1297	1	477	476	0	3	5	0	0
FS-1298	1	2	1	1	3	5	1	1
FS-1298	2	126	124	1	4	4	4	0
FS-1298	2	7	5	1	3	5	2	1
FS-1298	2	46	44	1	3	5	1	0
FS-1298	2	11	9	1	3	1	1	0
FS-1298	2	8	6	1	3	1	3	0
FS-1298	3	22	19	1	3	5	1	0
FS-1298	3	4	1	1	5	1	1	0
FS-1298	3	4	1	1	3	5	4	2
FS-1298	3	477	474	0	3	5	0	2
FS-1299	4	36	32	1	2	3	1	2
FS-1299	4	477	473	0	3	5	0	0
FS-1299	5	477	472	0	3	5	1	0
FS-1299	7	477	470	0	3	4	0	0
FS-1299	7	8	1	1	3	1	2	0
FS-1299	7	223	216	1	3	5	0	0
FS-1299	7	477	470	0	3	2	0	0
FS-1299	7	31	24	1	3	5	2	0
FS-1299	8	49	41	1	3	2	1	0
FS-1299	8	477	469	0	3	4	0	0
FS-1300	8	477	469	0	3	5	0	0
FS-1300	8	477	469	0	4	4	0	1
FS-1300	8	477	469	0	3	1	0	0
FS-1300	8	15	7	1	3	1	2	0
FS-1300	8	477	469	0	4	1	0	0
FS-1300	9	101	92	1	4	5	1	0
FS-1300	9	10	1	1	3	5	1	0
FS-1300	9	64	55	1	3	5	0	1
FS-1300	9	477	468	0	3	4	0	0
FS-1301	10	477	467	0	3	1	0	0
FS-1301	10	477	467	0	3	4	0	0
FS-1301	10	19	9	1	4	5	1	1
FS-1301	10	17	7	1	3	5	0	2
FS-1301	11	12	1	1	3	4	0	0
FS-1301	11	12	1	1	3	4	0	0
FS-1301	11	12	1	1	5	1	1	0
FS-1301	11	23	12	1	3	5	1	0
FS-1301	11	24	13	1	3	5	1	0
FS-1301	11	477	466	0	3	1	0	0
FS-1302	11	477	466	0	4	1	0	0
FS-1302	14	477	463	0	3	1	0	0
FS-1302	14	41	27	1	3	5	1	0
FS-1302	15	23	8	1	3	1	1	0
FS-1302	15	22	7	1	3	5	1	0
FS-1302	16	22	6	1	3	5	2	0
FS-1302	16	17	1	1	3	5	1	0
FS-1302	16	241	225	1	3	1	3	3
FS-1302	16	18	2	1	4	5	4	1
FS-1302	16	477	461	0	3	1	0	0
FS-1303	17	477	460	0	3	4	0	0
FS-1303	17	225	208	1	3	4	0	1
FS-1303	17	477	460	0	3	4	0	1
FS-1303	17	23	6	1	3	5	2	0
FS-1303	17	18	1	1	4	1	0	0
FS-1303	17	477	460	0	3	1	0	1
FS-1303	18	19	1	1	3	4	1	0
FS-1303	18	19	1	1	3	2	0	0
FS-1303	18	23	5	1	3	1	0	0
FS-1303	18	19	1	1	2	1	2	0
FS-1304	18	63	45	1	3	1	3	2
FS-1304	19	477	458	0	3	5	0	0
FS-1304	21	24	3	1	3	5	4	2
FS-1304	21	31	10	1	3	5	4	1
FS-1304	21	30	9	1	3	5	4	3
FS-1304	21	100	79	1	4	5	4	0
FS-1304	22	477	455	0	4	2	0	0
FS-1304	22	133	111	1	4	5	1	0
FS-1304	22	32	10	1	3	1	2	1
FS-1304	22	24	2	1	4	5	4	0
FS-1305	22	27	5	1	1	5	2	0
FS-1305	22	253	231	1	3	1	4	1
FS-1305	22	54	32	1	3	3	2	4
FS-1305	22	477	455	0	4	4	0	2
FS-1305	22	25	3	1	3	1	2	0
FS-1305	22	111	89	1	3	1	1	1
FS-1305	23	100	77	1	3	2	2	2
FS-1305	23	25	2	1	1	5	2	0
FS-1305	23	46	23	1	3	1	1	0
FS-1305	23	477	454	0	3	4	0	1
FS-1306	23	31	8	1	3	1	1	2
FS-1306	23	30	7	1	3	1	1	0
FS-1306	24	31	7	1	3	4	2	0
FS-1306	24	25	1	1	5	1	4	0
FS-1306	24	477	453	0	4	4	0	0
FS-1306	24	28	4	1	3	1	2	0
FS-1306	24	477	453	0	3	4	0	1
FS-1306	24	133	109	1	5	5	0	0
FS-1306	25	32	7	1	3	5	4	2
FS-1306	25	477	452	0	3	4	0	1
FS-1307	25	50	25	1	3	5	1	0
FS-1307	25	477	452	0	3	5	0	0
FS-1307	25	26	1	1	3	5	0	0
FS-1307	25	33	8	1	4	4	1	0
FS-1307	26	218	192	1	3	2	0	1
FS-1307	26	27	1	1	3	5	2	0
FS-1307	28	203	175	1	3	5	2	1
FS-1307	28	29	1	1	3	5	2	0
FS-1307	28	50	22	1	3	5	1	1
FS-1307	28	477	449	0	3	4	0	0
FS-1308	28	29	1	1	3	5	0	0
FS-1308	28	58	30	1	3	1	2	1
FS-1308	28	477	449	0	4	1	0	0
FS-1308	29	30	1	1	3	5	4	1
FS-1308	29	309	280	1	3	5	0	0
FS-1308	29	477	448	0	3	1	0	0
FS-1308	29	477	448	0	4	4	0	1
FS-1308	29	87	58	1	3	1	3	1
FS-1308	29	477	448	0	3	5	0	0
FS-1308	29	477	448	0	3	5	0	0
FS-1309	30	31	1	1	4	4	2	0
FS-1309	30	477	447	0	3	1	0	0
FS-1309	30	477	447	0	3	4	0	0
FS-1309	30	477	447	0	3	1	0	0
FS-1309	30	477	447	0	3	2	0	0
FS-1309	30	37	7	1	3	5	2	0
FS-1309	30	477	447	0	3	2	0	2
FS-1309	31	39	8	1	4	5	4	0
FS-1310	31	33	2	1	2	1	4	1
FS-1310	31	477	446	0	3	1	0	2
FS-1310	32	58	26	1	3	4	1	1
FS-1310	32	477	445	0	3	1	0	2
FS-1310	33	37	4	1	3	4	0	0
FS-1310	33	37	4	1	3	1	0	0
FS-1310	35	37	2	1	3	5	1	0
FS-1310	35	37	2	1	3	5	1	0
FS-1310	35	72	37	1	3	5	1	0
FS-1310	36	65	29	1	3	1	4	1
FS-1311	36	46	10	1	3	5	2	0
FS-1311	36	477	441	0	2	1	0	0
FS-1311	36	45	9	1	2	1	4	3
FS-1311	36	57	21	1	3	4	0	1
FS-1311	37	58	21	1	3	1	2	0
FS-1311	37	38	1	1	3	1	3	0
FS-1311	37	40	3	1	3	5	1	0
FS-1311	37	477	440	0	3	2	0	0
FS-1311	37	477	440	0	3	4	0	0
FS-1311	37	50	13	1	3	5	4	1
FS-1312	38	39	1	1	3	1	4	1
FS-1312	38	186	148	1	4	1	3	0
FS-1312	38	39	1	1	3	5	0	1
FS-1312	38	477	439	0	3	4	0	1
FS-1312	38	477	439	0	4	1	0	0
FS-1312	38	142	104	1	3	4	0	0
FS-1312	38	39	1	1	3	1	1	2
FS-1312	39	40	1	1	3	5	1	0
FS-1312	39	477	438	0	4	1	0	0
FS-1312	39	106	67	1	4	5	2	1
FS-1313	40	41	1	1	4	1	1	0
FS-1313	41	477	436	0	4	1	0	0
FS-1313	41	477	436	0	3	5	1	1
FS-1313	41	42	1	1	3	5	1	0
FS-1313	42	477	435	0	3	5	0	1
FS-1313	42	477	435	0	3	1	0	0
FS-1313	42	128	86	1	3	1	3	0
FS-1313	43	72	29	1	3	5	1	0
FS-1313	43	395	352	1	3	1	0	1
FS-1313	43	49	6	1	3	1	0	0
FS-1314	43	477	434	0	3	4	0	0
FS-1314	43	71	28	1	3	3	1	4
FS-1314	43	45	2	1	3	4	1	1
FS-1314	43	57	14	1	3	1	1	1
FS-1314	43	477	434	0	4	5	0	0
FS-1314	43	57	14	1	3	1	2	2
FS-1314	43	477	434	0	3	1	0	0
FS-1314	44	477	433	0	4	2	0	0
FS-1314	44	477	433	0	3	4	0	0
FS-1314	44	45	1	1	5	5	1	0
FS-1315	45	197	152	1	3	5	2	4
FS-1315	45	46	1	1	4	1	1	1
FS-1315	45	477	432	0	3	5	0	0
FS-1315	45	46	1	1	3	4	1	0
FS-1315	46	333	287	1	4	1	0	1
FS-1315	46	154	108	1	4	4	3	0
FS-1315	46	284	238	1	4	4	2	0
FS-1315	46	477	431	0	3	4	0	0
FS-1315	46	50	4	1	3	1	1	0
FS-1316	46	47	1	1	4	4	0	0
FS-1316	46	53	7	1	3	5	1	0
FS-1316	46	73	27	1	3	5	1	0
FS-1316	47	63	16	1	3	1	4	1
FS-1316	48	118	70	1	3	5	2	0
FS-1316	48	58	10	1	3	5	2	0
FS-1316	48	50	2	1	5	4	1	0
FS-1316	48	50	2	1	4	4	1	0
FS-1316	49	50	1	1	3	1	0	0
FS-1317	49	64	15	1	3	4	2	1
FS-1317	50	60	10	1	3	4	1	1
FS-1317	50	106	56	1	3	4	0	1
FS-1317	50	61	11	1	3	4	1	1
FS-1317	50	165	115	1	3	1	3	1
FS-1317	50	51	1	1	4	4	2	0
FS-1317	51	95	44	1	3	1	2	2
FS-1317	51	477	426	0	3	1	0	1
FS-1317	52	61	9	1	3	1	1	0
FS-1317	52	477	425	0	2	1	0	0
FS-1318	53	57	4	1	3	1	1	0
FS-1318	53	477	424	0	3	5	0	0
FS-1318	53	477	424	0	3	4	0	1
FS-1318	53	57	4	1	4	5	4	1
FS-1318	53	477	424	0	3	3	0	0
FS-1318	53	167	114	1	3	5	1	4
FS-1318	53	56	3	1	4	5	4	0
FS-1318	53	64	11	1	3	1	1	0
FS-1318	54	477	423	0	4	5	0	0
FS-1319	54	67	13	1	3	1	2	0
FS-1319	54	477	423	0	4	1	0	0
FS-1319	54	57	3	1	4	4	1	0
FS-1319	54	57	3	1	5	4	1	0
FS-1319	56	58	2	1	3	1	2	0
FS-1319	56	80	24	1	4	1	4	0
FS-1319	56	61	5	1	3	5	1	0
FS-1319	56	102	46	1	3	5	1	0
FS-1319	57	72	15	1	4	5	4	0
FS-1319	57	58	1	1	3	5	4	2
FS-1320	58	477	419	0	4	1	0	0
FS-1320	58	477	419	0	4	1	0	0
FS-1320	58	59	1	1	5	4	1	0
FS-1320	58	84	26	1	4	5	4	2
FS-1320	58	221	163	1	3	1	0	1
FS-1320	58	59	1	1	4	1	0	0
FS-1320	58	477	419	0	3	4	0	0
FS-1320	58	59	1	1	2	5	0	1
FS-1320	58	409	351	1	3	4	1	1
FS-1321	59	60	1	1	5	1	1	0
FS-1321	59	60	1	1	3	1	1	1
FS-1321	59	68	9	1	3	5	4	3
FS-1321	59	477	418	0	3	1	0	0
FS-1321	59	65	6	1	3	5	4	0
FS-1321	59	78	19	1	3	5	4	4
FS-1321	60	61	1	1	5	3	0	0
FS-1321	60	226	166	1	3	4	2	1
FS-1321	60	61	1	1	3	4	0	1
FS-1321	60	477	417	0	3	5	0	1
FS-1322	60	477	417	0	4	1	0	0
FS-1322	60	133	73	1	2	5	0	0
FS-1322	60	65	5	1	3	4	1	2
FS-1322	61	64	3	1	3	4	1	1
FS-1322	63	73	10	1	3	5	4	4
FS-1322	63	65	2	1	3	4	2	0
FS-1322	63	71	8	1	3	5	4	2
FS-1322	63	64	1	1	4	4	1	1
FS-1323	63	66	3	1	4	5	4	2
FS-1323	63	477	414	0	3	1	0	1
FS-1323	64	68	4	1	4	5	4	2
FS-1323	64	67	3	1	3	5	4	2
FS-1323	64	477	413	0	3	4	0	0
FS-1323	64	71	7	1	3	4	1	0
FS-1323	64	477	413	0	3	1	0	1
FS-1323	64	253	189	1	4	5	2	2
FS-1323	64	477	413	0	3	4	0	0
FS-1323	64	71	7	1	4	1	2	0
FS-1324	65	68	3	1	4	5	4	0
FS-1324	65	71	6	1	3	5	4	0
FS-1324	65	477	412	0	2	1	0	0
FS-1324	65	67	2	1	3	1	2	0
FS-1324	66	477	411	0	3	5	0	2
FS-1324	66	73	7	1	4	4	1	0
FS-1324	66	67	1	1	3	1	0	0
FS-1324	66	477	411	0	3	5	0	1
FS-1324	66	72	6	1	3	1	1	1
FS-1325	66	79	13	1	3	5	4	2
FS-1325	67	73	6	1	3	1	1	0
FS-1325	67	68	1	1	3	4	1	0
FS-1325	67	71	4	1	3	5	4	2
FS-1325	67	477	410	0	3	5	0	0
FS-1325	67	477	410	0	3	5	0	0
FS-1325	67	477	410	0	3	4	0	1
FS-1325	68	72	4	1	3	4	1	0
FS-1325	68	73	5	1	3	5	1	0
FS-1325	69	477	408	0	3	1	0	0
FS-1326	70	477	407	0	5	4	0	0
FS-1326	70	73	3	1	4	1	2	0
FS-1326	70	477	407	0	3	4	0	0
FS-1326	70	477	407	0	3	5	0	0
FS-1326	70	477	407	0	3	5	0	0
FS-1326	70	477	407	0	3	4	0	3
FS-1326	70	71	1	1	3	1	0	2
FS-1326	70	71	1	1	3	1	0	1
FS-1326	70	78	8	1	3	1	4	4
FS-1326	71	477	406	0	3	1	0	0
FS-1327	71	477	406	0	3	5	0	0
FS-1327	71	72	1	1	3	1	1	0
FS-1327	71	129	58	1	3	4	1	2
FS-1327	71	72	1	1	3	1	0	1
FS-1327	71	477	406	0	3	5	0	1
FS-1327	71	72	1	1	4	4	1	0
FS-1327	71	477	406	0	3	4	0	0
FS-1327	72	84	12	1	3	5	0	0
FS-1327	72	477	405	0	3	5	0	1
FS-1327	72	477	405	0	3	1	0	0
FS-1328	72	73	1	1	3	1	1	2
FS-1328	72	154	82	1	2	5	4	1
FS-1328	72	477	405	0	3	5	0	0
FS-1328	72	119	47	1	3	2	4	2
FS-1328	72	477	405	0	3	4	0	0
FS-1328	72	477	405	0	3	4	0	1
FS-1328	72	123	51	1	3	5	2	2
FS-1328	73	477	404	0	4	1	0	1
FS-1328	73	74	1	1	4	4	0	0
FS-1328	73	89	16	1	4	5	4	1
FS-1329	73	477	404	0	3	1	0	0
FS-1329	73	84	11	1	3	5	4	1
FS-1329	73	96	23	1	3	1	1	0
FS-1329	73	477	404	0	3	5	0	3
FS-1329	73	477	404	0	4	5	0	0
FS-1329	73	477	404	0	3	1	0	0
FS-1329	73	78	5	1	3	1	4	2
FS-1329	74	477	403	0	3	1	1	0
FS-1329	74	77	3	1	3	5	1	0
FS-1329	74	75	1	1	1	5	2	1
FS-1330	74	85	11	1	3	5	1	1
FS-1330	74	95	21	1	3	5	0	0
FS-1330	74	75	1	1	3	5	1	0
FS-1330	74	75	1	1	3	1	0	1
FS-1330	74	75	1	1	3	5	1	0
FS-1330	74	477	403	0	3	4	0	0
FS-1330	76	477	401	0	2	1	0	0
FS-1330	76	79	3	1	3	5	2	2
FS-1330	76	78	2	1	4	5	0	1
FS-1330	76	93	17	1	4	5	0	0
FS-1331	77	203	126	1	3	5	0	0
FS-1331	77	105	28	1	4	5	4	1
FS-1331	77	477	400	0	3	4	0	4
FS-1331	77	477	400	0	4	1	0	0
FS-1331	77	86	9	1	3	4	4	2
FS-1331	77	128	51	1	3	5	1	0
FS-1331	77	93	16	1	3	5	0	0
FS-1331	77	79	2	1	3	5	1	0
FS-1331	78	80	2	1	4	5	4	1
FS-1331	79	80	1	1	3	5	1	0
FS-1332	79	93	14	1	3	5	0	0
FS-1332	79	477	398	0	3	4	0	0
FS-1332	79	212	133	1	4	1	1	1
FS-1332	79	100	21	1	3	5	1	0
FS-1332	79	99	20	1	3	5	1	1
FS-1332	79	115	36	1	4	5	4	4
FS-1332	80	99	19	1	3	1	3	0
FS-1332	80	477	397	0	3	5	0	0
FS-1333	80	103	23	1	3	1	3	0
FS-1333	80	93	13	1	3	5	2	0
FS-1333	80	133	53	1	3	5	0	0
FS-1333	80	477	397	0	3	5	0	0
FS-1333	80	477	397	0	3	5	0	0
FS-1333	80	82	2	1	3	5	1	0
FS-1333	81	113	32	1	3	1	4	3
FS-1333	81	92	11	1	4	5	2	1
FS-1333	81	85	4	1	2	3	2	1
FS-1333	81	154	73	1	2	1	3	0
FS-1334	81	85	4	1	3	5	1	0
FS-1334	81	92	11	1	3	5	1	0
FS-1334	81	95	14	1	3	5	1	0
FS-1334	81	82	1	1	3	5	1	0
FS-1334	82	477	395	0	4	5	0	0
FS-1334	83	130	47	1	3	5	3	1
FS-1334	83	86	3	1	4	5	4	1
FS-1334	84	100	16	1	3	5	1	0
FS-1334	84	88	4	1	1	1	1	0
FS-1335	84	94	10	1	3	1	3	1
FS-1335	85	477	392	0	3	3	0	0
FS-1335	85	86	1	1	3	5	4	1
FS-1335	85	94	9	1	3	5	4	0
FS-1335	85	113	28	1	3	5	0	0
FS-1335	85	133	48	1	3	5	1	0
FS-1335	85	112	27	1	3	1	2	1
FS-1335	86	87	1	1	4	4	1	1
FS-1335	86	409	323	1	3	5	1	3
FS-1335	86	477	391	0	3	1	0	1
FS-1336	86	119	33	1	1	5	1	2
FS-1336	86	477	391	0	3	5	1	0
FS-1336	86	477	391	0	4	3	0	1
FS-1336	86	99	13	1	4	4	1	1
FS-1336	86	92	6	1	3	5	4	3
FS-1336	86	246	160	1	3	5	0	1
FS-1336	86	477	391	0	3	4	0	1
FS-1336	87	88	1	1	3	3	0	0
FS-1336	87	88	1	1	3	1	1	0
FS-1336	87	477	390	0	3	1	0	1
FS-1337	87	155	68	1	4	3	0	0
FS-1337	80	477	397	0	4	1	0	1
FS-1337	87	477	390	0	3	5	0	0
FS-1337	87	477	390	0	3	5	0	0
FS-1337	88	477	389	0	3	1	0	0
FS-1337	88	98	10	1	3	1	2	0
FS-1337	88	477	389	0	4	4	0	0
FS-1337	88	289	201	1	3	4	0	1
FS-1337	91	477	386	0	2	1	0	0
FS-1338	91	98	7	1	3	5	2	1
FS-1338	91	183	92	1	3	5	2	0
FS-1338	91	477	386	0	3	1	0	0
FS-1338	92	99	7	1	4	5	4	1
FS-1338	92	477	385	0	3	4	1	0
FS-1338	92	100	8	1	4	5	4	1
FS-1338	92	477	385	0	3	5	0	0
FS-1338	92	112	20	1	3	1	3	2
FS-1339	92	477	385	0	4	1	0	0
FS-1339	92	93	1	1	3	5	0	0
FS-1339	92	477	385	0	3	1	0	0
FS-1339	92	477	385	0	3	4	0	0
FS-1339	93	95	2	1	3	5	0	0
FS-1339	93	99	6	1	3	5	1	2
FS-1339	93	477	384	0	3	1	0	0
FS-1339	93	94	1	1	3	2	0	0
FS-1339	93	154	61	1	3	5	2	1
FS-1340	93	477	384	0	4	1	0	0
FS-1340	94	477	383	0	3	1	0	0
FS-1340	94	97	3	1	4	5	4	0
FS-1340	94	100	6	1	2	3	2	1
FS-1340	94	399	305	1	3	5	1	1
FS-1340	94	95	1	1	3	5	1	0
FS-1340	95	477	382	0	3	1	0	0
FS-1340	95	106	11	1	3	5	1	1
FS-1340	95	112	17	1	3	1	4	4
FS-1340	96	477	381	0	3	1	0	0
FS-1341	97	99	2	1	4	5	4	1
FS-1341	97	477	380	0	3	4	0	0
FS-1341	97	477	380	0	3	1	1	0
FS-1341	98	101	3	1	4	5	1	0
FS-1341	98	101	3	1	4	5	1	0
FS-1341	98	100	2	1	4	5	1	0
FS-1341	98	100	2	1	3	5	0	0
FS-1341	98	477	379	0	2	1	0	1
FS-1341	99	102	3	1	3	4	3	2
FS-1341	99	477	378	0	4	1	0	0
FS-1342	99	100	1	1	4	1	3	0
FS-1342	99	212	113	1	3	5	0	0
FS-1342	99	106	7	1	3	5	1	0
FS-1342	99	102	3	1	3	5	1	0
FS-1342	99	105	6	1	3	5	1	0
FS-1342	99	101	2	1	3	5	1	0
FS-1342	100	101	1	1	4	1	2	0
FS-1342	100	101	1	1	4	1	4	0
FS-1342	100	101	1	1	5	5	4	0
FS-1342	100	477	377	0	2	3	0	0
FS-1343	100	126	26	1	3	1	0	1
FS-1343	101	112	11	1	2	1	2	2
FS-1343	101	117	16	1	3	5	4	1
FS-1343	101	106	5	1	3	5	4	0
FS-1343	101	102	1	1	3	1	3	0
FS-1343	101	127	26	1	4	5	1	1
FS-1343	101	102	1	1	4	1	2	0
FS-1343	101	105	4	1	3	4	2	0
FS-1344	101	150	49	1	5	4	1	0
FS-1344	101	477	376	0	3	1	0	0
FS-1344	101	477	376	0	3	5	0	0
FS-1344	102	352	250	1	3	5	1	1
FS-1344	102	106	4	1	3	5	1	0
FS-1344	102	477	375	0	3	1	0	0
FS-1344	102	103	1	1	3	5	1	0
FS-1344	102	219	117	1	5	4	2	0
FS-1344	102	204	102	1	4	2	3	0
FS-1345	103	477	374	0	3	5	0	0
FS-1345	104	477	373	0	3	1	0	0
FS-1345	104	477	373	0	3	1	0	0
FS-1345	105	108	3	1	3	5	4	1
FS-1345	105	477	372	0	3	1	0	0
FS-1345	105	106	1	1	3	5	1	0
FS-1346	105	106	1	1	3	4	4	3
FS-1346	106	107	1	1	4	1	2	0
FS-1346	106	107	1	1	4	1	2	0
FS-1346	106	477	371	0	3	1	0	0
FS-1346	106	107	1	1	4	5	4	0
FS-1346	106	477	371	0	3	1	0	0
FS-1346	106	114	8	1	3	4	1	1
FS-1346	106	477	371	0	3	5	0	1
FS-1347	107	477	370	0	3	5	0	0
FS-1347	107	477	370	0	3	4	0	0
FS-1347	107	477	370	0	3	1	0	0
FS-1347	107	196	89	1	3	5	4	1
FS-1347	107	477	370	0	2	1	0	0
FS-1347	107	404	297	1	3	5	1	0
FS-1347	107	110	3	1	3	5	4	1
FS-1347	108	477	369	0	3	4	0	0
FS-1348	108	477	369	0	3	5	0	0
FS-1348	108	122	14	1	3	1	3	0
FS-1348	108	109	1	1	3	1	0	1
FS-1348	108	477	369	0	3	1	0	1
FS-1348	108	114	6	1	3	5	4	2
FS-1348	108	196	88	1	4	1	1	0
FS-1348	108	126	18	1	3	1	1	3
FS-1348	108	477	369	0	3	1	0	1
FS-1348	109	121	12	1	3	5	4	1
FS-1348	109	477	368	0	3	3	0	0
FS-1349	110	113	3	1	3	5	4	0
FS-1349	112	477	365	0	3	5	0	0
FS-1349	112	115	3	1	3	4	1	0
FS-1349	112	142	30	1	3	4	3	2
FS-1349	113	477	364	0	3	5	0	0
FS-1349	113	116	3	1	4	5	4	1
FS-1350	113	119	6	1	3	4	0	0
FS-1350	114	477	363	0	3	4	0	0
FS-1350	114	120	6	1	3	5	4	3
FS-1350	115	477	362	0	3	4	0	0
FS-1350	115	477	362	0	3	5	0	1
FS-1350	115	477	362	0	4	5	0	1
FS-1350	115	116	1	1	4	5	4	0
FS-1350	115	117	2	1	3	1	4	2
FS-1351	116	477	361	0	3	5	0	4
FS-1351	116	156	40	1	3	4	2	1
FS-1351	116	135	19	1	3	4	2	0
FS-1351	116	477	361	0	4	1	1	0
FS-1351	116	477	361	0	4	1	0	0
FS-1351	117	477	360	0	4	4	0	0
FS-1351	120	477	357	0	2	4	0	0
FS-1351	120	477	357	0	3	1	0	0
FS-1351	120	477	357	0	3	1	0	0
FS-1352	121	477	356	0	3	4	0	2
FS-1352	121	477	356	0	3	1	0	1
FS-1352	122	477	355	0	3	5	0	0
FS-1352	122	284	162	1	3	5	2	2
FS-1352	122	196	74	1	3	1	3	1
FS-1352	122	123	1	1	3	5	4	0
FS-1352	123	477	354	0	3	1	0	0
FS-1352	123	184	61	1	3	5	3	1
FS-1352	125	477	352	0	3	1	0	0
FS-1353	126	477	351	0	3	1	0	0
FS-1353	126	477	351	0	4	4	0	0
FS-1353	127	477	350	0	3	2	0	2
FS-1353	127	477	350	0	3	4	0	1
FS-1353	127	157	30	1	3	3	2	2
FS-1353	127	477	350	0	3	1	0	0
FS-1353	127	182	55	1	3	4	1	3
FS-1353	127	128	1	1	3	1	4	3
FS-1353	127	477	350	0	2	1	0	2
FS-1353	127	133	6	1	3	1	3	0
FS-1354	127	142	15	1	3	1	3	0
FS-1354	128	477	349	0	3	4	0	0
FS-1354	128	133	5	1	4	5	4	1
FS-1354	129	477	348	0	3	1	0	0
FS-1354	129	135	6	1	3	4	4	0
FS-1354	130	155	25	1	5	1	3	0
FS-1354	130	477	347	0	4	1	0	0
FS-1354	130	332	202	1	3	5	1	0
FS-1354	133	134	1	1	4	5	4	1
FS-1355	134	135	1	1	4	5	4	1
FS-1355	134	135	1	1	4	5	4	1
FS-1355	134	136	2	1	4	5	0	2
FS-1355	134	205	71	1	3	2	2	2
FS-1355	134	136	2	1	4	5	4	2
FS-1355	134	136	2	1	4	5	0	2
FS-1355	134	136	2	1	4	5	4	1
FS-1355	134	135	1	1	4	5	4	1
FS-1355	134	136	2	1	4	5	4	1
FS-1355	134	136	2	1	4	5	4	1
FS-1356	134	137	3	1	4	5	4	1
FS-1356	134	136	2	1	4	5	0	1
FS-1356	134	136	2	1	4	5	0	1
FS-1356	134	164	30	1	4	5	4	2
FS-1356	134	477	343	0	4	4	1	0
FS-1356	134	135	1	1	3	2	0	0
FS-1356	134	295	161	1	3	5	1	1
FS-1356	134	135	1	1	4	5	4	2
FS-1356	134	136	2	1	4	5	0	1
FS-1356	134	136	2	1	4	5	0	4
FS-1357	134	136	2	1	4	5	4	1
FS-1357	135	477	342	0	4	4	1	0
FS-1357	135	477	342	0	3	2	0	1
FS-1357	135	137	2	1	5	1	1	1
FS-1357	135	477	342	0	4	2	0	1
FS-1357	136	477	341	0	4	5	0	0
FS-1357	136	477	341	0	3	5	0	0
FS-1357	136	151	15	1	3	5	2	0
FS-1357	136	477	341	0	3	1	0	0
FS-1358	136	477	341	0	3	1	0	0
FS-1358	136	137	1	1	4	1	4	1
FS-1358	136	165	29	1	3	4	1	1
FS-1358	136	204	68	1	3	5	3	0
FS-1358	136	477	341	0	2	1	0	0
FS-1358	136	137	1	1	2	1	4	2
FS-1358	136	142	6	1	4	5	4	1
FS-1358	137	142	5	1	3	1	4	1
FS-1358	137	142	5	1	3	4	2	0
FS-1359	137	138	1	1	3	1	2	1
FS-1359	137	147	10	1	4	5	4	1
FS-1359	137	138	1	1	4	5	4	1
FS-1359	137	138	1	1	4	5	4	2
FS-1359	137	477	340	0	4	4	0	0
FS-1359	137	138	1	1	3	4	0	1
FS-1359	137	477	340	0	2	1	0	3
FS-1359	138	477	339	0	3	5	1	0
FS-1359	140	143	3	1	4	4	1	0
FS-1359	140	477	337	0	3	1	0	0
FS-1360	140	141	1	1	4	5	0	1
FS-1360	140	142	2	1	3	1	4	0
FS-1360	142	151	9	1	3	4	4	1
FS-1360	142	477	335	0	3	1	0	1
FS-1360	142	477	335	0	3	1	0	0
FS-1360	142	477	335	0	3	5	0	0
FS-1360	142	477	335	0	3	5	0	0
FS-1360	142	158	16	1	3	5	2	2
FS-1360	142	165	23	1	3	5	2	3
FS-1360	142	176	34	1	3	5	2	3
FS-1361	142	197	55	1	3	5	2	2
FS-1361	142	143	1	1	3	1	4	0
FS-1361	142	477	335	0	3	1	0	0
FS-1361	142	477	335	0	3	1	0	0
FS-1361	143	477	334	0	3	1	0	0
FS-1361	143	157	14	1	3	1	1	0
FS-1361	143	477	334	0	3	2	0	0
FS-1361	143	408	265	1	3	5	0	1
FS-1361	143	144	1	1	3	1	4	1
FS-1361	144	145	1	1	4	5	3	1
FS-1362	144	145	1	1	4	5	4	2
FS-1362	144	168	24	1	3	4	1	1
FS-1362	144	206	62	1	3	1	1	0
FS-1362	144	477	333	0	3	4	0	0
FS-1362	144	477	333	0	4	5	0	2
FS-1362	147	149	2	1	4	1	2	1
FS-1362	147	148	1	1	4	5	2	3
FS-1362	142	147	5	1	3	4	2	0
FS-1362	147	149	2	1	4	5	2	1
FS-1363	148	477	329	0	4	5	0	1
FS-1363	148	150	2	1	4	5	2	2
FS-1363	148	149	1	1	4	5	4	1
FS-1363	148	477	329	0	3	5	0	0
FS-1363	148	240	92	1	3	5	3	0
FS-1363	148	182	34	1	3	1	3	0
FS-1363	148	151	3	1	3	1	3	0
FS-1363	149	152	3	1	2	5	4	0
FS-1363	149	157	8	1	3	1	0	2
FS-1363	149	477	328	0	3	4	1	0
FS-1364	149	477	328	0	3	4	0	0
FS-1364	149	163	14	1	3	4	3	0
FS-1364	149	158	9	1	3	1	1	0
FS-1364	150	200	50	1	3	5	1	0
FS-1364	150	157	7	1	3	4	1	1
FS-1364	150	477	327	0	3	1	0	0
FS-1364	150	151	1	1	3	1	1	0
FS-1364	151	477	326	0	3	1	0	0
FS-1364	152	153	1	1	3	5	2	1
FS-1364	152	155	3	1	4	5	3	1
FS-1365	152	155	3	1	4	5	3	0
FS-1365	152	153	1	1	4	5	3	3
FS-1365	152	155	3	1	4	5	4	0
FS-1365	154	161	7	1	3	4	4	2
FS-1365	154	477	323	0	3	4	0	0
FS-1365	154	477	323	0	3	4	0	3
FS-1365	155	477	322	0	4	4	0	0
FS-1365	155	477	322	0	5	1	0	0
FS-1365	156	219	63	1	3	4	2	0
FS-1365	157	158	1	1	3	4	3	1
FS-1366	157	477	320	0	2	1	0	0
FS-1366	157	353	196	1	3	1	4	1
FS-1366	157	289	132	1	3	1	1	1
FS-1366	158	193	35	1	3	1	1	1
FS-1366	158	159	1	1	4	1	4	2
FS-1366	158	191	33	1	3	5	2	0
FS-1366	158	477	319	0	3	3	0	0
FS-1366	158	159	1	1	5	1	4	0
FS-1366	160	224	64	1	3	1	3	0
FS-1367	162	477	315	0	3	1	0	0
FS-1367	162	477	315	0	3	1	0	1
FS-1367	162	204	42	1	3	1	0	0
FS-1367	163	165	2	1	4	1	4	0
FS-1367	163	189	26	1	4	4	1	0
FS-1367	164	165	1	1	3	1	4	1
FS-1367	164	165	1	1	4	1	4	2
FS-1367	164	477	313	0	3	1	0	0
FS-1367	164	477	313	0	3	1	0	1
FS-1367	164	165	1	1	4	1	1	0
FS-1368	164	169	5	1	3	1	0	0
FS-1368	164	165	1	1	3	5	4	1
FS-1368	164	170	6	1	2	1	3	0
FS-1368	165	169	4	1	3	1	0	1
FS-1368	165	477	312	0	3	4	0	0
FS-1368	165	477	312	0	4	5	0	0
FS-1368	165	166	1	1	3	4	4	1
FS-1368	165	477	312	0	4	1	0	1
FS-1368	168	212	44	1	3	5	2	2
FS-1368	170	477	307	0	3	5	0	0
FS-1369	170	196	26	1	4	4	1	1
FS-1369	170	477	307	0	3	5	0	0
FS-1369	171	172	1	1	4	4	3	0
FS-1369	171	477	306	0	3	4	0	0
FS-1369	172	477	305	0	3	4	0	0
FS-1369	172	248	76	1	3	5	1	0
FS-1369	175	477	302	0	2	1	0	0
FS-1369	175	477	302	0	3	1	0	0
FS-1369	175	477	302	0	3	5	0	0
FS-1369	175	477	302	0	3	5	0	0
FS-1370	176	477	301	0	3	4	0	0
FS-1370	176	477	301	0	3	1	0	0
FS-1370	176	182	6	1	3	1	3	1
FS-1370	176	182	6	1	3	4	3	0
FS-1370	178	179	1	1	4	1	2	0
FS-1370	178	179	1	1	3	5	2	0
FS-1370	178	179	1	1	3	1	1	1
FS-1370	179	477	298	0	4	4	0	1
FS-1370	179	477	298	0	3	4	0	0
FS-1371	179	189	10	1	3	5	3	0
FS-1371	180	477	297	0	3	4	0	0
FS-1371	182	183	1	1	4	4	3	0
FS-1371	182	332	150	1	1	5	2	4
FS-1371	182	183	1	1	3	4	4	2
FS-1371	182	183	1	1	3	1	2	0
FS-1371	183	477	294	0	3	1	0	0
FS-1371	184	477	293	0	3	1	0	1
FS-1371	184	189	5	1	3	4	4	0
FS-1372	185	477	292	0	3	4	0	3
FS-1372	185	187	2	1	3	1	2	1
FS-1372	185	190	5	1	4	1	1	0
FS-1372	185	191	6	1	3	1	3	0
FS-1372	186	477	291	0	3	4	0	0
FS-1372	189	477	288	0	4	4	0	0
FS-1372	191	192	1	1	4	5	4	0
FS-1372	191	207	16	1	4	4	3	0
FS-1372	191	219	28	1	4	4	3	0
FS-1372	189	192	3	1	4	1	4	0
FS-1373	191	477	286	0	3	1	0	0
FS-1373	192	239	47	1	3	1	3	0
FS-1373	192	477	285	0	5	4	1	1
FS-1373	192	197	5	1	4	5	4	1
FS-1373	192	477	285	0	3	2	0	0
FS-1373	193	220	27	1	4	4	2	1
FS-1373	194	477	283	0	3	1	0	0
FS-1373	194	195	1	1	2	1	0	0
FS-1373	196	225	29	1	3	1	3	0
FS-1373	197	477	280	0	3	4	0	3
FS-1374	197	477	280	0	3	2	0	0
FS-1374	197	477	280	0	5	1	0	0
FS-1374	198	477	279	0	3	4	0	2
FS-1374	198	200	2	1	3	5	4	0
FS-1374	198	254	56	1	2	4	1	0
FS-1374	198	477	279	0	3	3	0	0
FS-1374	198	227	29	1	3	1	3	0
FS-1374	199	228	29	1	4	1	3	0
FS-1374	199	477	278	0	3	1	0	0
FS-1374	199	262	63	1	3	5	2	1
FS-1375	200	231	31	1	3	5	4	0
FS-1375	200	201	1	1	3	1	0	0
FS-1375	200	477	277	0	3	4	0	0
FS-1375	200	477	277	0	3	5	0	0
FS-1375	200	477	277	0	3	5	0	0
FS-1375	200	477	277	0	3	5	0	0
FS-1375	200	477	277	0	3	5	0	0
FS-1375	200	477	277	0	3	1	0	1
FS-1375	200	225	25	1	3	1	4	0
FS-1375	202	477	275	0	3	5	0	0
FS-1376	203	477	274	0	3	4	0	0
FS-1376	203	205	2	1	4	4	1	0
FS-1376	204	477	273	0	3	4	0	0
FS-1376	204	477	273	0	3	4	0	2
FS-1376	205	206	1	1	3	1	0	0
FS-1376	205	207	2	1	4	1	3	0
FS-1376	205	264	59	1	1	5	0	2
FS-1376	205	224	19	1	3	5	2	1
FS-1376	206	281	75	1	3	1	3	3
FS-1377	206	477	271	0	3	1	0	0
FS-1377	207	477	270	0	3	1	0	0
FS-1377	207	232	25	1	5	1	3	0
FS-1377	210	477	267	0	3	1	0	0
FS-1377	210	245	35	1	4	1	2	0
FS-1377	211	477	266	0	3	1	0	0
FS-1377	212	324	112	1	3	5	1	0
FS-1377	212	477	265	0	3	5	0	1
FS-1377	212	260	48	1	3	5	2	0
FS-1377	212	242	30	1	3	5	2	1
FS-1378	212	242	30	1	3	5	1	1
FS-1378	212	420	208	1	3	5	1	3
FS-1378	212	237	25	1	3	5	2	2
FS-1378	213	477	264	0	3	2	0	1
FS-1378	213	228	15	1	4	1	0	0
FS-1378	213	219	6	1	4	1	2	0
FS-1378	213	219	6	1	3	1	3	0
FS-1378	213	477	264	0	3	5	0	0
FS-1378	213	225	12	1	3	3	3	0
FS-1378	213	219	6	1	5	5	2	1
FS-1379	213	268	55	1	3	5	4	2
FS-1379	214	269	55	1	3	5	2	1
FS-1379	214	218	4	1	5	1	2	2
FS-1379	215	477	262	0	3	1	0	0
FS-1379	217	407	190	1	3	5	0	1
FS-1379	217	221	4	1	3	1	1	1
FS-1379	217	218	1	1	5	4	1	1
FS-1379	217	477	260	0	3	3	0	0
FS-1379	217	477	260	0	3	4	0	1
FS-1379	217	218	1	1	4	1	2	1
FS-1380	218	477	259	0	3	4	0	0
FS-1380	219	284	65	1	3	1	4	1
FS-1380	219	220	1	1	3	1	0	0
FS-1380	219	477	258	0	3	2	0	0
FS-1380	219	235	16	1	3	1	1	1
FS-1380	219	252	33	1	4	1	1	0
FS-1380	220	477	257	0	4	1	0	0
FS-1380	220	223	3	1	4	5	2	0
FS-1380	220	221	1	1	3	1	0	1
FS-1381	220	477	257	0	4	1	0	1
FS-1381	220	477	257	0	3	5	0	1
FS-1381	220	247	27	1	5	4	4	2
FS-1381	220	225	5	1	3	4	4	1
FS-1381	220	221	1	1	4	4	4	3
FS-1381	221	247	26	1	3	1	2	1
FS-1381	221	329	108	1	3	1	4	0
FS-1381	221	385	164	1	3	1	0	1
FS-1381	221	336	115	1	3	4	1	1
FS-1381	222	226	4	1	4	1	2	0
FS-1382	224	249	25	1	4	4	1	0
FS-1382	224	233	9	1	3	4	4	0
FS-1382	224	228	4	1	4	4	1	1
FS-1382	224	225	1	1	3	1	2	0
FS-1382	225	477	252	0	3	1	0	0
FS-1382	225	477	252	0	4	4	0	0
FS-1382	226	477	251	0	4	4	0	0
FS-1382	226	477	251	0	3	1	0	0
FS-1382	226	235	9	1	2	1	0	0
FS-1382	227	228	1	1	4	4	1	0
FS-1383	227	263	36	1	3	4	1	4
FS-1383	228	239	11	1	3	4	4	0
FS-1383	228	245	17	1	3	1	0	0
FS-1383	228	261	33	1	3	1	1	1
FS-1383	228	306	78	1	2	5	1	0
FS-1383	231	477	246	0	2	1	0	0
FS-1383	231	248	17	1	3	1	4	0
FS-1383	231	239	8	1	3	1	1	0
FS-1383	232	255	23	1	3	1	3	4
FS-1383	232	347	115	1	3	1	0	1
FS-1384	232	268	36	1	4	1	3	0
FS-1384	232	477	245	0	3	1	0	0
FS-1384	233	477	244	0	3	1	0	0
FS-1384	233	477	244	0	3	1	0	1
FS-1384	233	259	26	1	4	1	4	2
FS-1384	233	302	69	1	3	5	1	1
FS-1384	233	254	21	1	3	1	1	0
FS-1384	233	477	244	0	3	4	0	0
FS-1384	234	236	2	1	3	5	4	2
FS-1384	234	238	4	1	4	5	0	0
FS-1385	234	477	243	0	4	5	0	0
FS-1385	234	235	1	1	3	5	2	1
FS-1385	234	316	82	1	3	5	1	1
FS-1385	234	459	225	1	3	5	1	1
FS-1385	234	240	6	1	3	4	1	0
FS-1385	234	235	1	1	3	1	0	1
FS-1385	234	375	141	1	3	5	1	0
FS-1385	234	246	12	1	3	4	4	0
FS-1385	234	239	5	1	3	1	2	1
FS-1385	234	477	243	0	3	1	0	0
FS-1386	234	477	243	0	3	1	0	1
FS-1386	235	239	4	1	3	4	2	2
FS-1386	235	251	16	1	3	1	2	0
FS-1386	235	241	6	1	3	1	3	0
FS-1386	235	477	242	0	4	4	0	0
FS-1386	235	477	242	0	3	4	0	0
FS-1386	235	477	242	0	3	1	0	0
FS-1386	235	245	10	1	3	1	2	0
FS-1386	235	261	26	1	3	1	3	1
FS-1386	236	350	114	1	3	5	1	0
FS-1387	238	333	95	1	4	3	2	1
FS-1387	238	283	45	1	3	3	0	0
FS-1387	238	248	10	1	3	5	0	1
FS-1387	239	346	107	1	3	5	2	1
FS-1387	239	240	1	1	3	1	0	0
FS-1387	239	477	238	0	4	1	0	1
FS-1387	239	266	27	1	3	5	1	2
FS-1387	239	276	37	1	3	5	2	0
FS-1387	239	283	44	1	3	5	1	0
FS-1387	239	477	238	0	3	4	0	2
FS-1388	239	255	16	1	3	5	2	1
FS-1388	240	477	237	0	3	2	0	0
FS-1388	240	282	42	1	3	4	1	0
FS-1388	241	477	236	0	3	4	0	0
FS-1388	241	252	11	1	4	4	1	0
FS-1388	241	246	5	1	3	4	1	0
FS-1388	241	260	19	1	3	1	3	3
FS-1388	241	477	236	0	4	1	0	1
FS-1388	245	246	1	1	2	4	0	1
FS-1389	245	477	232	0	4	4	0	0
FS-1389	245	477	232	0	3	4	0	3
FS-1389	246	262	16	1	3	1	1	0
FS-1389	246	477	231	0	3	1	0	0
FS-1389	246	477	231	0	3	2	0	1
FS-1389	247	252	5	1	3	1	2	0
FS-1389	247	477	230	0	4	5	0	0
FS-1389	248	477	229	0	4	4	0	0
FS-1389	248	263	15	1	3	5	2	0
FS-1389	248	477	229	0	3	1	0	1
FS-1390	248	253	5	1	2	1	0	2
FS-1390	248	477	229	0	3	1	0	2
FS-1390	249	254	5	1	4	4	4	2
FS-1390	249	477	228	0	3	1	0	0
FS-1390	249	477	228	0	3	1	0	0
FS-1390	252	477	225	0	3	1	0	0
FS-1390	252	284	32	1	3	5	1	0
FS-1390	252	477	225	0	3	5	1	0
FS-1390	252	261	9	1	3	1	4	2
FS-1390	253	477	224	0	3	5	0	0
FS-1391	253	254	1	1	2	1	0	1
FS-1391	254	477	223	0	3	5	0	2
FS-1391	254	477	223	0	4	4	0	0
FS-1391	255	256	1	1	4	1	4	2
FS-1391	255	477	222	0	3	1	0	0
FS-1391	255	477	222	0	3	4	0	3
FS-1391	256	477	221	0	4	1	0	0
FS-1391	259	477	218	0	3	1	0	0
FS-1391	259	260	1	1	4	1	1	0
FS-1392	259	477	218	0	3	4	0	0
FS-1392	259	477	218	0	3	2	0	2
FS-1392	259	477	218	0	3	5	0	0
FS-1392	259	296	37	1	3	5	2	0
FS-1392	259	289	30	1	3	5	2	1
FS-1392	260	282	22	1	3	1	3	0
FS-1392	262	263	1	1	4	4	1	1
FS-1392	262	477	215	0	3	4	0	0
FS-1392	262	477	215	0	3	1	0	0
FS-1393	262	266	4	1	3	5	0	0
FS-1393	263	477	214	0	3	1	0	0
FS-1393	263	269	6	1	4	1	1	1
FS-1393	263	477	214	0	4	1	0	1
FS-1393	265	477	212	0	3	5	0	1
FS-1393	266	477	211	0	3	1	0	0
FS-1393	266	281	15	1	3	5	1	0
FS-1393	266	267	1	1	1	5	1	0
FS-1393	266	270	4	1	4	1	1	1
FS-1393	267	309	42	1	3	1	0	1
FS-1394	267	477	210	0	3	5	0	1
FS-1394	267	297	30	1	3	4	4	3
FS-1394	269	303	34	1	3	5	1	0
FS-1394	269	274	5	1	3	5	1	0
FS-1394	269	275	6	1	3	5	1	0
FS-1394	269	284	15	1	3	1	3	2
FS-1394	272	355	83	1	4	4	1	0
FS-1394	273	275	2	1	3	4	1	1
FS-1394	274	282	8	1	4	1	1	0
FS-1395	274	276	2	1	4	4	1	0
FS-1395	274	283	9	1	4	1	1	3
FS-1395	274	275	1	1	1	3	0	0
FS-1395	274	477	203	0	3	1	0	0
FS-1395	274	275	1	1	4	1	0	0
FS-1395	275	477	202	0	3	5	0	1
FS-1395	275	282	7	1	4	4	1	0
FS-1395	276	277	1	1	4	1	3	0
FS-1395	276	277	1	1	3	4	1	1
FS-1395	276	298	22	1	3	1	1	0
FS-1396	276	456	180	1	4	4	1	0
FS-1396	276	277	1	1	3	5	2	2
FS-1396	277	281	4	1	3	1	3	1
FS-1396	277	319	42	1	4	1	4	0
FS-1396	277	278	1	1	3	1	4	1
FS-1396	277	477	200	0	3	1	0	0
FS-1396	280	477	197	0	4	1	0	0
FS-1396	280	281	1	1	4	4	1	0
FS-1396	280	283	3	1	4	4	1	0
FS-1397	280	347	67	1	4	4	1	0
FS-1397	280	477	197	0	3	5	0	4
FS-1397	280	284	4	1	3	1	1	1
FS-1397	280	284	4	1	3	5	0	0
FS-1397	280	477	197	0	3	1	0	0
FS-1397	280	282	2	1	3	1	1	1
FS-1397	280	477	197	0	3	1	0	1
FS-1397	281	477	196	0	4	4	0	0
FS-1397	281	282	1	1	4	4	0	0
FS-1398	281	477	196	0	4	4	0	0
FS-1398	281	477	196	0	4	4	0	0
FS-1398	282	477	195	0	4	4	0	0
FS-1398	282	292	10	1	3	1	1	0
FS-1398	283	477	194	0	3	4	0	1
FS-1398	283	346	63	1	3	4	1	0
FS-1398	283	477	194	0	3	5	0	1
FS-1398	284	287	3	1	4	4	1	0
FS-1398	284	285	1	1	3	2	0	1
FS-1398	284	477	193	0	3	5	0	1
FS-1399	284	290	6	1	4	1	1	0
FS-1399	284	477	193	0	4	4	0	0
FS-1399	287	477	190	0	3	2	0	4
FS-1399	287	288	1	1	3	1	1	1
FS-1399	287	291	4	1	4	4	1	0
FS-1399	287	477	190	0	3	5	0	0
FS-1399	288	305	17	1	3	4	1	1
FS-1399	288	424	136	1	3	1	1	0
FS-1399	288	477	189	0	3	1	0	1
FS-1399	288	337	49	1	3	1	1	3
FS-1400	289	290	1	1	3	1	4	0
FS-1400	290	341	51	1	3	2	1	1
FS-1400	290	291	1	1	3	1	2	0
FS-1400	290	291	1	1	3	1	4	0
FS-1400	290	295	5	1	3	1	1	0
FS-1400	290	291	1	1	3	1	3	1
FS-1400	290	347	57	1	3	4	1	2
FS-1400	290	291	1	1	3	1	2	1
FS-1400	290	305	15	1	3	4	1	0
FS-1400	290	291	1	1	3	1	1	1
FS-1401	290	477	187	0	4	1	0	1
FS-1401	291	295	4	1	3	5	1	1
FS-1401	293	303	10	1	3	4	0	0
FS-1401	294	477	183	0	3	1	0	0
FS-1401	294	379	85	1	3	1	0	0
FS-1401	294	320	26	1	3	4	1	1
FS-1401	294	303	9	1	3	5	2	0
FS-1401	294	320	26	1	3	5	2	0
FS-1401	295	296	1	1	1	1	0	1
FS-1402	295	477	182	0	3	5	0	1
FS-1402	295	296	1	1	3	1	4	0
FS-1402	295	477	182	0	3	4	0	0
FS-1402	296	477	181	0	3	1	0	1
FS-1402	296	304	8	1	3	5	1	1
FS-1402	296	297	1	1	3	1	1	0
FS-1402	296	297	1	1	3	4	1	1
FS-1402	296	302	6	1	2	1	4	2
FS-1402	297	299	2	1	3	1	4	0
FS-1402	297	298	1	1	5	4	4	0
FS-1403	297	309	12	1	4	4	0	0
FS-1403	298	299	1	1	3	1	0	0
FS-1403	298	477	179	0	3	3	0	0
FS-1403	301	303	2	1	3	5	2	0
FS-1403	301	477	176	0	3	4	0	1
FS-1403	301	317	16	1	3	5	2	0
FS-1403	301	477	176	0	3	2	0	1
FS-1403	302	449	147	1	3	1	4	0
FS-1403	302	477	175	0	3	4	0	0
FS-1403	302	311	9	1	3	1	4	0
FS-1404	302	477	175	0	3	1	0	0
FS-1404	303	308	5	1	3	1	1	0
FS-1404	304	309	5	1	3	1	4	0
FS-1404	304	477	173	0	3	5	0	0
FS-1404	305	318	13	1	3	4	1	0
FS-1404	305	357	52	1	3	1	3	0
FS-1404	305	309	4	1	3	5	1	2
FS-1404	305	309	4	1	3	1	4	2
FS-1404	305	307	2	1	3	1	1	0
FS-1405	305	477	172	0	5	3	0	0
FS-1405	305	309	4	1	3	4	1	1
FS-1405	308	421	113	1	3	5	1	4
FS-1405	310	318	8	1	3	1	1	0
FS-1405	311	319	8	1	4	1	4	0
FS-1405	311	477	166	0	4	4	0	0
FS-1405	311	338	27	1	3	5	0	1
FS-1405	311	338	27	1	3	5	0	3
FS-1406	312	477	165	0	3	4	0	2
FS-1406	312	387	75	1	3	4	1	0
FS-1406	312	377	65	1	3	2	0	0
FS-1406	312	319	7	1	3	4	2	0
FS-1406	314	324	10	1	3	4	2	0
FS-1406	315	316	1	1	3	1	4	1
FS-1406	315	477	162	0	3	1	0	0
FS-1406	315	327	12	1	3	5	2	4
FS-1406	315	316	1	1	3	5	0	1
FS-1406	315	477	162	0	3	4	0	0
FS-1407	316	317	1	1	3	4	4	1
FS-1407	316	317	1	1	3	1	0	1
FS-1407	316	317	1	1	3	1	0	1
FS-1407	316	317	1	1	3	1	0	1
FS-1407	316	477	161	0	3	1	3	3
FS-1407	317	335	18	1	2	1	1	0
FS-1407	317	477	160	0	3	1	0	0
FS-1407	317	477	160	0	3	1	0	0
FS-1407	317	477	160	0	3	1	0	0
FS-1407	317	477	160	0	3	5	0	0
FS-1408	317	477	160	0	5	4	0	1
FS-1408	317	415	98	1	3	1	3	0
FS-1408	317	324	7	1	3	5	1	1
FS-1408	316	424	108	1	4	4	0	1
FS-1408	317	477	160	0	4	4	0	1
FS-1408	319	337	18	1	3	5	1	1
FS-1408	320	477	157	0	4	1	0	0
FS-1408	322	477	155	0	3	1	0	0
FS-1408	322	347	25	1	3	1	1	0
FS-1408	322	325	3	1	4	5	1	0
FS-1409	322	477	155	0	3	5	0	1
FS-1409	323	477	154	0	1	5	0	0
FS-1409	323	344	21	1	3	4	0	1
FS-1409	324	477	153	0	4	4	0	1
FS-1409	324	328	4	1	3	5	2	1
FS-1409	325	332	7	1	3	4	4	0
FS-1409	328	350	22	1	3	5	1	0
FS-1409	328	477	149	0	3	1	0	0
FS-1409	329	477	148	0	3	1	0	0
FS-1409	329	477	148	0	3	1	0	0
FS-1410	329	330	1	1	3	1	0	0
FS-1410	329	343	14	1	3	1	1	0
FS-1410	330	331	1	1	4	4	1	0
FS-1410	330	477	147	0	4	4	0	0
FS-1410	330	477	147	0	4	4	0	0
FS-1410	330	336	6	1	5	4	1	0
FS-1410	330	333	3	1	4	4	1	0
FS-1410	330	477	147	0	4	4	0	0
FS-1410	330	331	1	1	4	4	1	0
FS-1410	331	477	146	0	3	4	0	0
FS-1411	331	477	146	0	4	4	0	0
FS-1411	331	429	98	1	3	1	1	4
FS-1411	332	333	1	1	2	4	1	0
FS-1411	332	339	7	1	3	4	1	0
FS-1411	332	338	6	1	3	5	1	0
FS-1411	332	477	145	0	3	1	0	0
FS-1411	332	351	19	1	3	5	2	0
FS-1411	333	477	144	0	3	5	0	0
FS-1411	333	418	85	1	3	2	1	4
FS-1411	333	336	3	1	5	4	1	0
FS-1412	333	337	4	1	3	5	2	0
FS-1412	333	347	14	1	3	4	0	0
FS-1412	337	477	140	0	3	1	0	0
FS-1412	337	344	7	1	3	4	2	0
FS-1412	337	399	62	1	5	4	1	0
FS-1412	337	477	140	0	3	1	0	0
FS-1412	338	477	139	0	4	1	0	0
FS-1412	339	379	40	1	3	5	1	0
FS-1413	339	420	81	1	3	5	1	0
FS-1413	339	344	5	1	3	5	2	1
FS-1413	339	373	34	1	3	1	1	0
FS-1413	340	477	137	0	3	4	0	0
FS-1413	340	477	137	0	2	1	0	1
FS-1413	342	477	135	0	3	1	0	1
FS-1413	343	344	1	1	3	1	1	0
FS-1413	344	347	3	1	4	5	2	0
FS-1413	344	402	58	1	3	4	0	0
FS-1414	344	403	59	1	3	1	3	2
FS-1414	344	477	133	0	4	4	0	0
FS-1414	345	346	1	1	4	5	2	0
FS-1414	345	347	2	1	3	1	0	0
FS-1414	345	346	1	1	3	1	1	0
FS-1414	345	347	2	1	3	1	1	0
FS-1414	345	347	2	1	2	5	2	0
FS-1414	346	477	131	0	3	2	0	1
FS-1414	346	477	131	0	3	4	0	0
FS-1414	347	351	4	1	3	5	2	0
FS-1415	347	373	26	1	3	5	1	0
FS-1415	348	351	3	1	3	5	1	0
FS-1415	348	349	1	1	3	5	1	1
FS-1415	350	387	37	1	3	4	1	0
FS-1415	350	353	3	1	3	5	2	1
FS-1415	350	351	1	1	3	5	0	2
FS-1415	351	383	32	1	3	5	1	1
FS-1415	351	477	126	0	3	1	0	0
FS-1415	351	399	48	1	4	1	1	0
FS-1415	351	374	23	1	3	4	0	1
FS-1416	351	352	1	1	3	5	2	0
FS-1416	352	366	14	1	3	5	1	1
FS-1416	353	409	56	1	3	5	1	1
FS-1416	353	367	14	1	3	4	1	0
FS-1416	354	477	123	0	4	1	0	1
FS-1416	354	356	2	1	4	1	1	0
FS-1416	354	355	1	1	3	1	3	0
FS-1416	354	366	12	1	3	5	1	1
FS-1416	355	364	9	1	3	5	0	2
FS-1416	356	477	121	0	3	5	0	1
FS-1417	356	357	1	1	3	5	2	0
FS-1417	357	366	9	1	3	4	4	0
FS-1417	358	403	45	1	4	4	1	0
FS-1417	358	359	1	1	3	1	0	0
FS-1417	360	477	117	0	4	4	0	0
FS-1417	360	382	22	1	3	1	1	0
FS-1417	360	443	83	1	3	1	0	3
FS-1417	360	477	117	0	4	4	0	0
FS-1417	361	477	116	0	3	4	0	0
FS-1417	361	477	116	0	3	1	0	0
FS-1418	362	363	1	1	3	1	0	0
FS-1418	362	427	65	1	3	4	1	0
FS-1418	363	364	1	1	3	1	2	1
LIX-67	4	7	3	1	3	4	0	0
LIX-67	10	30	20	1	3	3	1	0
LIX-67	25	26	1	1	3	1	0	0
LIX-67	30	477	447	0	3	2	1	0
LIX-67	66	113	47	1	3	3	0	0
LIX-67	66	113	47	1	3	1	0	0
LIX-67	66	113	47	1	3	3	0	0
LIX-67	66	113	47	1	3	3	0	0
LIX-67	66	477	411	0	3	1	0	0
LIX-68	67	477	410	0	3	1	0	0
LIX-68	78	477	399	0	3	1	0	0
LIX-68	78	477	399	0	3	1	0	0
LIX-68	84	477	393	0	3	1	0	0
LIX-68	84	477	393	0	3	4	0	0
LIX-68	84	477	393	0	3	1	0	0
LIX-68	84	477	393	0	3	4	0	0
LIX-68	84	477	393	0	3	4	0	0
LIX-68	85	477	392	0	3	4	0	0
LIX-68	92	477	385	0	3	1	0	0
LIX-69	93	477	384	0	3	1	0	0
LIX-69	94	477	383	0	3	4	0	0
LIX-69	95	477	382	0	3	1	0	0
LIX-69	100	477	377	0	3	1	0	0
LIX-69	100	477	377	0	1	1	0	0
LIX-69	105	477	372	0	3	3	0	0
LIX-69	108	477	369	0	3	1	0	0
LIX-69	108	477	369	0	3	4	0	0
LIX-69	108	477	369	0	3	4	0	0
LIX-69	108	477	369	0	3	4	0	0
LIX-70	113	477	364	0	3	1	0	0
LIX-70	118	477	359	0	3	1	0	0
LIX-70	119	477	358	0	3	1	0	0
LIX-70	175	477	302	0	3	4	0	0
LIX-70	175	477	302	0	3	4	0	0
LIX-70	175	477	302	0	3	3	0	0
LIX-70	176	477	301	0	3	3	0	0
LIX-70	176	189	13	1	3	1	0	0
LIX-70	176	477	301	0	3	3	0	0
LIX-70	178	477	299	0	3	3	0	0
LIX-71	178	477	299	0	3	3	0	0
LIX-71	179	477	298	0	3	4	0	0
LIX-71	189	190	1	1	3	1	0	0
LIX-71	189	477	288	0	3	4	0	0
LIX-71	189	477	288	0	3	4	0	0
LIX-71	189	477	288	0	3	4	0	0
LIX-71	189	477	288	0	3	4	0	0
LIX-71	189	477	288	0	3	3	0	0
LIX-71	189	477	288	0	3	3	0	0
LIX-71	189	477	288	0	3	4	0	0
LIX-72	190	477	287	0	3	4	0	0
LIX-72	190	477	287	0	3	4	0	0
LIX-72	190	477	287	0	3	4	0	0
LIX-72	190	477	287	0	3	4	0	0
LIX-72	190	477	287	0	3	4	0	0
LIX-72	190	477	287	0	3	4	0	0
LIX-72	190	191	1	1	3	1	0	0
LIX-72	190	191	1	1	3	1	0	0
LIX-72	192	477	285	0	3	4	0	0
LIX-72	192	477	285	0	3	4	0	0
LIX-73	193	477	284	0	3	4	0	0
LIX-73	196	477	281	0	3	4	0	0
LIX-73	196	477	281	0	3	4	0	0
LIX-73	196	477	281	0	3	4	0	0
LIX-73	196	477	281	0	3	4	0	0
LIX-73	196	477	281	0	3	4	0	0
LIX-73	196	477	281	0	3	4	0	0
LIX-73	196	477	281	0	3	4	0	0
LIX-73	197	477	280	0	3	4	0	0
LIX-73	197	477	280	0	3	4	0	0
LIX-74	197	477	280	0	3	3	0	0
LIX-74	197	477	280	0	3	3	0	0
LIX-74	199	477	278	0	3	3	0	0
LIX-74	204	477	273	0	3	4	0	0
LIX-74	204	477	273	0	3	4	0	0
LIX-74	204	477	273	0	3	4	0	0
LIX-74	204	477	273	0	3	4	0	0
LIX-74	205	477	272	0	3	3	0	0
LIX-74	206	477	271	0	3	3	0	0
LIX-74	211	477	266	0	4	1	0	0
LIX-75	232	477	245	0	3	3	0	0
LIX-75	261	422	161	1	3	4	0	0
LIX-75	261	422	161	1	3	4	0	0
LIX-75	263	477	214	0	3	1	0	0
LIX-75	267	422	155	1	3	4	0	0
LIX-75	267	422	155	1	3	4	0	0
LIX-75	267	422	155	1	3	4	0	0
LIX-75	267	422	155	1	3	4	0	0
LIX-75	267	422	155	1	3	4	0	0
LIX-76	299	422	123	1	3	4	0	0
LIX-76	299	422	123	1	3	4	0	0
LIX-76	299	422	123	1	3	4	0	0
LIX-76	299	422	123	1	3	4	0	0
LIX-76	299	422	123	1	3	4	0	0
LIX-76	301	422	121	1	3	4	0	0
LIX-76	301	422	121	1	3	4	0	0
LIX-76	301	477	176	0	3	4	0	0
LIX-77	301	477	176	0	3	4	0	0
LIX-77	302	477	175	0	3	1	0	0
LIX-77	302	477	175	0	3	1	0	0
LIX-77	302	477	175	0	3	1	0	0
LIX-77	303	477	174	0	3	1	1	0
LIX-77	303	477	174	0	3	3	0	0
LIX-77	303	477	174	0	3	4	0	0
LIX-77	303	477	174	0	3	4	0	0
LIX-77	304	477	173	0	3	4	0	0
LIX-77	304	477	173	0	3	1	0	0
LIX-78	304	477	173	0	3	3	0	0
LIX-78	304	477	173	0	3	3	0	0
LIX-78	304	477	173	0	3	4	0	0
LIX-78	304	477	173	0	3	4	0	0
LIX-78	304	477	173	0	3	4	0	0
LIX-78	305	477	172	0	3	3	0	0
LIX-78	305	477	172	0	3	4	0	0
LIX-78	305	477	172	0	3	4	0	0
LIX-78	305	477	172	0	3	4	0	0
LIX-78	317	477	160	0	3	4	0	0
LIX-79	317	477	160	0	3	4	0	0
VE-1835	0	64	64	1	3	1	0	1
VE-1835	1	477	476	0	3	1	0	0
VE-1835	1	11	10	1	3	1	1	0
VE-1835	1	9	8	1	3	1	1	0
VE-1835	1	4	3	1	3	5	0	0
VE-1835	1	14	13	1	4	1	1	3
VE-1835	1	2	1	1	4	1	1	1
VE-1835	1	2	1	1	3	1	0	1
VE-1835	1	477	476	0	3	1	0	0
VE-1835	1	40	39	1	3	1	1	1
VE-1836	2	3	1	1	3	1	1	1
VE-1836	2	4	2	1	3	2	1	1
VE-1836	2	477	475	0	4	1	0	0
VE-1836	2	477	475	0	2	1	0	0
VE-1836	2	477	475	0	3	1	0	0
VE-1836	2	3	1	1	3	1	1	0
VE-1836	2	25	23	1	3	5	1	1
VE-1836	2	21	19	1	3	1	1	0
VE-1836	3	38	35	1	3	5	1	0
VE-1836	3	4	1	1	3	1	0	1
VE-1837	3	4	1	1	3	1	1	0
VE-1837	3	477	474	0	3	3	0	0
VE-1837	3	21	18	1	3	5	1	0
VE-1837	3	46	43	1	4	2	1	0
VE-1837	3	4	1	1	5	3	0	0
VE-1837	3	477	474	0	4	1	0	1
VE-1837	3	4	1	1	5	1	0	0
VE-1837	3	477	474	0	3	5	0	0
VE-1837	3	477	474	0	3	5	0	0
VE-1837	3	10	7	1	4	1	1	0
VE-1838	3	127	124	1	4	1	1	1
VE-1838	4	477	473	0	3	1	0	0
VE-1838	4	8	4	1	2	1	0	0
VE-1838	4	25	21	1	3	1	1	1
VE-1838	4	9	5	1	3	1	1	0
VE-1838	4	16	12	1	3	1	1	0
VE-1838	4	17	13	1	3	4	1	2
VE-1838	4	46	42	1	3	4	1	1
VE-1838	4	5	1	1	3	1	0	0
VE-1838	4	38	34	1	3	5	1	1
VE-1839	5	8	3	1	3	1	1	0
VE-1839	5	11	6	1	3	5	0	0
VE-1839	5	11	6	1	3	5	0	0
VE-1839	7	22	15	1	3	1	1	0
VE-1839	7	148	141	1	1	4	2	0
VE-1839	7	477	470	0	3	1	0	1
VE-1839	7	477	470	0	3	2	0	0
VE-1839	7	477	470	0	3	5	0	0
VE-1839	7	477	470	0	4	1	0	0
VE-1839	8	9	1	1	3	5	0	0
VE-1840	8	9	1	1	3	5	0	0
VE-1840	8	11	3	1	3	5	0	0
VE-1840	8	9	1	1	3	5	0	0
VE-1840	8	11	3	1	3	5	0	0
VE-1840	8	9	1	1	3	5	0	0
VE-1840	8	9	1	1	3	5	0	0
VE-1840	8	9	1	1	3	5	0	0
VE-1840	8	9	1	1	3	5	0	0
VE-1840	8	9	1	1	3	5	0	0
VE-1840	8	9	1	1	3	5	0	0
VE-1841	8	107	99	1	3	4	2	1
VE-1841	8	16	8	1	2	5	1	0
VE-1841	8	477	469	0	1	1	0	0
VE-1841	8	17	9	1	3	1	1	1
VE-1841	8	9	1	1	3	1	1	0
VE-1841	8	477	469	0	5	4	0	0
VE-1841	8	12	4	1	3	1	1	2
VE-1841	8	9	1	1	3	1	1	0
VE-1841	8	9	1	1	3	5	1	0
VE-1841	9	15	6	1	3	1	1	1
VE-1842	9	10	1	1	3	1	1	0
VE-1842	9	45	36	1	3	1	1	0
VE-1842	9	23	14	1	4	1	2	0
VE-1842	9	116	107	1	3	4	1	4
VE-1842	9	477	468	0	3	1	0	0
VE-1842	9	477	468	0	5	3	0	1
VE-1842	9	28	19	1	3	1	1	0
VE-1842	9	225	216	1	3	1	1	0
VE-1842	9	15	6	1	3	1	1	0
VE-1843	9	16	7	1	3	1	1	0
VE-1843	9	477	468	0	3	1	0	0
VE-1843	9	477	468	0	3	1	0	0
VE-1843	9	85	76	1	3	3	1	0
VE-1843	10	176	166	1	3	1	1	0
VE-1843	10	16	6	1	3	5	0	0
VE-1843	10	68	58	1	3	3	1	3
VE-1843	10	15	5	1	3	5	1	0
VE-1843	10	17	7	1	3	5	1	0
VE-1843	10	477	467	0	3	1	0	0
VE-1844	10	11	1	1	3	1	0	0
VE-1844	10	477	467	0	3	1	0	0
VE-1844	10	47	37	1	3	1	1	0
VE-1844	10	14	4	1	3	5	1	0
VE-1844	10	477	467	0	3	1	0	1
VE-1844	11	21	10	1	3	1	1	0
VE-1844	11	477	466	0	3	1	0	0
VE-1844	11	32	21	1	3	1	1	0
VE-1844	11	44	33	1	4	4	1	1
VE-1844	11	53	42	1	3	4	0	0
VE-1845	12	22	10	1	3	1	1	1
VE-1845	12	477	465	0	3	4	0	1
VE-1845	12	16	4	1	3	1	1	1
VE-1845	15	261	246	1	3	4	1	1
VE-1845	15	477	462	0	3	5	0	0
VE-1845	15	16	1	1	3	1	2	1
VE-1845	15	51	36	1	3	1	1	0
VE-1845	15	17	2	1	3	5	1	0
VE-1845	15	21	6	1	3	5	1	0
VE-1845	15	30	15	1	3	1	1	0
VE-1846	15	17	2	1	2	1	0	3
VE-1846	15	16	1	1	1	3	0	1
VE-1846	16	18	2	1	3	4	1	0
VE-1846	16	477	461	0	5	1	0	1
VE-1846	16	58	42	1	3	5	0	1
VE-1846	16	17	1	1	3	1	1	0
VE-1846	16	56	40	1	2	1	0	0
VE-1846	16	37	21	1	3	1	1	1
VE-1846	16	26	10	1	3	5	1	0
VE-1846	16	107	91	1	3	4	1	0
VE-1847	16	477	461	0	3	1	0	0
VE-1847	16	19	3	1	3	1	0	0
VE-1847	16	29	13	1	3	1	2	0
VE-1847	16	17	1	1	3	1	1	0
VE-1847	17	477	460	0	5	5	0	0
VE-1847	17	61	44	1	2	1	0	0
VE-1847	17	477	460	0	3	1	1	0
VE-1847	17	477	460	0	4	1	0	0
VE-1847	17	31	14	1	4	5	1	0
VE-1847	17	26	9	1	3	5	1	0
VE-1848	17	26	9	1	3	5	1	0
VE-1848	17	26	9	1	3	5	1	0
VE-1848	17	18	1	1	5	1	1	1
VE-1848	17	26	9	1	3	5	1	0
VE-1848	17	26	9	1	3	5	1	0
VE-1848	17	23	6	1	3	5	1	0
VE-1848	17	28	11	1	3	5	1	0
VE-1848	17	477	460	0	3	4	0	0
VE-1848	17	18	1	1	3	1	1	0
VE-1848	17	22	5	1	3	5	1	0
VE-1849	17	21	4	1	2	1	1	0
VE-1849	17	18	1	1	4	4	0	1
VE-1849	17	42	25	1	5	1	1	1
VE-1849	18	23	5	1	2	1	0	1
VE-1849	18	22	4	1	3	1	1	0
VE-1849	18	28	10	1	3	5	1	1
VE-1849	18	25	7	1	3	5	1	1
VE-1849	18	477	459	0	4	4	0	0
VE-1849	18	25	7	1	3	5	1	0
VE-1849	18	28	10	1	3	1	1	0
VE-1850	18	21	3	1	3	1	1	0
VE-1850	18	24	6	1	5	1	1	0
VE-1850	19	477	458	0	4	4	0	0
VE-1850	19	477	458	0	3	5	0	1
VE-1850	20	21	1	1	3	1	2	1
VE-1850	20	477	457	0	4	4	0	0
VE-1850	20	23	3	1	4	1	1	0
VE-1850	20	57	37	1	5	1	1	0
VE-1850	21	22	1	1	2	3	0	2
VE-1850	21	26	5	1	3	5	1	2
VE-1851	21	22	1	1	4	4	1	0
VE-1851	21	38	17	1	3	5	1	1
VE-1851	21	477	456	0	4	4	0	0
VE-1851	21	37	16	1	3	1	1	1
VE-1851	21	25	4	1	3	1	1	0
VE-1851	22	477	455	0	3	5	0	0
VE-1851	22	32	10	1	3	1	0	3
VE-1851	22	25	3	1	2	1	1	0
VE-1851	22	32	10	1	3	1	1	1
VE-1851	22	24	2	1	3	1	1	0
VE-1852	23	477	454	0	3	4	0	0
VE-1852	23	24	1	1	2	1	1	0
VE-1852	23	101	78	1	3	5	0	0
VE-1852	23	37	14	1	3	1	1	2
VE-1852	23	28	5	1	2	1	1	0
VE-1852	23	102	79	1	3	5	1	0
VE-1852	23	73	50	1	3	5	1	3
VE-1852	23	477	454	0	4	1	0	0
VE-1852	23	31	8	1	3	1	0	0
VE-1852	23	28	5	1	3	1	1	1
VE-1853	23	25	2	1	3	1	1	0
VE-1853	23	25	2	1	2	1	1	0
VE-1853	24	477	453	0	3	1	0	0
VE-1853	24	155	131	1	3	4	1	4
VE-1853	24	477	453	0	3	1	0	0
VE-1853	24	477	453	0	3	1	0	0
VE-1853	24	36	12	1	3	5	1	0
VE-1853	24	477	453	0	2	1	0	0
VE-1853	24	477	453	0	3	1	1	1
VE-1853	24	477	453	0	3	1	0	0
VE-1854	24	57	33	1	4	4	1	0
VE-1854	24	50	26	1	3	5	1	0
VE-1854	24	30	6	1	3	5	1	0
VE-1854	24	31	7	1	3	4	1	0
VE-1854	24	29	5	1	3	5	1	0
VE-1854	24	190	166	1	3	4	1	3
VE-1854	24	34	10	1	3	1	1	3
VE-1854	24	87	63	1	3	1	1	0
VE-1854	24	27	3	1	3	1	1	0
VE-1854	24	477	453	0	3	1	0	0
VE-1855	24	42	18	1	3	5	1	2
VE-1855	25	26	1	1	2	1	1	0
VE-1855	25	33	8	1	3	4	1	0
VE-1855	25	45	20	1	3	5	1	0
VE-1855	25	28	3	1	3	1	1	1
VE-1855	25	477	452	0	3	5	0	0
VE-1855	25	45	20	1	3	1	0	0
VE-1855	25	28	3	1	3	1	1	0
VE-1855	25	28	3	1	3	1	1	0
VE-1855	26	477	451	0	4	1	0	0
VE-1856	26	72	46	1	3	3	1	1
VE-1856	27	28	1	1	2	1	0	0
VE-1856	27	28	1	1	2	1	1	0
VE-1856	28	477	449	0	3	1	0	0
VE-1856	28	101	73	1	3	4	1	0
VE-1856	28	477	449	0	3	5	0	1
VE-1856	28	30	2	1	3	5	1	0
VE-1856	28	37	9	1	3	1	1	0
VE-1856	28	477	449	0	4	1	0	0
VE-1856	28	43	15	1	3	1	1	1
VE-1857	28	123	95	1	1	1	0	3
VE-1857	28	66	38	1	3	1	1	4
VE-1857	28	29	1	1	3	1	0	0
VE-1857	28	51	23	1	3	1	1	0
VE-1857	28	29	1	1	3	1	1	1
VE-1857	28	42	14	1	3	1	1	2
VE-1857	29	477	448	0	3	5	0	2
VE-1857	29	30	1	1	3	1	1	0
VE-1857	29	35	6	1	5	1	1	0
VE-1857	29	30	1	1	2	1	1	1
VE-1858	29	39	10	1	3	5	1	0
VE-1858	29	32	3	1	4	1	0	0
VE-1858	29	477	448	0	3	1	0	0
VE-1858	29	256	227	1	3	4	1	0
VE-1858	29	477	448	0	3	1	0	1
VE-1858	29	30	1	1	3	1	1	0
VE-1858	29	43	14	1	3	4	1	0
VE-1858	29	30	1	1	3	1	1	0
VE-1858	30	46	16	1	3	5	1	1
VE-1858	30	32	2	1	2	1	1	4
VE-1859	30	32	2	1	3	1	1	0
VE-1859	30	477	447	0	3	5	0	1
VE-1859	30	31	1	1	3	1	0	1
VE-1859	30	477	447	0	3	1	0	1
VE-1859	30	53	23	1	3	1	0	1
VE-1859	30	46	16	1	3	1	1	1
VE-1859	30	35	5	1	3	5	1	0
VE-1859	30	35	5	1	3	1	1	0
VE-1859	31	42	11	1	3	3	1	1
VE-1859	31	33	2	1	3	1	1	0
VE-1860	31	94	63	1	2	1	1	0
VE-1860	31	35	4	1	3	1	1	0
VE-1860	31	477	446	0	4	2	0	2
VE-1860	31	477	446	0	4	4	0	1
VE-1860	31	44	13	1	3	1	0	0
VE-1860	31	477	446	0	3	1	0	0
VE-1860	31	32	1	1	3	1	1	1
VE-1860	32	39	7	1	3	1	1	0
VE-1860	32	105	73	1	3	5	1	2
VE-1861	32	65	33	1	3	1	1	0
VE-1861	32	37	5	1	3	1	1	0
VE-1861	32	36	4	1	3	1	1	0
VE-1861	32	36	4	1	3	1	1	0
VE-1861	32	39	7	1	3	1	1	0
VE-1861	32	191	159	1	3	4	0	1
VE-1861	32	35	3	1	3	1	1	0
VE-1861	33	36	3	1	3	1	1	0
VE-1861	33	477	444	0	3	1	0	0
VE-1861	33	477	444	0	3	1	0	0
VE-1862	35	225	190	1	2	4	2	2
VE-1862	35	477	442	0	4	5	0	0
VE-1862	35	46	11	1	2	1	1	3
VE-1862	35	477	442	0	3	1	0	0
VE-1862	35	233	198	1	3	1	4	2
VE-1862	35	50	15	1	4	4	1	0
VE-1862	35	38	3	1	3	1	1	0
VE-1862	36	42	6	1	3	1	1	0
VE-1862	36	37	1	1	3	1	1	0
VE-1862	36	140	104	1	3	1	0	0
VE-1863	36	477	441	0	3	1	0	0
VE-1863	36	37	1	1	1	1	1	0
VE-1863	36	477	441	0	2	1	0	0
VE-1863	36	74	38	1	3	5	1	0
VE-1863	36	477	441	0	3	1	0	0
VE-1863	36	44	8	1	3	5	1	0
VE-1863	36	38	2	1	1	1	0	1
VE-1863	36	39	3	1	3	1	1	0
VE-1863	36	45	9	1	3	1	1	0
VE-1863	36	37	1	1	3	1	0	0
VE-1864	36	477	441	0	3	5	0	0
VE-1864	36	37	1	1	3	1	1	2
VE-1864	36	37	1	1	3	1	1	0
VE-1864	37	38	1	1	3	1	1	1
VE-1864	37	477	440	0	3	1	0	1
VE-1864	37	56	19	1	5	1	1	0
VE-1864	37	42	5	1	5	1	1	0
VE-1864	37	38	1	1	3	1	1	1
VE-1864	37	477	440	0	3	1	0	0
VE-1864	37	477	440	0	3	1	0	1
VE-1865	37	477	440	0	3	5	0	0
VE-1865	38	95	57	1	3	5	1	0
VE-1865	38	154	116	1	3	5	1	0
VE-1865	38	39	1	1	3	1	1	0
VE-1865	38	53	15	1	4	4	2	0
VE-1865	38	477	439	0	1	1	0	0
VE-1865	38	39	1	1	3	1	0	0
VE-1865	38	477	439	0	3	3	0	0
VE-1865	38	51	13	1	3	1	1	0
VE-1865	38	57	19	1	3	1	1	4
VE-1866	38	42	4	1	3	1	1	0
VE-1866	38	351	313	1	3	5	0	0
VE-1866	39	68	29	1	3	1	1	4
VE-1866	39	53	14	1	3	5	1	0
VE-1866	39	42	3	1	4	1	0	1
VE-1866	39	43	4	1	3	1	1	2
VE-1866	39	131	92	1	2	1	1	0
VE-1866	39	122	83	1	3	1	1	3
VE-1866	39	477	438	0	3	1	1	1
VE-1866	39	477	438	0	4	4	0	1
VE-1867	39	477	438	0	3	4	0	2
VE-1867	39	43	4	1	3	5	2	0
VE-1867	39	45	6	1	3	5	1	0
VE-1867	39	44	5	1	3	5	1	0
VE-1867	39	42	3	1	3	1	1	0
VE-1867	39	70	31	1	3	1	1	1
VE-1867	39	477	438	0	3	4	0	0
VE-1867	39	45	6	1	3	5	1	0
VE-1867	40	42	2	1	3	1	1	1
VE-1867	41	59	18	1	3	5	1	0
VE-1868	41	47	6	1	3	1	1	0
VE-1868	42	121	79	1	3	4	0	0
VE-1868	42	43	1	1	3	1	0	1
VE-1868	42	59	17	1	3	1	0	0
VE-1868	42	477	435	0	3	5	0	0
VE-1868	42	477	435	0	3	2	0	2
VE-1868	42	44	2	1	3	1	1	0
VE-1868	42	477	435	0	3	1	1	0
VE-1868	43	44	1	1	3	1	1	0
VE-1868	43	477	434	0	3	1	0	2
VE-1869	43	157	114	1	3	5	1	0
VE-1869	43	477	434	0	3	4	0	0
VE-1869	43	57	14	1	3	4	0	0
VE-1869	43	73	30	1	3	1	1	1
VE-1869	43	57	14	1	3	4	0	1
VE-1869	43	58	15	1	3	1	1	2
VE-1869	43	99	56	1	3	1	1	0
VE-1869	43	64	21	1	4	1	1	0
VE-1869	43	44	1	1	3	1	1	0
VE-1869	43	78	35	1	4	1	1	0
VE-1870	43	141	98	1	3	1	0	0
VE-1870	43	477	434	0	3	1	0	1
VE-1870	43	477	434	0	3	1	2	1
VE-1870	43	77	34	1	3	5	1	0
VE-1870	43	45	2	1	3	3	0	1
VE-1870	43	197	154	1	3	4	1	1
VE-1870	43	51	8	1	3	4	1	0
VE-1870	43	44	1	1	3	1	0	1
VE-1870	43	46	3	1	3	1	1	0
VE-1870	43	477	434	0	3	4	0	0
VE-1871	44	53	9	1	3	1	1	3
VE-1871	44	379	335	1	3	1	0	1
VE-1871	44	477	433	0	3	4	0	0
VE-1871	44	51	7	1	3	1	1	0
VE-1871	44	477	433	0	3	5	0	0
VE-1871	44	65	21	1	3	5	1	0
VE-1871	44	77	33	1	5	4	1	0
VE-1871	45	46	1	1	3	1	1	0
VE-1871	45	74	29	1	3	4	1	0
VE-1871	45	477	432	0	4	5	0	0
VE-1872	45	59	14	1	3	5	1	0
VE-1872	45	46	1	1	3	1	0	0
VE-1872	45	241	196	1	2	1	0	0
VE-1872	45	477	432	0	3	4	0	1
VE-1872	45	252	207	1	3	4	1	2
VE-1872	45	248	203	1	3	4	1	2
VE-1872	45	62	17	1	3	2	1	4
VE-1872	46	84	38	1	3	4	1	0
VE-1872	46	477	431	0	3	2	1	0
VE-1872	46	208	162	1	1	3	2	3
VE-1873	46	59	13	1	3	4	1	0
VE-1873	46	477	431	0	3	5	0	0
VE-1873	46	477	431	0	4	4	0	0
VE-1873	46	57	11	1	5	1	1	0
VE-1873	46	477	431	0	5	4	0	0
VE-1873	46	477	431	0	3	1	0	2
VE-1873	46	477	431	0	3	1	0	2
VE-1873	46	51	5	1	3	1	1	1
VE-1873	46	61	15	1	3	1	1	1
VE-1873	46	109	63	1	3	2	2	4
VE-1874	46	77	31	1	3	5	0	1
VE-1874	46	107	61	1	3	5	1	1
VE-1874	47	50	3	1	3	1	1	0
VE-1874	47	112	65	1	3	4	3	4
VE-1874	49	51	2	1	2	1	0	0
VE-1874	49	81	32	1	3	5	1	0
VE-1874	50	63	13	1	4	1	0	0
VE-1874	50	92	42	1	4	5	1	2
VE-1874	50	148	98	1	2	5	1	4
VE-1874	50	64	14	1	4	5	1	1
VE-1875	50	59	9	1	3	5	1	2
VE-1875	50	70	20	1	3	5	1	2
VE-1875	50	477	427	0	3	5	1	1
VE-1875	50	63	13	1	3	5	1	1
VE-1875	50	51	1	1	3	3	1	0
VE-1875	51	89	38	1	3	5	1	1
VE-1875	51	52	1	1	2	1	0	0
VE-1875	51	52	1	1	3	1	1	0
VE-1875	51	202	151	1	2	1	0	0
VE-1875	51	57	6	1	3	1	1	0
VE-1876	51	52	1	1	4	5	0	0
VE-1876	51	477	426	0	2	1	0	0
VE-1876	51	176	125	1	3	1	1	2
VE-1876	51	477	426	0	3	1	0	0
VE-1876	51	52	1	1	3	1	1	0
VE-1876	52	53	1	1	3	5	1	0
VE-1876	52	156	104	1	3	5	1	0
VE-1876	52	298	246	1	3	1	4	0
VE-1876	52	232	180	1	3	1	1	2
VE-1876	52	53	1	1	3	1	0	0
VE-1877	52	122	70	1	3	4	1	2
VE-1877	52	53	1	1	3	5	1	0
VE-1877	52	311	259	1	3	4	1	4
VE-1877	52	477	425	0	3	4	0	2
VE-1877	52	270	218	1	1	1	0	2
VE-1877	52	95	43	1	1	1	1	2
VE-1877	52	57	5	1	3	1	1	1
VE-1877	52	59	7	1	3	1	1	0
VE-1877	53	297	244	1	3	1	4	1
VE-1877	53	54	1	1	3	1	0	0
VE-1878	53	82	29	1	3	4	1	3
VE-1878	53	91	38	1	3	5	1	1
VE-1878	53	477	424	0	3	1	0	0
VE-1878	53	98	45	1	3	1	2	1
VE-1878	53	54	1	1	3	5	0	0
VE-1878	53	477	424	0	3	2	0	4
VE-1878	53	179	126	1	2	1	1	0
VE-1878	53	99	46	1	3	5	0	1
VE-1878	53	60	7	1	3	1	2	0
VE-1878	53	64	11	1	3	1	1	0
VE-1879	53	477	424	0	3	1	0	0
VE-1879	53	65	12	1	3	1	1	0
VE-1879	54	152	98	1	3	4	1	0
VE-1879	54	63	9	1	3	4	1	0
VE-1879	54	56	2	1	3	1	1	0
VE-1879	54	477	423	0	4	1	0	0
VE-1879	54	58	4	1	3	1	1	2
VE-1879	55	60	5	1	3	4	1	0
VE-1879	55	56	1	1	3	2	0	0
VE-1879	55	477	422	0	3	5	0	0
VE-1880	55	56	1	1	2	1	0	0
VE-1880	56	477	421	0	3	1	0	0
VE-1880	56	477	421	0	3	1	0	2
VE-1880	56	477	421	0	4	4	0	1
VE-1880	56	477	421	0	3	5	0	1
VE-1880	56	57	1	1	3	5	1	1
VE-1880	56	57	1	1	3	1	0	0
VE-1880	56	477	421	0	3	1	1	1
VE-1880	56	57	1	1	3	4	1	1
VE-1880	56	477	421	0	3	1	0	0
VE-1881	57	58	1	1	3	5	0	0
VE-1881	57	477	420	0	3	1	1	0
VE-1881	57	477	420	0	2	1	0	0
VE-1881	57	58	1	1	3	1	1	0
VE-1881	57	92	35	1	3	2	1	4
VE-1881	57	60	3	1	3	1	2	0
VE-1881	57	103	46	1	3	1	2	0
VE-1881	57	60	3	1	3	1	1	3
VE-1881	58	60	2	1	3	1	1	0
VE-1881	58	61	3	1	2	1	0	0
VE-1882	58	59	1	1	3	1	1	0
VE-1882	58	477	419	0	2	1	0	0
VE-1882	58	477	419	0	4	4	0	0
VE-1882	58	157	99	1	3	5	1	1
VE-1882	58	60	2	1	3	5	1	2
VE-1882	58	84	26	1	3	4	1	4
VE-1882	58	60	2	1	3	1	1	1
VE-1882	58	114	56	1	3	1	1	0
VE-1882	58	60	2	1	3	1	1	0
VE-1882	58	59	1	1	3	1	0	1
VE-1883	58	85	27	1	3	5	1	0
VE-1883	58	105	47	1	3	5	1	0
VE-1883	59	70	11	1	3	5	1	0
VE-1883	59	61	2	1	3	1	1	0
VE-1883	59	477	418	0	3	1	0	0
VE-1883	59	65	6	1	3	2	1	0
VE-1883	59	60	1	1	3	1	1	0
VE-1883	59	64	5	1	3	1	1	1
VE-1883	59	477	418	0	3	1	0	1
VE-1883	59	99	40	1	3	4	1	4
VE-1884	59	100	41	1	3	5	2	0
VE-1884	59	93	34	1	2	2	1	0
VE-1884	60	477	417	0	3	2	0	1
VE-1884	60	218	158	1	3	4	0	2
VE-1884	60	477	417	0	3	1	0	0
VE-1884	60	106	46	1	4	4	1	0
VE-1884	60	73	13	1	3	5	1	0
VE-1884	60	477	417	0	3	5	0	0
VE-1884	60	61	1	1	4	4	1	0
VE-1884	60	66	6	1	1	1	0	0
VE-1885	60	477	417	0	3	4	0	0
VE-1885	60	477	417	0	3	1	0	1
VE-1885	60	205	145	1	3	1	1	0
VE-1885	60	477	417	0	3	1	1	0
VE-1885	60	477	417	0	3	3	1	1
VE-1885	61	82	21	1	3	5	1	0
VE-1885	63	477	414	0	2	4	1	0
VE-1885	63	99	36	1	3	4	1	1
VE-1885	63	79	16	1	3	1	1	3
VE-1885	63	98	35	1	3	1	1	0
VE-1886	63	113	50	1	3	1	0	3
VE-1886	63	66	3	1	3	5	1	1
VE-1886	63	149	86	1	3	5	1	1
VE-1886	63	81	18	1	4	1	2	0
VE-1886	63	71	8	1	3	5	1	1
VE-1886	63	477	414	0	3	1	0	0
VE-1886	63	143	80	1	3	4	2	4
VE-1886	63	64	1	1	3	5	1	0
VE-1886	63	477	414	0	3	1	0	1
VE-1886	64	477	413	0	3	5	0	0
VE-1887	64	477	413	0	2	1	0	0
VE-1887	64	267	203	1	3	1	2	0
VE-1887	64	477	413	0	3	1	1	0
VE-1887	64	247	183	1	3	1	1	2
VE-1887	64	477	413	0	3	1	0	1
VE-1887	64	161	97	1	3	3	2	0
VE-1887	64	296	232	1	5	5	1	0
VE-1887	64	92	28	1	3	1	2	0
VE-1887	64	98	34	1	4	4	1	1
VE-1887	64	66	2	1	3	1	2	0
VE-1888	64	116	52	1	5	4	1	0
VE-1888	64	127	63	1	5	4	1	0
VE-1888	64	477	413	0	4	4	0	0
VE-1888	64	102	38	1	3	5	1	1
VE-1888	64	381	317	1	4	4	0	0
VE-1888	65	85	20	1	3	1	2	2
VE-1888	65	98	33	1	3	1	1	0
VE-1888	65	477	412	0	3	5	0	0
VE-1888	65	71	6	1	3	1	1	1
VE-1888	65	66	1	1	3	1	1	0
VE-1889	65	477	412	0	4	4	0	0
VE-1889	65	120	55	1	5	1	0	0
VE-1889	65	78	13	1	4	1	1	0
VE-1889	65	477	412	0	3	5	0	0
VE-1889	65	477	412	0	3	5	0	0
VE-1889	65	477	412	0	4	4	0	0
VE-1889	65	477	412	0	4	4	0	0
VE-1889	65	477	412	0	4	4	0	0
VE-1889	65	80	15	1	4	1	1	0
VE-1889	65	70	5	1	3	5	1	0
VE-1890	65	72	7	1	5	4	1	0
VE-1890	65	332	267	1	5	4	1	0
VE-1890	65	116	51	1	4	4	1	0
VE-1890	65	477	412	0	3	1	0	0
VE-1890	65	477	412	0	4	1	0	0
VE-1890	66	133	67	1	5	4	1	0
VE-1890	66	70	4	1	3	1	1	1
VE-1890	66	273	207	1	2	4	1	1
VE-1890	66	94	28	1	3	5	1	0
VE-1891	66	119	53	1	3	3	1	3
VE-1891	66	477	411	0	3	1	0	1
VE-1891	66	477	411	0	3	1	0	1
VE-1891	66	477	411	0	4	4	0	0
VE-1891	66	477	411	0	3	1	0	0
VE-1891	66	119	53	1	3	5	1	0
VE-1891	66	182	116	1	3	5	1	0
VE-1891	66	69	3	1	3	3	1	0
VE-1891	67	68	1	1	3	1	1	0
VE-1891	67	71	4	1	3	1	1	0
VE-1892	67	427	360	1	3	1	1	1
VE-1892	67	477	410	0	3	5	0	0
VE-1892	67	477	410	0	3	1	0	0
VE-1892	67	477	410	0	4	5	1	1
VE-1892	67	477	410	0	3	1	0	0
VE-1892	67	85	18	1	3	1	1	0
VE-1892	67	85	18	1	3	5	1	1
VE-1892	68	477	409	0	3	1	0	0
VE-1892	68	322	254	1	3	1	1	1
VE-1892	69	206	137	1	4	1	1	0
VE-1893	69	477	408	0	3	1	0	0
VE-1893	70	477	407	0	3	1	0	0
VE-1893	70	477	407	0	3	5	0	0
VE-1893	71	73	2	1	3	1	1	0
VE-1893	71	477	406	0	3	5	0	0
VE-1893	71	477	406	0	3	5	0	0
VE-1893	71	477	406	0	3	5	0	0
VE-1893	71	84	13	1	3	5	0	0
VE-1893	71	477	406	0	3	5	0	0
VE-1893	71	477	406	0	3	1	0	0
VE-1894	71	477	406	0	3	1	0	2
VE-1894	71	477	406	0	3	1	0	0
VE-1894	71	477	406	0	3	1	0	0
VE-1894	71	72	1	1	3	1	0	0
VE-1894	71	72	1	1	3	1	1	0
VE-1894	71	477	406	0	3	5	0	0
VE-1894	71	106	35	1	3	5	2	2
VE-1894	71	477	406	0	3	1	0	0
VE-1894	71	477	406	0	2	4	0	4
VE-1894	71	477	406	0	3	1	0	0
VE-1895	71	94	23	1	3	1	1	0
VE-1895	72	73	1	1	4	1	1	0
VE-1895	72	262	190	1	3	5	1	2
VE-1895	72	83	11	1	3	2	1	0
VE-1895	72	477	405	0	1	1	0	0
VE-1895	72	92	20	1	1	1	1	1
VE-1895	72	477	405	0	5	1	0	0
VE-1895	72	82	10	1	3	3	1	4
VE-1895	72	120	48	1	3	5	1	0
VE-1895	72	74	2	1	3	3	1	1
VE-1896	72	477	405	0	3	5	0	0
VE-1896	72	73	1	1	3	5	1	0
VE-1896	72	74	2	1	3	1	1	0
VE-1896	72	91	19	1	3	1	1	1
VE-1896	73	477	404	0	4	4	0	1
VE-1896	73	79	6	1	3	1	1	0
VE-1896	73	477	404	0	3	1	0	1
VE-1896	73	81	8	1	3	1	1	0
VE-1896	73	78	5	1	3	1	1	0
VE-1896	73	477	404	0	3	1	0	0
VE-1897	73	74	1	1	3	1	1	0
VE-1897	73	86	13	1	3	1	1	0
VE-1897	73	93	20	1	4	1	1	0
VE-1897	73	477	404	0	3	5	0	0
VE-1897	74	477	403	0	2	1	0	0
VE-1897	74	78	4	1	3	1	1	1
VE-1897	74	93	19	1	3	1	1	1
VE-1897	74	127	53	1	3	1	1	0
VE-1897	74	477	403	0	3	1	0	1
VE-1897	74	80	6	1	3	4	1	0
VE-1898	74	477	403	0	3	1	0	0
VE-1898	74	477	403	0	3	1	0	0
VE-1898	74	82	8	1	3	5	1	0
VE-1898	74	477	403	0	3	4	1	2
VE-1898	74	78	4	1	3	4	1	0
VE-1898	74	477	403	0	3	4	0	0
VE-1898	75	114	39	1	3	5	1	0
VE-1898	77	477	400	0	3	1	0	0
VE-1898	77	121	44	1	3	5	2	0
VE-1898	77	477	400	0	4	4	0	0
VE-1899	77	94	17	1	3	1	1	1
VE-1899	77	99	22	1	3	1	1	1
VE-1899	77	79	2	1	3	1	1	0
VE-1899	77	82	5	1	3	3	1	1
VE-1899	77	85	8	1	3	5	1	0
VE-1899	78	85	7	1	2	4	1	0
VE-1899	78	477	399	0	4	1	0	1
VE-1899	78	477	399	0	3	1	0	0
VE-1899	78	477	399	0	3	4	0	0
VE-1899	78	477	399	0	3	1	0	0
VE-1900	78	477	399	0	3	5	0	1
VE-1900	78	111	33	1	3	4	1	0
VE-1900	78	477	399	0	3	1	0	0
VE-1900	78	84	6	1	3	1	1	0
VE-1900	79	477	398	0	3	1	0	0
VE-1900	79	477	398	0	4	2	0	2
VE-1900	79	477	398	0	4	4	0	0
VE-1900	79	86	7	1	3	1	1	1
VE-1900	79	217	138	1	3	5	1	0
VE-1900	79	108	29	1	3	5	2	1
VE-1901	79	477	398	0	3	4	0	0
VE-1901	79	126	47	1	1	5	0	0
VE-1901	79	87	8	1	3	1	1	0
VE-1901	79	80	1	1	3	1	1	0
VE-1901	79	98	19	1	3	1	1	2
VE-1901	79	477	398	0	2	1	0	2
VE-1901	79	172	93	1	2	1	2	2
VE-1901	80	85	5	1	3	1	1	2
VE-1901	80	88	8	1	3	1	1	0
VE-1901	80	89	9	1	2	1	1	0
VE-1902	80	90	10	1	2	1	0	0
VE-1902	80	84	4	1	3	1	1	0
VE-1902	80	477	397	0	3	1	0	0
VE-1902	80	277	197	1	3	4	2	0
VE-1902	80	88	8	1	2	1	1	0
VE-1902	80	477	397	0	3	1	0	0
VE-1902	80	317	237	1	3	3	1	0
VE-1902	80	177	97	1	2	4	1	4
VE-1902	80	136	56	1	3	1	0	0
VE-1902	80	87	7	1	3	5	0	1
VE-1903	80	122	42	1	3	1	1	1
VE-1903	80	94	14	1	1	5	1	0
VE-1903	80	88	8	1	2	1	1	0
VE-1903	81	97	16	1	3	4	1	1
VE-1903	81	455	374	1	1	1	1	3
VE-1903	81	87	6	1	2	1	1	0
VE-1903	81	82	1	1	3	1	1	0
VE-1903	81	89	8	1	2	1	1	0
VE-1903	81	105	24	1	3	1	1	0
VE-1903	81	477	396	0	3	2	0	0
VE-1904	81	477	396	0	3	4	0	0
VE-1904	82	130	48	1	3	4	2	0
VE-1904	82	85	3	1	3	1	1	0
VE-1904	82	88	6	1	2	1	1	0
VE-1904	83	477	394	0	3	1	0	1
VE-1904	84	202	118	1	2	1	0	0
VE-1904	84	178	94	1	4	4	1	0
VE-1904	84	88	4	1	3	1	2	1
VE-1904	84	107	23	1	3	1	1	1
VE-1904	84	91	7	1	3	3	1	1
VE-1905	84	95	11	1	4	1	2	1
VE-1905	84	477	393	0	3	5	0	0
VE-1905	84	86	2	1	2	1	1	0
VE-1905	84	158	74	1	3	5	1	0
VE-1905	84	118	34	1	3	1	2	1
VE-1905	84	87	3	1	3	1	1	0
VE-1905	84	85	1	1	3	1	1	0
VE-1905	84	86	2	1	3	1	1	0
VE-1905	85	107	22	1	3	1	0	1
VE-1905	85	90	5	1	3	2	1	1
VE-1906	85	87	2	1	4	5	1	1
VE-1906	85	87	2	1	3	1	1	0
VE-1906	85	88	3	1	3	1	1	0
VE-1906	85	477	392	0	3	5	0	0
VE-1906	86	477	391	0	3	4	0	0
VE-1906	86	95	9	1	3	1	1	0
VE-1906	86	477	391	0	3	1	0	0
VE-1906	86	477	391	0	3	1	0	0
VE-1906	86	87	1	1	3	1	0	0
VE-1906	86	477	391	0	3	4	0	4
VE-1907	86	87	1	1	3	4	1	0
VE-1907	86	91	5	1	3	1	1	0
VE-1907	87	92	5	1	3	1	1	1
VE-1907	87	91	4	1	3	1	1	0
VE-1907	87	98	11	1	2	1	1	0
VE-1907	87	95	8	1	4	1	1	0
VE-1907	87	99	12	1	4	1	1	0
VE-1907	87	133	46	1	1	4	1	0
VE-1907	87	477	390	0	3	4	0	0
VE-1907	87	155	68	1	3	5	1	0
VE-1908	87	88	1	1	3	1	1	0
VE-1908	87	351	264	1	3	1	1	2
VE-1908	88	477	389	0	4	4	0	0
VE-1908	88	93	5	1	3	5	1	0
VE-1908	88	151	63	1	3	1	1	0
VE-1908	88	95	7	1	4	1	1	1
VE-1908	88	477	389	0	3	5	0	0
VE-1908	89	477	388	0	3	1	0	0
VE-1908	90	477	387	0	2	1	0	0
VE-1908	91	106	15	1	3	5	1	1
VE-1909	91	477	386	0	3	1	0	0
VE-1909	92	95	3	1	3	3	1	0
VE-1909	92	93	1	1	4	4	1	0
VE-1909	92	322	230	1	3	1	1	1
VE-1909	92	93	1	1	3	4	0	0
VE-1909	92	477	385	0	3	4	0	0
VE-1909	92	154	62	1	3	5	2	0
VE-1909	92	217	125	1	3	1	1	2
VE-1909	92	477	385	0	4	1	0	0
VE-1909	92	93	1	1	1	1	1	0
VE-1910	92	93	1	1	3	1	1	1
VE-1910	93	137	44	1	3	1	0	1
VE-1910	93	95	2	1	2	1	1	0
VE-1910	93	477	384	0	2	4	0	1
VE-1910	93	112	19	1	3	4	1	0
VE-1910	93	98	5	1	3	1	1	0
VE-1910	93	103	10	1	5	4	1	1
VE-1910	93	477	384	0	3	3	0	0
VE-1910	93	133	40	1	2	1	2	0
VE-1910	93	157	64	1	2	1	2	0
VE-1911	93	153	60	1	2	1	2	0
VE-1911	93	477	384	0	3	4	0	1
VE-1911	93	95	2	1	3	5	1	0
VE-1911	93	477	384	0	3	4	0	0
VE-1911	94	477	383	0	2	1	0	1
VE-1911	94	224	130	1	3	1	0	2
VE-1911	94	95	1	1	2	1	1	0
VE-1911	94	477	383	0	1	1	0	0
VE-1911	94	150	56	1	2	1	2	0
VE-1911	94	98	4	1	4	1	1	1
VE-1912	94	120	26	1	1	1	2	0
VE-1912	94	96	2	1	4	1	1	0
VE-1912	94	146	52	1	3	1	0	1
VE-1912	94	96	2	1	3	5	1	0
VE-1912	95	116	21	1	3	1	1	1
VE-1912	95	477	382	0	3	1	0	0
VE-1912	95	106	11	1	3	5	2	0
VE-1912	95	98	3	1	3	5	1	0
VE-1912	96	98	2	1	3	5	2	1
VE-1912	97	98	1	1	3	5	1	0
VE-1913	98	101	3	1	3	1	1	0
VE-1913	98	112	14	1	3	1	2	1
VE-1913	98	477	379	0	3	1	0	0
VE-1913	98	114	16	1	3	1	1	2
VE-1913	98	99	1	1	3	3	2	0
VE-1913	98	128	30	1	1	5	2	0
VE-1913	98	477	379	0	3	1	0	0
VE-1913	98	113	15	1	3	1	1	1
VE-1913	98	100	2	1	3	5	1	0
VE-1913	98	106	8	1	3	5	0	0
VE-1914	98	144	46	1	3	3	1	1
VE-1914	98	108	10	1	3	5	2	0
VE-1914	98	477	379	0	3	5	0	0
VE-1914	99	100	1	1	3	5	1	1
VE-1914	99	100	1	1	3	5	1	1
VE-1914	99	100	1	1	3	5	1	0
VE-1914	99	100	1	1	3	5	1	0
VE-1914	99	101	2	1	3	5	1	2
VE-1914	99	100	1	1	3	1	0	0
VE-1914	99	105	6	1	3	1	0	0
VE-1915	99	100	1	1	1	1	1	1
VE-1915	99	477	378	0	3	1	0	1
VE-1915	99	100	1	1	3	5	1	0
VE-1915	99	106	7	1	3	5	1	1
VE-1915	99	103	4	1	3	1	2	0
VE-1915	99	101	2	1	3	5	1	2
VE-1915	99	103	4	1	3	1	2	1
VE-1915	99	108	9	1	4	1	1	0
VE-1915	99	133	34	1	1	5	2	0
VE-1916	99	110	11	1	3	1	0	1
VE-1916	99	126	27	1	3	4	2	2
VE-1916	99	102	3	1	3	5	1	0
VE-1916	99	106	7	1	3	5	1	1
VE-1916	100	106	6	1	3	5	2	0
VE-1916	100	101	1	1	3	5	0	1
VE-1916	100	262	162	1	3	5	2	1
VE-1916	100	111	11	1	2	1	2	0
VE-1916	100	112	12	1	3	1	2	0
VE-1916	100	477	377	0	3	1	0	0
VE-1917	100	102	2	1	3	5	1	1
VE-1917	100	114	14	1	3	5	2	0
VE-1917	100	102	2	1	3	3	1	1
VE-1917	100	127	27	1	3	3	1	0
VE-1917	100	477	377	0	3	4	0	0
VE-1917	100	101	1	1	3	5	1	0
VE-1917	100	182	82	1	3	5	1	1
VE-1917	100	477	377	0	3	1	0	0
VE-1917	100	129	29	1	1	5	1	0
VE-1917	100	477	377	0	3	5	0	0
VE-1918	100	477	377	0	3	1	0	0
VE-1918	100	209	109	1	3	1	1	0
VE-1918	100	477	377	0	3	4	0	0
VE-1918	100	462	362	1	4	1	0	0
VE-1918	100	137	37	1	3	3	1	0
VE-1918	100	477	377	0	3	5	0	3
VE-1918	101	114	13	1	3	1	2	0
VE-1918	101	102	1	1	3	1	1	0
VE-1918	101	477	376	0	3	1	0	0
VE-1918	101	477	376	0	3	1	0	0
VE-1919	101	255	154	1	3	4	0	1
VE-1919	101	111	10	1	3	1	1	0
VE-1919	101	477	376	0	3	4	0	0
VE-1919	101	104	3	1	3	5	2	0
VE-1919	101	107	6	1	3	5	2	1
VE-1919	101	107	6	1	3	5	2	0
VE-1919	101	110	9	1	3	5	2	0
VE-1919	101	107	6	1	3	5	1	0
VE-1919	101	116	15	1	3	5	1	0
VE-1919	102	211	109	1	3	1	1	0
VE-1920	102	105	3	1	2	1	2	0
VE-1920	102	477	375	0	1	1	0	0
VE-1920	102	106	4	1	2	1	1	0
VE-1920	102	162	60	1	4	1	1	0
VE-1920	102	114	12	1	3	4	1	0
VE-1920	102	477	375	0	3	4	0	0
VE-1920	102	122	20	1	3	5	2	1
VE-1920	102	477	375	0	3	5	0	0
VE-1920	102	477	375	0	3	5	0	0
VE-1920	102	125	23	1	3	5	2	1
VE-1921	102	105	3	1	3	5	2	0
VE-1921	102	121	19	1	3	5	2	3
VE-1921	102	126	24	1	3	5	1	1
VE-1921	102	477	375	0	3	1	0	0
VE-1921	102	112	10	1	3	5	2	1
VE-1921	102	114	12	1	3	1	1	0
VE-1921	103	477	374	0	3	4	0	0
VE-1921	105	108	3	1	3	1	1	4
VE-1921	105	106	1	1	3	3	0	1
VE-1921	105	112	7	1	3	1	2	0
VE-1922	105	477	372	0	4	4	0	0
VE-1922	105	477	372	0	3	1	0	0
VE-1922	105	106	1	1	3	5	2	1
VE-1922	105	477	372	0	3	4	0	0
VE-1922	105	107	2	1	3	1	1	1
VE-1922	106	477	371	0	3	1	0	1
VE-1922	106	109	3	1	3	1	1	2
VE-1922	106	107	1	1	3	5	1	0
VE-1922	106	128	22	1	3	4	2	0
VE-1922	106	477	371	0	3	2	0	1
VE-1923	106	112	6	1	4	1	2	1
VE-1923	106	121	15	1	3	1	2	0
VE-1923	106	113	7	1	3	5	1	0
VE-1923	106	115	9	1	3	1	1	2
VE-1923	106	109	3	1	3	5	0	1
VE-1923	106	107	1	1	3	5	1	0
VE-1923	107	477	370	0	4	4	0	0
VE-1923	107	163	56	1	3	1	2	2
VE-1923	107	121	14	1	3	1	0	1
VE-1923	107	116	9	1	3	1	1	0
VE-1924	107	113	6	1	3	1	1	2
VE-1924	107	477	370	0	3	1	0	0
VE-1924	107	108	1	1	5	4	1	0
VE-1924	108	109	1	1	1	5	2	3
VE-1924	108	109	1	1	3	1	0	0
VE-1924	108	109	1	1	3	1	1	0
VE-1924	108	109	1	1	3	5	1	0
VE-1924	108	114	6	1	3	1	2	1
VE-1924	108	128	20	1	2	1	2	0
VE-1924	108	109	1	1	3	1	1	0
VE-1925	108	134	26	1	4	1	1	0
VE-1925	108	208	100	1	3	1	2	1
VE-1925	109	114	5	1	3	5	1	0
VE-1925	109	477	368	0	3	1	0	3
VE-1925	109	322	213	1	3	1	1	0
VE-1925	109	477	368	0	3	1	0	0
VE-1925	109	477	368	0	3	2	1	0
VE-1925	109	110	1	1	3	3	2	0
VE-1925	109	141	32	1	3	1	2	1
VE-1925	109	145	36	1	3	4	2	0
VE-1926	109	114	5	1	1	1	1	1
VE-1926	110	477	367	0	3	4	0	1
VE-1926	110	477	367	0	3	1	0	0
VE-1926	110	113	3	1	4	4	1	0
VE-1926	110	114	4	1	2	1	2	0
VE-1926	110	113	3	1	2	1	1	0
VE-1926	111	113	2	1	3	1	0	0
VE-1926	111	204	93	1	3	5	2	2
VE-1926	111	157	46	1	3	3	0	0
VE-1926	111	116	5	1	2	1	2	0
VE-1927	111	477	366	0	1	5	0	0
VE-1927	112	114	2	1	3	5	2	0
VE-1927	112	477	365	0	3	4	0	0
VE-1927	112	477	365	0	3	5	0	0
VE-1927	112	114	2	1	3	5	2	0
VE-1927	112	113	1	1	2	1	2	0
VE-1927	112	477	365	0	3	3	0	0
VE-1927	112	115	3	1	3	1	2	0
VE-1927	112	477	365	0	3	3	0	0
VE-1927	112	477	365	0	3	1	0	1
VE-1928	112	114	2	1	3	1	1	0
VE-1928	112	114	2	1	3	1	1	0
VE-1928	113	120	7	1	3	1	1	0
VE-1928	113	477	364	0	3	4	0	1
VE-1928	113	115	2	1	4	4	0	1
VE-1928	113	116	3	1	4	4	1	1
VE-1928	113	381	268	1	1	1	0	4
VE-1928	113	477	364	0	3	1	0	0
VE-1928	113	117	4	1	3	4	1	0
VE-1928	113	477	364	0	3	1	0	0
VE-1929	113	477	364	0	3	2	0	1
VE-1929	113	275	162	1	5	1	0	0
VE-1929	113	174	61	1	2	1	0	0
VE-1929	113	114	1	1	3	3	0	1
VE-1929	114	477	363	0	3	1	0	0
VE-1929	114	381	267	1	1	1	0	2
VE-1929	114	477	363	0	4	1	0	0
VE-1929	114	477	363	0	3	1	0	0
VE-1929	114	127	13	1	3	1	1	0
VE-1929	114	477	363	0	3	1	0	1
VE-1930	114	477	363	0	3	4	0	1
VE-1930	114	477	363	0	3	1	0	0
VE-1930	114	269	155	1	4	5	1	1
VE-1930	114	115	1	1	3	1	0	0
VE-1930	114	120	6	1	3	5	1	0
VE-1930	114	148	34	1	3	4	0	4
VE-1930	114	129	15	1	3	3	2	3
VE-1930	114	134	20	1	3	2	2	2
VE-1930	114	140	26	1	3	3	2	2
VE-1930	114	119	5	1	3	3	1	1
VE-1931	114	126	12	1	3	1	1	1
VE-1931	114	121	7	1	3	3	1	0
VE-1931	115	126	11	1	3	1	2	0
VE-1931	115	118	3	1	3	5	1	1
VE-1931	115	121	6	1	3	1	0	0
VE-1931	115	116	1	1	3	1	1	1
VE-1931	115	225	110	1	3	1	2	1
VE-1931	115	135	20	1	3	1	1	0
VE-1931	115	477	362	0	3	4	0	0
VE-1931	115	119	4	1	3	5	1	0
VE-1932	115	477	362	0	3	5	0	0
VE-1932	115	477	362	0	3	5	0	1
VE-1932	115	126	11	1	3	5	1	2
VE-1932	115	149	34	1	3	3	1	3
VE-1932	115	117	2	1	3	1	1	0
VE-1932	115	477	362	0	3	1	1	0
VE-1932	115	183	68	1	2	1	1	3
VE-1932	115	120	5	1	3	1	2	0
VE-1932	115	477	362	0	3	5	0	0
VE-1932	115	477	362	0	3	1	0	0
VE-1933	115	116	1	1	3	1	1	1
VE-1933	115	116	1	1	3	1	2	0
VE-1933	115	155	40	1	3	5	2	0
VE-1933	115	477	362	0	3	5	0	0
VE-1933	115	155	40	1	3	5	2	0
VE-1933	115	120	5	1	3	5	1	0
VE-1933	115	127	12	1	3	5	2	0
VE-1933	115	477	362	0	3	1	0	1
VE-1933	115	117	2	1	3	1	1	0
VE-1933	116	119	3	1	3	1	1	0
VE-1934	116	165	49	1	3	5	2	0
VE-1934	116	477	361	0	3	1	0	0
VE-1934	116	477	361	0	3	1	0	0
VE-1934	116	477	361	0	3	1	0	0
VE-1934	116	125	9	1	4	4	3	0
VE-1934	116	477	361	0	3	1	0	0
VE-1934	117	118	1	1	3	5	1	0
VE-1934	117	130	13	1	1	5	2	0
VE-1934	117	119	2	1	3	5	2	0
VE-1934	117	477	360	0	3	5	0	0
VE-1935	118	119	1	1	2	1	2	0
VE-1935	118	477	359	0	2	1	0	0
VE-1935	118	119	1	1	2	1	2	0
VE-1935	118	477	359	0	2	1	0	0
VE-1935	118	477	359	0	3	1	0	0
VE-1935	118	119	1	1	3	5	0	1
VE-1935	118	119	1	1	1	5	0	1
VE-1935	118	127	9	1	3	1	2	0
VE-1935	118	155	37	1	3	1	1	0
VE-1935	119	141	22	1	3	3	0	1
VE-1936	119	199	80	1	3	4	2	2
VE-1936	119	121	2	1	3	1	1	0
VE-1936	119	120	1	1	3	1	1	1
VE-1936	119	120	1	1	3	1	1	0
VE-1936	119	121	2	1	3	1	0	1
VE-1936	119	120	1	1	1	1	2	0
VE-1936	119	167	48	1	3	5	2	0
VE-1936	120	121	1	1	3	1	1	0
VE-1936	120	477	357	0	3	4	0	0
VE-1936	120	477	357	0	3	4	0	2
VE-1937	120	151	31	1	3	1	2	0
VE-1937	120	124	4	1	3	5	1	0
VE-1937	120	125	5	1	3	5	1	0
VE-1937	120	134	14	1	3	5	1	0
VE-1937	120	130	10	1	3	5	2	0
VE-1937	120	192	72	1	4	1	1	0
VE-1937	120	158	38	1	3	5	0	0
VE-1937	120	477	357	0	3	5	0	0
VE-1937	120	477	357	0	4	4	0	0
VE-1937	120	477	357	0	4	4	0	0
VE-1938	120	477	357	0	4	4	0	0
VE-1938	120	133	13	1	3	1	2	0
VE-1938	121	160	39	1	3	1	2	4
VE-1938	121	122	1	1	3	1	1	0
VE-1938	121	133	12	1	1	1	2	0
VE-1938	121	122	1	1	3	1	1	0
VE-1938	121	122	1	1	3	1	1	1
VE-1938	121	192	71	1	1	2	1	2
VE-1938	121	126	5	1	3	1	2	0
VE-1938	121	128	7	1	3	1	1	0
VE-1939	122	133	11	1	3	4	2	0
VE-1939	122	477	355	0	3	1	0	0
VE-1939	122	477	355	0	4	1	0	0
VE-1939	122	123	1	1	4	1	0	1
VE-1939	122	123	1	1	4	1	1	0
VE-1939	122	123	1	1	3	1	1	0
VE-1939	122	477	355	0	3	1	0	0
VE-1939	122	477	355	0	3	1	1	0
VE-1939	122	477	355	0	3	1	0	0
VE-1940	122	123	1	1	3	5	1	0
VE-1940	122	477	355	0	4	1	0	0
VE-1940	122	477	355	0	3	5	0	0
VE-1940	122	332	210	1	5	4	1	1
VE-1940	122	178	56	1	5	4	1	1
VE-1940	122	477	355	0	3	1	0	0
VE-1940	122	477	355	0	3	1	0	0
VE-1940	122	477	355	0	3	4	0	0
VE-1940	122	218	96	1	2	5	2	2
VE-1940	122	178	56	1	2	5	2	2
VE-1941	122	126	4	1	3	1	2	0
VE-1941	122	477	355	0	3	1	1	1
VE-1941	122	477	355	0	3	5	0	0
VE-1941	122	477	355	0	3	5	0	0
VE-1941	122	477	355	0	3	5	0	0
VE-1941	122	123	1	1	4	4	2	0
VE-1941	123	205	82	1	3	1	1	0
VE-1941	123	165	42	1	3	5	1	0
VE-1941	123	156	33	1	3	1	2	4
VE-1941	123	124	1	1	3	1	0	1
VE-1942	123	124	1	1	3	1	1	0
VE-1942	123	140	17	1	3	4	2	0
VE-1942	123	477	354	0	3	5	0	0
VE-1942	123	126	3	1	3	1	2	0
VE-1942	123	204	81	1	4	1	2	1
VE-1942	124	477	353	0	3	4	0	0
VE-1942	124	477	353	0	3	5	0	0
VE-1942	124	477	353	0	3	5	0	0
VE-1942	124	477	353	0	3	5	0	0
VE-1942	124	477	353	0	3	5	0	0
VE-1943	124	413	289	1	3	1	1	0
VE-1943	124	125	1	1	3	1	0	1
VE-1943	124	151	27	1	3	4	1	0
VE-1943	126	133	7	1	3	1	2	1
VE-1943	126	477	351	0	3	5	0	0
VE-1943	126	132	6	1	3	1	2	0
VE-1943	126	477	351	0	3	1	0	0
VE-1943	126	477	351	0	2	1	0	1
VE-1943	126	477	351	0	3	1	0	0
VE-1943	126	477	351	0	3	1	0	0
VE-1944	126	148	22	1	1	4	1	1
VE-1944	126	205	79	1	3	4	1	1
VE-1944	126	477	351	0	3	1	0	1
VE-1944	126	213	87	1	3	1	0	2
VE-1944	126	345	219	1	3	1	0	1
VE-1944	126	477	351	0	3	5	0	0
VE-1944	126	127	1	1	3	1	1	0
VE-1944	126	477	351	0	3	1	0	0
VE-1944	127	128	1	1	3	1	1	0
VE-1944	127	477	350	0	3	5	0	0
VE-1945	127	477	350	0	3	1	0	0
VE-1945	127	128	1	1	3	3	1	0
VE-1945	127	281	154	1	3	3	0	0
VE-1945	127	135	8	1	3	3	0	0
VE-1945	127	142	15	1	3	1	2	1
VE-1945	127	477	350	0	3	1	0	0
VE-1945	127	477	350	0	3	1	0	0
VE-1945	127	477	350	0	3	2	0	0
VE-1945	127	477	350	0	2	1	0	0
VE-1945	127	477	350	0	3	1	0	0
VE-1946	127	148	21	1	3	1	2	1
VE-1946	127	477	350	0	3	5	0	0
VE-1946	127	153	26	1	3	4	1	0
VE-1946	127	141	14	1	3	1	2	0
VE-1946	127	144	17	1	3	4	2	0
VE-1946	127	146	19	1	1	4	2	4
VE-1946	127	133	6	1	3	4	2	0
VE-1946	127	129	2	1	3	1	2	0
VE-1946	127	130	3	1	3	1	1	0
VE-1946	127	477	350	0	4	3	0	0
VE-1947	128	165	37	1	3	5	1	0
VE-1947	128	129	1	1	1	5	1	0
VE-1947	128	129	1	1	3	5	2	0
VE-1947	128	477	349	0	3	1	0	0
VE-1947	128	133	5	1	3	1	2	1
VE-1947	128	477	349	0	3	1	0	0
VE-1947	128	132	4	1	3	1	1	0
VE-1947	128	130	2	1	4	1	1	2
VE-1947	128	477	349	0	3	3	0	0
VE-1947	128	130	2	1	3	1	2	0
VE-1948	128	477	349	0	3	2	0	1
VE-1948	128	177	49	1	3	1	2	0
VE-1948	129	130	1	1	3	1	1	0
VE-1948	129	477	348	0	3	1	0	0
VE-1948	129	150	21	1	3	1	2	0
VE-1948	129	197	68	1	3	1	1	1
VE-1948	129	477	348	0	3	5	0	0
VE-1948	129	155	26	1	3	3	2	2
VE-1948	129	477	348	0	3	5	0	1
VE-1949	129	147	18	1	1	4	2	0
VE-1949	129	137	8	1	1	3	1	0
VE-1949	129	135	6	1	3	5	0	0
VE-1949	129	153	24	1	3	1	2	2
VE-1949	129	133	4	1	3	5	2	0
VE-1949	129	135	6	1	3	5	2	2
VE-1949	129	134	5	1	3	1	1	0
VE-1949	130	133	3	1	1	1	0	0
VE-1949	130	151	21	1	1	1	2	0
VE-1949	130	150	20	1	3	5	2	1
VE-1950	130	144	14	1	3	5	2	0
VE-1950	130	136	6	1	3	1	0	1
VE-1950	130	477	347	0	1	1	0	0
VE-1950	130	157	27	1	3	4	1	2
VE-1950	130	144	14	1	3	1	2	0
VE-1950	130	176	46	1	3	5	0	0
VE-1950	130	132	2	1	1	1	1	0
VE-1950	130	131	1	1	3	5	0	0
VE-1950	130	156	26	1	3	5	1	0
VE-1950	131	141	10	1	3	3	2	4
VE-1951	131	132	1	1	3	5	0	0
VE-1951	131	132	1	1	2	5	0	2
VE-1951	132	157	25	1	3	3	1	0
VE-1951	132	176	44	1	4	5	0	0
VE-1951	132	133	1	1	3	5	0	0
VE-1951	132	133	1	1	3	5	2	0
VE-1951	132	138	6	1	3	1	2	1
VE-1951	132	133	1	1	3	3	0	1
VE-1951	132	477	345	0	3	5	0	0
VE-1951	133	477	344	0	3	5	0	0
VE-1952	133	477	344	0	3	5	0	0
VE-1952	133	477	344	0	3	5	0	0
VE-1952	133	477	344	0	3	5	0	0
VE-1952	133	477	344	0	2	1	0	2
VE-1952	133	149	16	1	4	1	1	0
VE-1952	133	156	23	1	3	5	1	0
VE-1952	133	477	344	0	4	1	0	0
VE-1952	133	143	10	1	3	1	1	0
VE-1952	133	477	344	0	3	1	0	0
VE-1952	133	158	25	1	1	1	2	1
VE-1953	133	202	69	1	3	1	2	0
VE-1953	133	141	8	1	1	1	1	0
VE-1953	133	205	72	1	3	5	1	1
VE-1953	133	165	32	1	3	5	0	0
VE-1953	134	135	1	1	3	4	2	0
VE-1953	134	477	343	0	1	1	0	0
VE-1953	134	477	343	0	2	5	0	1
VE-1953	134	477	343	0	2	5	0	1
VE-1953	134	477	343	0	2	5	0	1
VE-1953	134	477	343	0	2	5	0	1
VE-1954	134	135	1	1	2	5	0	2
VE-1954	134	477	343	0	2	5	0	1
VE-1954	134	477	343	0	2	5	0	1
VE-1954	134	135	1	1	2	5	0	2
VE-1954	134	477	343	0	2	5	0	1
VE-1954	134	477	343	0	2	5	0	1
VE-1954	134	477	343	0	2	5	0	1
VE-1954	134	477	343	0	2	5	0	1
VE-1954	134	477	343	0	2	5	0	1
VE-1954	134	477	343	0	2	5	0	1
VE-1955	134	477	343	0	2	5	0	1
VE-1955	134	477	343	0	2	5	0	1
VE-1955	134	254	120	1	2	5	2	2
VE-1955	134	175	41	1	2	5	0	2
VE-1955	134	477	343	0	2	5	0	1
VE-1955	134	135	1	1	2	5	2	2
VE-1955	134	477	343	0	4	4	0	0
VE-1955	134	144	10	1	3	1	2	0
VE-1955	134	156	22	1	3	1	1	0
VE-1955	134	143	9	1	3	5	1	0
VE-1956	134	135	1	1	3	4	2	0
VE-1956	134	135	1	1	3	3	0	0
VE-1956	134	137	3	1	3	5	2	0
VE-1956	134	135	1	1	3	5	0	1
VE-1956	134	174	40	1	2	1	1	0
VE-1956	134	165	31	1	2	1	2	0
VE-1956	134	477	343	0	2	1	1	0
VE-1956	135	136	1	1	3	1	2	0
VE-1956	135	210	75	1	3	1	1	0
VE-1956	135	168	33	1	3	1	2	3
VE-1957	135	150	15	1	2	1	0	1
VE-1957	135	477	342	0	3	5	0	0
VE-1957	135	136	1	1	3	4	2	0
VE-1957	135	136	1	1	4	5	2	0
VE-1957	135	177	42	1	3	1	0	1
VE-1957	135	136	1	1	3	1	2	0
VE-1957	135	148	13	1	3	1	1	0
VE-1957	135	148	13	1	3	1	2	0
VE-1957	135	144	9	1	3	1	2	1
VE-1957	136	141	5	1	3	1	1	0
VE-1958	136	415	279	1	3	1	1	0
VE-1958	136	182	46	1	3	1	0	0
VE-1958	136	477	341	0	3	1	0	0
VE-1958	136	144	8	1	3	1	1	0
VE-1958	136	477	341	0	3	5	0	0
VE-1958	136	239	103	1	3	1	1	0
VE-1958	136	153	17	1	3	4	1	0
VE-1958	136	477	341	0	1	1	0	2
VE-1958	136	144	8	1	3	1	3	0
VE-1958	136	138	2	1	3	1	2	2
VE-1959	136	137	1	1	3	1	2	1
VE-1959	136	137	1	1	3	1	0	3
VE-1959	136	140	4	1	3	1	2	2
VE-1959	136	315	179	1	3	1	0	2
VE-1959	136	141	5	1	3	1	2	2
VE-1959	136	141	5	1	3	1	2	2
VE-1959	136	315	179	1	3	1	0	1
VE-1959	136	154	18	1	3	1	1	1
VE-1959	136	150	14	1	2	5	1	4
VE-1959	136	141	5	1	1	1	0	1
VE-1960	136	477	341	0	3	5	1	0
VE-1960	136	477	341	0	3	5	0	0
VE-1960	137	168	31	1	3	1	1	1
VE-1960	137	138	1	1	3	5	1	0
VE-1960	137	163	26	1	3	1	1	0
VE-1960	137	157	20	1	3	1	3	2
VE-1960	137	477	340	0	3	1	0	0
VE-1960	137	477	340	0	3	5	1	0
VE-1960	137	138	1	1	3	1	2	2
VE-1960	137	140	3	1	3	1	1	0
VE-1961	137	477	340	0	3	1	0	1
VE-1961	137	477	340	0	3	1	0	1
VE-1961	137	138	1	1	3	5	2	1
VE-1961	137	142	5	1	3	1	3	0
VE-1961	137	142	5	1	3	1	3	0
VE-1961	137	145	8	1	3	1	2	0
VE-1961	138	477	339	0	3	5	0	0
VE-1961	139	141	2	1	2	5	2	0
VE-1961	139	477	338	0	2	1	1	0
VE-1961	139	141	2	1	3	1	2	0
VE-1962	140	141	1	1	3	5	2	0
VE-1962	140	477	337	0	2	1	0	0
VE-1962	140	141	1	1	3	5	0	1
VE-1962	140	477	337	0	3	1	0	0
VE-1962	140	477	337	0	4	5	0	0
VE-1962	140	477	337	0	3	1	0	0
VE-1962	140	141	1	1	3	5	2	1
VE-1962	140	477	337	0	3	5	0	0
VE-1962	140	141	1	1	3	1	1	0
VE-1962	140	167	27	1	3	1	2	2
VE-1963	140	477	337	0	3	1	0	0
VE-1963	140	143	3	1	3	1	2	1
VE-1963	140	144	4	1	3	1	2	0
VE-1963	140	153	13	1	3	5	1	0
VE-1963	140	477	337	0	3	5	0	0
VE-1963	140	477	337	0	3	5	0	0
VE-1963	140	477	337	0	3	5	0	0
VE-1963	140	141	1	1	3	5	2	0
VE-1963	140	450	310	1	3	1	0	1
VE-1963	140	141	1	1	3	1	2	0
VE-1964	140	477	337	0	3	1	0	0
VE-1964	140	141	1	1	3	5	1	0
VE-1964	140	141	1	1	3	1	1	1
VE-1964	141	151	10	1	3	1	2	0
VE-1964	141	154	13	1	3	1	1	0
VE-1964	141	477	336	0	4	1	0	0
VE-1964	141	164	23	1	3	1	2	0
VE-1964	141	477	336	0	3	4	0	1
VE-1964	141	477	336	0	3	1	0	0
VE-1964	141	176	35	1	4	5	1	0
VE-1965	141	477	336	0	2	1	0	0
VE-1965	141	142	1	1	3	1	1	0
VE-1965	141	142	1	1	3	1	1	0
VE-1965	141	477	336	0	3	1	1	0
VE-1965	141	142	1	1	3	5	2	0
VE-1965	141	142	1	1	3	5	2	0
VE-1965	141	142	1	1	3	4	0	0
VE-1965	141	477	336	0	3	5	0	1
VE-1965	141	142	1	1	3	1	0	0
VE-1965	141	142	1	1	3	1	0	0
VE-1966	141	143	2	1	3	1	1	1
VE-1966	141	477	336	0	3	1	0	0
VE-1966	141	149	8	1	3	4	1	0
VE-1966	141	154	13	1	3	1	1	1
VE-1966	141	142	1	1	3	1	0	0
VE-1966	141	142	1	1	3	3	0	0
VE-1966	141	148	7	1	3	1	1	0
VE-1966	142	144	2	1	3	3	1	0
VE-1966	142	196	54	1	3	4	2	0
VE-1966	142	150	8	1	3	4	2	1
VE-1967	142	477	335	0	3	1	0	0
VE-1967	142	477	335	0	3	1	0	4
VE-1967	142	477	335	0	3	1	1	0
VE-1967	142	176	34	1	3	1	0	0
VE-1967	142	239	97	1	3	4	1	0
VE-1967	142	149	7	1	3	1	2	1
VE-1967	142	477	335	0	3	5	0	0
VE-1967	142	143	1	1	3	1	2	0
VE-1967	142	179	37	1	3	4	0	1
VE-1967	142	144	2	1	3	4	0	1
VE-1968	142	144	2	1	1	1	2	0
VE-1968	142	143	1	1	3	5	0	0
VE-1968	142	149	7	1	3	4	2	0
VE-1968	142	477	335	0	3	1	0	1
VE-1968	142	145	3	1	1	1	2	0
VE-1968	142	477	335	0	3	2	0	0
VE-1968	142	148	6	1	3	1	1	1
VE-1968	142	155	13	1	3	1	1	0
VE-1968	143	154	11	1	3	5	1	1
VE-1968	143	196	53	1	1	1	0	0
VE-1969	143	154	11	1	3	1	2	1
VE-1969	143	147	4	1	3	1	2	0
VE-1969	143	477	334	0	3	4	1	0
VE-1969	143	477	334	0	3	4	1	0
VE-1969	143	211	68	1	3	1	1	0
VE-1969	143	166	23	1	3	1	1	0
VE-1969	143	144	1	1	3	3	0	1
VE-1969	143	144	1	1	3	1	2	1
VE-1969	143	144	1	1	3	1	2	0
VE-1969	143	150	7	1	3	5	2	3
VE-1970	143	154	11	1	3	1	3	0
VE-1970	143	316	173	1	3	1	1	1
VE-1970	143	149	6	1	3	5	1	0
VE-1970	144	477	333	0	3	1	0	0
VE-1970	144	148	4	1	3	1	1	1
VE-1970	144	477	333	0	3	1	0	1
VE-1970	144	145	1	1	3	5	2	1
VE-1970	144	477	333	0	3	5	0	2
VE-1970	144	162	18	1	3	3	2	0
VE-1970	144	145	1	1	3	3	0	0
VE-1971	144	145	1	1	3	1	1	1
VE-1971	144	182	38	1	4	1	1	0
VE-1971	144	148	4	1	3	1	2	1
VE-1971	144	477	333	0	3	1	0	0
VE-1971	144	477	333	0	3	2	0	2
VE-1971	144	148	4	1	3	5	0	0
VE-1971	144	477	333	0	3	3	0	0
VE-1971	144	164	20	1	3	1	1	1
VE-1971	144	477	333	0	3	4	0	1
VE-1972	145	155	10	1	3	1	0	0
VE-1972	145	151	6	1	1	1	1	1
VE-1972	147	477	330	0	3	1	0	0
VE-1972	147	158	11	1	3	1	1	1
VE-1972	147	148	1	1	3	1	0	0
VE-1972	148	170	22	1	3	3	2	0
VE-1972	148	149	1	1	3	1	3	2
VE-1972	148	158	10	1	3	5	1	0
VE-1972	148	157	9	1	3	1	1	0
VE-1972	148	179	31	1	3	1	0	2
VE-1973	148	154	6	1	3	1	1	3
VE-1973	148	150	2	1	3	5	2	0
VE-1973	148	477	329	0	3	5	0	1
VE-1973	148	203	55	1	3	5	1	0
VE-1973	148	174	26	1	3	1	1	0
VE-1973	148	477	329	0	3	1	0	1
VE-1973	148	155	7	1	3	3	1	1
VE-1973	148	149	1	1	3	1	0	0
VE-1973	149	155	6	1	5	3	0	0
VE-1973	149	167	18	1	3	5	2	1
VE-1974	149	477	328	0	3	1	0	1
VE-1974	149	477	328	0	4	4	0	1
VE-1974	149	477	328	0	3	1	0	1
VE-1974	149	161	12	1	3	1	0	0
VE-1974	150	165	15	1	3	1	2	0
VE-1974	150	151	1	1	4	1	1	0
VE-1974	150	477	327	0	1	1	0	1
VE-1974	150	477	327	0	4	1	0	0
VE-1974	150	477	327	0	3	1	0	1
VE-1974	150	222	72	1	2	1	1	2
VE-1975	150	158	8	1	2	1	1	2
VE-1975	150	156	6	1	3	5	0	2
VE-1975	150	155	5	1	3	5	1	0
VE-1975	150	174	24	1	3	1	2	1
VE-1975	150	151	1	1	3	1	1	0
VE-1975	150	151	1	1	3	1	1	0
VE-1975	150	477	327	0	3	1	0	0
VE-1975	150	333	183	1	4	1	0	1
VE-1975	150	155	5	1	3	5	2	0
VE-1975	151	154	3	1	3	5	1	0
VE-1976	151	152	1	1	3	5	0	0
VE-1976	151	247	96	1	2	1	0	0
VE-1976	151	155	4	1	3	1	1	0
VE-1976	151	477	326	0	4	2	0	0
VE-1976	151	179	28	1	3	5	1	0
VE-1976	151	191	40	1	3	5	1	0
VE-1976	151	205	54	1	3	5	1	2
VE-1976	151	228	77	1	3	4	1	1
VE-1976	151	155	4	1	3	5	1	0
VE-1976	151	161	10	1	3	5	1	1
VE-1977	151	209	58	1	3	4	1	3
VE-1977	151	162	11	1	3	1	1	0
VE-1977	151	155	4	1	2	1	3	0
VE-1977	152	155	3	1	2	1	1	0
VE-1977	152	477	325	0	4	1	0	0
VE-1977	152	177	25	1	2	4	1	0
VE-1977	152	158	6	1	3	4	2	0
VE-1977	153	168	15	1	3	1	2	1
VE-1977	153	156	3	1	3	5	1	0
VE-1977	153	477	324	0	4	1	0	0
VE-1978	154	175	21	1	3	1	0	1
VE-1978	154	157	3	1	3	1	0	0
VE-1978	154	171	17	1	3	5	1	1
VE-1978	154	172	18	1	3	4	1	0
VE-1978	154	477	323	0	3	5	0	0
VE-1978	154	477	323	0	3	5	0	0
VE-1978	154	168	14	1	3	5	1	0
VE-1978	154	168	14	1	3	5	1	0
VE-1978	154	156	2	1	3	5	1	0
VE-1978	154	160	6	1	3	1	2	1
VE-1979	154	477	323	0	3	1	0	0
VE-1979	154	477	323	0	3	5	0	0
VE-1979	155	183	28	1	3	1	2	2
VE-1979	155	157	2	1	3	1	2	1
VE-1979	155	159	4	1	3	1	1	0
VE-1979	155	477	322	0	3	5	0	1
VE-1979	155	159	4	1	3	1	1	0
VE-1979	155	477	322	0	3	4	0	1
VE-1979	155	477	322	0	4	1	0	0
VE-1979	155	157	2	1	3	5	2	1
VE-1980	155	222	67	1	1	5	1	3
VE-1980	155	174	19	1	3	1	2	0
VE-1980	155	477	322	0	3	5	0	0
VE-1980	155	477	322	0	3	5	0	0
VE-1980	155	477	322	0	3	4	0	0
VE-1980	155	477	322	0	5	4	0	0
VE-1980	155	189	34	1	3	1	2	0
VE-1980	155	477	322	0	4	4	0	0
VE-1980	155	158	3	1	3	1	1	0
VE-1980	155	210	55	1	4	4	1	0
VE-1981	155	166	11	1	3	1	2	0
VE-1981	156	477	321	0	2	1	0	1
VE-1981	156	188	32	1	3	3	2	0
VE-1981	156	162	6	1	3	1	2	0
VE-1981	156	322	166	1	3	1	1	0
VE-1981	156	162	6	1	3	5	2	0
VE-1981	156	161	5	1	3	5	1	1
VE-1981	156	158	2	1	2	1	3	0
VE-1981	156	157	1	1	3	1	0	0
VE-1981	156	477	321	0	3	1	0	0
VE-1982	156	194	38	1	3	5	1	2
VE-1982	156	477	321	0	3	2	0	0
VE-1982	157	477	320	0	3	5	0	0
VE-1982	157	253	96	1	3	4	0	0
VE-1982	157	163	6	1	3	4	2	1
VE-1982	157	477	320	0	3	1	0	0
VE-1982	157	161	4	1	3	1	2	0
VE-1982	158	159	1	1	3	1	1	0
VE-1982	158	162	4	1	4	3	1	0
VE-1982	158	208	50	1	3	3	2	2
VE-1983	158	477	319	0	3	1	0	1
VE-1983	158	477	319	0	4	4	0	0
VE-1983	158	477	319	0	3	1	0	0
VE-1983	158	161	3	1	3	1	2	0
VE-1983	158	477	319	0	4	4	0	0
VE-1983	158	477	319	0	3	5	0	2
VE-1983	158	477	319	0	3	1	0	0
VE-1983	158	165	7	1	3	1	2	0
VE-1983	158	164	6	1	3	1	2	0
VE-1983	159	160	1	1	3	1	1	0
VE-1984	159	477	318	0	3	1	0	0
VE-1984	159	477	318	0	4	3	0	0
VE-1984	159	477	318	0	3	3	0	4
VE-1984	159	477	318	0	3	4	0	2
VE-1984	159	477	318	0	3	4	0	1
VE-1984	159	477	318	0	4	4	0	1
VE-1984	160	332	172	1	4	4	1	0
VE-1984	160	477	317	0	3	4	0	2
VE-1984	160	477	317	0	3	2	0	1
VE-1984	161	477	316	0	3	3	0	0
VE-1985	161	185	24	1	3	1	1	1
VE-1985	161	163	2	1	3	5	2	0
VE-1985	161	163	2	1	3	5	2	0
VE-1985	161	168	7	1	3	1	2	1
VE-1985	161	477	316	0	3	1	0	0
VE-1985	161	162	1	1	3	5	1	1
VE-1985	161	477	316	0	3	1	0	0
VE-1985	161	163	2	1	3	1	1	1
VE-1985	161	162	1	1	3	1	2	2
VE-1986	161	183	22	1	3	1	2	0
VE-1986	161	165	4	1	3	1	2	1
VE-1986	161	162	1	1	3	1	3	0
VE-1986	161	477	316	0	3	1	0	0
VE-1986	161	165	4	1	3	1	2	1
VE-1986	162	477	315	0	3	1	0	0
VE-1986	162	164	2	1	3	1	2	0
VE-1986	162	178	16	1	3	5	1	0
VE-1986	162	163	1	1	3	5	1	0
VE-1986	162	163	1	1	4	1	1	0
VE-1987	162	169	7	1	3	1	1	0
VE-1987	162	164	2	1	3	1	1	0
VE-1987	162	163	1	1	3	1	2	1
VE-1987	162	163	1	1	3	1	2	0
VE-1987	162	477	315	0	3	1	0	2
VE-1987	162	165	3	1	3	1	2	0
VE-1987	163	166	3	1	3	1	2	2
VE-1987	163	165	2	1	3	1	2	0
VE-1987	163	477	314	0	4	2	0	1
VE-1987	163	165	2	1	4	1	1	0
VE-1988	163	170	7	1	3	3	2	0
VE-1988	163	168	5	1	3	3	2	0
VE-1988	163	171	8	1	3	5	1	2
VE-1988	163	170	7	1	3	1	0	1
VE-1988	163	165	2	1	3	1	1	0
VE-1988	163	165	2	1	3	4	1	0
VE-1988	163	194	31	1	3	1	1	0
VE-1988	163	333	170	1	3	1	1	2
VE-1988	163	176	13	1	4	1	1	0
VE-1988	164	171	7	1	3	1	1	0
VE-1989	164	176	12	1	3	1	1	4
VE-1989	164	203	39	1	3	1	1	1
VE-1989	164	171	7	1	3	5	2	0
VE-1989	164	165	1	1	3	1	0	2
VE-1989	164	477	313	0	4	4	0	0
VE-1989	164	477	313	0	3	1	0	2
VE-1989	164	477	313	0	3	1	0	1
VE-1989	164	255	91	1	4	5	1	1
VE-1989	164	168	4	1	3	1	2	0
VE-1989	164	171	7	1	3	5	1	1
VE-1990	164	165	1	1	4	4	0	0
VE-1990	164	477	313	0	3	4	1	2
VE-1990	164	238	74	1	3	4	1	1
VE-1990	165	168	3	1	3	1	2	0
VE-1990	165	168	3	1	3	1	2	0
VE-1990	165	477	312	0	3	4	0	0
VE-1990	165	477	312	0	2	4	0	0
VE-1990	165	174	9	1	3	1	0	2
VE-1990	165	170	5	1	1	1	1	1
VE-1990	165	168	3	1	3	5	1	0
VE-1991	165	477	312	0	3	5	0	0
VE-1991	165	477	312	0	3	1	0	0
VE-1991	165	166	1	1	3	1	3	0
VE-1991	165	166	1	1	3	1	0	0
VE-1991	165	176	11	1	3	5	1	1
VE-1991	165	201	36	1	3	5	1	0
VE-1991	165	178	13	1	3	5	0	0
VE-1991	165	166	1	1	3	1	1	1
VE-1991	165	166	1	1	3	1	0	0
VE-1991	166	477	311	0	3	2	0	0
VE-1992	166	170	4	1	3	1	2	0
VE-1992	166	175	9	1	3	1	1	0
VE-1992	166	175	9	1	3	1	1	1
VE-1992	166	168	2	1	3	5	2	0
VE-1992	167	224	57	1	3	3	2	0
VE-1992	167	477	310	0	3	5	0	0
VE-1992	167	477	310	0	3	4	0	0
VE-1992	168	208	40	1	3	5	2	0
VE-1992	168	173	5	1	3	3	2	2
VE-1992	168	202	34	1	2	1	0	0
VE-1993	168	176	8	1	3	5	1	0
VE-1993	168	171	3	1	3	5	1	0
VE-1993	168	177	9	1	3	5	0	0
VE-1993	168	477	309	0	3	4	1	0
VE-1993	168	178	10	1	3	5	1	0
VE-1993	168	204	36	1	4	1	1	0
VE-1993	168	477	309	0	3	1	0	0
VE-1993	168	217	49	1	3	4	1	0
VE-1993	168	184	16	1	3	1	2	1
VE-1993	168	177	9	1	3	5	0	0
VE-1994	168	196	28	1	3	4	1	0
VE-1994	168	175	7	1	3	1	1	0
VE-1994	169	172	3	1	3	4	1	0
VE-1994	169	477	308	0	3	1	0	0
VE-1994	169	182	13	1	3	5	1	1
VE-1994	169	477	308	0	3	4	1	0
VE-1994	169	176	7	1	3	1	2	2
VE-1994	169	477	308	0	3	3	0	0
VE-1994	169	175	6	1	3	1	1	1
VE-1994	170	477	307	0	3	1	0	0
VE-1995	170	477	307	0	1	1	0	0
VE-1995	170	182	12	1	2	1	2	0
VE-1995	170	175	5	1	3	1	0	0
VE-1995	170	171	1	1	3	5	1	0
VE-1995	171	172	1	1	3	5	1	0
VE-1995	171	373	202	1	3	1	1	1
VE-1995	171	174	3	1	3	1	2	0
VE-1995	171	477	306	0	3	4	0	0
VE-1995	171	477	306	0	1	1	0	0
VE-1995	171	477	306	0	1	1	0	0
VE-1996	171	477	306	0	4	2	0	1
VE-1996	171	477	306	0	3	1	0	2
VE-1996	171	477	306	0	3	1	0	0
VE-1996	171	172	1	1	3	5	1	0
VE-1996	171	175	4	1	3	1	2	0
VE-1996	171	175	4	1	1	1	1	2
VE-1996	172	176	4	1	3	1	0	0
VE-1996	172	180	8	1	3	3	2	0
VE-1996	172	431	259	1	3	1	1	0
VE-1996	172	177	5	1	3	1	1	0
VE-1997	172	190	18	1	3	3	2	0
VE-1997	172	178	6	1	3	3	1	1
VE-1997	172	175	3	1	3	1	2	1
VE-1997	172	174	2	1	3	1	2	0
VE-1997	172	218	46	1	4	1	2	2
VE-1997	172	183	11	1	3	5	1	1
VE-1997	175	277	102	1	3	5	0	1
VE-1997	175	477	302	0	4	4	0	0
VE-1997	175	178	3	1	3	3	2	0
VE-1997	175	183	8	1	3	3	1	0
VE-1998	175	176	1	1	3	1	2	0
VE-1998	175	178	3	1	3	5	1	0
VE-1998	175	477	302	0	3	5	0	0
VE-1998	175	190	15	1	3	1	1	1
VE-1998	175	191	16	1	3	1	1	1
VE-1998	175	271	96	1	3	4	1	4
VE-1998	175	205	30	1	3	5	1	0
VE-1998	175	477	302	0	3	5	0	0
VE-1998	175	177	2	1	1	1	0	2
VE-1998	175	179	4	1	3	1	1	0
VE-1999	176	200	24	1	3	1	1	0
VE-1999	176	477	301	0	3	1	0	0
VE-1999	176	196	20	1	2	1	1	0
VE-1999	176	246	70	1	3	1	1	0
VE-1999	176	477	301	0	3	1	0	0
VE-1999	176	183	7	1	3	5	2	0
VE-1999	176	477	301	0	3	4	0	0
VE-1999	176	177	1	1	3	1	2	1
VE-1999	176	477	301	0	3	5	0	1
VE-1999	176	177	1	1	3	5	0	2
VE-2000	176	177	1	1	1	2	1	1
VE-2000	176	477	301	0	2	1	0	0
VE-2000	176	180	4	1	3	1	2	0
VE-2000	176	477	301	0	3	1	0	1
VE-2000	177	180	3	1	2	1	2	0
VE-2000	177	183	6	1	3	5	1	0
VE-2000	177	194	17	1	2	4	1	4
VE-2000	177	178	1	1	1	5	1	4
VE-2000	177	182	5	1	3	1	1	0
VE-2000	177	180	3	1	3	5	2	0
VE-2001	177	178	1	1	3	1	3	3
VE-2001	177	179	2	1	2	1	2	0
VE-2001	177	477	300	0	4	2	0	0
VE-2001	177	238	61	1	3	1	1	0
VE-2001	177	178	1	1	3	1	0	0
VE-2001	177	205	28	1	5	4	1	0
VE-2001	177	211	34	1	3	1	0	2
VE-2001	177	477	300	0	3	1	0	0
VE-2001	177	185	8	1	3	5	1	2
VE-2001	177	192	15	1	3	5	1	0
VE-2002	178	252	74	1	5	4	1	2
VE-2002	178	182	4	1	3	1	1	0
VE-2002	178	477	299	0	1	5	0	0
VE-2002	178	477	299	0	3	4	0	0
VE-2002	178	477	299	0	3	1	0	1
VE-2002	178	185	7	1	3	1	2	0
VE-2002	178	477	299	0	3	3	0	0
VE-2002	178	179	1	1	3	1	0	2
VE-2002	178	181	3	1	3	1	2	0
VE-2002	178	200	22	1	3	5	1	0
VE-2003	178	344	166	1	3	3	0	0
VE-2003	178	179	1	1	3	1	0	0
VE-2003	179	207	28	1	3	4	1	0
VE-2003	179	477	298	0	3	1	0	0
VE-2003	179	181	2	1	4	1	1	1
VE-2003	179	208	29	1	3	1	2	1
VE-2003	179	227	48	1	3	1	0	0
VE-2003	179	192	13	1	5	5	1	0
VE-2003	179	182	3	1	3	1	2	0
VE-2003	180	185	5	1	3	1	2	0
VE-2004	180	211	31	1	3	1	1	0
VE-2004	180	193	13	1	4	4	1	0
VE-2004	181	477	296	0	3	1	0	0
VE-2004	181	189	8	1	3	1	1	0
VE-2004	181	245	64	1	3	1	1	0
VE-2004	181	182	1	1	3	3	1	0
VE-2004	182	201	19	1	3	5	1	0
VE-2004	182	199	17	1	3	5	1	0
VE-2004	182	477	295	0	3	3	0	0
VE-2004	182	477	295	0	3	3	0	0
VE-2005	182	183	1	1	3	1	0	0
VE-2005	182	183	1	1	3	1	2	0
VE-2005	182	270	88	1	3	1	1	0
VE-2005	182	477	295	0	3	4	0	1
VE-2005	182	477	295	0	3	5	0	0
VE-2005	182	203	21	1	3	5	0	0
VE-2005	182	477	295	0	4	1	1	1
VE-2005	182	190	8	1	3	3	1	0
VE-2005	182	183	1	1	3	1	2	0
VE-2006	182	186	4	1	3	3	1	0
VE-2006	183	198	15	1	3	5	1	0
VE-2006	183	184	1	1	3	1	1	1
VE-2006	183	477	294	0	2	4	1	3
VE-2006	183	191	8	1	1	1	0	0
VE-2006	183	186	3	1	3	1	1	0
VE-2006	183	184	1	1	3	1	2	1
VE-2006	183	185	2	1	3	1	1	0
VE-2006	183	477	294	0	4	1	0	1
VE-2006	183	192	9	1	3	1	2	1
VE-2007	183	214	31	1	3	5	1	1
VE-2007	183	477	294	0	3	1	0	0
VE-2007	183	477	294	0	2	1	0	0
VE-2007	183	186	3	1	4	1	2	1
VE-2007	183	184	1	1	3	1	1	0
VE-2007	183	477	294	0	3	1	0	0
VE-2007	183	191	8	1	3	1	1	1
VE-2007	183	186	3	1	3	1	1	3
VE-2007	183	477	294	0	3	3	0	0
VE-2007	183	421	238	1	3	4	1	3
VE-2008	183	249	66	1	3	1	1	1
VE-2008	184	194	10	1	3	5	1	0
VE-2008	184	204	20	1	3	1	1	2
VE-2008	184	477	293	0	3	1	0	1
VE-2008	184	477	293	0	4	3	0	0
VE-2008	184	187	3	1	3	1	1	1
VE-2008	184	477	293	0	3	1	1	0
VE-2008	184	186	2	1	3	1	0	1
VE-2008	184	192	8	1	2	1	1	0
VE-2008	184	477	293	0	3	1	0	0
VE-2009	184	194	10	1	3	4	2	0
VE-2009	184	192	8	1	2	1	2	0
VE-2009	185	437	252	1	3	1	0	0
VE-2009	185	191	6	1	3	1	1	0
VE-2009	185	192	7	1	4	1	1	0
VE-2009	185	265	80	1	3	1	2	1
VE-2009	185	477	292	0	3	1	0	0
VE-2009	185	256	71	1	3	5	1	0
VE-2009	185	186	1	1	3	1	1	0
VE-2009	185	189	4	1	3	4	1	0
VE-2010	185	191	6	1	3	1	0	0
VE-2010	186	211	25	1	3	1	1	0
VE-2010	186	192	6	1	3	4	2	0
VE-2010	186	189	3	1	3	1	1	1
VE-2010	186	477	291	0	4	1	0	0
VE-2010	186	208	22	1	3	1	2	1
VE-2010	186	191	5	1	3	3	1	0
VE-2010	186	194	8	1	3	5	1	0
VE-2010	186	477	291	0	3	4	0	0
VE-2010	186	477	291	0	3	1	0	0
VE-2011	186	187	1	1	3	5	1	0
VE-2011	186	194	8	1	3	1	1	2
VE-2011	186	190	4	1	3	1	1	1
VE-2011	186	477	291	0	3	1	0	0
VE-2011	186	477	291	0	3	3	0	0
VE-2011	187	201	14	1	3	5	1	0
VE-2011	187	197	10	1	3	1	2	0
VE-2011	187	315	128	1	3	1	0	0
VE-2011	187	218	31	1	3	4	2	0
VE-2011	187	477	290	0	3	1	0	1
VE-2012	189	210	21	1	3	3	2	1
VE-2012	189	213	24	1	3	1	1	0
VE-2012	189	204	15	1	1	3	0	0
VE-2012	189	191	2	1	3	5	2	0
VE-2012	189	477	288	0	3	5	0	0
VE-2012	189	477	288	0	3	5	0	0
VE-2012	189	190	1	1	2	1	4	1
VE-2012	189	201	12	1	3	1	1	0
VE-2012	189	477	288	0	3	1	0	0
VE-2012	189	191	2	1	3	1	2	0
VE-2013	190	211	21	1	3	4	2	0
VE-2013	190	203	13	1	3	5	1	1
VE-2013	190	477	287	0	3	1	1	0
VE-2013	190	477	287	0	3	1	0	0
VE-2013	190	477	287	0	3	5	0	0
VE-2013	190	194	4	1	1	4	3	1
VE-2013	190	219	29	1	4	4	1	0
VE-2013	190	477	287	0	3	4	0	1
VE-2013	191	477	286	0	3	1	0	0
VE-2013	191	477	286	0	3	1	0	0
VE-2014	191	477	286	0	3	1	0	0
VE-2014	191	477	286	0	3	3	0	0
VE-2014	191	212	21	1	3	3	0	0
VE-2014	191	477	286	0	3	1	0	1
VE-2014	191	477	286	0	3	1	0	0
VE-2014	191	192	1	1	4	1	0	1
VE-2014	191	477	286	0	3	1	0	0
VE-2014	191	193	2	1	3	1	2	0
VE-2014	192	193	1	1	3	4	0	1
VE-2014	192	199	7	1	3	1	1	1
VE-2015	192	477	285	0	3	4	0	3
VE-2015	192	233	41	1	3	1	0	1
VE-2015	192	197	5	1	2	1	1	0
VE-2015	192	207	15	1	3	1	1	0
VE-2015	192	477	285	0	3	4	0	0
VE-2015	192	477	285	0	3	3	0	0
VE-2015	192	207	15	1	4	4	1	0
VE-2015	192	310	118	1	4	4	0	1
VE-2015	192	206	14	1	5	4	2	0
VE-2015	192	372	180	1	4	4	1	1
VE-2016	192	371	179	1	4	4	1	0
VE-2016	192	332	140	1	4	4	1	1
VE-2016	192	217	25	1	4	4	1	0
VE-2016	192	259	67	1	4	4	1	0
VE-2016	193	205	12	1	3	1	0	0
VE-2016	193	198	5	1	3	1	2	0
VE-2016	193	213	20	1	4	4	2	0
VE-2016	193	477	284	0	4	1	0	0
VE-2016	193	210	17	1	4	1	2	1
VE-2016	193	213	20	1	4	4	2	1
VE-2017	193	381	188	1	4	4	1	1
VE-2017	193	477	284	0	3	4	0	0
VE-2017	193	198	5	1	3	1	1	0
VE-2017	193	477	284	0	3	1	0	0
VE-2017	193	202	9	1	2	1	1	0
VE-2017	194	477	283	0	5	1	0	0
VE-2017	194	477	283	0	3	1	0	0
VE-2017	195	211	16	1	3	1	1	0
VE-2017	196	477	281	0	4	1	0	0
VE-2017	196	197	1	1	3	1	1	0
VE-2018	196	203	7	1	3	1	1	0
VE-2018	196	203	7	1	3	1	1	0
VE-2018	196	203	7	1	3	1	1	0
VE-2018	196	199	3	1	3	1	1	1
VE-2018	196	207	11	1	3	1	1	2
VE-2018	196	210	14	1	3	1	1	1
VE-2018	196	477	281	0	3	1	1	0
VE-2018	196	237	41	1	1	1	0	0
VE-2018	196	253	57	1	3	5	1	0
VE-2018	196	477	281	0	3	5	0	0
VE-2019	196	477	281	0	3	4	0	0
VE-2019	197	238	41	1	3	1	1	0
VE-2019	197	203	6	1	3	1	2	0
VE-2019	197	228	31	1	3	1	1	0
VE-2019	197	253	56	1	3	5	1	0
VE-2019	197	253	56	1	3	5	1	0
VE-2019	197	256	59	1	3	5	1	0
VE-2019	197	199	2	1	2	1	1	0
VE-2019	198	477	279	0	3	4	0	1
VE-2019	198	477	279	0	3	4	0	0
VE-2020	198	477	279	0	3	1	0	0
VE-2020	198	199	1	1	3	3	2	1
VE-2020	198	258	60	1	3	2	2	0
VE-2020	198	206	8	1	1	1	1	0
VE-2020	198	203	5	1	3	1	1	1
VE-2020	198	477	279	0	4	1	0	1
VE-2020	198	477	279	0	3	1	0	0
VE-2020	198	214	16	1	2	1	1	0
VE-2020	199	477	278	0	1	1	0	0
VE-2020	199	210	11	1	3	1	2	0
VE-2021	199	210	11	1	3	1	1	0
VE-2021	199	477	278	0	3	5	0	0
VE-2021	199	207	8	1	4	1	2	2
VE-2021	199	208	9	1	3	4	2	3
VE-2021	199	477	278	0	2	1	0	0
VE-2021	199	207	8	1	3	1	0	1
VE-2021	200	477	277	0	3	4	0	1
VE-2021	200	203	3	1	4	5	1	1
VE-2021	200	202	2	1	3	4	1	3
VE-2021	200	201	1	1	3	5	1	0
VE-2022	201	477	276	0	3	1	0	1
VE-2022	203	210	7	1	3	1	1	1
VE-2022	203	477	274	0	3	2	0	1
VE-2022	203	332	129	1	5	4	1	0
VE-2022	203	281	78	1	5	4	1	0
VE-2022	203	253	50	1	3	2	3	0
VE-2022	203	210	7	1	3	1	1	1
VE-2022	203	227	24	1	3	1	1	0
VE-2022	204	207	3	1	3	1	1	0
VE-2022	204	477	273	0	3	1	0	0
VE-2023	204	477	273	0	4	1	0	0
VE-2023	204	205	1	1	3	1	1	1
VE-2023	204	477	273	0	1	1	0	0
VE-2023	204	388	184	1	4	4	1	0
VE-2023	204	477	273	0	3	4	0	0
VE-2023	204	477	273	0	3	1	0	0
VE-2023	205	247	42	1	5	4	2	0
VE-2023	205	233	28	1	5	4	1	0
VE-2023	205	477	272	0	4	4	1	0
VE-2023	205	332	127	1	4	4	2	0
VE-2024	206	210	4	1	3	1	0	0
VE-2024	206	211	5	1	3	4	2	1
VE-2024	206	207	1	1	3	5	1	0
VE-2024	206	477	271	0	3	5	0	0
VE-2024	206	211	5	1	3	1	1	0
VE-2024	206	211	5	1	2	1	1	0
VE-2024	206	233	27	1	4	4	1	0
VE-2024	206	210	4	1	3	1	1	0
VE-2024	206	210	4	1	3	1	1	0
VE-2024	206	210	4	1	3	2	1	0
VE-2025	206	477	271	0	3	5	0	0
VE-2025	207	477	270	0	3	4	0	0
VE-2025	207	213	6	1	3	1	1	0
VE-2025	207	477	270	0	3	5	0	0
VE-2025	207	224	17	1	3	1	1	1
VE-2025	207	399	192	1	4	4	1	0
VE-2025	207	477	270	0	3	1	0	0
VE-2025	207	477	270	0	4	4	1	0
VE-2025	207	235	28	1	4	1	2	0
VE-2025	207	477	270	0	3	5	0	0
VE-2026	207	213	6	1	3	4	1	0
VE-2026	208	477	269	0	4	2	0	0
VE-2026	208	210	2	1	4	4	1	0
VE-2026	209	210	1	1	3	1	2	0
VE-2026	209	222	13	1	3	5	2	0
VE-2026	209	477	268	0	3	4	0	1
VE-2026	209	477	268	0	3	4	0	1
VE-2026	209	262	53	1	4	4	2	0
VE-2026	210	477	267	0	3	2	0	0
VE-2026	210	477	267	0	3	1	0	0
VE-2027	210	477	267	0	3	1	0	0
VE-2027	210	211	1	1	3	4	1	0
VE-2027	210	477	267	0	3	1	0	0
VE-2027	210	477	267	0	3	5	0	0
VE-2027	210	214	4	1	3	1	2	0
VE-2027	211	477	266	0	3	1	0	0
VE-2027	211	477	266	0	1	1	0	0
VE-2027	211	217	6	1	3	1	1	0
VE-2027	211	217	6	1	3	4	1	0
VE-2027	211	219	8	1	3	4	1	0
VE-2028	211	477	266	0	3	5	0	0
VE-2028	211	213	2	1	2	1	2	1
VE-2028	211	477	266	0	2	1	1	0
VE-2028	211	477	266	0	3	1	0	0
VE-2028	212	477	265	0	5	4	1	0
VE-2028	212	477	265	0	3	1	0	0
VE-2028	212	477	265	0	3	4	0	0
VE-2028	212	305	93	1	3	4	0	0
VE-2028	212	477	265	0	3	1	0	0
VE-2028	212	477	265	0	4	1	1	0
VE-2029	212	217	5	1	1	1	1	0
VE-2029	212	283	71	1	3	4	1	0
VE-2029	212	217	5	1	3	4	1	1
VE-2029	213	254	41	1	3	3	1	1
VE-2029	213	214	1	1	2	1	1	0
VE-2029	213	401	188	1	3	4	1	0
VE-2029	213	253	40	1	3	4	1	2
VE-2029	213	477	264	0	3	4	0	0
VE-2029	213	225	12	1	3	1	1	0
VE-2029	213	214	1	1	3	1	1	0
VE-2030	214	217	3	1	3	4	1	0
VE-2030	214	215	1	1	3	5	2	0
VE-2030	214	215	1	1	3	1	2	0
VE-2030	214	477	263	0	3	1	0	0
VE-2030	214	319	105	1	3	1	2	1
VE-2030	214	477	263	0	3	1	0	0
VE-2030	214	279	65	1	3	5	1	1
VE-2030	214	288	74	1	3	5	1	0
VE-2030	214	477	263	0	3	5	0	0
VE-2030	214	477	263	0	3	1	0	0
VE-2031	214	217	3	1	3	1	0	0
VE-2031	214	226	12	1	3	1	1	0
VE-2031	214	477	263	0	3	4	0	0
VE-2031	214	477	263	0	3	4	0	1
VE-2031	215	217	2	1	3	4	2	1
VE-2031	216	236	20	1	2	1	1	0
VE-2031	217	221	4	1	3	1	2	0
VE-2031	217	477	260	0	3	4	0	0
VE-2031	217	477	260	0	1	1	0	0
VE-2031	217	477	260	0	1	1	0	1
VE-2032	217	218	1	1	3	3	1	1
VE-2032	217	228	11	1	3	1	1	0
VE-2032	217	218	1	1	3	1	0	0
VE-2032	217	477	260	0	3	4	0	0
VE-2032	217	477	260	0	3	4	0	0
VE-2032	217	257	40	1	1	1	1	1
VE-2032	217	218	1	1	3	3	1	0
VE-2032	217	477	260	0	3	4	0	0
VE-2032	217	309	92	1	2	1	0	0
VE-2032	218	224	6	1	3	3	2	0
VE-2033	218	331	113	1	3	1	1	0
VE-2033	218	227	9	1	3	1	1	0
VE-2033	218	225	7	1	3	4	0	2
VE-2033	218	282	64	1	3	1	0	1
VE-2033	218	477	259	0	3	1	0	0
VE-2033	218	219	1	1	3	5	2	0
VE-2033	219	220	1	1	3	1	2	1
VE-2033	219	220	1	1	3	1	0	0
VE-2033	219	280	61	1	3	1	1	0
VE-2033	219	236	17	1	2	1	1	0
VE-2034	219	221	2	1	3	1	1	1
VE-2034	219	220	1	1	3	1	0	1
VE-2034	219	253	34	1	1	1	0	1
VE-2034	219	225	6	1	3	1	1	0
VE-2034	219	221	2	1	3	4	2	0
VE-2034	220	225	5	1	3	1	1	0
VE-2034	220	477	257	0	3	3	0	2
VE-2034	220	221	1	1	3	1	2	0
VE-2034	220	477	257	0	3	1	0	0
VE-2034	220	261	41	1	3	1	1	1
VE-2035	220	221	1	1	4	4	1	0
VE-2035	220	477	257	0	4	1	0	2
VE-2035	220	235	15	1	2	1	1	0
VE-2035	220	221	1	1	3	1	1	0
VE-2035	220	223	3	1	3	1	0	2
VE-2035	220	257	37	1	3	1	1	0
VE-2035	220	221	1	1	3	1	0	0
VE-2035	220	227	7	1	3	4	1	0
VE-2035	220	477	257	0	4	2	0	0
VE-2035	221	477	256	0	3	4	1	0
VE-2036	221	319	98	1	4	4	1	0
VE-2036	221	222	1	1	4	1	1	0
VE-2036	221	477	256	0	3	1	0	0
VE-2036	221	477	256	0	3	4	0	0
VE-2036	221	422	201	1	3	4	1	1
VE-2036	222	273	51	1	3	1	0	2
VE-2036	222	231	9	1	3	1	1	1
VE-2036	222	235	13	1	2	1	1	0
VE-2036	222	228	6	1	3	1	2	2
VE-2036	222	477	255	0	3	1	0	1
VE-2037	224	298	74	1	2	1	0	0
VE-2037	224	235	11	1	4	4	2	0
VE-2037	224	246	22	1	5	1	1	0
VE-2037	224	477	253	0	4	1	1	0
VE-2037	224	238	14	1	3	4	1	0
VE-2037	224	477	253	0	3	1	0	2
VE-2037	224	477	253	0	4	1	0	1
VE-2037	224	247	23	1	3	2	1	2
VE-2037	224	227	3	1	3	1	1	0
VE-2037	224	225	1	1	3	1	2	0
VE-2038	224	477	253	0	3	1	0	0
VE-2038	225	477	252	0	3	1	0	0
VE-2038	225	456	231	1	3	4	1	1
VE-2038	225	227	2	1	3	1	1	0
VE-2038	225	227	2	1	3	1	1	0
VE-2038	225	285	60	1	4	1	1	0
VE-2038	225	477	252	0	3	4	1	0
VE-2038	225	280	55	1	3	5	1	0
VE-2038	225	238	13	1	3	5	1	1
VE-2038	225	226	1	1	3	4	2	0
VE-2039	225	256	31	1	3	5	1	0
VE-2039	225	227	2	1	3	1	2	0
VE-2039	226	312	86	1	3	1	0	0
VE-2039	226	227	1	1	3	1	0	0
VE-2039	226	239	13	1	3	1	1	0
VE-2039	226	415	189	1	3	4	0	1
VE-2039	226	239	13	1	4	5	1	0
VE-2039	226	228	2	1	3	1	1	1
VE-2039	227	477	250	0	3	3	0	2
VE-2039	227	234	7	1	3	1	1	1
VE-2040	227	228	1	1	3	1	1	1
VE-2040	227	477	250	0	3	1	0	1
VE-2040	227	231	4	1	3	3	1	0
VE-2040	227	477	250	0	3	5	1	0
VE-2040	227	477	250	0	3	5	0	1
VE-2040	227	253	26	1	3	5	0	0
VE-2040	227	229	2	1	2	1	1	0
VE-2040	227	232	5	1	3	1	1	1
VE-2040	227	477	250	0	3	1	0	0
VE-2040	227	233	6	1	3	1	1	0
VE-2041	228	229	1	1	3	1	1	2
VE-2041	228	232	4	1	3	1	1	0
VE-2041	228	254	26	1	3	1	1	0
VE-2041	228	229	1	1	3	1	2	0
VE-2041	228	477	249	0	3	1	0	1
VE-2041	228	477	249	0	3	1	0	0
VE-2041	228	477	249	0	3	1	0	0
VE-2041	228	477	249	0	3	1	0	0
VE-2041	228	233	5	1	3	1	1	2
VE-2041	228	386	158	1	3	1	1	0
VE-2042	229	295	66	1	3	2	3	0
VE-2042	229	233	4	1	3	1	1	0
VE-2042	229	230	1	1	3	1	1	0
VE-2042	231	268	37	1	3	1	2	0
VE-2042	231	257	26	1	3	1	1	0
VE-2042	231	233	2	1	3	4	1	0
VE-2042	231	477	246	0	3	4	0	0
VE-2042	231	233	2	1	3	4	1	0
VE-2042	231	477	246	0	3	1	0	0
VE-2042	231	477	246	0	3	5	0	0
VE-2043	232	267	35	1	3	5	0	1
VE-2043	232	234	2	1	3	1	1	1
VE-2043	232	249	17	1	3	4	1	0
VE-2043	232	240	8	1	3	1	1	1
VE-2043	233	477	244	0	3	1	0	1
VE-2043	233	373	140	1	2	1	1	2
VE-2043	233	477	244	0	3	4	0	4
VE-2043	233	249	16	1	3	1	0	0
VE-2043	233	477	244	0	4	4	0	0
VE-2043	233	238	5	1	3	4	1	0
VE-2044	233	340	107	1	3	4	1	0
VE-2044	233	477	244	0	3	1	0	0
VE-2044	233	477	244	0	3	1	0	0
VE-2044	233	234	1	1	3	1	1	0
VE-2044	234	263	29	1	3	1	2	0
VE-2044	234	477	243	0	4	5	0	0
VE-2044	234	263	29	1	3	5	0	1
VE-2044	234	477	243	0	3	3	0	0
VE-2044	234	477	243	0	3	1	0	0
VE-2044	234	238	4	1	3	4	1	0
VE-2045	234	235	1	1	4	5	1	0
VE-2045	234	242	8	1	3	1	1	0
VE-2045	234	477	243	0	3	4	0	0
VE-2045	234	235	1	1	3	1	1	0
VE-2045	234	477	243	0	3	1	1	1
VE-2045	235	236	1	1	3	1	2	0
VE-2045	235	477	242	0	3	1	0	0
VE-2045	235	477	242	0	2	4	0	0
VE-2045	235	477	242	0	3	4	0	0
VE-2045	235	477	242	0	4	4	0	1
VE-2046	235	477	242	0	3	4	0	1
VE-2046	236	477	241	0	3	1	0	0
VE-2046	236	257	21	1	3	1	1	0
VE-2046	236	477	241	0	3	1	1	0
VE-2046	238	477	239	0	3	1	0	0
VE-2046	238	240	2	1	3	5	1	0
VE-2046	238	241	3	1	3	4	1	0
VE-2046	238	239	1	1	3	1	1	0
VE-2046	238	477	239	0	3	2	0	0
VE-2046	238	477	239	0	3	4	0	1
VE-2047	238	266	28	1	4	1	1	1
VE-2047	238	253	15	1	3	1	1	0
VE-2047	239	240	1	1	5	1	1	0
VE-2047	239	477	238	0	2	4	0	0
VE-2047	239	255	16	1	1	1	0	0
VE-2047	239	477	238	0	3	1	0	0
VE-2047	239	246	7	1	3	1	2	0
VE-2047	239	291	52	1	3	4	1	0
VE-2047	239	240	1	1	3	1	0	1
VE-2047	239	240	1	1	3	3	0	0
VE-2048	239	253	14	1	4	4	1	0
VE-2048	239	252	13	1	3	5	1	0
VE-2048	240	256	16	1	3	5	1	1
VE-2048	240	255	15	1	3	5	1	1
VE-2048	240	395	155	1	3	4	2	0
VE-2048	240	297	57	1	3	5	0	1
VE-2048	241	308	67	1	3	4	1	1
VE-2048	241	242	1	1	3	1	0	0
VE-2048	241	290	49	1	3	5	1	0
VE-2048	241	252	11	1	3	1	1	0
VE-2049	242	293	51	1	3	4	1	1
VE-2049	242	247	5	1	3	4	1	1
VE-2049	242	477	235	0	3	1	0	0
VE-2049	242	246	4	1	4	4	1	0
VE-2049	242	277	35	1	3	1	2	0
VE-2049	242	477	235	0	3	5	0	0
VE-2049	244	245	1	1	2	1	1	0
VE-2049	246	477	231	0	3	1	0	0
VE-2049	246	262	16	1	3	5	1	0
VE-2049	246	249	3	1	3	1	1	0
VE-2050	246	477	231	0	3	1	0	1
VE-2050	246	282	36	1	3	4	0	1
VE-2050	247	252	5	1	3	1	1	1
VE-2050	247	255	8	1	3	1	1	1
VE-2050	247	375	128	1	3	4	0	0
VE-2050	247	249	2	1	2	1	1	0
VE-2050	247	252	5	1	3	4	1	1
VE-2050	247	262	15	1	3	1	0	1
VE-2050	247	252	5	1	3	1	0	0
VE-2050	248	288	40	1	4	1	1	0
VE-2051	248	252	4	1	3	1	1	1
VE-2051	248	266	18	1	3	1	1	0
VE-2051	248	317	69	1	3	5	1	0
VE-2051	248	252	4	1	2	1	1	0
VE-2051	248	252	4	1	3	1	1	0
VE-2051	249	251	2	1	3	1	1	0
VE-2051	249	477	228	0	3	1	1	0
VE-2051	249	260	11	1	3	5	1	0
VE-2051	249	477	228	0	3	1	0	1
VE-2051	249	477	228	0	3	5	0	1
VE-2052	249	253	4	1	3	1	2	2
VE-2052	250	253	3	1	3	4	1	2
VE-2052	250	251	1	1	3	1	2	0
VE-2052	250	414	164	1	4	4	0	2
VE-2052	251	257	6	1	2	1	1	0
VE-2052	252	477	225	0	3	1	0	0
VE-2052	252	257	5	1	3	1	1	0
VE-2052	252	257	5	1	3	1	1	0
VE-2052	253	477	224	0	3	1	1	0
VE-2052	253	477	224	0	3	5	1	0
VE-2053	253	477	224	0	3	5	1	0
VE-2053	253	287	34	1	3	5	1	0
VE-2053	253	254	1	1	3	5	1	0
VE-2053	253	477	224	0	3	5	1	0
VE-2053	253	477	224	0	3	5	1	0
VE-2053	253	276	23	1	3	3	1	1
VE-2053	253	262	9	1	3	3	1	0
VE-2053	253	256	3	1	3	1	1	1
VE-2053	253	287	34	1	3	2	1	0
VE-2053	253	254	1	1	3	3	1	0
VE-2054	253	269	16	1	3	1	1	1
VE-2054	254	255	1	1	3	1	2	0
VE-2054	254	295	41	1	4	1	1	0
VE-2054	254	477	223	0	3	5	0	0
VE-2054	254	276	22	1	3	1	1	0
VE-2054	254	322	68	1	3	4	1	0
VE-2054	254	430	176	1	3	3	1	0
VE-2054	255	262	7	1	3	1	1	0
VE-2054	255	477	222	0	3	1	0	0
VE-2054	255	291	36	1	3	1	2	1
VE-2055	255	422	167	1	3	1	1	2
VE-2055	255	477	222	0	3	1	0	0
VE-2055	255	351	96	1	3	4	2	1
VE-2055	255	256	1	1	3	4	1	0
VE-2055	255	477	222	0	3	1	0	1
VE-2055	255	263	8	1	3	1	3	0
VE-2055	255	276	21	1	3	2	1	2
VE-2055	256	477	221	0	3	4	0	1
VE-2055	256	259	3	1	3	4	1	0
VE-2055	256	477	221	0	3	4	0	1
VE-2056	256	259	3	1	3	4	1	0
VE-2056	256	260	4	1	3	1	1	1
VE-2056	256	268	12	1	3	1	0	1
VE-2056	256	276	20	1	3	1	1	1
VE-2056	256	280	24	1	3	5	1	0
VE-2056	256	477	221	0	2	4	0	1
VE-2056	256	477	221	0	3	4	0	1
VE-2056	256	477	221	0	3	2	0	0
VE-2056	256	263	7	1	4	4	1	0
VE-2056	258	477	219	0	3	1	0	2
VE-2057	259	261	2	1	3	1	1	0
VE-2057	259	477	218	0	3	4	0	0
VE-2057	259	290	31	1	3	4	1	0
VE-2057	259	477	218	0	3	1	0	2
VE-2057	259	266	7	1	3	1	0	0
VE-2057	259	275	16	1	4	5	1	0
VE-2057	259	477	218	0	3	1	0	2
VE-2057	259	260	1	1	3	1	0	0
VE-2057	259	477	218	0	3	1	0	0
VE-2057	259	284	25	1	3	5	0	2
VE-2058	259	451	192	1	3	4	1	1
VE-2058	259	477	218	0	3	4	0	1
VE-2058	259	260	1	1	3	1	2	0
VE-2058	259	260	1	1	3	1	2	1
VE-2058	260	477	217	0	3	4	0	1
VE-2058	260	437	177	1	3	1	0	2
VE-2058	260	345	85	1	3	1	0	2
VE-2058	260	477	217	0	4	1	0	0
VE-2058	260	477	217	0	2	1	0	0
VE-2058	261	477	216	0	3	1	0	0
VE-2059	261	284	23	1	3	4	1	0
VE-2059	261	477	216	0	3	1	0	0
VE-2059	261	268	7	1	3	1	1	0
VE-2059	261	477	216	0	3	1	0	0
VE-2059	261	268	7	1	1	1	1	0
VE-2059	261	477	216	0	3	1	0	0
VE-2059	261	263	2	1	3	1	1	0
VE-2059	261	267	6	1	3	1	2	0
VE-2060	261	477	216	0	3	1	0	0
VE-2060	261	267	6	1	3	1	1	0
VE-2060	261	477	216	0	1	1	0	1
VE-2060	261	267	6	1	3	1	1	1
VE-2060	262	268	6	1	3	4	1	1
VE-2060	262	477	215	0	3	1	0	0
VE-2060	262	477	215	0	1	1	0	1
VE-2060	262	297	35	1	3	1	2	0
VE-2060	262	477	215	0	3	1	0	0
VE-2060	262	274	12	1	3	4	1	0
VE-2061	262	277	15	1	3	1	1	0
VE-2061	262	477	215	0	3	1	0	0
VE-2061	262	265	3	1	3	1	2	0
VE-2061	262	477	215	0	3	5	0	0
VE-2061	262	477	215	0	3	5	0	0
VE-2061	262	477	215	0	3	5	0	0
VE-2061	263	477	214	0	3	1	0	0
VE-2061	263	306	43	1	3	1	1	0
VE-2061	263	273	10	1	3	4	1	0
VE-2061	263	273	10	1	3	4	1	1
VE-2062	263	266	3	1	3	1	1	0
VE-2062	264	265	1	1	3	1	2	1
VE-2062	264	275	11	1	3	1	0	1
VE-2062	264	280	16	1	3	4	2	1
VE-2062	265	477	212	0	3	1	0	0
VE-2062	265	266	1	1	3	1	2	0
VE-2062	266	267	1	1	3	4	1	0
VE-2062	266	270	4	1	3	1	1	1
VE-2062	266	477	211	0	3	1	0	0
VE-2062	267	271	4	1	3	1	1	0
VE-2063	267	477	210	0	4	1	0	0
VE-2063	267	269	2	1	3	1	1	0
VE-2063	267	269	2	1	3	1	1	0
VE-2063	267	477	210	0	2	1	0	1
VE-2063	267	269	2	1	3	1	0	0
VE-2063	268	278	10	1	3	5	1	3
VE-2063	268	273	5	1	3	1	1	1
VE-2063	268	273	5	1	3	3	1	0
VE-2063	268	298	30	1	3	1	1	1
VE-2063	268	285	17	1	3	2	1	0
VE-2064	268	269	1	1	3	4	1	1
VE-2064	268	269	1	1	3	1	0	0
VE-2064	268	477	209	0	4	5	0	0
VE-2064	269	477	208	0	3	1	0	0
VE-2064	269	284	15	1	4	4	1	0
VE-2064	269	275	6	1	2	1	0	0
VE-2064	269	278	9	1	3	4	1	0
VE-2064	269	280	11	1	3	1	1	0
VE-2064	269	281	12	1	3	1	2	0
VE-2064	269	287	18	1	3	1	2	1
VE-2065	270	477	207	0	3	1	0	0
VE-2065	270	279	9	1	3	4	2	0
VE-2065	270	277	7	1	3	1	2	2
VE-2065	270	302	32	1	3	1	1	1
VE-2065	270	477	207	0	3	4	0	1
VE-2065	270	477	207	0	3	4	0	1
VE-2065	270	432	162	1	3	1	1	1
VE-2065	270	275	5	1	3	1	1	0
VE-2065	271	276	5	1	3	1	0	0
VE-2065	271	289	18	1	2	1	1	1
VE-2066	272	287	15	1	3	4	1	1
VE-2066	273	298	25	1	3	4	1	0
VE-2066	273	274	1	1	1	1	1	2
VE-2066	273	477	204	0	3	5	0	2
VE-2066	273	277	4	1	4	5	1	1
VE-2066	273	477	204	0	3	1	0	0
VE-2066	273	477	204	0	3	4	0	0
VE-2066	273	477	204	0	4	1	0	0
VE-2066	274	477	203	0	3	2	0	0
VE-2066	274	277	3	1	3	1	2	1
VE-2067	274	477	203	0	3	1	0	0
VE-2067	274	279	5	1	3	1	1	0
VE-2067	274	276	2	1	3	1	1	0
VE-2067	274	281	7	1	3	1	0	0
VE-2067	274	276	2	1	3	1	1	1
VE-2067	274	477	203	0	4	1	0	0
VE-2067	274	316	42	1	3	1	1	0
VE-2067	275	277	2	1	3	1	2	1
VE-2067	275	282	7	1	3	1	1	2
VE-2067	275	294	19	1	3	1	1	0
VE-2068	275	278	3	1	3	1	1	0
VE-2068	275	477	202	0	4	4	0	0
VE-2068	275	316	41	1	3	1	1	1
VE-2068	275	477	202	0	3	2	0	1
VE-2068	275	282	7	1	3	1	1	0
VE-2068	275	477	202	0	4	1	0	0
VE-2068	275	282	7	1	3	4	1	0
VE-2068	275	477	202	0	3	4	0	0
VE-2068	275	277	2	1	4	1	0	0
VE-2069	276	477	201	0	3	1	0	0
VE-2069	276	277	1	1	3	5	1	0
VE-2069	277	280	3	1	3	4	1	0
VE-2069	277	280	3	1	3	1	0	0
VE-2069	277	281	4	1	4	5	1	3
VE-2069	277	285	8	1	3	1	1	1
VE-2069	277	286	9	1	3	1	2	0
VE-2069	277	477	200	0	3	5	0	0
VE-2069	277	282	5	1	3	4	1	0
VE-2069	277	400	123	1	3	2	0	4
VE-2070	277	282	5	1	3	2	1	1
VE-2070	277	294	17	1	3	4	1	0
VE-2070	277	285	8	1	3	1	1	1
VE-2070	278	293	15	1	3	4	1	2
VE-2070	278	285	7	1	3	1	1	2
VE-2070	278	283	5	1	2	1	1	0
VE-2070	279	280	1	1	3	1	2	0
VE-2070	280	301	21	1	3	2	1	2
VE-2070	280	344	64	1	3	4	0	0
VE-2070	280	281	1	1	3	1	1	0
VE-2071	280	282	2	1	3	1	1	0
VE-2071	280	281	1	1	3	1	1	1
VE-2071	280	284	4	1	3	4	1	2
VE-2071	280	477	197	0	3	4	0	0
VE-2071	280	287	7	1	3	1	1	0
VE-2071	281	282	1	1	3	1	0	0
VE-2071	281	289	8	1	3	1	1	0
VE-2071	281	477	196	0	3	1	0	0
VE-2071	281	294	13	1	3	1	1	3
VE-2071	281	286	5	1	3	1	1	0
VE-2072	282	291	9	1	3	2	1	0
VE-2072	282	477	195	0	3	1	0	0
VE-2072	282	287	5	1	3	4	1	0
VE-2072	282	286	4	1	3	2	1	1
VE-2072	282	477	195	0	3	5	1	0
VE-2072	283	284	1	1	3	1	0	1
VE-2072	283	477	194	0	2	1	0	0
VE-2072	283	284	1	1	3	1	1	0
VE-2072	283	477	194	0	3	1	0	0
VE-2072	283	284	1	1	3	1	1	1
VE-2073	283	318	35	1	3	5	1	0
VE-2073	283	288	5	1	3	4	0	0
VE-2073	284	477	193	0	4	1	0	0
VE-2073	284	385	101	1	3	1	1	0
VE-2073	284	344	60	1	3	1	1	2
VE-2073	284	290	6	1	3	5	1	1
VE-2073	284	477	193	0	3	1	0	0
VE-2073	284	296	12	1	3	1	1	2
VE-2073	284	323	39	1	3	4	1	2
VE-2073	284	477	193	0	3	4	0	0
VE-2074	285	332	47	1	3	4	2	0
VE-2074	285	286	1	1	4	1	1	1
VE-2074	285	291	6	1	3	1	1	3
VE-2074	285	477	192	0	4	1	0	1
VE-2074	286	314	28	1	3	1	1	1
VE-2074	286	477	191	0	3	1	0	0
VE-2074	287	297	10	1	3	1	1	0
VE-2074	287	477	190	0	3	1	0	0
VE-2074	288	354	66	1	3	1	1	0
VE-2074	288	477	189	0	3	1	0	0
VE-2075	288	477	189	0	3	1	0	0
VE-2075	288	303	15	1	3	1	1	0
VE-2075	288	290	2	1	3	4	1	0
VE-2075	288	477	189	0	3	1	0	0
VE-2075	288	477	189	0	3	1	0	0
VE-2075	288	477	189	0	3	2	0	1
VE-2075	288	290	2	1	3	1	1	1
VE-2075	288	336	48	1	3	1	0	1
VE-2075	288	477	189	0	3	1	0	0
VE-2075	289	477	188	0	3	1	0	1
VE-2076	289	477	188	0	3	4	0	0
VE-2076	289	290	1	1	4	1	1	0
VE-2076	289	292	3	1	4	1	1	0
VE-2076	289	293	4	1	3	3	1	0
VE-2076	289	477	188	0	3	1	0	0
VE-2076	289	294	5	1	3	1	1	0
VE-2076	289	477	188	0	3	1	0	0
VE-2076	289	292	3	1	3	1	1	2
VE-2076	290	293	3	1	3	2	1	0
VE-2076	290	477	187	0	3	5	0	0
VE-2077	290	332	42	1	3	4	0	0
VE-2077	290	477	187	0	4	1	0	0
VE-2077	290	295	5	1	3	1	1	0
VE-2077	290	477	187	0	2	1	0	0
VE-2077	290	477	187	0	3	1	0	0
VE-2077	290	329	39	1	3	1	1	1
VE-2077	291	477	186	0	3	4	0	0
VE-2077	291	477	186	0	3	3	0	0
VE-2077	291	306	15	1	3	1	1	1
VE-2077	291	477	186	0	3	1	0	0
VE-2078	291	292	1	1	3	4	0	0
VE-2078	291	477	186	0	3	1	0	0
VE-2078	291	311	20	1	3	4	0	0
VE-2078	291	477	186	0	3	1	0	1
VE-2078	292	477	185	0	2	4	0	0
VE-2078	292	351	59	1	3	1	2	0
VE-2078	294	318	24	1	3	1	1	1
VE-2078	294	316	22	1	3	1	1	0
VE-2078	295	296	1	1	3	1	1	0
VE-2078	295	477	182	0	3	1	0	0
VE-2079	295	477	182	0	3	5	0	1
VE-2079	295	477	182	0	3	2	0	1
VE-2079	295	300	5	1	3	1	1	0
VE-2079	295	302	7	1	3	1	0	0
VE-2079	296	331	35	1	3	4	1	0
VE-2079	296	312	16	1	3	1	1	0
VE-2079	296	308	12	1	3	4	1	0
VE-2079	296	402	106	1	4	4	1	0
VE-2079	296	297	1	1	5	5	0	0
VE-2079	296	477	181	0	4	5	0	0
VE-2080	296	297	1	1	3	4	1	1
VE-2080	296	477	181	0	3	1	0	0
VE-2080	296	477	181	0	3	1	0	0
VE-2080	297	477	180	0	3	1	0	0
VE-2080	297	311	14	1	3	4	1	0
VE-2080	297	308	11	1	3	1	1	0
VE-2080	297	298	1	1	5	1	1	0
VE-2080	297	315	18	1	3	4	1	0
VE-2080	297	477	180	0	3	1	0	0
VE-2080	297	477	180	0	3	5	0	0
VE-2081	297	477	180	0	3	1	0	0
VE-2081	297	477	180	0	3	4	0	1
VE-2081	297	298	1	1	2	3	0	1
VE-2081	297	311	14	1	3	1	0	0
VE-2081	298	477	179	0	3	4	0	0
VE-2081	298	306	8	1	3	1	1	0
VE-2081	298	300	2	1	4	1	0	1
VE-2081	298	308	10	1	3	1	1	0
VE-2081	298	324	26	1	3	1	1	1
VE-2081	298	477	179	0	4	1	0	0
VE-2082	298	301	3	1	4	1	2	0
VE-2082	298	306	8	1	3	4	1	0
VE-2082	298	462	164	1	3	4	1	3
VE-2082	299	337	38	1	3	5	1	4
VE-2082	299	477	178	0	3	1	0	2
VE-2082	299	477	178	0	3	1	0	0
VE-2082	299	314	15	1	3	4	1	0
VE-2082	301	339	38	1	3	1	1	0
VE-2082	301	477	176	0	3	4	0	0
VE-2082	301	302	1	1	3	1	1	0
VE-2083	301	302	1	1	3	1	1	0
VE-2083	301	332	31	1	3	4	1	0
VE-2083	301	477	176	0	3	4	0	0
VE-2083	301	312	11	1	3	1	1	2
VE-2083	301	307	6	1	3	1	1	1
VE-2083	302	309	7	1	3	1	1	0
VE-2083	302	311	9	1	3	5	1	0
VE-2083	302	477	175	0	3	1	0	0
VE-2083	302	477	175	0	3	1	0	0
VE-2083	302	308	6	1	3	1	1	3
VE-2084	302	303	1	1	3	1	0	1
VE-2084	302	407	105	1	3	1	2	0
VE-2084	302	319	17	1	3	1	1	1
VE-2084	303	477	174	0	3	1	0	0
VE-2084	303	477	174	0	3	4	0	0
VE-2084	303	477	174	0	3	5	0	0
VE-2084	303	477	174	0	3	1	0	0
VE-2084	303	390	87	1	4	4	1	0
VE-2084	303	430	127	1	3	1	1	0
VE-2084	303	477	174	0	4	4	0	0
VE-2085	303	315	12	1	3	4	1	0
VE-2085	304	477	173	0	3	1	0	0
VE-2085	304	477	173	0	3	1	0	0
VE-2085	304	312	8	1	2	4	1	0
VE-2085	304	477	173	0	3	1	0	0
VE-2085	304	477	173	0	4	4	0	0
VE-2085	304	477	173	0	3	1	0	0
VE-2085	304	477	173	0	3	1	0	1
VE-2085	304	309	5	1	3	1	1	0
VE-2085	305	354	49	1	4	4	1	0
VE-2086	305	347	42	1	4	5	1	3
VE-2086	305	477	172	0	3	4	0	0
VE-2086	306	311	5	1	3	5	1	0
VE-2086	306	477	171	0	4	4	0	0
VE-2086	306	477	171	0	3	1	0	0
VE-2086	307	477	170	0	3	2	0	0
VE-2086	307	477	170	0	3	2	0	0
VE-2086	308	477	169	0	3	4	0	0
VE-2086	308	311	3	1	3	1	0	0
VE-2086	309	310	1	1	3	5	1	0
VE-2087	309	351	42	1	3	1	1	0
VE-2087	309	477	168	0	3	1	0	0
VE-2087	309	345	36	1	2	1	0	1
VE-2087	309	330	21	1	3	4	1	0
VE-2087	309	477	168	0	3	2	0	1
VE-2087	309	477	168	0	3	3	0	0
VE-2087	310	477	167	0	3	1	0	0
VE-2087	310	477	167	0	3	1	0	0
VE-2087	310	477	167	0	3	1	0	1
VE-2087	310	385	75	1	3	1	1	0
VE-2088	310	314	4	1	3	4	1	0
VE-2088	310	313	3	1	3	1	1	0
VE-2088	310	477	167	0	3	2	0	0
VE-2088	310	445	135	1	4	5	0	0
VE-2088	310	337	27	1	3	5	0	1
VE-2088	310	369	59	1	3	4	0	1
VE-2088	311	312	1	1	5	4	1	0
VE-2088	311	477	166	0	3	1	0	1
VE-2088	311	318	7	1	3	1	1	0
VE-2088	311	477	166	0	3	4	0	1
VE-2089	311	477	166	0	3	4	0	2
VE-2089	311	343	32	1	3	4	1	0
VE-2089	311	477	166	0	3	5	0	0
VE-2089	311	314	3	1	3	1	0	0
VE-2089	311	399	88	1	4	4	1	0
VE-2089	311	413	102	1	4	4	1	0
VE-2089	312	477	165	0	3	1	0	0
VE-2089	312	333	21	1	3	1	0	0
VE-2089	312	314	2	1	3	1	1	0
VE-2089	312	315	3	1	3	1	2	0
VE-2090	313	477	164	0	3	1	0	3
VE-2090	313	477	164	0	3	1	0	3
VE-2090	313	477	164	0	3	1	0	0
VE-2090	313	315	2	1	3	4	1	0
VE-2090	315	322	7	1	3	1	1	1
VE-2090	315	316	1	1	3	1	1	0
VE-2090	315	477	162	0	3	1	1	0
VE-2090	315	477	162	0	3	1	0	0
VE-2090	315	477	162	0	4	1	0	0
VE-2090	316	477	161	0	4	1	0	0
VE-2091	316	317	1	1	3	1	1	1
VE-2091	317	372	55	1	2	1	1	0
VE-2091	317	477	160	0	2	1	0	0
VE-2091	317	336	19	1	3	1	0	1
VE-2091	317	371	54	1	3	1	1	0
VE-2091	317	339	22	1	3	1	1	2
VE-2091	317	319	2	1	4	1	2	0
VE-2091	317	477	160	0	4	4	0	0
VE-2091	317	319	2	1	3	4	1	0
VE-2091	317	373	56	1	3	4	1	0
VE-2092	318	322	4	1	3	4	1	0
VE-2092	318	477	159	0	3	1	0	0
VE-2092	318	477	159	0	3	1	0	0
VE-2092	318	319	1	1	3	1	0	0
VE-2092	318	324	6	1	3	1	1	0
VE-2092	318	394	76	1	4	1	0	0
VE-2092	318	319	1	1	3	1	1	0
VE-2092	319	477	158	0	3	1	0	0
VE-2092	319	477	158	0	5	1	0	0
VE-2092	319	477	158	0	3	1	0	0
VE-2093	319	330	11	1	3	1	1	0
VE-2093	319	323	4	1	3	4	0	0
VE-2093	319	330	11	1	3	4	1	0
VE-2093	319	321	2	1	3	5	0	1
VE-2093	319	477	158	0	3	5	0	2
VE-2093	319	323	4	1	3	1	1	0
VE-2093	320	355	35	1	3	4	1	1
VE-2093	320	322	2	1	3	1	1	0
VE-2093	322	477	155	0	3	1	0	0
VE-2093	322	477	155	0	1	1	0	0
VE-2094	322	326	4	1	3	1	1	0
VE-2094	322	347	25	1	3	1	1	1
VE-2094	322	340	18	1	3	5	1	0
VE-2094	323	352	29	1	3	5	1	1
VE-2094	323	324	1	1	3	1	1	0
VE-2094	323	477	154	0	4	1	1	0
VE-2094	323	477	154	0	5	4	0	0
VE-2094	323	477	154	0	3	2	0	0
VE-2094	323	477	154	0	3	1	0	1
VE-2094	323	324	1	1	3	1	1	0
VE-2095	323	477	154	0	3	4	0	0
VE-2095	323	332	9	1	3	1	1	0
VE-2095	323	336	13	1	3	4	0	0
VE-2095	324	336	12	1	3	1	1	0
VE-2095	324	330	6	1	3	4	1	0
VE-2095	324	343	19	1	3	1	0	2
VE-2095	324	477	153	0	3	2	0	0
VE-2095	324	477	153	0	3	4	0	2
VE-2095	324	477	153	0	4	4	0	0
VE-2095	324	477	153	0	3	1	0	1
VE-2096	324	375	51	1	3	5	1	1
VE-2096	325	345	20	1	3	4	1	0
VE-2096	325	477	152	0	3	1	0	0
VE-2096	325	477	152	0	3	1	0	0
VE-2096	325	326	1	1	3	5	1	0
VE-2096	326	462	136	1	3	1	0	1
VE-2096	328	343	15	1	3	5	0	1
VE-2096	328	477	149	0	4	5	0	0
VE-2096	328	477	149	0	3	5	0	0
VE-2096	329	330	1	1	3	1	1	0
VE-2097	329	477	148	0	4	1	0	0
VE-2097	329	330	1	1	3	1	1	0
VE-2097	330	477	147	0	3	5	0	2
VE-2097	330	477	147	0	3	1	0	0
VE-2097	330	477	147	0	5	4	0	0
VE-2097	330	332	2	1	1	1	1	0
VE-2097	330	332	2	1	3	1	1	0
VE-2097	330	477	147	0	4	4	1	1
VE-2097	331	332	1	1	3	1	1	0
VE-2097	331	343	12	1	2	1	2	1
VE-2098	331	414	83	1	3	5	0	0
VE-2098	331	332	1	1	3	1	1	0
VE-2098	332	336	4	1	3	5	0	0
VE-2098	332	477	145	0	3	1	0	0
VE-2098	332	477	145	0	3	1	0	0
VE-2098	332	339	7	1	3	1	1	0
VE-2098	332	367	35	1	3	4	0	1
VE-2098	333	336	3	1	3	5	0	0
VE-2098	333	340	7	1	3	1	1	0
VE-2098	333	354	21	1	3	1	1	0
VE-2099	333	477	144	0	3	1	0	0
VE-2099	333	350	17	1	4	4	1	1
VE-2099	334	352	18	1	4	3	0	0
VE-2099	336	477	141	0	3	4	1	0
VE-2099	336	337	1	1	3	5	0	0
VE-2099	336	477	141	0	3	4	0	0
VE-2099	336	477	141	0	3	5	0	0
VE-2099	337	345	8	1	3	5	1	0
VE-2099	337	477	140	0	3	1	0	0
VE-2100	337	477	140	0	3	4	0	2
VE-2100	337	453	116	1	3	4	1	1
VE-2100	337	477	140	0	3	1	0	1
VE-2100	337	414	77	1	3	5	0	0
VE-2100	337	338	1	1	3	4	1	0
VE-2100	338	344	6	1	3	1	1	0
VE-2100	338	339	1	1	3	4	1	0
VE-2100	338	343	5	1	3	1	1	0
VE-2100	338	477	139	0	3	1	0	0
VE-2100	338	401	63	1	3	1	1	0
VE-2101	338	477	139	0	3	4	0	0
VE-2101	338	477	139	0	3	1	0	1
VE-2101	339	340	1	1	3	1	1	0
VE-2101	339	477	138	0	3	4	0	0
VE-2101	339	344	5	1	3	1	1	0
VE-2101	340	477	137	0	3	1	0	0
VE-2101	340	346	6	1	3	1	0	0
VE-2101	340	343	3	1	3	1	1	1
VE-2101	340	341	1	1	3	1	0	2
VE-2102	341	347	6	1	3	5	1	0
VE-2102	341	347	6	1	3	4	1	0
VE-2102	343	346	3	1	3	1	1	0
VE-2102	343	347	4	1	3	1	0	0
VE-2102	343	477	134	0	4	4	0	0
VE-2102	343	477	134	0	3	1	0	0
VE-2102	343	344	1	1	3	1	0	2
VE-2102	343	477	134	0	3	4	0	0
VE-2102	344	347	3	1	3	1	2	0
VE-2102	344	395	51	1	2	1	1	1
VE-2103	344	477	133	0	3	1	0	0
VE-2103	344	477	133	0	3	1	0	0
VE-2103	345	353	8	1	4	4	1	0
VE-2103	345	368	23	1	3	1	1	1
VE-2103	345	455	110	1	3	4	1	0
VE-2103	345	347	2	1	3	1	1	0
VE-2103	345	374	29	1	3	1	1	2
VE-2103	346	477	131	0	3	4	0	1
VE-2103	346	408	62	1	4	1	1	0
VE-2103	346	354	8	1	3	1	3	0
VE-2104	346	366	20	1	3	4	3	0
VE-2104	347	351	4	1	2	1	2	1
VE-2104	347	477	130	0	3	1	0	0
VE-2104	347	351	4	1	3	5	1	0
VE-2104	347	399	52	1	4	2	2	0
VE-2104	347	395	48	1	4	4	2	0
VE-2104	347	477	130	0	3	4	0	1
VE-2104	349	477	128	0	3	4	0	0
VE-2104	349	449	100	1	3	1	1	0
VE-2104	350	477	127	0	4	4	1	0
VE-2105	350	477	127	0	3	4	0	4
VE-2105	350	351	1	1	3	2	0	0
VE-2105	350	477	127	0	2	1	0	3
VE-2105	351	477	126	0	3	4	0	0
VE-2105	351	477	126	0	3	1	0	0
VE-2105	351	414	63	1	3	1	0	0
VE-2105	351	477	126	0	3	4	0	1
VE-2105	352	477	125	0	3	4	0	0
VE-2105	352	353	1	1	3	2	1	0
VE-2105	353	477	124	0	2	2	0	2
VE-2106	353	477	124	0	3	2	0	1
VE-2106	353	477	124	0	3	1	0	0
VE-2106	353	477	124	0	3	1	0	0
VE-2106	354	403	49	1	3	3	0	0
VE-2106	354	477	123	0	3	1	0	0
VE-2106	356	366	10	1	3	4	1	1
VE-2106	357	387	30	1	3	1	0	0
VE-2106	358	477	119	0	4	1	0	0
VE-2106	359	477	118	0	3	1	0	0
VE-2106	359	477	118	0	3	1	0	3
VE-2107	359	477	118	0	3	1	1	0
VE-2107	360	407	47	1	3	4	1	1
VE-2107	360	477	117	0	3	1	0	1
VE-2107	360	371	11	1	5	4	1	0
VE-2107	361	362	1	1	4	1	1	1
VE-2107	361	477	116	0	3	1	0	1
VE-2107	361	477	116	0	3	1	0	0
VE-2107	361	386	25	1	3	4	2	0
VEMALL-16	3	477	474	0	3	1	1	0
VEMALL-16	10	477	467	0	4	5	1	0
VEMALL-16	21	24	3	1	1	4	1	1
VEMALL-16	29	477	448	0	4	5	0	0
VEMALL-16	36	477	441	0	4	4	0	0
VEMALL-17	36	477	441	0	4	3	0	0
VEMALL-17	37	477	440	0	3	5	1	1
VEMALL-17	37	38	1	1	4	4	1	1
VEMALL-17	50	372	322	1	3	5	1	1
VEMALL-17	65	71	6	1	4	3	1	1
VEMALL-17	71	477	406	0	3	5	1	0
VEMALL-17	72	477	405	0	4	5	1	0
VEMALL-17	73	477	404	0	4	5	1	0
VEMALL-17	73	477	404	0	3	4	1	1
VEMALL-17	73	86	13	1	1	4	1	1
VEMALL-18	86	91	5	1	3	4	1	1
VEMALL-18	87	477	390	0	3	4	0	0
VEMALL-18	87	477	390	0	3	5	0	0
VEMALL-18	87	477	390	0	3	5	0	0
VEMALL-18	93	477	384	0	3	5	0	0
VEMALL-18	93	477	384	0	3	5	0	0
VEMALL-18	93	477	384	0	4	5	1	0
VEMALL-18	95	477	382	0	4	5	1	0
VEMALL-18	99	100	1	1	3	1	1	0
VEMALL-18	102	105	3	1	3	5	1	0
VEMALL-19	102	103	1	1	3	1	1	0
VEMALL-19	105	114	9	1	3	4	1	0
VEMALL-19	107	108	1	1	3	4	1	0
VEMALL-19	107	114	7	1	4	4	1	0
VEMALL-19	108	477	369	0	4	4	1	1
VEMALL-19	108	372	264	1	3	5	1	1
VEMALL-19	108	305	197	1	3	5	1	0
VEMALL-19	109	110	1	1	3	3	1	1
VEMALL-19	109	477	368	0	3	1	0	0
VEMALL-19	112	477	365	0	3	5	1	1
VEMALL-20	113	477	364	0	4	4	1	0
VEMALL-20	135	234	99	1	3	4	1	0
VEMALL-20	141	477	336	0	3	2	0	0
VEMALL-20	143	161	18	1	3	4	1	1
VEMALL-20	143	477	334	0	3	5	1	0
VEMALL-20	155	477	322	0	4	5	1	0
VEMALL-20	156	477	321	0	4	5	1	1
VEMALL-20	171	172	1	1	3	3	1	0
VEMALL-20	177	246	69	1	4	1	1	0
VEMALL-20	197	198	1	1	5	3	0	0
VEMALL-21	214	217	3	1	2	1	1	1
VEMALL-21	235	236	1	1	3	1	1	0
VEMALL-21	235	318	83	1	4	4	1	0
VEMALL-21	239	477	238	0	4	5	1	0
VEMALL-21	240	359	119	1	4	3	1	0
VEMALL-21	240	243	3	1	5	4	1	0
VEMALL-21	245	246	1	1	4	1	1	0
VEMALL-21	246	248	2	1	4	5	1	0
VEMALL-21	249	250	1	1	4	1	1	2
VEMALL-21	259	260	1	1	3	1	1	2
VEMALL-22	290	477	187	0	3	2	0	0
VEMALL-22	294	477	183	0	4	3	0	0
VEMALL-22	296	297	1	1	4	4	1	0
VEMALL-22	311	316	5	1	4	4	1	0
VEMALL-22	317	477	160	0	3	4	0	0
VEMALL-22	317	477	160	0	5	4	0	0
VEMALL-22	318	477	159	0	4	4	1	0
VEMALL-22	318	319	1	1	3	3	1	0
VEMALL-22	318	477	159	0	4	5	1	0
VEMALL-22	318	323	5	1	2	3	1	0
VEMALL-23	339	359	20	1	4	4	1	1
RACE-40	7	477	470	0	4	4	0	1
RACE-40	7	477	470	0	4	4	0	1
TPASYNC-13	1	2	1	1	3	1	0	0
TPASYNC-13	51	52	1	1	1	1	0	0
TPASYNC-13	64	70	6	1	5	1	1	0
TPASYNC-13	78	79	1	1	3	1	1	1
TPASYNC-13	93	94	1	1	3	1	0	0
TPASYNC-13	137	138	1	1	3	4	1	0
TPASYNC-13	192	193	1	1	3	1	0	0
TPASYNC-14	200	203	3	1	3	1	0	0
TPASYNC-14	211	212	1	1	3	4	0	0
TPASYNC-14	228	230	2	1	3	1	0	0
TPASYNC-14	276	277	1	1	3	1	0	0
TPASYNC-14	360	372	12	1	3	1	0	0
TPASYNC-14	360	361	1	1	3	1	1	0
TPCLIENT-189	8	10	2	1	3	1	0	0
TPCLIENT-189	17	477	460	0	3	1	0	0
TPCLIENT-189	21	30	9	1	3	1	0	0
TPCLIENT-189	22	23	1	1	5	1	1	0
TPCLIENT-189	22	23	1	1	3	1	0	1
TPCLIENT-190	24	26	2	1	4	1	2	0
TPCLIENT-190	31	34	3	1	3	1	0	0
TPCLIENT-190	37	38	1	1	4	4	1	0
TPCLIENT-190	38	39	1	1	4	1	0	1
TPCLIENT-190	43	44	1	1	3	1	0	1
TPCLIENT-190	52	56	4	1	4	1	2	1
TPCLIENT-190	59	63	4	1	4	1	0	0
TPCLIENT-190	64	65	1	1	4	4	0	0
TPCLIENT-190	66	67	1	1	3	1	1	1
TPCLIENT-191	72	73	1	1	3	1	0	0
TPCLIENT-191	78	458	380	1	3	1	0	1
TPCLIENT-191	93	477	384	0	3	4	1	0
TPCLIENT-191	98	99	1	1	1	1	0	0
TPCLIENT-191	99	101	2	1	4	1	2	0
TPCLIENT-191	105	106	1	1	3	1	0	0
TPCLIENT-191	109	422	313	1	5	2	0	0
TPCLIENT-191	114	115	1	1	3	1	0	0
TPCLIENT-191	114	120	6	1	3	1	0	0
TPCLIENT-191	115	477	362	0	4	1	0	0
TPCLIENT-192	118	477	359	0	3	1	0	0
TPCLIENT-192	121	122	1	1	1	1	0	0
TPCLIENT-192	129	130	1	1	4	1	0	0
TPCLIENT-192	129	130	1	1	4	1	1	0
TPCLIENT-192	161	167	6	1	3	1	2	0
TPCLIENT-192	170	174	4	1	3	1	0	0
TPCLIENT-192	178	182	4	1	3	1	0	0
TPCLIENT-192	186	189	3	1	4	1	2	0
TPCLIENT-192	188	192	4	1	3	4	1	0
TPCLIENT-192	188	189	1	1	4	1	1	0
TPCLIENT-193	189	190	1	1	4	1	0	0
TPCLIENT-193	193	194	1	1	3	4	1	1
TPCLIENT-193	193	194	1	1	3	4	1	1
TPCLIENT-193	195	196	1	1	4	1	1	0
TPCLIENT-193	197	198	1	1	3	1	1	0
TPCLIENT-193	212	214	2	1	3	1	0	0
TPCLIENT-193	214	477	263	0	3	1	0	0
TPCLIENT-193	216	218	2	1	3	2	0	0
TPCLIENT-193	216	477	261	0	3	1	0	1
TPCLIENT-193	219	224	5	1	3	4	2	0
TPCLIENT-194	222	223	1	1	3	1	1	0
TPCLIENT-194	222	223	1	1	3	4	0	0
TPCLIENT-194	228	270	42	1	3	5	1	0
TPCLIENT-194	228	229	1	1	3	4	0	0
TPCLIENT-194	228	242	14	1	3	1	1	0
TPCLIENT-194	277	279	2	1	5	4	2	0
TPCLIENT-194	287	293	6	1	3	1	1	0
TPCLIENT-194	294	295	1	1	3	4	1	0
TPCLIENT-194	300	302	2	1	3	1	0	0
TPCLIENT-194	301	302	1	1	2	1	0	1
TPCLIENT-195	323	324	1	1	4	1	0	0
TPCLIENT-195	329	330	1	1	3	2	0	1
TPCLIENT-195	338	356	18	1	4	4	2	0
TPCLIENT-195	338	477	139	0	3	1	1	0
TPCLIENT-195	343	349	6	1	3	1	0	0
TPCLIENT-195	345	349	4	1	4	1	2	0
TPCLIENT-195	348	351	3	1	3	1	1	0
TPCORE-50	5	6	1	1	3	2	1	1
TPCORE-50	5	6	1	1	3	2	1	1
TPCORE-50	5	6	1	1	3	4	1	0
TPCORE-50	5	9	4	1	3	4	1	1
TPCORE-50	10	11	1	1	3	4	1	1
TPCORE-50	10	11	1	1	3	4	1	1
TPCORE-50	32	33	1	1	3	1	2	0
TPCORE-50	35	39	4	1	3	4	2	0
TPCORE-51	36	37	1	1	3	4	2	0
TPCORE-51	36	37	1	1	3	4	2	0
TPCORE-51	38	39	1	1	3	1	0	0
TPCORE-51	39	43	4	1	2	1	2	0
TPCORE-51	54	55	1	1	3	1	2	0
TPCORE-51	57	58	1	1	3	4	1	0
TPCORE-51	58	60	2	1	3	3	0	0
TPCORE-51	63	67	4	1	3	4	2	0
TPCORE-51	74	407	333	1	4	4	0	0
TPCORE-51	77	101	24	1	3	1	2	2
TPCORE-52	79	80	1	1	4	4	1	1
TPCORE-52	97	100	3	1	3	1	0	0
TPCORE-52	112	113	1	1	3	1	0	1
TPCORE-52	113	114	1	1	4	4	1	1
TPCORE-52	115	129	14	1	4	1	1	0
TPCORE-52	115	407	292	1	3	4	0	0
TPCORE-52	115	127	12	1	3	1	0	0
TPCORE-52	141	142	1	1	3	4	1	0
TPCORE-52	171	176	5	1	3	1	2	0
TPCORE-52	183	190	7	1	3	1	0	0
TPCORE-53	186	200	14	1	3	1	0	0
TPCORE-53	190	191	1	1	3	4	0	0
TPCORE-53	190	191	1	1	4	1	1	0
TPCORE-53	190	407	217	1	3	1	0	0
TPCORE-53	192	193	1	1	2	4	1	0
TPCORE-53	192	217	25	1	3	4	1	0
TPCORE-53	192	193	1	1	3	4	1	0
TPCORE-53	195	196	1	1	5	1	1	0
TPCORE-53	202	203	1	1	2	4	1	0
TPCORE-54	203	204	1	1	3	1	1	0
TPCORE-54	204	205	1	1	3	1	1	0
TPCORE-54	204	205	1	1	3	1	1	0
TPCORE-54	206	477	271	0	3	4	0	0
TPCORE-54	206	207	1	1	3	2	1	0
TPCORE-54	206	207	1	1	3	2	1	0
TPCORE-54	206	207	1	1	3	2	1	0
TPCORE-54	206	207	1	1	3	2	1	0
TPCORE-54	210	211	1	1	3	2	1	0
TPCORE-54	216	218	2	1	3	2	0	0
TPCORE-55	225	226	1	1	3	4	2	0
TPCORE-55	246	251	5	1	3	3	1	0
TPCORE-55	250	251	1	1	4	4	1	2
TPCORE-55	250	251	1	1	4	4	1	2
TPCORE-55	250	251	1	1	4	4	1	3
TPCORE-55	250	251	1	1	4	4	1	2
TPCORE-55	250	251	1	1	4	4	1	1
TPCORE-55	250	251	1	1	4	4	1	1
TPCORE-55	250	251	1	1	4	4	1	1
TPCORE-55	283	284	1	1	3	1	1	0
TPCORE-56	295	296	1	1	3	1	1	0
TPCORE-56	301	302	1	1	3	1	0	0
TPCORE-56	307	308	1	1	3	1	2	0
TPCORE-56	330	342	12	1	3	2	1	1
TPCORE-56	338	344	6	1	3	1	1	0
TPCORE-56	362	366	4	1	3	1	1	0
PA-11	55	477	422	0	3	1	0	0
NITE-1000	297	477	180	0	3	3	1	1
NITE-1000	297	477	180	0	3	3	1	0
NITE-1000	297	330	33	1	3	5	1	1
NITE-1000	297	357	60	1	5	3	2	1
NITE-1000	297	301	4	1	3	1	1	0
NITE-1000	297	477	180	0	3	3	0	1
NITE-1000	297	477	180	0	3	4	0	0
NITE-1000	297	303	6	1	3	1	1	0
NITE-1000	297	477	180	0	3	1	0	1
NITE-1000	297	318	21	1	3	1	1	1
NITE-1001	297	477	180	0	1	1	1	0
NITE-1001	297	477	180	0	3	1	1	0
NITE-1001	297	324	27	1	3	3	1	0
NITE-1001	297	301	4	1	2	1	1	1
NITE-1001	298	477	179	0	4	3	1	0
NITE-1001	298	477	179	0	2	1	1	0
NITE-1001	298	299	1	1	3	1	1	0
NITE-1001	298	333	35	1	2	1	1	0
NITE-1001	298	317	19	1	3	3	1	1
NITE-1001	298	477	179	0	3	3	1	1
NITE-1002	298	299	1	1	3	1	1	0
NITE-1002	298	477	179	0	3	1	0	1
NITE-1002	298	301	3	1	4	1	1	0
NITE-1002	298	302	4	1	3	4	1	0
NITE-1002	298	301	3	1	3	1	1	0
NITE-1002	298	477	179	0	3	2	1	1
NITE-1002	298	299	1	1	3	1	1	1
NITE-1002	298	401	103	1	3	1	1	0
NITE-1002	298	303	5	1	3	1	1	0
NITE-1002	298	477	179	0	3	1	1	0
NITE-1003	298	301	3	1	4	3	0	1
NITE-1003	299	301	2	1	3	4	1	1
NITE-1003	299	477	178	0	3	4	1	0
NITE-1003	299	301	2	1	4	3	1	0
NITE-1003	300	477	177	0	2	1	1	0
NITE-1003	300	477	177	0	4	2	1	0
NITE-1003	301	303	2	1	3	1	1	0
NITE-1003	301	306	5	1	3	4	1	3
NITE-1003	301	477	176	0	4	4	0	0
NITE-1003	301	477	176	0	3	1	1	0
NITE-1004	301	477	176	0	3	4	1	0
NITE-1004	301	477	176	0	3	1	0	0
NITE-1004	301	302	1	1	1	1	1	0
NITE-1004	301	323	22	1	3	1	1	1
NITE-1004	301	477	176	0	3	1	0	0
NITE-1004	301	304	3	1	3	4	1	0
NITE-1004	301	302	1	1	3	1	0	0
NITE-1004	301	325	24	1	3	1	1	1
NITE-1004	301	477	176	0	3	4	1	0
NITE-1004	301	338	37	1	3	5	1	0
NITE-1005	301	333	32	1	3	5	1	0
NITE-1005	301	477	176	0	3	3	1	0
NITE-1005	301	316	15	1	1	1	1	1
NITE-1005	301	315	14	1	3	1	1	0
NITE-1005	301	384	83	1	2	1	0	0
NITE-1005	301	302	1	1	3	3	1	0
NITE-1005	301	302	1	1	2	1	0	0
NITE-1005	302	477	175	0	3	1	0	0
NITE-1005	302	477	175	0	3	1	1	1
NITE-1005	302	477	175	0	3	1	0	0
NITE-1006	302	303	1	1	3	5	0	0
NITE-1006	302	477	175	0	3	4	1	0
NITE-1006	302	306	4	1	4	1	1	0
NITE-1006	302	396	94	1	3	1	1	1
NITE-1006	302	304	2	1	2	1	1	0
NITE-1006	302	477	175	0	2	1	1	0
NITE-1006	302	477	175	0	3	1	1	1
NITE-1006	302	477	175	0	3	1	0	0
NITE-1006	302	477	175	0	3	3	0	1
NITE-1006	302	464	162	1	3	1	1	1
NITE-1007	302	477	175	0	4	4	0	0
NITE-1007	302	336	34	1	2	3	0	0
NITE-1007	302	477	175	0	3	1	0	0
NITE-1007	302	477	175	0	3	4	0	0
NITE-1007	302	477	175	0	3	4	0	0
NITE-1007	302	477	175	0	3	4	0	0
NITE-1007	303	375	72	1	3	4	1	0
NITE-1007	303	477	174	0	3	4	0	0
NITE-1007	303	477	174	0	3	1	1	1
NITE-1007	303	332	29	1	3	1	1	0
NITE-1008	303	331	28	1	3	4	1	0
NITE-1008	303	477	174	0	3	4	0	0
NITE-1008	303	477	174	0	3	1	1	1
NITE-1008	303	477	174	0	3	4	0	0
NITE-1008	303	305	2	1	3	4	1	1
NITE-1008	303	315	12	1	4	4	1	0
NITE-1008	303	477	174	0	3	3	0	1
NITE-1008	303	389	86	1	3	1	1	2
NITE-1008	303	477	174	0	4	1	1	0
NITE-1008	303	477	174	0	3	4	0	0
NITE-1009	303	477	174	0	4	3	1	0
NITE-1009	303	304	1	1	4	3	0	0
NITE-1009	303	316	13	1	3	1	0	0
NITE-1009	303	477	174	0	3	3	0	2
NITE-1009	303	477	174	0	3	3	0	2
NITE-1009	303	477	174	0	3	3	0	1
NITE-1009	303	477	174	0	3	3	0	1
NITE-1009	303	477	174	0	3	3	0	1
NITE-1009	303	322	19	1	3	3	1	0
NITE-1009	303	304	1	1	4	1	1	1
NITE-1010	303	477	174	0	3	4	0	0
NITE-1010	304	315	11	1	3	1	1	0
NITE-1010	304	396	92	1	3	1	0	0
NITE-1010	304	309	5	1	3	1	1	0
NITE-1010	304	456	152	1	3	1	1	0
NITE-1010	304	311	7	1	3	3	1	0
NITE-1010	304	330	26	1	3	4	1	1
NITE-1010	304	309	5	1	3	4	1	1
NITE-1010	304	332	28	1	3	1	1	0
NITE-1010	304	308	4	1	3	1	1	0
NITE-1011	304	305	1	1	3	1	0	4
NITE-1011	304	477	173	0	3	1	0	0
NITE-1011	304	477	173	0	3	4	1	0
NITE-1011	304	477	173	0	3	1	1	0
NITE-1011	304	477	173	0	3	1	0	0
NITE-1011	304	309	5	1	3	4	1	0
NITE-1011	304	380	76	1	3	3	1	1
NITE-1011	304	317	13	1	3	1	1	0
NITE-1011	304	406	102	1	3	1	0	2
NITE-1011	305	306	1	1	3	3	1	0
NITE-1012	305	306	1	1	3	3	0	0
NITE-1012	305	477	172	0	3	1	0	0
NITE-1012	305	477	172	0	3	4	1	0
NITE-1012	305	306	1	1	3	5	1	0
NITE-1012	305	477	172	0	4	3	0	0
NITE-1012	305	306	1	1	4	5	0	0
NITE-1012	305	309	4	1	5	5	1	0
NITE-1012	305	312	7	1	3	4	1	0
NITE-1012	305	308	3	1	4	1	1	0
NITE-1013	305	357	52	1	3	4	1	2
NITE-1013	305	477	172	0	3	1	0	0
NITE-1013	305	306	1	1	3	3	0	0
NITE-1013	305	310	5	1	3	4	1	0
NITE-1013	305	316	11	1	2	1	1	0
NITE-1013	305	340	35	1	3	4	1	0
NITE-1013	305	477	172	0	2	1	1	0
NITE-1013	305	313	8	1	4	5	0	0
NITE-1013	306	450	144	1	4	1	1	0
NITE-1013	307	477	170	0	1	1	0	0
NITE-1014	309	310	1	1	3	1	0	0
NITE-1014	309	316	7	1	3	4	1	0
NITE-1014	309	322	13	1	3	4	1	0
NITE-1014	309	477	168	0	3	1	0	0
NITE-1014	309	477	168	0	4	4	1	1
NITE-1014	309	458	149	1	5	2	1	1
NITE-1014	309	313	4	1	4	3	0	0
NITE-1014	309	311	2	1	2	1	1	0
NITE-1014	309	477	168	0	3	1	0	0
NITE-1014	309	310	1	1	3	1	1	0
NITE-1015	309	345	36	1	3	1	1	0
NITE-1015	309	312	3	1	3	4	1	0
NITE-1015	309	477	168	0	3	2	0	0
NITE-1015	310	315	5	1	3	3	0	0
NITE-1015	310	317	7	1	3	3	1	0
NITE-1015	310	322	12	1	3	4	0	0
NITE-1015	310	319	9	1	3	1	1	0
NITE-1015	310	311	1	1	3	4	0	0
NITE-1015	310	330	20	1	3	1	1	2
NITE-1015	310	323	13	1	3	1	1	1
NITE-1016	310	394	84	1	3	3	1	0
NITE-1016	310	442	132	1	3	3	1	1
NITE-1016	310	323	13	1	3	1	1	1
NITE-1016	310	409	99	1	3	3	0	0
NITE-1016	310	477	167	0	3	3	0	0
NITE-1016	310	477	167	0	3	3	0	0
NITE-1016	310	477	167	0	3	3	0	0
NITE-1016	310	343	33	1	3	1	1	0
NITE-1016	310	312	2	1	3	3	0	0
NITE-1016	310	313	3	1	4	5	0	0
NITE-1017	310	477	167	0	3	1	1	0
NITE-1017	310	316	6	1	3	1	1	0
NITE-1017	310	333	23	1	3	4	1	2
NITE-1017	310	388	78	1	3	3	1	3
NITE-1017	310	325	15	1	3	5	1	4
NITE-1017	310	344	34	1	3	5	1	4
NITE-1017	310	347	37	1	3	5	1	3
NITE-1017	310	355	45	1	3	5	1	4
NITE-1017	310	389	79	1	3	5	1	2
NITE-1017	310	395	85	1	3	5	1	4
NITE-1018	310	380	70	1	3	5	0	2
NITE-1018	311	313	2	1	4	3	0	0
NITE-1018	311	477	166	0	4	4	0	0
NITE-1018	311	395	84	1	3	1	1	0
NITE-1018	311	329	18	1	5	5	1	1
NITE-1018	311	387	76	1	3	1	1	1
NITE-1018	311	477	166	0	3	4	0	0
NITE-1018	311	477	166	0	3	1	0	0
NITE-1018	311	315	4	1	3	5	1	0
NITE-1018	311	345	34	1	2	1	1	0
NITE-1019	311	313	2	1	3	1	0	0
NITE-1019	311	325	14	1	3	1	1	0
NITE-1019	311	322	11	1	3	1	1	0
NITE-1019	311	330	19	1	3	1	1	0
NITE-1019	311	325	14	1	3	4	1	0
NITE-1019	311	330	19	1	3	4	1	2
NITE-1019	311	315	4	1	3	1	1	0
NITE-1019	311	322	11	1	3	1	1	0
NITE-1019	311	477	166	0	3	1	1	1
NITE-1019	311	477	166	0	3	1	0	0
NITE-1020	311	333	22	1	3	1	1	2
NITE-1020	312	477	165	0	3	2	1	1
NITE-1020	312	316	4	1	3	5	1	0
NITE-1020	312	340	28	1	3	3	0	0
NITE-1020	312	316	4	1	3	4	0	1
NITE-1020	312	375	63	1	3	4	1	2
NITE-1020	312	420	108	1	4	4	1	1
NITE-1020	312	318	6	1	2	1	1	0
NITE-1020	312	477	165	0	3	3	0	4
NITE-1020	312	314	2	1	3	1	1	3
NITE-1021	312	315	3	1	3	1	0	0
NITE-1021	313	314	1	1	3	3	0	1
NITE-1021	314	477	163	0	3	4	1	0
NITE-1021	315	477	162	0	3	2	0	0
NITE-1021	315	452	137	1	3	1	1	0
NITE-1021	315	354	39	1	4	3	0	0
NITE-1021	315	326	11	1	4	3	1	0
NITE-1021	315	323	8	1	3	3	1	1
NITE-1021	315	477	162	0	3	1	1	0
NITE-1021	315	402	87	1	3	1	1	1
NITE-1022	315	316	1	1	3	4	1	0
NITE-1022	315	316	1	1	3	4	1	0
NITE-1022	315	477	162	0	3	2	1	1
NITE-1022	315	477	162	0	4	1	0	0
NITE-1022	315	477	162	0	3	1	0	0
NITE-1022	315	353	38	1	3	1	1	0
NITE-1022	315	324	9	1	3	1	1	0
NITE-1022	315	316	1	1	4	3	1	1
NITE-1022	315	317	2	1	3	1	1	2
NITE-1022	316	323	7	1	3	1	1	0
NITE-1023	316	339	23	1	3	3	1	0
NITE-1023	316	317	1	1	3	3	1	1
NITE-1023	316	477	161	0	4	4	0	0
NITE-1023	316	319	3	1	3	1	1	0
NITE-1023	316	324	8	1	3	5	1	1
NITE-1023	316	317	1	1	2	1	1	0
NITE-1023	316	333	17	1	3	5	1	0
NITE-1023	316	317	1	1	3	5	1	0
NITE-1023	316	357	41	1	2	1	1	0
NITE-1023	316	350	34	1	3	4	1	0
NITE-1024	316	477	161	0	3	4	0	0
NITE-1024	316	399	83	1	3	1	1	2
NITE-1024	316	339	23	1	3	1	1	1
NITE-1024	316	319	3	1	3	3	0	0
NITE-1024	317	477	160	0	2	1	0	1
NITE-1024	317	477	160	0	3	3	0	0
NITE-1024	317	318	1	1	3	1	1	0
NITE-1024	317	477	160	0	3	1	0	0
NITE-1024	317	422	105	1	3	4	1	0
NITE-1024	317	477	160	0	3	1	0	2
NITE-1025	317	429	112	1	3	1	1	0
NITE-1025	317	477	160	0	3	4	1	1
NITE-1025	317	477	160	0	3	1	1	0
NITE-1025	317	318	1	1	3	3	1	1
NITE-1025	317	375	58	1	3	1	1	2
NITE-1025	317	477	160	0	3	4	1	0
NITE-1025	317	477	160	0	3	4	1	0
NITE-1025	317	351	34	1	3	2	1	2
NITE-1025	317	477	160	0	3	4	1	0
NITE-1025	317	477	160	0	3	1	0	1
NITE-1026	317	324	7	1	3	1	1	1
NITE-1026	317	434	117	1	2	1	1	0
NITE-1026	317	352	35	1	3	1	1	1
NITE-1026	317	343	26	1	4	1	1	0
NITE-1026	317	352	35	1	2	1	1	3
NITE-1026	318	477	159	0	4	5	0	0
NITE-1026	318	477	159	0	3	1	0	0
NITE-1026	318	477	159	0	3	3	1	1
NITE-1026	318	477	159	0	3	3	1	1
NITE-1026	318	477	159	0	3	1	1	1
NITE-1027	318	477	159	0	3	3	1	1
NITE-1027	318	477	159	0	3	3	0	1
NITE-1027	318	337	19	1	3	4	1	1
NITE-1027	318	319	1	1	3	1	1	0
NITE-1027	318	477	159	0	3	1	0	2
NITE-1027	318	329	11	1	3	3	0	0
NITE-1027	318	477	159	0	4	3	1	0
NITE-1027	318	336	18	1	3	4	1	0
NITE-1027	318	320	2	1	1	1	1	1
NITE-1027	318	357	39	1	3	4	1	2
NITE-1028	318	333	15	1	4	4	1	0
NITE-1028	318	477	159	0	3	4	1	0
NITE-1028	318	477	159	0	3	1	1	0
NITE-1028	318	477	159	0	3	1	1	0
NITE-1028	318	477	159	0	3	1	0	0
NITE-1028	318	322	4	1	2	1	1	0
NITE-1028	318	477	159	0	3	2	1	4
NITE-1028	318	333	15	1	3	2	1	3
NITE-1028	318	477	159	0	3	2	1	1
NITE-1028	318	351	33	1	3	2	1	1
NITE-1029	318	369	51	1	3	1	1	1
NITE-1029	319	336	17	1	2	1	1	0
NITE-1029	319	477	158	0	3	4	1	2
NITE-1029	319	320	1	1	3	3	1	0
NITE-1029	319	320	1	1	3	3	1	0
NITE-1029	319	320	1	1	3	4	1	0
NITE-1029	319	477	158	0	3	4	1	0
NITE-1029	319	477	158	0	3	4	1	0
NITE-1029	319	331	12	1	2	1	1	0
NITE-1029	319	477	158	0	3	3	1	0
NITE-1030	319	344	25	1	3	1	1	0
NITE-1030	319	332	13	1	1	1	1	0
NITE-1030	319	434	115	1	3	4	0	0
NITE-1030	319	320	1	1	3	3	1	2
NITE-1030	319	477	158	0	3	3	1	1
NITE-1030	319	393	74	1	3	3	1	1
NITE-1030	319	477	158	0	3	3	1	0
NITE-1030	319	381	62	1	3	3	1	2
NITE-1030	319	477	158	0	3	3	1	3
NITE-1030	319	477	158	0	3	3	1	2
NITE-1031	319	387	68	1	3	3	0	1
NITE-1031	319	477	158	0	3	3	1	1
NITE-1031	319	477	158	0	3	1	0	0
NITE-1031	321	477	156	0	2	1	1	0
NITE-1031	322	385	63	1	2	1	1	1
NITE-1031	322	477	155	0	3	1	0	0
NITE-1031	322	380	58	1	3	1	1	0
NITE-1031	322	477	155	0	4	1	0	0
NITE-1031	322	339	17	1	4	4	1	0
NITE-1031	322	329	7	1	3	3	0	0
NITE-1032	322	323	1	1	3	3	1	0
NITE-1032	322	323	1	1	3	4	1	0
NITE-1032	322	477	155	0	4	3	1	0
NITE-1032	322	326	4	1	2	1	1	0
NITE-1032	322	353	31	1	3	1	0	1
NITE-1032	322	477	155	0	3	4	0	0
NITE-1032	322	477	155	0	3	3	0	0
NITE-1032	322	323	1	1	2	1	0	1
NITE-1032	322	323	1	1	3	4	1	1
NITE-1032	322	358	36	1	3	3	1	0
NITE-1033	322	330	8	1	3	2	1	4
NITE-1033	322	477	155	0	3	2	0	1
NITE-1033	322	477	155	0	3	2	0	1
NITE-1033	322	477	155	0	3	4	1	0
NITE-1033	322	477	155	0	3	1	0	0
NITE-1033	322	326	4	1	3	4	1	2
NITE-1033	322	324	2	1	3	3	0	0
NITE-1033	322	477	155	0	5	3	0	0
NITE-1033	323	324	1	1	3	5	0	1
NITE-1033	323	324	1	1	3	1	1	0
NITE-1034	323	477	154	0	4	1	0	0
NITE-1034	323	324	1	1	3	1	1	0
NITE-1034	323	337	14	1	3	5	1	1
NITE-1034	323	330	7	1	3	5	1	1
NITE-1034	323	477	154	0	3	4	0	0
NITE-1034	323	477	154	0	3	3	1	1
NITE-1034	323	361	38	1	3	4	1	0
NITE-1034	323	403	80	1	3	3	1	3
NITE-1034	323	340	17	1	2	4	1	0
NITE-1034	323	324	1	1	3	3	1	0
NITE-1035	323	477	154	0	3	4	0	1
NITE-1035	323	324	1	1	3	3	1	0
NITE-1035	323	333	10	1	3	4	1	1
NITE-1035	323	360	37	1	4	2	1	1
NITE-1035	324	332	8	1	3	1	1	0
NITE-1035	324	339	15	1	3	1	1	0
NITE-1035	324	339	15	1	2	1	1	1
NITE-1035	324	325	1	1	3	1	0	0
NITE-1035	324	329	5	1	3	1	1	0
NITE-1035	324	394	70	1	4	1	1	0
NITE-1036	324	477	153	0	4	3	0	0
NITE-1036	324	477	153	0	3	4	0	0
NITE-1036	324	477	153	0	3	4	0	0
NITE-1036	324	477	153	0	3	1	0	0
NITE-1036	324	477	153	0	4	5	0	0
NITE-1036	324	333	9	1	3	5	1	1
NITE-1036	324	343	19	1	3	5	1	3
NITE-1036	324	343	19	1	3	5	1	0
NITE-1036	324	338	14	1	3	5	1	0
NITE-1036	324	337	13	1	3	5	1	0
NITE-1037	324	325	1	1	3	1	1	0
NITE-1037	324	351	27	1	2	2	1	1
NITE-1037	324	326	2	1	3	3	0	0
NITE-1037	325	339	14	1	3	1	1	0
NITE-1037	325	334	9	1	2	1	1	2
NITE-1037	325	326	1	1	3	1	1	0
NITE-1037	325	380	55	1	3	3	1	0
NITE-1037	325	394	69	1	3	1	1	2
NITE-1037	325	387	62	1	3	1	1	2
NITE-1037	325	380	55	1	3	3	1	0
NITE-1038	325	338	13	1	3	4	1	1
NITE-1038	325	326	1	1	3	4	1	0
NITE-1038	325	343	18	1	2	4	1	0
NITE-1038	325	477	152	0	3	1	1	0
NITE-1038	325	477	152	0	3	4	1	0
NITE-1038	325	361	36	1	1	1	1	1
NITE-1038	325	337	12	1	3	4	1	0
NITE-1038	325	477	152	0	3	4	1	0
NITE-1038	326	477	151	0	3	1	0	0
NITE-1038	326	477	151	0	3	1	0	0
NITE-1039	326	330	4	1	3	1	1	0
NITE-1039	326	375	49	1	3	1	1	1
NITE-1039	326	327	1	1	1	1	1	1
NITE-1039	326	330	4	1	1	1	1	0
NITE-1039	326	477	151	0	2	1	0	0
NITE-1039	326	477	151	0	3	4	0	0
NITE-1039	326	477	151	0	3	1	1	1
NITE-1039	326	331	5	1	2	1	1	1
NITE-1039	326	477	151	0	3	1	0	0
NITE-1039	327	329	2	1	3	1	1	4
NITE-1040	328	329	1	1	2	1	0	1
NITE-1040	328	332	4	1	2	1	1	1
NITE-1040	328	329	1	1	2	1	0	0
NITE-1040	329	360	31	1	3	1	1	0
NITE-1040	329	352	23	1	2	1	1	1
NITE-1040	329	337	8	1	3	4	1	0
NITE-1040	329	347	18	1	3	1	1	0
NITE-1040	329	477	148	0	4	2	0	0
NITE-1040	329	477	148	0	3	1	0	1
NITE-1040	329	477	148	0	3	4	1	0
NITE-1041	329	338	9	1	3	5	1	1
NITE-1041	329	477	148	0	3	4	0	0
NITE-1041	329	332	3	1	3	4	1	0
NITE-1041	329	334	5	1	3	4	1	1
NITE-1041	330	434	104	1	3	1	1	1
NITE-1041	330	409	79	1	3	1	1	2
NITE-1041	330	477	147	0	3	1	0	0
NITE-1041	330	477	147	0	3	1	1	1
NITE-1041	330	477	147	0	3	2	1	2
NITE-1041	330	477	147	0	3	4	1	0
NITE-1042	330	477	147	0	3	5	0	0
NITE-1042	330	396	66	1	2	1	1	4
NITE-1042	330	336	6	1	3	3	1	1
NITE-1042	330	477	147	0	3	1	0	0
NITE-1042	330	477	147	0	3	1	1	0
NITE-1042	330	477	147	0	2	1	1	0
NITE-1042	330	477	147	0	5	4	1	0
NITE-1042	330	333	3	1	3	1	1	0
NITE-1042	330	344	14	1	3	3	1	1
NITE-1042	330	331	1	1	3	1	1	0
NITE-1043	330	477	147	0	3	4	0	0
NITE-1043	330	477	147	0	3	1	0	1
NITE-1043	331	332	1	1	1	1	1	0
NITE-1043	331	332	1	1	3	3	1	0
NITE-1043	331	361	30	1	3	1	1	4
NITE-1043	331	336	5	1	3	3	0	0
NITE-1043	331	338	7	1	4	5	1	0
NITE-1043	331	477	146	0	5	2	0	0
NITE-1043	331	477	146	0	3	5	0	0
NITE-1044	331	357	26	1	3	4	1	0
NITE-1044	331	477	146	0	3	4	0	0
NITE-1044	331	338	7	1	5	5	1	0
NITE-1044	331	477	146	0	3	5	1	0
NITE-1044	331	402	71	1	3	1	0	0
NITE-1044	331	477	146	0	3	4	0	0
NITE-1044	331	346	15	1	2	1	1	0
NITE-1044	331	338	7	1	3	1	0	0
NITE-1044	331	357	26	1	3	1	1	3
NITE-1044	331	332	1	1	3	4	1	0
NITE-1045	331	345	14	1	3	4	0	4
NITE-1045	331	391	60	1	3	1	1	0
NITE-1045	332	477	145	0	3	1	0	0
NITE-1045	332	338	6	1	3	3	1	0
NITE-1045	332	346	14	1	3	3	0	0
NITE-1045	332	477	145	0	3	1	1	4
NITE-1045	332	477	145	0	3	5	0	0
NITE-1045	332	337	5	1	3	1	1	0
NITE-1045	332	477	145	0	3	5	1	0
NITE-1045	332	477	145	0	3	5	1	0
NITE-1046	332	477	145	0	3	5	0	0
NITE-1046	332	345	13	1	3	5	1	1
NITE-1046	332	347	15	1	3	5	1	3
NITE-1046	332	347	15	1	3	5	0	0
NITE-1046	332	347	15	1	3	5	1	0
NITE-1046	332	353	21	1	2	1	1	0
NITE-1046	332	477	145	0	3	1	0	0
NITE-1046	332	477	145	0	3	1	0	0
NITE-1046	332	399	67	1	3	3	0	4
NITE-1046	332	344	12	1	3	1	1	0
NITE-1047	332	477	145	0	3	1	1	0
NITE-1047	332	410	78	1	4	4	1	0
NITE-1047	332	344	12	1	2	1	1	1
NITE-1047	332	477	145	0	3	1	1	0
NITE-1047	332	358	26	1	3	1	1	0
NITE-1047	332	340	8	1	3	4	1	0
NITE-1047	332	441	109	1	4	5	1	0
NITE-1047	332	477	145	0	2	1	1	0
NITE-1047	332	477	145	0	3	4	0	0
NITE-1047	332	477	145	0	3	2	0	4
NITE-1048	332	347	15	1	3	2	1	1
NITE-1048	332	477	145	0	3	5	0	0
NITE-1048	332	350	18	1	3	1	0	0
NITE-1048	332	344	12	1	2	1	1	2
NITE-1048	332	333	1	1	3	1	1	1
NITE-1048	333	477	144	0	3	4	1	0
NITE-1048	333	477	144	0	4	1	0	0
NITE-1048	333	396	63	1	3	3	1	0
NITE-1048	333	350	17	1	3	1	1	1
NITE-1048	333	393	60	1	4	1	1	0
NITE-1049	333	334	1	1	3	3	1	0
NITE-1049	333	339	6	1	3	1	0	0
NITE-1049	333	344	11	1	3	4	1	0
NITE-1049	333	353	20	1	3	4	1	0
NITE-1049	333	477	144	0	3	4	1	0
NITE-1049	333	477	144	0	3	4	1	1
NITE-1049	333	477	144	0	4	1	0	0
NITE-1049	333	477	144	0	3	3	1	0
NITE-1049	333	477	144	0	3	3	0	0
NITE-1049	333	477	144	0	3	1	0	0
NITE-1050	334	477	143	0	3	1	1	0
NITE-1050	334	477	143	0	3	1	0	0
NITE-1050	336	477	141	0	3	1	0	0
NITE-1050	336	477	141	0	3	4	0	0
NITE-1050	336	477	141	0	4	1	1	0
NITE-1050	336	360	24	1	3	4	1	2
NITE-1050	336	477	141	0	3	1	0	0
NITE-1050	336	382	46	1	2	4	1	3
NITE-1050	336	477	141	0	2	2	1	1
NITE-1050	336	338	2	1	3	1	1	0
NITE-1051	336	337	1	1	3	4	1	1
NITE-1051	336	338	2	1	3	1	0	1
NITE-1051	336	477	141	0	3	4	1	1
NITE-1051	336	344	8	1	3	1	1	1
NITE-1051	336	346	10	1	3	1	1	1
NITE-1051	336	477	141	0	4	1	0	0
NITE-1051	336	477	141	0	3	1	0	0
NITE-1051	337	477	140	0	3	4	1	1
NITE-1051	337	380	43	1	2	1	1	3
NITE-1051	337	378	41	1	4	3	0	0
NITE-1052	337	394	57	1	2	1	1	1
NITE-1052	337	338	1	1	2	1	1	0
NITE-1052	337	340	3	1	3	1	1	0
NITE-1052	337	338	1	1	3	4	1	0
NITE-1052	337	477	140	0	3	1	0	0
NITE-1052	337	338	1	1	3	3	1	0
NITE-1052	337	477	140	0	3	4	0	0
NITE-1052	337	477	140	0	3	1	0	0
NITE-1052	337	346	9	1	2	1	1	0
NITE-1052	337	477	140	0	4	2	1	0
NITE-1053	337	477	140	0	4	5	1	0
NITE-1053	337	477	140	0	4	5	1	0
NITE-1053	337	477	140	0	4	5	1	0
NITE-1053	338	375	37	1	3	3	0	0
NITE-1053	338	343	5	1	3	1	1	0
NITE-1053	338	339	1	1	3	3	1	1
NITE-1053	338	340	2	1	3	1	1	0
NITE-1053	338	385	47	1	3	1	1	3
NITE-1053	338	401	63	1	3	3	1	0
NITE-1053	338	477	139	0	3	4	0	0
NITE-1054	338	354	16	1	3	1	0	0
NITE-1054	338	477	139	0	3	2	1	4
NITE-1054	338	477	139	0	3	2	0	1
NITE-1054	338	358	20	1	3	2	1	2
NITE-1054	338	407	69	1	3	2	1	2
NITE-1054	338	413	75	1	3	2	0	1
NITE-1054	338	413	75	1	3	2	1	2
NITE-1054	338	413	75	1	3	2	1	1
NITE-1054	338	477	139	0	3	2	0	1
NITE-1054	338	339	1	1	3	1	1	0
NITE-1055	338	477	139	0	3	1	1	2
NITE-1055	338	477	139	0	3	1	1	1
NITE-1055	338	340	2	1	3	3	1	0
NITE-1055	338	339	1	1	3	5	0	1
NITE-1055	338	477	139	0	3	1	1	1
NITE-1055	338	350	12	1	3	4	1	2
NITE-1055	338	345	7	1	2	1	1	0
NITE-1055	338	477	139	0	3	1	0	0
NITE-1055	338	358	20	1	3	1	1	2
NITE-1055	338	413	75	1	4	3	0	1
NITE-1056	338	416	78	1	3	1	1	1
NITE-1056	338	430	92	1	2	1	1	4
NITE-1056	338	340	2	1	2	3	0	0
NITE-1056	338	477	139	0	3	4	0	0
NITE-1056	339	340	1	1	3	3	1	0
NITE-1056	339	343	4	1	4	1	1	0
NITE-1056	339	477	138	0	3	3	0	0
NITE-1056	339	354	15	1	3	3	0	0
NITE-1056	339	340	1	1	5	3	0	0
NITE-1056	339	477	138	0	3	1	1	0
NITE-1057	339	477	138	0	4	4	0	0
NITE-1057	339	359	20	1	2	1	0	1
NITE-1057	339	352	13	1	3	1	1	0
NITE-1057	339	379	40	1	3	4	1	1
NITE-1057	339	477	138	0	3	5	0	0
NITE-1057	339	477	138	0	4	4	0	1
NITE-1057	339	477	138	0	4	3	1	1
NITE-1057	339	345	6	1	3	1	1	0
NITE-1057	339	343	4	1	3	3	1	1
NITE-1057	339	358	19	1	3	1	0	1
NITE-1058	339	378	39	1	3	1	1	0
NITE-1058	339	477	138	0	3	3	1	1
NITE-1058	339	409	70	1	3	1	1	2
NITE-1058	339	427	88	1	3	1	0	2
NITE-1058	339	378	39	1	3	1	1	2
NITE-1058	340	477	137	0	3	1	1	0
NITE-1058	340	477	137	0	3	1	0	0
NITE-1058	340	341	1	1	3	4	1	0
NITE-1058	340	477	137	0	5	3	0	1
NITE-1058	340	343	3	1	2	1	1	0
NITE-1059	340	381	41	1	4	3	1	1
NITE-1059	340	378	38	1	3	1	1	0
NITE-1059	340	477	137	0	3	4	0	0
NITE-1059	340	477	137	0	3	3	1	0
NITE-1059	340	357	17	1	3	4	1	1
NITE-1059	340	477	137	0	3	5	1	0
NITE-1059	340	477	137	0	3	5	1	1
NITE-1059	340	477	137	0	3	3	1	0
NITE-1059	340	401	61	1	3	3	0	3
NITE-1059	340	354	14	1	3	5	1	0
NITE-1060	340	477	137	0	3	4	1	0
NITE-1060	340	477	137	0	3	1	0	0
NITE-1060	340	403	63	1	4	1	1	2
NITE-1060	340	477	137	0	3	1	1	2
NITE-1060	340	402	62	1	3	1	1	2
NITE-1060	340	354	14	1	3	4	1	1
NITE-1060	340	360	20	1	3	3	1	1
NITE-1060	341	477	136	0	3	4	0	0
NITE-1060	341	477	136	0	3	1	0	1
NITE-1060	343	344	1	1	3	1	1	0
NITE-1061	343	344	1	1	3	4	1	0
NITE-1061	343	344	1	1	3	4	1	0
NITE-1061	343	477	134	0	3	1	0	0
NITE-1061	343	374	31	1	3	1	1	0
NITE-1061	343	477	134	0	3	3	0	0
NITE-1061	343	346	3	1	4	1	1	0
NITE-1061	343	344	1	1	2	1	1	0
NITE-1061	343	346	3	1	4	1	1	0
NITE-1061	343	477	134	0	3	1	0	0
NITE-1061	343	477	134	0	3	5	0	0
NITE-1062	343	477	134	0	4	3	0	1
NITE-1062	343	358	15	1	3	3	1	1
NITE-1062	343	344	1	1	3	1	1	0
NITE-1062	343	344	1	1	3	1	1	0
NITE-1062	343	350	7	1	3	1	1	0
NITE-1062	343	477	134	0	3	4	1	0
NITE-1062	343	477	134	0	3	4	0	0
NITE-1062	343	477	134	0	3	4	1	0
NITE-1062	343	354	11	1	4	5	0	0
NITE-1062	343	387	44	1	3	5	1	2
NITE-1063	343	344	1	1	4	1	2	0
NITE-1063	343	477	134	0	3	1	0	0
NITE-1063	344	477	133	0	3	1	0	0
NITE-1063	344	477	133	0	3	1	0	1
NITE-1063	344	477	133	0	3	1	0	1
NITE-1063	344	477	133	0	3	1	0	0
NITE-1063	344	477	133	0	3	1	0	0
NITE-1063	344	477	133	0	4	3	0	1
NITE-1063	344	477	133	0	3	4	0	0
NITE-1063	344	417	73	1	4	3	1	0
NITE-1064	344	380	36	1	3	2	1	3
NITE-1064	344	477	133	0	3	4	0	0
NITE-1064	344	477	133	0	3	4	0	1
NITE-1064	344	351	7	1	3	1	1	2
NITE-1064	344	430	86	1	3	1	0	3
NITE-1064	344	394	50	1	3	1	1	3
NITE-1064	344	345	1	1	4	4	1	0
NITE-1064	344	477	133	0	4	4	0	0
NITE-1064	345	382	37	1	3	1	1	0
NITE-1064	345	477	132	0	3	3	1	1
NITE-1065	345	346	1	1	3	1	1	1
NITE-1065	345	477	132	0	4	4	1	0
NITE-1065	345	477	132	0	3	1	1	1
NITE-1065	345	477	132	0	3	5	0	0
NITE-1065	345	477	132	0	3	4	1	0
NITE-1065	345	477	132	0	3	4	1	0
NITE-1065	345	346	1	1	3	1	1	0
NITE-1065	345	347	2	1	3	1	1	1
NITE-1065	345	357	12	1	3	1	1	0
NITE-1065	345	346	1	1	3	1	1	0
NITE-1066	345	477	132	0	3	1	0	0
NITE-1066	345	346	1	1	3	4	1	0
NITE-1066	345	477	132	0	3	1	0	0
NITE-1066	345	477	132	0	3	3	1	0
NITE-1066	345	477	132	0	3	4	1	0
NITE-1066	345	477	132	0	3	1	0	0
NITE-1066	345	346	1	1	3	1	1	0
NITE-1066	346	347	1	1	3	1	1	0
NITE-1066	346	477	131	0	3	4	1	0
NITE-1066	346	464	118	1	2	1	1	1
NITE-1067	346	477	131	0	3	3	0	1
NITE-1067	346	357	11	1	2	1	1	1
NITE-1067	346	477	131	0	3	1	0	1
NITE-1067	346	347	1	1	3	3	0	0
NITE-1067	346	429	83	1	4	5	1	0
NITE-1067	346	477	131	0	3	5	1	0
NITE-1067	346	477	131	0	3	3	0	0
NITE-1067	346	378	32	1	3	3	0	0
NITE-1067	346	477	131	0	3	4	1	1
NITE-1067	347	477	130	0	3	4	0	0
NITE-1068	347	348	1	1	3	4	1	0
NITE-1068	347	477	130	0	3	4	0	0
NITE-1068	347	350	3	1	3	3	1	0
NITE-1068	347	477	130	0	3	3	1	0
NITE-1068	347	477	130	0	2	1	1	0
NITE-1068	347	477	130	0	3	1	1	1
NITE-1068	347	477	130	0	3	1	0	0
NITE-1068	347	477	130	0	3	3	1	1
NITE-1068	347	388	41	1	3	3	1	2
NITE-1068	347	477	130	0	3	3	1	1
NITE-1069	347	477	130	0	1	1	1	0
NITE-1069	347	445	98	1	3	1	1	3
NITE-1069	347	378	31	1	3	5	1	0
NITE-1069	347	477	130	0	3	1	1	2
NITE-1069	347	477	130	0	3	1	1	0
NITE-1069	347	477	130	0	4	4	0	1
NITE-1069	347	477	130	0	2	4	1	4
NITE-1069	347	477	130	0	5	2	1	0
NITE-1069	347	477	130	0	3	3	1	0
NITE-1069	347	477	130	0	3	3	1	2
NITE-1070	347	385	38	1	3	4	1	0
NITE-1070	348	350	2	1	3	3	1	1
NITE-1070	348	477	129	0	3	2	1	1
NITE-1070	348	477	129	0	3	4	0	0
NITE-1070	348	353	5	1	3	3	0	0
NITE-1070	348	477	129	0	3	1	0	0
NITE-1070	348	477	129	0	3	1	0	0
NITE-1070	348	477	129	0	3	4	0	0
NITE-1070	350	477	127	0	3	3	1	0
NITE-1070	350	351	1	1	3	3	1	0
NITE-1071	350	477	127	0	3	3	1	1
NITE-1071	350	458	108	1	4	2	1	4
NITE-1071	350	477	127	0	3	2	1	0
NITE-1071	350	375	25	1	2	3	1	1
NITE-1071	350	477	127	0	3	3	1	1
NITE-1071	350	359	9	1	4	3	1	1
NITE-1071	350	351	1	1	3	1	1	1
NITE-1071	350	477	127	0	3	1	0	0
NITE-1071	350	358	8	1	3	4	1	1
NITE-1071	350	351	1	1	3	1	1	0
NITE-1072	350	414	64	1	3	4	1	0
NITE-1072	350	428	78	1	3	3	1	1
NITE-1072	350	477	127	0	3	1	0	0
NITE-1072	350	477	127	0	3	5	0	2
NITE-1072	350	477	127	0	3	2	0	2
NITE-1072	350	361	11	1	3	5	0	0
NITE-1072	351	477	126	0	4	1	0	0
NITE-1072	351	361	10	1	3	4	1	0
NITE-1072	351	401	50	1	3	4	1	0
NITE-1072	351	477	126	0	3	3	0	2
NITE-1073	351	477	126	0	3	3	0	1
NITE-1073	351	352	1	1	3	4	1	0
NITE-1073	351	374	23	1	2	1	1	1
NITE-1073	351	477	126	0	2	1	0	0
NITE-1073	352	477	125	0	3	4	0	0
NITE-1073	352	477	125	0	4	4	0	0
NITE-1073	352	477	125	0	4	4	0	0
NITE-1073	352	477	125	0	4	3	1	0
NITE-1073	352	434	82	1	3	4	0	3
NITE-1073	352	358	6	1	3	3	1	4
NITE-1074	352	477	125	0	3	3	1	1
NITE-1074	352	477	125	0	3	3	1	2
NITE-1074	352	387	35	1	4	4	1	0
NITE-1074	352	358	6	1	3	3	1	0
NITE-1074	352	353	1	1	2	1	1	1
NITE-1074	352	477	125	0	4	1	0	1
NITE-1074	353	477	124	0	3	3	0	0
NITE-1074	353	477	124	0	3	4	1	1
NITE-1074	353	409	56	1	4	3	1	0
NITE-1074	353	393	40	1	3	4	1	1
NITE-1075	353	394	41	1	3	1	1	4
NITE-1075	353	477	124	0	3	3	0	1
NITE-1075	353	385	32	1	3	1	1	4
NITE-1075	353	386	33	1	3	1	1	0
NITE-1075	353	387	34	1	3	3	1	0
NITE-1075	353	402	49	1	3	1	1	0
NITE-1075	353	375	22	1	3	1	1	1
NITE-1075	353	477	124	0	4	3	1	0
NITE-1075	353	394	41	1	3	5	1	3
NITE-1075	353	408	55	1	3	1	1	1
NITE-1076	353	477	124	0	3	4	1	0
NITE-1076	353	477	124	0	3	4	1	0
NITE-1076	353	388	35	1	3	3	1	4
NITE-1076	353	386	33	1	3	1	1	1
NITE-1076	353	393	40	1	3	1	1	0
NITE-1076	353	403	50	1	3	1	1	0
NITE-1076	353	393	40	1	3	1	1	1
NITE-1076	353	477	124	0	3	1	1	1
NITE-1076	353	436	83	1	3	1	1	0
NITE-1076	353	441	88	1	3	1	1	1
NITE-1077	353	388	35	1	3	1	1	0
NITE-1077	353	477	124	0	4	4	1	0
NITE-1077	354	477	123	0	3	1	1	0
NITE-1077	354	360	6	1	3	5	1	0
NITE-1077	354	360	6	1	3	5	1	0
NITE-1077	354	375	21	1	3	5	1	0
NITE-1077	354	388	34	1	3	5	1	1
NITE-1077	354	382	28	1	3	5	1	3
NITE-1077	354	375	21	1	3	1	1	1
NITE-1077	354	359	5	1	4	3	1	0
NITE-1078	354	477	123	0	3	4	1	0
NITE-1078	354	477	123	0	3	4	0	0
NITE-1078	354	477	123	0	4	1	1	0
NITE-1078	354	477	123	0	3	3	1	0
NITE-1078	354	387	33	1	3	3	1	2
NITE-1078	354	358	4	1	3	1	1	1
NITE-1078	354	399	45	1	3	1	1	3
NITE-1078	354	477	123	0	5	3	0	0
NITE-1078	354	399	45	1	3	1	1	1
NITE-1078	354	477	123	0	3	1	1	1
NITE-1079	354	477	123	0	3	4	1	1
NITE-1079	354	477	123	0	3	4	0	0
NITE-1079	354	477	123	0	4	3	1	0
NITE-1079	354	396	42	1	3	5	1	0
NITE-1079	354	375	21	1	2	1	1	3
NITE-1079	354	477	123	0	3	4	0	1
NITE-1079	356	380	24	1	3	5	1	4
NITE-1079	357	477	120	0	3	4	1	0
NITE-1079	357	386	29	1	3	4	1	4
NITE-1079	357	464	107	1	3	4	1	1
NITE-1080	357	361	4	1	3	4	0	0
NITE-1080	357	477	120	0	2	4	1	2
NITE-1080	357	477	120	0	3	3	0	0
NITE-1080	357	360	3	1	3	5	1	0
NITE-1080	357	477	120	0	4	5	0	0
NITE-1080	357	477	120	0	4	3	0	0
NITE-1080	357	358	1	1	3	1	0	0
NITE-1080	357	477	120	0	3	3	0	2
NITE-1080	357	477	120	0	3	1	1	0
NITE-1080	358	375	17	1	3	1	1	0
NITE-1081	358	375	17	1	3	4	1	0
NITE-1081	358	361	3	1	3	3	1	1
NITE-1081	358	359	1	1	3	3	1	1
NITE-1081	358	359	1	1	5	1	1	0
NITE-1081	358	450	92	1	2	1	1	0
NITE-1081	358	360	2	1	2	1	1	0
NITE-1081	358	477	119	0	3	3	0	1
NITE-1081	358	477	119	0	3	3	1	1
NITE-1081	359	477	118	0	3	4	0	0
NITE-1081	359	477	118	0	3	1	1	0
NITE-1082	359	362	3	1	3	4	1	0
NITE-1082	359	477	118	0	3	1	1	1
NITE-1082	359	477	118	0	2	1	1	2
NITE-1082	359	361	2	1	3	3	1	0
NITE-1082	359	389	30	1	4	1	1	2
NITE-1082	359	477	118	0	2	1	0	0
NITE-1082	359	477	118	0	3	4	1	1
NITE-1082	359	378	19	1	3	3	1	0
NITE-1082	360	361	1	1	3	1	1	0
NITE-1082	360	477	117	0	3	3	1	2
NITE-1083	360	361	1	1	3	3	1	0
NITE-1083	360	477	117	0	3	3	0	1
NITE-1083	360	477	117	0	3	3	0	0
NITE-1083	360	386	26	1	3	4	0	1
NITE-1083	360	388	28	1	3	4	1	0
NITE-1083	360	477	117	0	3	1	0	0
NITE-1083	360	477	117	0	3	3	1	1
NITE-1083	360	477	117	0	3	4	1	0
NITE-1083	360	477	117	0	3	1	0	0
NITE-1083	361	381	20	1	3	4	1	0
NITE-1084	361	477	116	0	3	1	1	1
NITE-1084	361	434	73	1	3	3	0	1
NITE-1084	361	477	116	0	4	1	1	0
NITE-1084	361	477	116	0	3	4	0	0
NITE-1084	361	477	116	0	3	5	0	0
NITE-1084	361	477	116	0	3	3	1	0
NITE-1084	361	477	116	0	2	3	1	0
NITE-1084	362	477	115	0	3	1	0	0
NITE-1084	362	477	115	0	2	4	0	0
NITE-1084	362	477	115	0	4	4	1	0
NITE-1085	362	477	115	0	3	3	1	0
NITE-1085	362	477	115	0	3	4	0	0
NITE-1085	362	380	18	1	3	4	1	0
NITE-1085	363	477	114	0	3	1	0	2
NITE-734	1	126	125	1	5	1	1	0
NITE-734	2	477	475	0	3	3	0	2
NITE-734	2	477	475	0	3	1	0	0
NITE-735	3	15	12	1	3	1	1	1
NITE-735	4	477	473	0	3	3	0	0
NITE-735	4	10	6	1	3	3	1	1
NITE-735	4	17	13	1	3	3	1	1
NITE-735	4	477	473	0	4	4	0	1
NITE-735	4	10	6	1	3	1	0	0
NITE-735	7	409	402	1	4	5	0	0
NITE-735	7	14	7	1	3	4	1	0
NITE-735	8	30	22	1	2	3	1	0
NITE-735	8	409	401	1	3	1	0	0
NITE-736	8	477	469	0	4	1	0	0
NITE-736	8	477	469	0	3	1	0	0
NITE-736	8	56	48	1	3	1	1	1
NITE-736	8	477	469	0	3	1	0	0
NITE-736	8	9	1	1	2	1	1	1
NITE-736	8	10	2	1	2	1	1	1
NITE-736	8	191	183	1	3	1	1	1
NITE-736	8	477	469	0	3	1	0	0
NITE-736	8	477	469	0	3	1	0	0
NITE-736	9	477	468	0	3	4	1	0
NITE-737	9	409	400	1	4	1	0	0
NITE-737	9	477	468	0	2	3	1	0
NITE-737	9	409	400	1	4	2	0	2
NITE-737	9	409	400	1	4	1	0	0
NITE-737	9	409	400	1	3	4	0	0
NITE-737	9	36	27	1	3	1	1	0
NITE-737	9	17	8	1	3	3	1	1
NITE-737	9	10	1	1	2	1	1	0
NITE-737	9	16	7	1	3	4	1	3
NITE-737	9	477	468	0	5	4	0	1
NITE-738	9	16	7	1	2	4	1	1
NITE-738	10	477	467	0	5	4	0	0
NITE-738	10	477	467	0	3	1	0	0
NITE-738	10	58	48	1	3	1	0	3
NITE-738	10	477	467	0	3	3	1	1
NITE-738	10	11	1	1	3	1	1	0
NITE-738	10	86	76	1	3	3	1	1
NITE-738	10	30	20	1	3	4	0	1
NITE-738	10	477	467	0	3	3	1	2
NITE-738	10	31	21	1	3	1	1	0
NITE-739	10	11	1	1	3	4	1	0
NITE-739	11	12	1	1	1	1	1	0
NITE-739	11	25	14	1	5	1	1	0
NITE-739	11	347	336	1	2	3	0	1
NITE-739	11	477	466	0	4	4	0	0
NITE-739	11	15	4	1	4	4	1	0
NITE-739	11	14	3	1	3	1	1	0
NITE-739	11	15	4	1	3	1	1	0
NITE-739	11	56	45	1	4	1	1	0
NITE-739	11	14	3	1	3	1	1	0
NITE-740	11	12	1	1	3	1	1	0
NITE-740	11	477	466	0	3	1	0	0
NITE-740	11	477	466	0	3	4	0	0
NITE-740	11	28	17	1	3	3	1	0
NITE-740	11	58	47	1	3	3	1	0
NITE-740	11	267	256	1	3	1	1	1
NITE-740	14	477	463	0	2	1	0	0
NITE-740	14	15	1	1	3	1	0	0
NITE-740	14	30	16	1	3	3	1	1
NITE-740	14	49	35	1	3	1	1	0
NITE-741	14	233	219	1	3	1	1	0
NITE-741	14	15	1	1	2	1	0	0
NITE-741	14	15	1	1	3	1	1	0
NITE-741	14	17	3	1	4	1	1	1
NITE-741	14	477	463	0	3	1	1	2
NITE-741	14	53	39	1	2	3	1	1
NITE-741	14	477	463	0	3	4	0	0
NITE-741	14	477	463	0	3	5	0	0
NITE-741	14	477	463	0	3	5	0	0
NITE-741	14	65	51	1	3	3	1	0
NITE-742	15	17	2	1	4	1	1	0
NITE-742	15	87	72	1	3	2	1	0
NITE-742	15	36	21	1	3	5	0	0
NITE-742	15	36	21	1	3	5	0	0
NITE-742	15	36	21	1	3	5	0	0
NITE-742	15	45	30	1	3	5	0	0
NITE-742	15	50	35	1	3	5	0	0
NITE-742	15	55	40	1	3	5	0	0
NITE-742	15	38	23	1	3	5	0	0
NITE-742	15	37	22	1	3	5	0	0
NITE-743	15	38	23	1	3	5	0	0
NITE-743	15	39	24	1	3	5	0	0
NITE-743	15	39	24	1	3	5	0	0
NITE-743	15	39	24	1	3	5	0	0
NITE-743	15	48	33	1	3	5	0	0
NITE-743	15	49	34	1	3	5	0	0
NITE-743	15	80	65	1	3	4	1	4
NITE-743	15	35	20	1	3	2	1	3
NITE-743	15	39	24	1	3	2	1	2
NITE-743	15	42	27	1	3	3	1	1
NITE-744	15	477	462	0	3	4	0	0
NITE-744	15	330	315	1	4	3	1	0
NITE-744	15	477	462	0	3	1	0	0
NITE-744	16	23	7	1	3	3	1	1
NITE-744	16	477	461	0	3	3	0	1
NITE-744	16	477	461	0	3	4	1	0
NITE-744	16	477	461	0	3	1	0	1
NITE-744	16	477	461	0	3	1	0	1
NITE-744	16	17	1	1	3	1	0	0
NITE-744	16	477	461	0	4	1	0	0
NITE-745	16	17	1	1	3	1	1	1
NITE-745	16	42	26	1	4	5	1	0
NITE-745	16	44	28	1	4	5	1	0
NITE-745	16	17	1	1	3	1	1	0
NITE-745	16	18	2	1	3	1	1	2
NITE-745	16	477	461	0	3	1	0	0
NITE-745	16	22	6	1	3	1	1	0
NITE-745	16	477	461	0	4	1	0	0
NITE-745	17	477	460	0	3	1	1	0
NITE-745	17	72	55	1	4	1	1	0
NITE-746	17	252	235	1	4	1	1	0
NITE-746	17	18	1	1	3	1	1	0
NITE-746	17	60	43	1	4	1	1	0
NITE-746	17	18	1	1	3	1	1	0
NITE-746	17	38	21	1	3	1	1	0
NITE-746	17	18	1	1	3	1	1	1
NITE-746	17	82	65	1	2	3	1	2
NITE-746	17	100	83	1	3	4	1	0
NITE-746	17	477	460	0	3	1	0	1
NITE-746	17	30	13	1	3	3	1	0
NITE-747	17	477	460	0	3	2	0	0
NITE-747	18	19	1	1	3	4	1	0
NITE-747	18	477	459	0	2	1	1	0
NITE-747	18	30	12	1	3	1	1	0
NITE-747	18	42	24	1	4	1	0	2
NITE-747	18	30	12	1	3	4	1	0
NITE-747	18	42	24	1	2	1	1	1
NITE-747	18	21	3	1	3	1	1	1
NITE-747	18	477	459	0	3	1	0	0
NITE-747	18	477	459	0	4	1	0	0
NITE-748	18	477	459	0	4	1	0	0
NITE-748	18	94	76	1	3	1	1	1
NITE-748	18	477	459	0	3	4	0	0
NITE-748	21	45	24	1	3	1	1	1
NITE-748	21	24	3	1	3	3	1	1
NITE-748	21	42	21	1	3	4	1	0
NITE-748	21	477	456	0	3	1	0	0
NITE-748	21	308	287	1	3	1	0	1
NITE-748	21	52	31	1	3	1	1	0
NITE-749	21	25	4	1	3	3	1	0
NITE-749	21	25	4	1	3	3	1	1
NITE-749	22	23	1	1	3	4	1	0
NITE-749	22	23	1	1	3	3	1	1
NITE-749	22	477	455	0	3	3	0	1
NITE-749	22	477	455	0	3	2	0	1
NITE-749	22	43	21	1	3	1	1	0
NITE-749	22	477	455	0	3	1	0	0
NITE-749	22	23	1	1	3	1	1	0
NITE-749	22	477	455	0	3	1	1	0
NITE-750	22	23	1	1	3	1	1	0
NITE-750	22	91	69	1	3	4	1	1
NITE-750	22	24	2	1	3	4	1	0
NITE-750	22	43	21	1	3	5	1	0
NITE-750	22	35	13	1	3	3	1	3
NITE-750	22	23	1	1	3	1	1	0
NITE-750	22	23	1	1	3	1	1	0
NITE-750	22	23	1	1	3	1	1	4
NITE-750	22	37	15	1	3	1	1	2
NITE-750	22	28	6	1	3	3	1	1
NITE-751	23	477	454	0	3	5	1	0
NITE-751	23	31	8	1	3	3	1	0
NITE-751	23	107	84	1	3	1	1	0
NITE-751	23	44	21	1	3	5	1	1
NITE-751	23	37	14	1	3	1	1	0
NITE-751	23	477	454	0	4	1	0	0
NITE-751	23	86	63	1	3	5	1	0
NITE-751	23	63	40	1	3	5	1	0
NITE-751	23	28	5	1	3	5	1	1
NITE-751	23	39	16	1	3	1	1	2
NITE-752	23	31	8	1	3	1	1	0
NITE-752	23	25	2	1	3	4	1	0
NITE-752	23	24	1	1	3	1	1	0
NITE-752	23	477	454	0	2	1	1	0
NITE-752	24	148	124	1	3	3	1	0
NITE-752	24	322	298	1	3	3	1	0
NITE-752	24	477	453	0	3	3	0	3
NITE-752	24	477	453	0	3	3	1	2
NITE-752	24	477	453	0	3	3	0	0
NITE-752	24	25	1	1	3	1	1	0
NITE-753	24	25	1	1	3	1	1	0
NITE-753	24	71	47	1	3	3	1	1
NITE-753	24	35	11	1	3	3	1	0
NITE-753	24	37	13	1	3	4	1	3
NITE-753	24	28	4	1	3	1	1	0
NITE-753	24	129	105	1	3	4	1	2
NITE-753	24	65	41	1	3	3	1	0
NITE-753	24	409	385	1	3	4	0	3
NITE-753	24	477	453	0	2	3	0	2
NITE-753	24	477	453	0	3	4	0	4
NITE-754	24	39	15	1	3	1	1	3
NITE-754	24	409	385	1	3	4	0	2
NITE-754	24	409	385	1	4	4	0	1
NITE-754	25	28	3	1	3	3	1	0
NITE-754	25	409	384	1	3	4	0	3
NITE-754	25	409	384	1	3	4	0	2
NITE-754	25	409	384	1	3	4	0	2
NITE-754	25	477	452	0	3	1	0	0
NITE-754	25	409	384	1	3	4	0	4
NITE-754	25	409	384	1	3	4	0	2
NITE-755	25	26	1	1	1	3	1	0
NITE-755	25	477	452	0	4	4	1	0
NITE-755	25	477	452	0	3	1	1	0
NITE-755	25	409	384	1	4	4	0	2
NITE-755	25	409	384	1	3	4	0	1
NITE-755	28	249	221	1	3	3	1	0
NITE-755	28	477	449	0	4	1	0	0
NITE-755	28	42	14	1	3	3	1	1
NITE-755	28	42	14	1	3	3	1	1
NITE-755	28	30	2	1	3	5	1	0
NITE-756	28	29	1	1	3	3	1	0
NITE-756	28	31	3	1	3	4	1	2
NITE-756	28	477	449	0	3	4	0	2
NITE-756	28	477	449	0	3	4	0	2
NITE-756	29	129	100	1	4	1	0	2
NITE-756	29	129	100	1	3	1	0	2
NITE-756	29	65	36	1	3	4	1	0
NITE-756	29	30	1	1	3	1	1	0
NITE-756	29	30	1	1	3	4	1	0
NITE-756	29	30	1	1	3	1	1	0
NITE-757	29	477	448	0	3	1	0	0
NITE-757	29	477	448	0	3	4	0	0
NITE-757	29	477	448	0	3	1	1	0
NITE-757	29	30	1	1	3	1	1	0
NITE-757	29	43	14	1	1	3	1	0
NITE-757	29	477	448	0	3	1	0	1
NITE-757	29	30	1	1	1	1	1	0
NITE-757	29	30	1	1	3	1	1	0
NITE-757	30	42	12	1	3	1	1	0
NITE-757	30	477	447	0	3	1	0	1
NITE-758	30	32	2	1	3	1	1	0
NITE-758	30	81	51	1	3	1	1	0
NITE-758	30	309	279	1	3	3	1	1
NITE-758	30	58	28	1	3	3	1	1
NITE-758	30	477	447	0	3	4	1	2
NITE-758	30	130	100	1	3	1	1	1
NITE-758	30	37	7	1	3	4	1	1
NITE-758	30	149	119	1	3	4	1	1
NITE-758	30	43	13	1	3	3	1	0
NITE-758	30	477	447	0	3	1	0	0
NITE-759	30	31	1	1	3	4	1	2
NITE-759	30	477	447	0	3	1	0	0
NITE-759	30	116	86	1	3	1	1	1
NITE-759	30	477	447	0	3	3	1	2
NITE-759	30	51	21	1	2	1	1	1
NITE-759	30	477	447	0	2	3	1	0
NITE-759	31	477	446	0	3	4	0	0
NITE-759	31	477	446	0	4	1	0	0
NITE-759	31	35	4	1	3	1	0	1
NITE-759	31	32	1	1	1	1	1	2
NITE-760	31	477	446	0	5	4	0	0
NITE-760	31	409	378	1	3	4	0	1
NITE-760	31	409	378	1	3	4	0	1
NITE-760	31	105	74	1	3	1	0	1
NITE-760	31	81	50	1	3	3	1	3
NITE-760	31	409	378	1	3	4	0	1
NITE-760	31	38	7	1	3	4	1	1
NITE-760	32	410	378	1	3	4	0	1
NITE-760	32	127	95	1	3	4	0	1
NITE-760	32	477	445	0	3	4	0	1
NITE-761	32	33	1	1	3	4	1	0
NITE-761	32	477	445	0	3	1	1	0
NITE-761	32	33	1	1	3	4	1	0
NITE-761	32	33	1	1	2	1	1	0
NITE-761	32	178	146	1	3	4	1	0
NITE-761	32	218	186	1	3	3	1	4
NITE-761	32	477	445	0	3	1	1	1
NITE-761	32	33	1	1	3	1	0	1
NITE-761	32	256	224	1	3	1	1	1
NITE-761	34	73	39	1	3	3	1	0
NITE-762	35	477	442	0	1	1	0	0
NITE-762	35	350	315	1	3	3	0	0
NITE-762	35	477	442	0	3	1	0	0
NITE-762	35	477	442	0	3	3	0	0
NITE-762	35	385	350	1	3	1	1	1
NITE-762	35	36	1	1	3	3	1	0
NITE-762	35	42	7	1	3	4	1	0
NITE-762	35	477	442	0	3	4	0	0
NITE-762	36	117	81	1	3	1	1	1
NITE-762	36	477	441	0	3	1	0	1
NITE-763	36	477	441	0	3	1	0	1
NITE-763	36	477	441	0	3	1	0	4
NITE-763	36	56	20	1	3	1	1	1
NITE-763	36	477	441	0	3	1	0	0
NITE-763	36	477	441	0	3	1	0	0
NITE-763	36	477	441	0	3	4	0	0
NITE-763	36	477	441	0	3	4	0	0
NITE-763	36	477	441	0	3	3	1	1
NITE-763	36	71	35	1	2	1	1	2
NITE-763	36	37	1	1	3	1	1	0
NITE-764	36	477	441	0	3	4	1	0
NITE-764	37	477	440	0	3	4	1	0
NITE-764	37	477	440	0	3	1	0	1
NITE-764	37	38	1	1	3	3	1	1
NITE-764	37	477	440	0	3	4	1	0
NITE-764	37	284	247	1	3	3	1	0
NITE-764	38	73	35	1	2	3	0	2
NITE-764	38	337	299	1	2	4	0	1
NITE-764	38	402	364	1	3	4	1	4
NITE-764	38	45	7	1	3	1	1	1
NITE-765	38	50	12	1	3	4	1	0
NITE-765	38	270	232	1	2	1	0	1
NITE-765	38	45	7	1	3	4	1	0
NITE-765	38	44	6	1	3	1	0	0
NITE-765	38	477	439	0	3	1	0	0
NITE-765	38	63	25	1	3	1	1	0
NITE-765	38	39	1	1	3	1	0	0
NITE-765	38	88	50	1	4	1	1	1
NITE-765	39	477	438	0	3	4	0	0
NITE-765	39	102	63	1	4	5	1	0
NITE-766	39	477	438	0	4	4	0	0
NITE-766	39	409	370	1	4	4	0	2
NITE-766	39	40	1	1	4	5	0	0
NITE-766	39	40	1	1	3	1	1	0
NITE-766	39	455	416	1	3	4	1	4
NITE-766	39	477	438	0	3	4	1	0
NITE-766	39	477	438	0	3	1	0	0
NITE-766	39	477	438	0	3	4	0	0
NITE-766	40	58	18	1	2	5	1	0
NITE-766	42	477	435	0	3	1	0	0
NITE-767	42	477	435	0	2	1	0	0
NITE-767	42	477	435	0	3	3	1	0
NITE-767	42	477	435	0	2	3	0	0
NITE-767	42	44	2	1	4	4	0	0
NITE-767	42	477	435	0	3	1	0	0
NITE-767	42	409	367	1	3	5	0	0
NITE-767	42	107	65	1	3	4	1	0
NITE-767	42	43	1	1	3	5	1	1
NITE-767	42	477	435	0	3	1	1	0
NITE-767	42	477	435	0	3	5	1	0
NITE-768	42	94	52	1	3	5	1	0
NITE-768	42	409	367	1	3	4	0	2
NITE-768	43	86	43	1	3	1	1	0
NITE-768	43	129	86	1	4	4	1	0
NITE-768	43	44	1	1	3	4	0	1
NITE-768	43	52	9	1	3	3	1	0
NITE-768	43	52	9	1	3	1	1	1
NITE-768	43	477	434	0	3	3	0	0
NITE-768	43	477	434	0	2	1	0	1
NITE-768	43	44	1	1	3	5	1	0
NITE-769	43	58	15	1	3	3	1	0
NITE-769	43	102	59	1	4	4	1	1
NITE-769	43	477	434	0	3	1	1	0
NITE-769	43	100	57	1	3	4	1	0
NITE-769	43	46	3	1	3	1	1	0
NITE-769	43	45	2	1	3	3	1	1
NITE-769	44	477	433	0	3	1	0	2
NITE-769	44	56	12	1	3	4	0	0
NITE-769	44	52	8	1	3	4	1	3
NITE-769	44	100	56	1	3	4	1	0
NITE-770	44	207	163	1	3	3	1	3
NITE-770	44	228	184	1	3	3	1	3
NITE-770	44	91	47	1	3	4	1	0
NITE-770	44	477	433	0	3	1	0	0
NITE-770	44	477	433	0	3	4	1	1
NITE-770	44	477	433	0	4	1	0	0
NITE-770	44	477	433	0	3	1	0	0
NITE-770	44	477	433	0	3	4	0	0
NITE-770	44	144	100	1	3	1	1	1
NITE-770	44	45	1	1	3	1	1	2
NITE-771	44	45	1	1	3	1	0	1
NITE-771	44	249	205	1	3	3	1	0
NITE-771	44	94	50	1	3	4	1	2
NITE-771	45	46	1	1	3	4	1	0
NITE-771	45	46	1	1	3	3	1	1
NITE-771	45	389	344	1	3	4	0	0
NITE-771	45	56	11	1	3	1	1	0
NITE-771	45	59	14	1	3	1	1	0
NITE-771	45	477	432	0	3	1	0	1
NITE-771	45	477	432	0	2	3	0	1
NITE-772	45	57	12	1	3	3	1	0
NITE-772	45	477	432	0	1	1	0	0
NITE-772	45	46	1	1	3	4	1	0
NITE-772	45	477	432	0	3	1	0	1
NITE-772	45	409	364	1	3	4	0	4
NITE-772	46	50	4	1	3	4	1	0
NITE-772	46	47	1	1	4	1	0	0
NITE-772	46	72	26	1	3	1	1	2
NITE-772	46	294	248	1	1	3	1	0
NITE-772	46	56	10	1	3	4	1	1
NITE-773	46	302	256	1	3	3	1	0
NITE-773	46	477	431	0	3	1	0	0
NITE-773	46	477	431	0	3	3	0	2
NITE-773	46	409	363	1	3	3	0	1
NITE-773	46	409	363	1	3	3	0	2
NITE-773	46	409	363	1	3	3	0	2
NITE-773	46	477	431	0	3	3	0	2
NITE-773	46	47	1	1	3	3	1	1
NITE-773	46	409	363	1	3	4	0	1
NITE-773	46	477	431	0	4	3	1	0
NITE-774	46	477	431	0	3	4	0	0
NITE-774	46	227	181	1	4	1	0	0
NITE-774	46	146	100	1	3	1	0	1
NITE-774	46	477	431	0	3	4	0	1
NITE-774	49	477	428	0	2	1	0	0
NITE-774	49	134	85	1	3	3	1	0
NITE-774	49	409	360	1	3	1	0	0
NITE-774	49	50	1	1	3	4	1	0
NITE-774	49	74	25	1	3	3	1	2
NITE-774	49	52	3	1	3	1	1	0
NITE-775	49	52	3	1	3	1	1	0
NITE-775	49	71	22	1	2	1	1	1
NITE-775	49	212	163	1	3	3	1	0
NITE-775	49	477	428	0	3	1	0	0
NITE-775	49	85	36	1	2	1	1	1
NITE-775	49	109	60	1	2	1	1	0
NITE-775	49	72	23	1	4	1	1	1
NITE-775	50	477	427	0	3	1	0	0
NITE-775	50	191	141	1	3	3	1	0
NITE-775	50	477	427	0	4	1	0	0
NITE-776	50	477	427	0	4	4	0	0
NITE-776	50	409	359	1	3	2	0	3
NITE-776	50	135	85	1	3	5	0	0
NITE-776	50	58	8	1	2	3	1	0
NITE-776	50	270	220	1	3	2	1	4
NITE-776	50	71	21	1	5	1	1	0
NITE-776	50	477	427	0	3	1	0	2
NITE-776	50	51	1	1	3	1	1	0
NITE-776	50	51	1	1	4	1	1	0
NITE-776	50	51	1	1	2	1	0	0
NITE-777	50	106	56	1	3	3	1	4
NITE-777	50	477	427	0	3	1	1	0
NITE-777	50	99	49	1	3	3	1	2
NITE-777	50	70	20	1	3	3	1	1
NITE-777	51	94	43	1	3	1	1	0
NITE-777	51	238	187	1	4	1	0	0
NITE-777	51	141	90	1	4	1	1	0
NITE-777	51	178	127	1	3	2	1	0
NITE-777	51	477	426	0	3	3	0	3
NITE-777	51	477	426	0	3	1	0	0
NITE-778	51	52	1	1	3	5	1	1
NITE-778	51	477	426	0	4	3	1	0
NITE-778	51	287	236	1	3	2	1	1
NITE-778	51	281	230	1	3	2	1	2
NITE-778	52	72	20	1	4	3	0	0
NITE-778	52	72	20	1	3	1	0	2
NITE-778	52	112	60	1	3	1	1	0
NITE-778	52	477	425	0	5	4	1	0
NITE-778	52	477	425	0	2	1	0	2
NITE-778	52	59	7	1	3	1	1	0
NITE-779	52	86	34	1	3	3	0	0
NITE-779	52	108	56	1	3	1	1	0
NITE-779	52	477	425	0	4	3	0	0
NITE-779	52	309	257	1	3	1	1	0
NITE-779	52	78	26	1	3	1	1	1
NITE-779	52	477	425	0	3	1	1	0
NITE-779	52	92	40	1	3	5	1	0
NITE-779	52	224	172	1	3	5	0	0
NITE-779	52	477	425	0	3	4	1	0
NITE-779	53	54	1	1	4	1	1	0
NITE-780	53	74	21	1	5	1	0	0
NITE-780	53	56	3	1	1	1	0	0
NITE-780	53	210	157	1	3	3	1	0
NITE-780	54	60	6	1	3	3	1	0
NITE-780	54	477	423	0	3	1	0	0
NITE-780	56	477	421	0	4	1	0	1
NITE-780	56	134	78	1	3	3	1	2
NITE-780	56	80	24	1	3	3	1	1
NITE-780	56	57	1	1	3	4	0	1
NITE-780	56	142	86	1	3	3	1	2
NITE-781	56	64	8	1	4	4	1	0
NITE-781	56	77	21	1	3	2	1	2
NITE-781	56	477	421	0	3	3	0	0
NITE-781	56	477	421	0	1	1	0	0
NITE-781	56	81	25	1	3	1	1	2
NITE-781	56	477	421	0	3	1	0	0
NITE-781	57	77	20	1	5	5	1	0
NITE-781	57	477	420	0	3	1	0	0
NITE-781	57	158	101	1	3	1	1	0
NITE-781	57	58	1	1	3	5	1	0
NITE-782	57	477	420	0	3	1	1	0
NITE-782	57	114	57	1	2	4	1	0
NITE-782	57	477	420	0	3	1	0	4
NITE-782	57	205	148	1	3	2	1	4
NITE-782	57	101	44	1	5	1	1	1
NITE-782	57	63	6	1	3	3	1	0
NITE-782	57	477	420	0	4	1	0	0
NITE-782	57	196	139	1	3	4	0	0
NITE-782	57	196	139	1	3	5	0	0
NITE-782	57	102	45	1	3	5	1	0
NITE-783	57	100	43	1	3	5	1	0
NITE-783	57	91	34	1	3	4	1	1
NITE-783	57	477	420	0	2	3	1	1
NITE-783	57	239	182	1	3	4	0	0
NITE-783	57	477	420	0	3	1	0	1
NITE-783	58	59	1	1	4	1	1	0
NITE-783	58	59	1	1	3	1	1	0
NITE-783	58	477	419	0	4	1	0	1
NITE-783	58	394	336	1	3	1	0	0
NITE-783	58	477	419	0	4	1	0	1
NITE-784	58	477	419	0	4	4	0	1
NITE-784	58	477	419	0	3	1	0	0
NITE-784	58	59	1	1	3	5	1	0
NITE-784	58	70	12	1	1	1	1	0
NITE-784	58	136	78	1	3	1	1	0
NITE-784	58	64	6	1	3	1	1	1
NITE-784	58	409	351	1	3	3	0	1
NITE-784	58	477	419	0	2	1	1	1
NITE-784	58	477	419	0	3	1	0	0
NITE-784	58	80	22	1	5	5	1	1
NITE-785	58	477	419	0	3	1	0	0
NITE-785	59	65	6	1	3	1	1	0
NITE-785	59	84	25	1	3	3	1	1
NITE-785	59	477	418	0	3	3	0	1
NITE-785	59	100	41	1	3	3	1	4
NITE-785	59	269	210	1	3	2	1	4
NITE-785	59	477	418	0	3	3	0	1
NITE-785	59	477	418	0	3	4	0	0
NITE-785	59	477	418	0	3	1	0	0
NITE-785	59	409	350	1	3	3	0	1
NITE-786	59	71	12	1	3	3	1	2
NITE-786	60	311	251	1	3	1	1	0
NITE-786	60	74	14	1	3	4	1	0
NITE-786	60	75	15	1	3	5	1	0
NITE-786	60	80	20	1	3	4	1	0
NITE-786	60	61	1	1	3	4	1	0
NITE-786	60	61	1	1	1	3	1	1
NITE-786	60	148	88	1	3	3	1	0
NITE-786	60	477	417	0	3	1	0	0
NITE-786	60	71	11	1	3	4	1	1
NITE-787	60	249	189	1	3	3	1	0
NITE-787	60	100	40	1	3	4	1	0
NITE-787	60	477	417	0	4	3	0	0
NITE-787	60	477	417	0	4	1	0	0
NITE-787	61	477	416	0	3	1	0	0
NITE-787	62	80	18	1	3	4	0	0
NITE-787	62	70	8	1	3	5	1	0
NITE-787	62	97	35	1	4	4	1	1
NITE-787	62	71	9	1	2	3	1	0
NITE-787	63	74	11	1	3	1	1	2
NITE-788	63	65	2	1	3	1	1	0
NITE-788	63	70	7	1	3	3	1	1
NITE-788	63	477	414	0	3	1	1	1
NITE-788	63	477	414	0	3	1	1	0
NITE-788	63	91	28	1	3	2	1	0
NITE-788	63	64	1	1	3	1	1	0
NITE-788	63	64	1	1	3	1	1	0
NITE-788	64	78	14	1	3	5	1	0
NITE-788	64	78	14	1	3	4	1	0
NITE-788	64	65	1	1	3	1	1	0
NITE-789	64	74	10	1	3	1	1	0
NITE-789	64	477	413	0	2	1	0	0
NITE-789	64	477	413	0	4	5	0	1
NITE-789	64	136	72	1	3	2	1	0
NITE-789	65	94	29	1	4	4	1	1
NITE-789	65	72	7	1	3	4	1	1
NITE-789	65	129	64	1	3	1	1	0
NITE-789	65	66	1	1	3	4	1	1
NITE-789	65	72	7	1	3	1	1	1
NITE-789	65	477	412	0	3	3	1	0
NITE-790	65	149	84	1	3	3	1	0
NITE-790	65	477	412	0	3	4	0	1
NITE-790	65	85	20	1	3	3	1	1
NITE-790	66	294	228	1	3	2	1	0
NITE-790	66	98	32	1	3	1	1	1
NITE-790	66	477	411	0	3	1	0	0
NITE-790	66	477	411	0	3	2	0	0
NITE-790	66	109	43	1	1	2	1	0
NITE-790	67	477	410	0	3	1	0	1
NITE-790	68	116	48	1	3	4	1	0
NITE-791	69	112	43	1	3	4	1	4
NITE-791	70	84	14	1	3	3	1	2
NITE-791	70	129	59	1	4	4	1	0
NITE-791	70	477	407	0	3	4	1	1
NITE-791	70	113	43	1	3	4	1	1
NITE-791	70	113	43	1	3	4	1	1
NITE-791	70	77	7	1	2	1	1	0
NITE-791	70	140	70	1	3	3	1	1
NITE-791	70	117	47	1	3	1	1	0
NITE-791	70	98	28	1	3	1	1	0
NITE-792	70	378	308	1	3	3	0	2
NITE-792	70	477	407	0	3	4	0	0
NITE-792	70	477	407	0	3	4	0	0
NITE-792	70	477	407	0	3	4	0	0
NITE-792	70	477	407	0	3	4	0	0
NITE-792	70	477	407	0	3	4	0	0
NITE-792	71	304	233	1	4	1	1	0
NITE-792	71	99	28	1	3	1	1	0
NITE-792	71	84	13	1	3	1	1	0
NITE-792	71	74	3	1	4	1	1	0
NITE-793	71	477	406	0	3	1	0	1
NITE-793	71	91	20	1	5	4	1	0
NITE-793	71	74	3	1	3	5	1	0
NITE-793	71	95	24	1	3	1	1	0
NITE-793	71	477	406	0	3	4	0	1
NITE-793	71	477	406	0	3	4	0	0
NITE-793	71	477	406	0	3	4	0	0
NITE-793	71	135	64	1	3	3	0	1
NITE-793	71	477	406	0	3	4	0	0
NITE-793	71	477	406	0	4	1	1	0
NITE-794	72	98	26	1	3	3	1	0
NITE-794	72	216	144	1	4	4	1	0
NITE-794	72	148	76	1	3	3	1	1
NITE-794	72	280	208	1	3	1	0	1
NITE-794	72	98	26	1	3	1	1	0
NITE-794	72	79	7	1	3	3	0	0
NITE-794	72	109	37	1	3	1	1	0
NITE-794	72	73	1	1	3	1	1	0
NITE-794	72	477	405	0	3	3	1	0
NITE-794	72	80	8	1	3	3	1	1
NITE-795	72	80	8	1	3	3	1	0
NITE-795	72	154	82	1	3	2	1	1
NITE-795	72	434	362	1	3	3	0	0
NITE-795	72	287	215	1	3	3	1	4
NITE-795	72	434	362	1	3	3	0	1
NITE-795	72	317	245	1	3	3	1	0
NITE-795	72	434	362	1	3	3	0	1
NITE-795	72	477	405	0	3	3	0	0
NITE-795	73	98	25	1	3	3	1	0
NITE-795	73	78	5	1	3	1	0	2
NITE-796	73	77	4	1	3	1	0	1
NITE-796	73	151	78	1	3	4	0	0
NITE-796	73	87	14	1	3	1	1	2
NITE-796	73	136	63	1	4	4	1	1
NITE-796	73	74	1	1	3	1	1	0
NITE-796	73	74	1	1	2	1	1	1
NITE-796	73	477	404	0	3	3	0	0
NITE-796	73	238	165	1	3	1	1	0
NITE-796	73	129	56	1	3	1	1	0
NITE-796	73	81	8	1	3	1	1	3
NITE-797	74	75	1	1	3	1	1	0
NITE-797	74	114	40	1	3	3	1	0
NITE-797	74	105	31	1	3	1	1	2
NITE-797	74	107	33	1	2	3	1	3
NITE-797	74	477	403	0	3	3	0	1
NITE-797	74	86	12	1	3	3	1	1
NITE-797	74	78	4	1	3	1	1	2
NITE-797	74	477	403	0	4	4	0	0
NITE-797	74	477	403	0	3	1	0	0
NITE-797	77	80	3	1	3	3	1	0
NITE-798	77	78	1	1	3	1	0	0
NITE-798	77	280	203	1	3	1	0	0
NITE-798	77	477	400	0	3	1	0	0
NITE-798	77	101	24	1	3	3	1	1
NITE-798	77	78	1	1	3	3	1	1
NITE-798	77	350	273	1	3	3	0	0
NITE-798	77	123	46	1	3	4	1	0
NITE-798	77	91	14	1	3	1	1	0
NITE-798	77	95	18	1	3	3	1	0
NITE-798	77	79	2	1	3	1	1	0
NITE-799	77	87	10	1	3	4	1	1
NITE-799	77	259	182	1	3	3	1	3
NITE-799	77	129	52	1	3	2	1	0
NITE-799	78	340	262	1	3	1	1	0
NITE-799	78	477	399	0	4	4	0	1
NITE-799	78	477	399	0	4	2	0	0
NITE-799	78	101	23	1	4	4	1	1
NITE-799	78	477	399	0	3	4	0	2
NITE-799	78	422	344	1	3	4	0	2
NITE-799	78	130	52	1	3	3	1	0
NITE-800	78	113	35	1	2	1	1	1
NITE-800	79	477	398	0	4	4	1	0
NITE-800	79	81	2	1	3	3	1	1
NITE-800	79	477	398	0	3	1	1	0
NITE-800	79	84	5	1	3	1	1	0
NITE-800	79	80	1	1	3	5	1	0
NITE-800	79	294	215	1	3	4	1	3
NITE-800	79	80	1	1	3	1	1	0
NITE-800	80	81	1	1	3	4	1	0
NITE-800	80	409	329	1	3	1	0	1
NITE-801	80	477	397	0	3	4	1	0
NITE-801	80	91	11	1	3	1	1	0
NITE-801	80	112	32	1	3	4	1	0
NITE-801	80	112	32	1	3	4	1	0
NITE-801	80	178	98	1	3	5	0	0
NITE-801	80	98	18	1	3	1	1	0
NITE-801	80	407	327	1	3	3	0	0
NITE-801	80	107	27	1	3	4	1	1
NITE-801	80	95	15	1	3	4	1	0
NITE-801	80	91	11	1	3	1	1	0
NITE-802	80	477	397	0	3	4	0	0
NITE-802	80	106	26	1	3	1	1	2
NITE-802	80	266	186	1	3	1	1	1
NITE-802	80	477	397	0	3	1	0	1
NITE-802	80	477	397	0	4	3	0	0
NITE-802	80	87	7	1	3	1	1	0
NITE-802	80	477	397	0	3	5	0	0
NITE-802	81	477	396	0	3	1	1	0
NITE-802	81	477	396	0	4	5	0	0
NITE-802	81	238	157	1	4	1	1	0
NITE-803	81	477	396	0	3	1	0	0
NITE-803	81	196	115	1	3	1	1	3
NITE-803	81	122	41	1	3	3	1	1
NITE-803	81	106	25	1	3	1	1	0
NITE-803	81	85	4	1	3	3	1	3
NITE-803	81	87	6	1	3	1	0	0
NITE-803	81	84	3	1	3	5	1	0
NITE-803	81	155	74	1	3	5	1	1
NITE-803	81	477	396	0	3	5	0	0
NITE-803	81	144	63	1	3	4	1	3
NITE-804	82	84	2	1	3	2	1	0
NITE-804	82	127	45	1	4	2	1	0
NITE-804	84	101	17	1	3	3	1	2
NITE-804	84	477	393	0	3	1	0	0
NITE-804	84	91	7	1	4	1	1	0
NITE-804	84	95	11	1	3	1	0	1
NITE-804	84	101	17	1	2	5	0	1
NITE-804	84	477	393	0	3	4	0	0
NITE-804	84	106	22	1	3	1	1	0
NITE-804	84	95	11	1	3	1	1	0
NITE-805	84	92	8	1	3	3	1	1
NITE-805	84	477	393	0	3	1	0	0
NITE-805	85	115	30	1	4	4	1	0
NITE-805	85	88	3	1	3	1	1	0
NITE-805	85	140	55	1	3	4	1	0
NITE-805	85	414	329	1	4	1	1	3
NITE-805	85	477	392	0	3	1	0	0
NITE-805	85	477	392	0	3	4	0	1
NITE-805	85	99	14	1	3	5	0	1
NITE-805	85	100	15	1	3	4	1	1
NITE-806	85	417	332	1	3	1	1	3
NITE-806	86	477	391	0	3	1	1	0
NITE-806	86	98	12	1	3	4	1	0
NITE-806	86	477	391	0	4	4	1	0
NITE-806	86	91	5	1	5	1	0	0
NITE-806	86	87	1	1	3	1	1	1
NITE-806	86	114	28	1	3	1	1	1
NITE-806	86	477	391	0	3	3	0	0
NITE-806	86	87	1	1	3	1	1	0
NITE-806	86	99	13	1	3	4	1	0
NITE-807	86	134	48	1	3	4	1	0
NITE-807	86	92	6	1	3	4	1	0
NITE-807	87	409	322	1	3	1	0	3
NITE-807	87	212	125	1	3	1	1	1
NITE-807	87	113	26	1	3	4	1	1
NITE-807	87	117	30	1	3	4	1	3
NITE-807	87	91	4	1	3	3	1	1
NITE-807	87	109	22	1	3	2	1	1
NITE-807	87	109	22	1	3	2	1	2
NITE-807	87	144	57	1	3	5	1	1
NITE-808	87	91	4	1	4	1	1	0
NITE-808	87	191	104	1	2	2	1	0
NITE-808	88	108	20	1	3	1	1	2
NITE-808	88	477	389	0	3	1	0	0
NITE-808	88	126	38	1	3	4	1	0
NITE-808	88	137	49	1	3	5	1	4
NITE-808	88	114	26	1	3	5	1	1
NITE-808	88	99	11	1	3	1	1	0
NITE-808	88	122	34	1	3	5	1	0
NITE-808	88	149	61	1	3	5	0	0
NITE-809	88	340	252	1	3	2	1	0
NITE-809	88	477	389	0	3	2	0	0
NITE-809	90	477	387	0	3	1	0	0
NITE-809	91	129	38	1	2	2	1	0
NITE-809	91	477	386	0	4	1	0	1
NITE-809	91	92	1	1	3	3	1	0
NITE-809	91	477	386	0	3	2	0	1
NITE-809	91	105	14	1	3	3	1	0
NITE-809	91	477	386	0	4	1	1	0
NITE-809	91	477	386	0	4	1	1	0
NITE-810	91	417	326	1	3	1	1	3
NITE-810	91	99	8	1	3	4	1	0
NITE-810	91	92	1	1	2	5	0	1
NITE-810	91	477	386	0	3	4	1	0
NITE-810	91	477	386	0	3	4	0	0
NITE-810	91	477	386	0	4	1	0	0
NITE-810	91	100	9	1	4	1	1	0
NITE-810	91	477	386	0	3	1	0	1
NITE-810	91	144	53	1	4	1	1	0
NITE-810	91	477	386	0	3	1	0	0
NITE-811	91	101	10	1	4	1	1	0
NITE-811	91	100	9	1	3	4	1	1
NITE-811	91	93	2	1	3	1	1	2
NITE-811	91	477	386	0	3	1	0	0
NITE-811	91	95	4	1	3	4	1	0
NITE-811	91	477	386	0	3	4	0	0
NITE-811	91	107	16	1	2	1	1	0
NITE-811	92	477	385	0	3	4	1	0
NITE-811	92	477	385	0	3	1	1	0
NITE-811	92	477	385	0	3	1	0	0
NITE-812	92	477	385	0	4	5	1	0
NITE-812	92	225	133	1	3	1	0	0
NITE-812	92	107	15	1	3	1	1	0
NITE-812	92	93	1	1	4	1	0	0
NITE-812	92	477	385	0	4	1	0	0
NITE-812	92	477	385	0	2	1	0	0
NITE-812	92	99	7	1	3	1	1	0
NITE-812	92	477	385	0	4	1	0	0
NITE-812	92	93	1	1	2	5	1	0
NITE-812	93	105	12	1	3	1	1	1
NITE-813	93	94	1	1	3	5	1	0
NITE-813	93	203	110	1	3	1	1	0
NITE-813	93	94	1	1	4	4	1	0
NITE-813	93	140	47	1	2	4	1	0
NITE-813	93	109	16	1	3	1	1	0
NITE-813	93	101	8	1	3	3	1	0
NITE-813	93	477	384	0	3	1	0	0
NITE-813	93	477	384	0	3	2	0	0
NITE-813	93	133	40	1	3	1	1	0
NITE-813	94	95	1	1	3	4	1	0
NITE-814	94	106	12	1	3	1	1	0
NITE-814	94	101	7	1	4	4	1	1
NITE-814	94	95	1	1	3	3	1	0
NITE-814	94	107	13	1	3	1	1	0
NITE-814	94	238	144	1	4	1	0	0
NITE-814	94	394	300	1	3	1	1	1
NITE-814	94	269	175	1	5	1	1	3
NITE-814	94	95	1	1	3	3	1	0
NITE-814	94	100	6	1	3	3	1	0
NITE-814	94	255	161	1	3	3	1	3
NITE-815	94	95	1	1	3	3	1	0
NITE-815	94	477	383	0	4	1	0	1
NITE-815	94	477	383	0	3	4	0	0
NITE-815	94	100	6	1	3	1	1	0
NITE-815	94	110	16	1	3	4	1	0
NITE-815	95	98	3	1	3	1	1	0
NITE-815	95	116	21	1	4	3	1	1
NITE-815	95	477	382	0	4	3	0	0
NITE-815	95	247	152	1	4	1	1	0
NITE-815	95	98	3	1	3	3	1	0
NITE-816	95	96	1	1	3	5	1	0
NITE-816	95	136	41	1	2	5	1	0
NITE-816	95	129	34	1	3	4	1	0
NITE-816	95	96	1	1	3	1	1	0
NITE-816	95	99	4	1	3	1	1	2
NITE-816	95	477	382	0	3	1	0	0
NITE-816	95	106	11	1	3	1	1	0
NITE-816	95	129	34	1	3	1	1	0
NITE-816	95	115	20	1	3	4	0	1
NITE-816	95	105	10	1	3	5	1	4
NITE-817	95	115	20	1	3	5	0	1
NITE-817	95	136	41	1	3	2	1	0
NITE-817	98	157	59	1	2	4	1	0
NITE-817	98	126	28	1	3	1	1	2
NITE-817	98	401	303	1	3	1	1	1
NITE-817	98	477	379	0	3	1	0	0
NITE-817	98	101	3	1	3	4	1	1
NITE-817	98	477	379	0	4	4	0	0
NITE-817	98	427	329	1	3	1	1	2
NITE-817	98	212	114	1	3	1	1	0
NITE-818	98	211	113	1	3	1	1	1
NITE-818	98	99	1	1	3	1	1	0
NITE-818	98	184	86	1	3	1	1	2
NITE-818	98	158	60	1	3	1	1	0
NITE-818	98	184	86	1	3	1	1	1
NITE-818	98	477	379	0	2	1	0	0
NITE-818	98	157	59	1	3	3	1	0
NITE-818	98	477	379	0	3	4	0	0
NITE-818	98	204	106	1	3	4	1	0
NITE-818	98	242	144	1	3	4	1	0
NITE-819	98	112	14	1	3	4	1	0
NITE-819	98	112	14	1	3	4	1	1
NITE-819	98	112	14	1	3	4	1	1
NITE-819	98	477	379	0	3	4	0	0
NITE-819	98	477	379	0	3	4	0	0
NITE-819	98	347	249	1	3	3	0	0
NITE-819	98	477	379	0	3	3	0	0
NITE-819	98	477	379	0	3	1	0	0
NITE-819	98	136	38	1	3	3	1	1
NITE-819	99	254	155	1	4	4	1	0
NITE-820	99	106	7	1	3	1	1	0
NITE-820	99	101	2	1	3	3	1	1
NITE-820	99	357	258	1	3	3	1	1
NITE-820	99	182	83	1	3	1	1	0
NITE-820	99	100	1	1	3	1	1	1
NITE-820	99	109	10	1	3	1	1	0
NITE-820	99	133	34	1	3	3	1	1
NITE-820	99	114	15	1	3	3	1	1
NITE-820	99	135	36	1	3	3	1	1
NITE-820	99	477	378	0	3	1	0	0
NITE-821	99	106	7	1	3	1	1	0
NITE-821	99	107	8	1	3	1	1	0
NITE-821	99	347	248	1	3	4	1	1
NITE-821	100	477	377	0	3	4	1	0
NITE-821	100	115	15	1	3	1	1	0
NITE-821	100	113	13	1	3	1	1	0
NITE-821	100	101	1	1	3	4	1	0
NITE-821	100	107	7	1	4	1	1	0
NITE-821	100	109	9	1	3	4	1	0
NITE-821	100	220	120	1	3	1	1	0
NITE-822	100	269	169	1	2	5	1	0
NITE-822	100	101	1	1	3	3	1	1
NITE-822	100	122	22	1	3	2	0	0
NITE-822	100	450	350	1	5	4	1	0
NITE-822	100	477	377	0	2	4	1	0
NITE-822	100	477	377	0	2	4	1	0
NITE-822	100	122	22	1	4	4	1	0
NITE-822	100	477	377	0	3	5	0	1
NITE-822	100	112	12	1	3	4	1	0
NITE-822	100	477	377	0	3	1	0	0
NITE-823	100	101	1	1	1	1	1	0
NITE-823	101	109	8	1	3	1	0	0
NITE-823	101	102	1	1	3	4	1	0
NITE-823	101	102	1	1	3	1	1	0
NITE-823	101	419	318	1	4	4	0	1
NITE-823	101	115	14	1	4	4	1	0
NITE-823	101	113	12	1	3	1	0	0
NITE-823	101	115	14	1	1	1	1	1
NITE-823	101	172	71	1	4	1	1	0
NITE-823	101	122	21	1	3	3	1	1
NITE-824	101	102	1	1	3	1	1	0
NITE-824	101	140	39	1	2	3	1	0
NITE-824	102	105	3	1	4	1	1	0
NITE-824	102	107	5	1	3	1	1	0
NITE-824	102	477	375	0	4	1	1	0
NITE-824	102	105	3	1	4	1	1	0
NITE-824	102	105	3	1	5	1	1	1
NITE-824	102	477	375	0	3	1	0	0
NITE-824	102	103	1	1	3	1	1	0
NITE-824	102	477	375	0	3	4	0	0
NITE-825	102	477	375	0	5	4	0	0
NITE-825	102	273	171	1	4	5	1	0
NITE-825	102	117	15	1	3	1	1	0
NITE-825	102	477	375	0	3	4	0	0
NITE-825	102	477	375	0	3	5	0	3
NITE-825	102	106	4	1	1	1	1	0
NITE-825	102	103	1	1	3	4	1	0
NITE-825	102	106	4	1	4	5	1	0
NITE-825	102	109	7	1	2	5	1	0
NITE-825	102	477	375	0	3	1	0	0
NITE-826	102	477	375	0	3	2	1	0
NITE-826	102	133	31	1	3	5	1	0
NITE-826	102	133	31	1	3	5	0	0
NITE-826	102	133	31	1	3	5	1	0
NITE-826	102	133	31	1	3	5	0	0
NITE-826	102	133	31	1	3	5	0	0
NITE-826	103	140	37	1	4	5	1	0
NITE-826	105	115	10	1	4	4	1	0
NITE-826	105	129	24	1	3	4	1	2
NITE-826	105	129	24	1	3	4	1	1
NITE-827	105	177	72	1	3	4	0	1
NITE-827	105	134	29	1	3	4	1	1
NITE-827	105	129	24	1	3	4	1	1
NITE-827	105	477	372	0	3	3	0	1
NITE-827	105	106	1	1	3	1	1	0
NITE-827	105	112	7	1	3	1	0	1
NITE-827	105	107	2	1	2	5	1	0
NITE-827	105	115	10	1	3	4	1	1
NITE-827	105	122	17	1	2	1	0	0
NITE-827	105	477	372	0	3	1	1	0
NITE-828	105	106	1	1	3	3	1	0
NITE-828	105	350	245	1	3	3	0	1
NITE-828	105	106	1	1	3	4	1	0
NITE-828	105	477	372	0	3	5	1	1
NITE-828	105	477	372	0	3	2	0	1
NITE-828	106	107	1	1	4	1	1	0
NITE-828	106	246	140	1	3	1	1	1
NITE-828	106	107	1	1	4	4	1	0
NITE-828	106	477	371	0	3	1	0	0
NITE-828	106	129	23	1	3	4	1	0
NITE-829	106	477	371	0	3	1	1	0
NITE-829	106	107	1	1	3	1	1	0
NITE-829	106	107	1	1	1	1	1	1
NITE-829	106	477	371	0	4	1	1	0
NITE-829	106	107	1	1	4	4	1	0
NITE-829	106	112	6	1	3	1	1	1
NITE-829	106	477	371	0	4	4	0	0
NITE-829	106	207	101	1	3	1	1	2
NITE-829	106	157	51	1	3	1	1	0
NITE-829	106	477	371	0	3	4	1	0
NITE-830	106	477	371	0	3	5	0	1
NITE-830	106	107	1	1	3	1	1	1
NITE-830	106	107	1	1	3	4	1	0
NITE-830	106	109	3	1	1	4	1	0
NITE-830	106	140	34	1	3	3	1	0
NITE-830	106	148	42	1	3	3	1	0
NITE-830	107	238	131	1	4	1	0	0
NITE-830	107	196	89	1	3	1	1	0
NITE-830	107	477	370	0	3	1	0	0
NITE-830	107	477	370	0	3	1	0	0
NITE-831	107	387	280	1	3	4	0	1
NITE-831	107	156	49	1	3	1	1	0
NITE-831	107	113	6	1	3	1	1	2
NITE-831	107	113	6	1	4	4	1	0
NITE-831	108	114	6	1	4	4	1	0
NITE-831	108	112	4	1	3	1	1	1
NITE-831	108	148	40	1	3	3	1	0
NITE-831	108	109	1	1	3	1	1	0
NITE-831	108	241	133	1	3	1	1	2
NITE-831	108	477	369	0	3	1	0	0
NITE-832	108	136	28	1	3	1	1	0
NITE-832	108	477	369	0	3	1	0	0
NITE-832	108	345	237	1	3	4	1	1
NITE-832	108	112	4	1	3	4	1	0
NITE-832	108	114	6	1	3	1	1	0
NITE-832	108	109	1	1	3	1	1	0
NITE-832	108	110	2	1	3	1	0	1
NITE-832	108	109	1	1	3	5	1	0
NITE-832	108	477	369	0	3	3	0	0
NITE-832	108	126	18	1	5	3	1	1
NITE-833	108	136	28	1	3	3	1	0
NITE-833	108	305	197	1	3	1	1	4
NITE-833	109	117	8	1	3	1	0	0
NITE-833	109	477	368	0	3	1	0	0
NITE-833	109	112	3	1	4	4	1	0
NITE-833	109	282	173	1	3	2	1	4
NITE-833	109	117	8	1	4	5	1	0
NITE-833	109	238	129	1	3	4	1	0
NITE-833	109	477	368	0	3	1	1	0
NITE-833	109	113	4	1	2	1	1	0
NITE-834	109	477	368	0	3	2	0	1
NITE-834	109	477	368	0	3	2	0	1
NITE-834	109	115	6	1	3	1	1	1
NITE-834	109	477	368	0	3	1	0	0
NITE-834	109	218	109	1	4	3	1	1
NITE-834	109	218	109	1	3	3	1	1
NITE-834	109	112	3	1	3	5	1	0
NITE-834	109	122	13	1	2	1	1	1
NITE-834	109	477	368	0	3	1	0	0
NITE-834	109	128	19	1	3	3	1	0
NITE-835	110	136	26	1	4	2	1	0
NITE-835	111	116	5	1	3	1	0	0
NITE-835	111	477	366	0	3	5	1	0
NITE-835	111	112	1	1	2	1	1	0
NITE-835	112	134	22	1	3	1	1	0
NITE-835	112	113	1	1	2	1	1	1
NITE-835	112	477	365	0	3	1	1	1
NITE-835	112	477	365	0	3	1	0	1
NITE-835	112	114	2	1	1	1	1	0
NITE-835	112	477	365	0	3	1	0	0
NITE-836	112	477	365	0	3	4	1	0
NITE-836	112	360	248	1	3	4	1	4
NITE-836	112	360	248	1	3	4	1	2
NITE-836	112	360	248	1	3	4	1	1
NITE-836	112	360	248	1	3	4	1	1
NITE-836	112	477	365	0	3	4	0	0
NITE-836	112	477	365	0	3	4	1	0
NITE-836	112	477	365	0	3	4	0	0
NITE-836	113	459	346	1	4	4	1	0
NITE-836	113	114	1	1	3	1	1	0
NITE-837	113	136	23	1	4	4	1	0
NITE-837	113	196	83	1	3	1	1	4
NITE-837	113	114	1	1	1	1	1	0
NITE-837	113	477	364	0	3	1	0	0
NITE-837	113	114	1	1	2	1	1	1
NITE-837	113	477	364	0	3	1	1	0
NITE-837	113	451	338	1	3	4	1	3
NITE-837	113	477	364	0	3	4	1	1
NITE-837	113	477	364	0	3	1	0	0
NITE-837	113	332	219	1	3	4	1	2
NITE-838	113	477	364	0	3	1	0	1
NITE-838	113	137	24	1	3	5	1	0
NITE-838	113	477	364	0	3	1	0	0
NITE-838	114	477	363	0	3	3	0	0
NITE-838	114	389	275	1	3	3	0	1
NITE-838	114	477	363	0	3	3	0	3
NITE-838	114	316	202	1	3	3	1	1
NITE-838	114	477	363	0	3	1	0	0
NITE-838	114	477	363	0	3	4	0	0
NITE-838	114	477	363	0	3	4	0	0
NITE-839	114	115	1	1	1	1	1	0
NITE-839	114	477	363	0	3	1	1	1
NITE-839	114	477	363	0	3	1	1	0
NITE-839	115	116	1	1	2	1	1	1
NITE-839	115	116	1	1	3	1	1	0
NITE-839	115	123	8	1	3	1	1	0
NITE-839	115	191	76	1	3	4	0	0
NITE-839	115	191	76	1	3	4	0	0
NITE-839	115	191	76	1	3	4	0	0
NITE-839	115	191	76	1	3	4	0	0
NITE-840	115	126	11	1	3	1	1	1
NITE-840	115	117	2	1	2	5	1	1
NITE-840	115	409	294	1	3	4	0	1
NITE-840	115	116	1	1	3	2	1	3
NITE-840	115	116	1	1	3	1	1	0
NITE-840	115	122	7	1	3	1	1	1
NITE-840	115	148	33	1	4	3	1	0
NITE-840	116	385	269	1	5	1	0	2
NITE-840	116	117	1	1	3	1	1	0
NITE-840	116	477	361	0	3	1	1	0
NITE-841	116	324	208	1	4	4	1	0
NITE-841	116	477	361	0	3	4	1	1
NITE-841	116	122	6	1	4	1	1	0
NITE-841	116	123	7	1	4	5	1	0
NITE-841	116	477	361	0	3	4	0	0
NITE-841	116	477	361	0	3	1	1	0
NITE-841	116	117	1	1	3	1	1	1
NITE-841	116	477	361	0	3	1	0	0
NITE-841	117	477	360	0	2	4	0	0
NITE-841	117	477	360	0	3	3	0	0
NITE-842	117	428	311	1	3	5	1	0
NITE-842	117	123	6	1	2	1	1	0
NITE-842	117	129	12	1	3	1	1	0
NITE-842	117	136	19	1	3	1	1	0
NITE-842	117	129	12	1	2	4	1	0
NITE-842	119	477	358	0	3	2	0	0
NITE-842	120	179	59	1	1	1	1	0
NITE-842	120	477	357	0	3	1	0	0
NITE-842	122	178	56	1	3	1	1	0
NITE-842	122	127	5	1	2	1	1	2
NITE-843	122	127	5	1	3	2	1	0
NITE-843	122	477	355	0	3	1	0	0
NITE-843	122	343	221	1	5	4	1	0
NITE-843	122	477	355	0	4	4	0	0
NITE-843	123	127	4	1	3	1	1	0
NITE-843	123	127	4	1	3	1	1	0
NITE-843	123	172	49	1	3	1	1	0
NITE-843	123	129	6	1	1	4	1	0
NITE-843	123	477	354	0	4	1	0	0
NITE-843	123	129	6	1	3	1	1	0
NITE-844	123	477	354	0	3	1	0	0
NITE-844	123	347	224	1	2	4	0	4
NITE-844	126	127	1	1	4	5	0	0
NITE-844	126	156	30	1	3	1	1	0
NITE-844	126	136	10	1	3	3	1	1
NITE-844	126	295	169	1	3	3	0	0
NITE-844	126	217	91	1	3	3	1	0
NITE-844	126	127	1	1	3	1	1	2
NITE-844	126	477	351	0	3	2	0	1
NITE-844	127	280	153	1	3	1	0	0
NITE-845	127	135	8	1	3	4	1	1
NITE-845	127	477	350	0	3	4	0	0
NITE-845	127	128	1	1	1	1	1	1
NITE-845	127	128	1	1	3	1	1	1
NITE-845	127	263	136	1	1	1	1	2
NITE-845	127	191	64	1	3	3	1	0
NITE-845	127	133	6	1	2	4	1	0
NITE-845	127	129	2	1	3	1	1	0
NITE-845	127	477	350	0	3	1	0	0
NITE-845	127	430	303	1	2	1	1	0
NITE-846	129	148	19	1	3	3	1	1
NITE-846	129	263	134	1	2	1	0	2
NITE-846	129	172	43	1	3	1	0	0
NITE-846	129	141	12	1	3	5	0	1
NITE-846	129	137	8	1	2	1	1	0
NITE-846	129	477	348	0	3	1	0	0
NITE-846	129	140	11	1	2	1	0	0
NITE-846	129	156	27	1	4	1	1	0
NITE-846	129	155	26	1	3	4	1	0
NITE-846	129	140	11	1	3	1	1	2
NITE-847	130	477	347	0	4	1	0	0
NITE-847	130	477	347	0	3	4	1	0
NITE-847	130	156	26	1	3	1	1	0
NITE-847	130	477	347	0	3	4	1	0
NITE-847	132	150	18	1	1	1	1	2
NITE-847	133	134	1	1	3	1	1	0
NITE-847	133	134	1	1	2	1	1	1
NITE-847	133	135	2	1	3	1	1	0
NITE-848	133	144	11	1	3	5	1	2
NITE-848	133	477	344	0	3	1	1	0
NITE-848	133	156	23	1	3	4	1	0
NITE-848	133	477	344	0	4	4	0	2
NITE-848	133	394	261	1	3	4	0	1
NITE-848	133	277	144	1	2	5	1	0
NITE-848	133	308	175	1	3	4	1	0
NITE-848	133	134	1	1	3	3	1	0
NITE-848	134	140	6	1	3	1	1	0
NITE-848	134	135	1	1	3	1	1	0
NITE-849	134	193	59	1	3	1	0	1
NITE-849	134	137	3	1	3	4	1	0
NITE-849	134	136	2	1	3	3	1	1
NITE-849	134	226	92	1	3	1	1	0
NITE-849	134	190	56	1	3	2	1	1
NITE-849	134	186	52	1	3	5	1	1
NITE-849	134	477	343	0	3	3	1	0
NITE-849	134	477	343	0	4	1	0	0
NITE-849	134	136	2	1	3	3	1	0
NITE-849	134	135	1	1	3	1	1	0
NITE-850	134	477	343	0	3	4	1	0
NITE-850	134	141	7	1	3	1	1	2
NITE-850	134	477	343	0	3	1	0	0
NITE-850	134	172	38	1	3	4	1	1
NITE-850	135	417	282	1	4	4	0	2
NITE-850	135	477	342	0	3	1	0	0
NITE-850	135	169	34	1	3	1	1	0
NITE-850	135	280	145	1	1	2	1	1
NITE-850	135	136	1	1	3	4	1	0
NITE-850	135	252	117	1	2	3	1	4
NITE-851	135	136	1	1	1	1	1	0
NITE-851	135	140	5	1	3	2	1	1
NITE-851	135	477	342	0	4	3	0	0
NITE-851	135	150	15	1	3	3	1	0
NITE-851	135	136	1	1	3	1	1	0
NITE-851	135	156	21	1	3	1	1	1
NITE-851	135	141	6	1	3	1	1	1
NITE-851	135	477	342	0	3	4	0	1
NITE-851	136	378	242	1	3	4	1	0
NITE-851	136	179	43	1	3	4	1	0
NITE-852	136	137	1	1	3	1	1	0
NITE-852	136	140	4	1	2	1	1	1
NITE-852	136	477	341	0	3	1	0	0
NITE-852	136	477	341	0	4	1	0	0
NITE-852	137	149	12	1	2	3	1	0
NITE-852	137	142	5	1	3	4	1	0
NITE-852	137	191	54	1	3	4	1	0
NITE-852	137	340	203	1	5	4	1	0
NITE-852	137	138	1	1	3	4	1	1
NITE-852	137	164	27	1	3	2	1	1
NITE-853	137	150	13	1	1	1	1	0
NITE-853	137	138	1	1	3	1	1	0
NITE-853	138	382	244	1	4	2	1	0
NITE-853	139	140	1	1	3	1	1	1
NITE-853	140	176	36	1	3	4	1	0
NITE-853	140	477	337	0	3	3	0	0
NITE-853	140	477	337	0	3	4	0	0
NITE-853	140	477	337	0	3	4	0	0
NITE-853	140	255	115	1	3	4	0	0
NITE-853	140	179	39	1	3	4	1	0
NITE-854	140	144	4	1	3	4	1	0
NITE-854	140	477	337	0	3	1	0	0
NITE-854	140	330	190	1	3	4	1	1
NITE-854	140	350	210	1	3	1	0	0
NITE-854	140	141	1	1	2	1	1	0
NITE-854	140	262	122	1	2	1	1	0
NITE-854	140	205	65	1	3	1	1	0
NITE-854	140	144	4	1	3	1	1	1
NITE-854	140	213	73	1	3	3	1	1
NITE-854	140	149	9	1	3	3	1	0
NITE-855	140	477	337	0	4	1	1	0
NITE-855	141	477	336	0	3	4	0	0
NITE-855	141	477	336	0	1	1	1	0
NITE-855	141	205	64	1	3	4	1	0
NITE-855	141	169	28	1	3	4	1	1
NITE-855	141	477	336	0	3	1	0	0
NITE-855	141	224	83	1	3	4	0	0
NITE-855	141	477	336	0	3	4	0	0
NITE-855	141	408	267	1	4	5	1	1
NITE-855	141	267	126	1	2	4	1	2
NITE-856	141	143	2	1	3	4	1	0
NITE-856	141	142	1	1	3	1	1	0
NITE-856	141	168	27	1	3	4	1	1
NITE-856	141	143	2	1	3	4	1	0
NITE-856	141	193	52	1	3	1	1	0
NITE-856	142	149	7	1	3	4	1	0
NITE-856	142	147	5	1	3	2	1	1
NITE-856	142	143	1	1	3	4	1	1
NITE-856	142	477	335	0	3	1	0	0
NITE-857	142	290	148	1	3	4	1	0
NITE-857	142	414	272	1	3	2	1	4
NITE-857	142	477	335	0	3	2	1	0
NITE-857	142	382	240	1	3	2	1	2
NITE-857	142	436	294	1	3	2	1	2
NITE-857	142	414	272	1	3	2	1	2
NITE-857	142	477	335	0	3	2	0	1
NITE-857	142	143	1	1	3	3	1	0
NITE-857	142	477	335	0	3	2	0	2
NITE-857	142	477	335	0	3	3	0	0
NITE-858	142	347	205	1	3	3	1	1
NITE-858	142	206	64	1	3	1	1	1
NITE-858	142	434	292	1	3	4	0	1
NITE-858	142	143	1	1	3	1	1	1
NITE-858	142	143	1	1	3	2	1	0
NITE-858	142	477	335	0	4	3	0	1
NITE-858	142	143	1	1	3	1	1	0
NITE-858	142	156	14	1	3	1	1	0
NITE-858	142	464	322	1	3	1	0	0
NITE-858	142	156	14	1	3	3	1	0
NITE-859	143	409	266	1	3	3	0	0
NITE-859	143	477	334	0	2	1	0	0
NITE-859	143	477	334	0	4	1	0	0
NITE-859	143	175	32	1	3	4	1	0
NITE-859	143	477	334	0	3	3	0	0
NITE-859	143	477	334	0	3	4	1	1
NITE-859	143	477	334	0	3	3	0	0
NITE-859	143	409	266	1	3	3	0	1
NITE-859	143	266	123	1	3	5	1	0
NITE-860	143	409	266	1	3	3	0	0
NITE-860	143	168	25	1	3	4	1	0
NITE-860	143	156	13	1	3	4	1	0
NITE-860	143	151	8	1	3	4	1	0
NITE-860	143	148	5	1	3	5	1	1
NITE-860	143	165	22	1	3	1	1	0
NITE-860	143	176	33	1	3	1	0	0
NITE-860	143	477	334	0	3	1	0	1
NITE-860	143	477	334	0	3	4	1	0
NITE-860	143	434	291	1	3	3	0	0
NITE-861	143	165	22	1	3	1	1	1
NITE-861	143	252	109	1	4	4	0	0
NITE-861	143	144	1	1	3	1	0	1
NITE-861	144	430	286	1	4	4	1	0
NITE-861	144	477	333	0	3	3	1	1
NITE-861	144	164	20	1	2	1	0	0
NITE-861	144	477	333	0	4	4	0	0
NITE-861	147	477	330	0	3	2	1	0
NITE-861	147	477	330	0	3	3	0	0
NITE-861	147	312	165	1	3	1	1	2
NITE-862	147	186	39	1	3	4	1	0
NITE-862	147	477	330	0	3	1	1	1
NITE-862	147	477	330	0	4	1	1	1
NITE-862	147	450	303	1	3	1	0	0
NITE-862	147	148	1	1	4	5	1	1
NITE-862	147	477	330	0	2	1	1	0
NITE-862	147	343	196	1	3	1	1	1
NITE-862	147	477	330	0	3	4	0	0
NITE-862	147	184	37	1	3	4	1	1
NITE-862	147	477	330	0	3	3	1	0
NITE-863	147	381	234	1	3	1	1	0
NITE-863	147	477	330	0	3	1	0	0
NITE-863	147	477	330	0	3	1	1	0
NITE-863	147	477	330	0	3	1	0	0
NITE-863	148	149	1	1	3	4	1	0
NITE-863	148	477	329	0	3	4	1	0
NITE-863	148	149	1	1	3	4	1	0
NITE-863	148	477	329	0	3	1	0	0
NITE-863	148	189	41	1	3	5	1	0
NITE-863	148	316	168	1	4	1	1	1
NITE-864	148	332	184	1	2	1	1	4
NITE-864	148	477	329	0	3	1	1	0
NITE-864	148	156	8	1	3	4	1	0
NITE-864	149	186	37	1	3	1	1	0
NITE-864	149	477	328	0	3	1	0	0
NITE-864	149	477	328	0	3	1	0	1
NITE-864	149	477	328	0	3	1	1	0
NITE-864	149	477	328	0	3	4	0	0
NITE-864	149	477	328	0	3	4	0	0
NITE-864	149	477	328	0	3	4	0	0
NITE-865	149	253	104	1	3	1	1	1
NITE-865	149	150	1	1	3	1	1	0
NITE-865	149	477	328	0	3	1	1	1
NITE-865	149	196	47	1	3	3	1	0
NITE-865	149	249	100	1	3	3	1	0
NITE-865	150	169	19	1	3	4	1	0
NITE-865	150	477	327	0	3	1	0	0
NITE-865	150	165	15	1	3	1	1	1
NITE-865	150	151	1	1	3	1	1	0
NITE-865	150	151	1	1	2	1	1	1
NITE-866	150	477	327	0	3	1	0	0
NITE-866	150	178	28	1	3	1	1	0
NITE-866	150	270	120	1	3	2	1	4
NITE-866	150	156	6	1	3	2	1	1
NITE-866	150	151	1	1	3	2	1	1
NITE-866	150	252	102	1	3	2	1	3
NITE-866	150	151	1	1	3	2	1	3
NITE-866	150	155	5	1	3	2	1	2
NITE-866	150	157	7	1	3	2	1	4
NITE-866	150	196	46	1	3	2	1	2
NITE-867	150	287	137	1	3	2	1	4
NITE-867	150	249	99	1	1	3	1	1
NITE-867	150	477	327	0	2	3	1	0
NITE-867	150	225	75	1	2	1	1	2
NITE-867	150	477	327	0	2	1	0	0
NITE-867	150	154	4	1	4	5	1	0
NITE-867	151	176	25	1	2	1	1	0
NITE-867	151	477	326	0	3	4	0	0
NITE-867	151	178	27	1	4	1	1	0
NITE-867	151	267	116	1	3	2	1	1
NITE-868	151	214	63	1	3	2	1	1
NITE-868	151	183	32	1	2	4	1	3
NITE-868	151	155	4	1	3	1	1	2
NITE-868	151	196	45	1	3	1	1	1
NITE-868	151	197	46	1	3	1	1	0
NITE-868	154	156	2	1	2	1	1	0
NITE-868	154	220	66	1	3	1	0	0
NITE-868	154	163	9	1	3	5	1	0
NITE-868	154	477	323	0	2	1	1	1
NITE-868	154	477	323	0	3	1	0	0
NITE-869	154	155	1	1	3	1	1	0
NITE-869	154	155	1	1	3	1	1	0
NITE-869	154	477	323	0	3	1	0	0
NITE-869	154	155	1	1	3	1	1	1
NITE-869	154	155	1	1	3	1	1	1
NITE-869	154	477	323	0	2	3	1	0
NITE-869	155	156	1	1	4	1	1	0
NITE-869	155	212	57	1	1	1	1	0
NITE-869	155	477	322	0	3	1	0	0
NITE-869	155	171	16	1	3	1	1	0
NITE-870	155	477	322	0	3	4	0	0
NITE-870	155	156	1	1	2	1	1	1
NITE-870	155	157	2	1	3	1	1	0
NITE-870	155	185	30	1	3	3	0	1
NITE-870	155	169	14	1	3	5	1	0
NITE-870	155	205	50	1	3	5	1	0
NITE-870	155	157	2	1	3	1	1	0
NITE-870	155	168	13	1	3	1	1	0
NITE-870	155	169	14	1	3	5	1	0
NITE-870	155	172	17	1	3	5	1	0
NITE-871	155	477	322	0	3	1	0	0
NITE-871	155	158	3	1	3	1	1	1
NITE-871	155	164	9	1	4	1	0	0
NITE-871	155	213	58	1	3	5	1	1
NITE-871	155	213	58	1	3	5	1	1
NITE-871	156	477	321	0	3	1	0	1
NITE-871	156	477	321	0	3	4	0	4
NITE-871	156	330	174	1	3	4	1	0
NITE-871	156	477	321	0	2	1	1	0
NITE-872	156	477	321	0	3	1	0	0
NITE-872	156	157	1	1	3	1	1	0
NITE-872	156	164	8	1	3	1	1	0
NITE-872	156	477	321	0	3	4	1	0
NITE-872	156	221	65	1	3	1	1	0
NITE-872	156	339	183	1	3	4	0	1
NITE-872	156	477	321	0	3	4	0	0
NITE-872	156	165	9	1	3	5	1	1
NITE-872	157	477	320	0	2	1	1	0
NITE-872	157	477	320	0	3	1	0	0
NITE-873	157	158	1	1	2	1	0	0
NITE-873	157	477	320	0	3	3	0	0
NITE-873	157	477	320	0	3	4	0	1
NITE-873	157	477	320	0	3	4	0	0
NITE-873	157	477	320	0	3	1	0	1
NITE-873	157	318	161	1	3	1	1	0
NITE-873	157	163	6	1	3	4	1	0
NITE-873	157	185	28	1	3	4	1	1
NITE-873	157	193	36	1	3	4	1	1
NITE-873	157	158	1	1	3	1	1	0
NITE-874	157	172	15	1	1	4	1	1
NITE-874	157	176	19	1	3	5	1	0
NITE-874	157	175	18	1	3	5	1	1
NITE-874	157	266	109	1	3	1	1	0
NITE-874	158	477	319	0	4	1	0	0
NITE-874	158	196	38	1	3	4	1	0
NITE-874	158	182	24	1	3	1	1	1
NITE-874	158	183	25	1	3	1	1	1
NITE-874	158	165	7	1	3	4	1	0
NITE-874	158	170	12	1	3	4	1	1
NITE-875	158	477	319	0	3	1	1	0
NITE-875	158	164	6	1	3	1	1	0
NITE-875	158	177	19	1	2	1	1	1
NITE-875	158	477	319	0	3	4	0	0
NITE-875	158	186	28	1	3	1	1	0
NITE-875	158	168	10	1	3	1	1	0
NITE-875	158	210	52	1	3	4	1	0
NITE-875	158	168	10	1	3	1	0	0
NITE-875	159	160	1	1	4	1	1	0
NITE-875	159	477	318	0	3	4	1	0
NITE-876	159	477	318	0	3	4	0	0
NITE-876	159	226	67	1	3	4	1	0
NITE-876	159	477	318	0	3	4	0	0
NITE-876	159	164	5	1	3	1	1	0
NITE-876	159	160	1	1	3	1	1	0
NITE-876	159	323	164	1	3	1	1	0
NITE-876	159	380	221	1	3	4	1	0
NITE-876	159	358	199	1	1	1	1	1
NITE-876	159	176	17	1	1	1	1	0
NITE-876	159	169	10	1	1	1	1	2
NITE-877	159	263	104	1	1	1	1	0
NITE-877	159	477	318	0	1	1	1	0
NITE-877	161	477	316	0	1	1	0	0
NITE-877	161	162	1	1	3	1	0	0
NITE-877	161	196	35	1	3	1	1	0
NITE-877	162	477	315	0	3	1	0	0
NITE-877	162	192	30	1	4	1	1	1
NITE-877	163	477	314	0	3	4	0	0
NITE-877	163	207	44	1	3	1	1	0
NITE-877	163	477	314	0	4	4	0	0
NITE-878	163	184	21	1	2	1	1	0
NITE-878	163	164	1	1	3	4	1	0
NITE-878	163	340	177	1	4	1	1	0
NITE-878	163	203	40	1	3	1	1	1
NITE-878	163	477	314	0	2	1	1	0
NITE-878	163	477	314	0	3	1	1	1
NITE-878	163	477	314	0	3	1	0	0
NITE-878	164	165	1	1	3	1	1	1
NITE-878	164	477	313	0	3	1	0	0
NITE-878	164	168	4	1	2	4	1	0
NITE-879	164	359	195	1	3	1	0	1
NITE-879	164	204	40	1	3	1	1	0
NITE-879	164	170	6	1	3	2	1	1
NITE-879	164	477	313	0	3	4	1	0
NITE-879	164	189	25	1	3	2	1	2
NITE-879	164	171	7	1	3	2	1	1
NITE-879	164	477	313	0	3	4	0	0
NITE-879	164	210	46	1	3	1	1	1
NITE-879	164	169	5	1	3	4	1	0
NITE-879	164	212	48	1	3	1	1	0
NITE-880	164	165	1	1	3	3	1	0
NITE-880	164	477	313	0	4	3	1	1
NITE-880	164	477	313	0	1	4	1	0
NITE-880	164	280	116	1	1	4	1	0
NITE-880	164	168	4	1	1	3	1	1
NITE-880	165	477	312	0	4	4	0	0
NITE-880	165	168	3	1	3	1	1	0
NITE-880	165	172	7	1	1	3	1	0
NITE-880	165	169	4	1	3	4	1	0
NITE-880	165	477	312	0	3	4	1	0
NITE-881	165	477	312	0	3	4	0	0
NITE-881	165	477	312	0	3	1	0	1
NITE-881	168	169	1	1	5	5	0	0
NITE-881	168	172	4	1	3	4	1	0
NITE-881	168	169	1	1	2	1	0	0
NITE-881	168	169	1	1	4	4	1	0
NITE-881	168	175	7	1	3	4	1	0
NITE-881	168	175	7	1	3	4	1	0
NITE-881	168	175	7	1	3	4	1	0
NITE-881	168	175	7	1	3	4	1	0
NITE-882	168	196	28	1	4	4	1	0
NITE-882	168	182	14	1	4	5	1	0
NITE-882	168	477	309	0	3	1	0	0
NITE-882	168	477	309	0	3	1	1	2
NITE-882	169	477	308	0	3	1	0	0
NITE-882	169	170	1	1	3	1	1	1
NITE-882	169	186	17	1	3	1	1	0
NITE-882	169	477	308	0	3	4	1	1
NITE-882	169	246	77	1	3	1	1	0
NITE-883	169	252	83	1	3	4	0	0
NITE-883	169	172	3	1	3	1	1	0
NITE-883	169	252	83	1	3	4	0	0
NITE-883	169	477	308	0	3	1	0	0
NITE-883	169	255	86	1	3	1	1	2
NITE-883	169	266	97	1	4	1	1	0
NITE-883	169	175	6	1	3	1	1	0
NITE-883	170	373	203	1	3	1	0	1
NITE-883	170	171	1	1	3	1	1	0
NITE-883	170	477	307	0	3	4	0	0
NITE-884	170	175	5	1	3	2	1	2
NITE-884	170	400	230	1	3	1	1	4
NITE-884	171	252	81	1	4	1	1	0
NITE-884	171	206	35	1	4	1	1	0
NITE-884	171	477	306	0	3	4	1	0
NITE-884	171	477	306	0	3	1	1	0
NITE-884	171	477	306	0	3	4	1	0
NITE-884	171	177	6	1	3	1	1	0
NITE-884	171	477	306	0	3	4	1	0
NITE-884	171	343	172	1	3	4	0	4
NITE-885	171	477	306	0	4	2	1	0
NITE-885	172	477	305	0	3	4	1	0
NITE-885	172	477	305	0	3	4	1	0
NITE-885	172	197	25	1	3	1	1	1
NITE-885	172	477	305	0	3	1	0	0
NITE-885	172	261	89	1	3	1	1	0
NITE-885	172	477	305	0	3	1	1	0
NITE-885	172	178	6	1	3	1	1	0
NITE-885	172	179	7	1	3	1	1	0
NITE-885	172	228	56	1	3	4	1	0
NITE-886	172	178	6	1	3	1	1	1
NITE-886	172	193	21	1	4	4	0	0
NITE-886	172	477	305	0	3	1	1	0
NITE-886	172	192	20	1	3	1	1	2
NITE-886	172	175	3	1	3	1	0	0
NITE-886	174	422	248	1	3	3	0	1
NITE-886	175	477	302	0	3	1	0	0
NITE-886	175	321	146	1	3	4	1	4
NITE-886	175	176	1	1	3	1	1	0
NITE-886	175	213	38	1	2	1	1	0
NITE-887	175	281	106	1	3	5	1	0
NITE-887	175	341	166	1	3	5	1	0
NITE-887	175	477	302	0	3	3	0	1
NITE-887	175	298	123	1	3	4	1	3
NITE-887	176	477	301	0	2	1	0	0
NITE-887	176	375	199	1	4	4	0	0
NITE-887	176	465	289	1	3	1	0	0
NITE-887	176	477	301	0	3	1	0	0
NITE-887	176	477	301	0	3	1	1	0
NITE-887	176	295	119	1	2	1	1	0
NITE-888	176	477	301	0	3	4	1	0
NITE-888	176	477	301	0	3	1	0	0
NITE-888	176	477	301	0	3	1	0	0
NITE-888	176	477	301	0	3	1	0	0
NITE-888	177	477	300	0	3	1	0	0
NITE-888	177	477	300	0	3	1	1	0
NITE-888	177	245	68	1	3	1	1	0
NITE-888	177	409	232	1	3	1	1	0
NITE-888	177	220	43	1	3	1	1	2
NITE-888	177	178	1	1	1	1	1	0
NITE-889	177	477	300	0	1	1	0	0
NITE-889	178	179	1	1	3	4	1	0
NITE-889	178	203	25	1	2	1	1	0
NITE-889	178	477	299	0	3	1	0	2
NITE-889	178	399	221	1	4	4	1	0
NITE-889	178	477	299	0	3	1	0	0
NITE-889	179	306	127	1	4	1	1	0
NITE-889	179	196	17	1	2	1	1	0
NITE-889	179	189	10	1	3	4	1	0
NITE-889	179	184	5	1	3	1	1	0
NITE-890	179	212	33	1	1	1	1	0
NITE-890	179	183	4	1	3	1	0	0
NITE-890	180	301	121	1	3	1	1	2
NITE-890	181	332	151	1	3	1	1	1
NITE-890	182	186	4	1	2	1	1	0
NITE-890	182	191	9	1	3	1	1	1
NITE-890	182	200	18	1	3	4	1	2
NITE-890	182	190	8	1	3	4	1	1
NITE-890	182	477	295	0	2	1	0	0
NITE-890	182	477	295	0	3	3	0	0
NITE-891	182	184	2	1	2	1	1	2
NITE-891	182	362	180	1	3	1	1	0
NITE-891	183	193	10	1	3	1	1	3
NITE-891	183	477	294	0	3	4	1	0
NITE-891	183	212	29	1	3	1	0	1
NITE-891	183	248	65	1	3	1	1	3
NITE-891	183	477	294	0	4	4	0	0
NITE-891	183	477	294	0	3	1	0	1
NITE-891	183	477	294	0	3	1	0	0
NITE-891	183	226	43	1	3	1	1	0
NITE-892	183	233	50	1	3	1	1	0
NITE-892	183	477	294	0	3	4	1	0
NITE-892	183	199	16	1	2	1	1	0
NITE-892	184	221	37	1	3	4	1	0
NITE-892	184	207	23	1	3	2	1	1
NITE-892	184	185	1	1	3	3	1	0
NITE-892	184	228	44	1	3	1	1	4
NITE-892	184	249	65	1	3	1	1	4
NITE-892	184	203	19	1	3	1	0	1
NITE-892	184	198	14	1	3	1	1	0
NITE-893	184	264	80	1	3	1	1	0
NITE-893	184	477	293	0	3	1	0	0
NITE-893	185	186	1	1	3	1	1	2
NITE-893	185	270	85	1	3	1	1	1
NITE-893	185	206	21	1	4	4	1	1
NITE-893	185	248	63	1	4	3	1	0
NITE-893	185	204	19	1	3	1	0	0
NITE-893	185	193	8	1	3	1	1	0
NITE-893	185	212	27	1	3	1	1	0
NITE-894	185	477	292	0	3	5	0	1
NITE-894	185	477	292	0	3	1	0	1
NITE-894	185	191	6	1	3	1	1	0
NITE-894	185	215	30	1	3	1	0	0
NITE-894	185	205	20	1	3	4	1	0
NITE-894	185	191	6	1	3	1	1	0
NITE-894	185	191	6	1	2	1	1	0
NITE-894	186	187	1	1	3	4	1	0
NITE-894	186	477	291	0	4	2	0	1
NITE-894	186	477	291	0	3	1	0	0
NITE-895	186	270	84	1	4	1	1	0
NITE-895	186	477	291	0	3	3	0	1
NITE-895	186	477	291	0	3	4	0	0
NITE-895	186	296	110	1	3	5	0	0
NITE-895	186	477	291	0	3	1	0	0
NITE-895	186	191	5	1	3	1	1	0
NITE-895	187	189	2	1	4	1	1	0
NITE-895	187	193	6	1	3	1	1	1
NITE-895	189	204	15	1	4	4	1	1
NITE-895	189	190	1	1	3	4	1	0
NITE-896	189	477	288	0	3	1	0	0
NITE-896	189	190	1	1	1	1	0	0
NITE-896	189	192	3	1	3	1	1	0
NITE-896	189	477	288	0	3	1	0	0
NITE-896	189	477	288	0	3	4	0	0
NITE-896	189	191	2	1	3	4	1	0
NITE-896	189	266	77	1	3	1	1	1
NITE-896	189	477	288	0	3	2	0	0
NITE-896	190	203	13	1	3	1	1	0
NITE-896	190	191	1	1	3	5	0	0
NITE-897	190	477	287	0	3	3	0	0
NITE-897	190	235	45	1	3	1	1	1
NITE-897	190	287	97	1	3	4	1	0
NITE-897	190	211	21	1	3	4	1	0
NITE-897	190	477	287	0	3	3	0	0
NITE-897	190	197	7	1	3	1	1	0
NITE-897	190	205	15	1	5	4	1	0
NITE-897	190	205	15	1	1	4	1	0
NITE-897	190	477	287	0	3	1	0	1
NITE-897	191	192	1	1	3	1	1	0
NITE-898	191	192	1	1	3	1	1	0
NITE-898	191	207	16	1	3	4	1	0
NITE-898	191	218	27	1	3	4	1	1
NITE-898	191	477	286	0	3	5	1	0
NITE-898	191	206	15	1	3	1	0	1
NITE-898	191	477	286	0	3	4	1	1
NITE-898	191	246	55	1	3	1	1	1
NITE-898	192	193	1	1	5	1	1	0
NITE-898	192	193	1	1	4	1	1	0
NITE-899	192	205	13	1	3	1	1	0
NITE-899	192	193	1	1	3	4	0	1
NITE-899	192	197	5	1	4	1	1	1
NITE-899	192	207	15	1	3	3	1	0
NITE-899	192	277	85	1	3	3	1	0
NITE-899	192	196	4	1	2	1	1	2
NITE-899	193	238	45	1	3	1	0	0
NITE-899	193	477	284	0	3	4	0	0
NITE-899	193	203	10	1	3	5	1	1
NITE-899	193	255	62	1	3	1	1	1
NITE-900	193	196	3	1	3	1	0	2
NITE-900	193	477	284	0	2	1	0	0
NITE-900	193	197	4	1	3	1	1	0
NITE-900	193	477	284	0	4	4	1	0
NITE-900	193	220	27	1	2	5	1	2
NITE-900	193	477	284	0	3	5	1	1
NITE-900	196	477	281	0	3	2	0	0
NITE-900	196	477	281	0	3	1	0	0
NITE-900	196	477	281	0	3	2	1	0
NITE-900	196	302	106	1	3	1	1	0
NITE-901	196	304	108	1	3	3	1	0
NITE-901	196	477	281	0	3	4	1	0
NITE-901	196	197	1	1	3	1	1	2
NITE-901	196	197	1	1	3	1	1	1
NITE-901	197	198	1	1	3	1	1	0
NITE-901	197	477	280	0	3	1	1	0
NITE-901	197	477	280	0	3	1	0	0
NITE-901	197	477	280	0	3	4	0	0
NITE-901	197	198	1	1	3	1	1	0
NITE-901	197	477	280	0	3	1	0	0
NITE-902	197	213	16	1	4	3	1	1
NITE-902	197	199	2	1	3	4	1	0
NITE-902	197	260	63	1	3	1	1	0
NITE-902	197	338	141	1	4	4	1	0
NITE-902	197	219	22	1	4	5	1	0
NITE-902	197	198	1	1	3	1	1	0
NITE-902	197	477	280	0	3	1	1	1
NITE-902	198	477	279	0	4	4	0	0
NITE-902	198	232	34	1	3	4	1	1
NITE-902	198	199	1	1	3	5	1	0
NITE-903	198	262	64	1	1	3	1	0
NITE-903	198	228	30	1	3	1	1	0
NITE-903	199	442	243	1	4	3	0	0
NITE-903	199	477	278	0	3	2	0	0
NITE-903	199	211	12	1	3	4	1	1
NITE-903	199	203	4	1	3	4	1	0
NITE-903	199	205	6	1	3	4	1	1
NITE-903	200	477	277	0	3	2	0	0
NITE-903	200	205	5	1	3	1	1	0
NITE-903	200	201	1	1	3	1	1	0
NITE-904	200	205	5	1	3	1	1	0
NITE-904	200	205	5	1	2	1	1	0
NITE-904	200	203	3	1	2	1	1	0
NITE-904	200	214	14	1	3	1	1	0
NITE-904	200	226	26	1	3	4	1	2
NITE-904	200	477	277	0	3	1	1	0
NITE-904	200	206	6	1	3	4	1	1
NITE-904	201	203	2	1	3	4	1	0
NITE-904	201	203	2	1	3	1	0	2
NITE-904	202	203	1	1	3	4	1	0
NITE-905	203	221	18	1	3	1	1	1
NITE-905	203	204	1	1	3	5	1	0
NITE-905	203	477	274	0	3	4	0	0
NITE-905	203	228	25	1	2	1	1	2
NITE-905	203	246	43	1	3	1	1	0
NITE-905	203	204	1	1	3	1	1	1
NITE-905	203	224	21	1	3	5	1	0
NITE-905	203	204	1	1	3	4	1	0
NITE-905	203	207	4	1	3	4	1	0
NITE-905	204	282	78	1	4	1	1	0
NITE-906	204	205	1	1	5	3	1	0
NITE-906	204	477	273	0	4	4	0	0
NITE-906	204	434	230	1	3	4	0	0
NITE-906	204	205	1	1	1	1	1	0
NITE-906	204	214	10	1	3	4	1	0
NITE-906	204	219	15	1	3	4	1	0
NITE-906	204	205	1	1	3	3	1	0
NITE-906	204	477	273	0	3	4	1	0
NITE-906	204	477	273	0	1	1	1	0
NITE-906	204	205	1	1	3	1	1	0
NITE-907	204	205	1	1	3	3	1	0
NITE-907	205	477	272	0	4	1	0	0
NITE-907	205	477	272	0	3	4	0	0
NITE-907	205	213	8	1	3	4	1	3
NITE-907	205	256	51	1	3	1	1	0
NITE-907	205	360	155	1	3	3	1	1
NITE-907	205	477	272	0	3	3	1	3
NITE-907	205	477	272	0	3	3	0	0
NITE-907	205	477	272	0	3	4	0	0
NITE-907	205	477	272	0	3	2	0	0
NITE-908	205	206	1	1	3	1	1	0
NITE-908	205	477	272	0	3	1	0	0
NITE-908	205	290	85	1	3	1	1	1
NITE-908	205	206	1	1	3	1	1	0
NITE-908	205	248	43	1	3	1	1	0
NITE-908	206	214	8	1	3	1	1	0
NITE-908	206	253	47	1	3	1	1	1
NITE-908	206	477	271	0	3	5	1	0
NITE-908	206	477	271	0	3	4	1	0
NITE-908	206	207	1	1	4	1	1	0
NITE-909	206	477	271	0	2	1	1	0
NITE-909	206	477	271	0	3	3	1	1
NITE-909	206	477	271	0	3	4	0	0
NITE-909	206	248	42	1	3	1	1	1
NITE-909	206	477	271	0	4	1	1	0
NITE-909	206	477	271	0	3	1	0	0
NITE-909	206	212	6	1	2	1	1	0
NITE-909	206	477	271	0	3	1	0	0
NITE-909	206	249	43	1	3	1	0	1
NITE-909	206	477	271	0	3	1	0	0
NITE-910	206	211	5	1	3	4	1	1
NITE-910	207	211	4	1	3	1	1	0
NITE-910	207	211	4	1	3	3	1	0
NITE-910	207	211	4	1	3	1	1	0
NITE-910	207	211	4	1	3	4	1	0
NITE-910	207	211	4	1	3	4	1	0
NITE-910	207	211	4	1	3	4	1	0
NITE-910	207	477	270	0	3	1	0	0
NITE-910	207	477	270	0	3	2	0	0
NITE-910	207	477	270	0	3	2	0	0
NITE-911	207	477	270	0	4	1	0	0
NITE-911	207	213	6	1	2	4	1	0
NITE-911	207	477	270	0	3	2	0	0
NITE-911	207	477	270	0	3	4	1	0
NITE-911	207	211	4	1	3	1	1	1
NITE-911	207	210	3	1	3	1	0	0
NITE-911	207	241	34	1	3	4	1	0
NITE-911	209	210	1	1	3	4	0	0
NITE-911	210	211	1	1	4	1	1	0
NITE-911	210	477	267	0	4	4	0	0
NITE-912	210	375	165	1	3	1	1	0
NITE-912	210	477	267	0	3	4	0	0
NITE-912	210	346	136	1	3	1	0	0
NITE-912	210	231	21	1	3	3	1	0
NITE-912	210	219	9	1	3	3	1	1
NITE-912	210	224	14	1	3	4	1	1
NITE-912	210	282	72	1	3	3	1	1
NITE-912	210	211	1	1	3	1	1	0
NITE-912	210	477	267	0	3	1	0	1
NITE-912	210	213	3	1	2	1	1	0
NITE-913	210	211	1	1	3	1	1	0
NITE-913	210	225	15	1	3	3	1	0
NITE-913	210	231	21	1	3	3	1	0
NITE-913	210	283	73	1	3	1	1	1
NITE-913	210	214	4	1	3	1	1	0
NITE-913	210	477	267	0	3	1	0	0
NITE-913	211	212	1	1	4	1	1	0
NITE-913	211	212	1	1	4	1	1	0
NITE-913	211	477	266	0	3	1	1	2
NITE-913	211	212	1	1	3	1	1	0
NITE-914	211	477	266	0	4	1	0	0
NITE-914	211	246	35	1	3	3	1	3
NITE-914	211	477	266	0	3	1	0	0
NITE-914	211	477	266	0	4	1	0	0
NITE-914	211	477	266	0	3	1	0	1
NITE-914	211	329	118	1	3	4	1	0
NITE-914	211	219	8	1	3	3	1	2
NITE-914	211	238	27	1	2	1	1	2
NITE-914	211	214	3	1	3	4	1	1
NITE-914	211	357	146	1	4	3	1	0
NITE-915	212	477	265	0	3	1	0	0
NITE-915	212	213	1	1	3	1	1	0
NITE-915	212	477	265	0	4	4	0	0
NITE-915	212	477	265	0	3	1	0	0
NITE-915	212	213	1	1	3	1	1	0
NITE-915	212	290	78	1	3	1	1	0
NITE-915	212	477	265	0	2	1	0	0
NITE-915	212	214	2	1	3	1	1	0
NITE-915	212	260	48	1	3	2	1	2
NITE-915	212	214	2	1	3	1	1	1
NITE-916	213	477	264	0	4	1	1	0
NITE-916	213	249	36	1	3	4	1	0
NITE-916	213	262	49	1	2	1	1	0
NITE-916	213	214	1	1	4	1	1	0
NITE-916	213	477	264	0	3	1	1	0
NITE-916	213	477	264	0	4	1	1	0
NITE-916	213	477	264	0	4	1	0	0
NITE-916	213	477	264	0	3	1	0	0
NITE-916	213	477	264	0	3	1	0	0
NITE-916	213	228	15	1	3	1	1	1
NITE-917	213	214	1	1	3	5	1	0
NITE-917	213	412	199	1	2	3	1	4
NITE-917	213	477	264	0	4	1	0	0
NITE-917	213	477	264	0	3	1	0	0
NITE-917	213	477	264	0	3	1	0	0
NITE-917	213	477	264	0	3	1	0	1
NITE-917	214	217	3	1	3	1	1	0
NITE-917	214	215	1	1	3	5	1	0
NITE-917	214	221	7	1	1	1	1	3
NITE-917	214	215	1	1	3	3	1	0
NITE-918	214	234	20	1	3	1	1	0
NITE-918	214	477	263	0	3	1	0	1
NITE-918	214	477	263	0	3	4	0	0
NITE-918	214	238	24	1	3	1	1	0
NITE-918	214	477	263	0	1	1	1	0
NITE-918	214	253	39	1	2	1	1	1
NITE-918	214	227	13	1	3	4	1	0
NITE-918	216	219	3	1	3	1	0	0
NITE-918	216	233	17	1	3	1	1	0
NITE-918	217	477	260	0	3	1	0	0
NITE-919	217	477	260	0	4	4	0	1
NITE-919	217	218	1	1	3	3	1	1
NITE-919	217	354	137	1	3	4	0	2
NITE-919	217	219	2	1	3	1	1	0
NITE-919	217	218	1	1	3	3	1	0
NITE-919	217	225	8	1	3	4	1	1
NITE-919	217	227	10	1	1	1	1	0
NITE-919	217	218	1	1	2	1	1	0
NITE-919	217	270	53	1	3	1	1	1
NITE-919	217	226	9	1	3	1	0	1
NITE-920	217	228	11	1	1	4	1	2
NITE-920	217	218	1	1	3	1	0	0
NITE-920	218	253	35	1	1	5	1	0
NITE-920	218	252	34	1	3	3	1	0
NITE-920	218	477	259	0	3	5	1	0
NITE-920	218	477	259	0	4	4	0	0
NITE-920	218	477	259	0	3	1	1	1
NITE-920	218	477	259	0	3	3	0	0
NITE-920	218	477	259	0	4	4	0	0
NITE-920	218	225	7	1	4	1	1	1
NITE-921	218	477	259	0	3	5	0	4
NITE-921	218	346	128	1	3	5	1	0
NITE-921	218	255	37	1	3	5	1	1
NITE-921	218	352	134	1	3	1	1	0
NITE-921	218	477	259	0	3	5	0	0
NITE-921	218	477	259	0	3	5	0	0
NITE-921	218	477	259	0	3	5	0	0
NITE-921	218	477	259	0	3	5	0	1
NITE-921	218	477	259	0	3	5	0	1
NITE-921	218	224	6	1	3	5	1	0
NITE-922	218	231	13	1	3	5	1	0
NITE-922	218	302	84	1	3	5	1	2
NITE-922	218	477	259	0	3	3	0	3
NITE-922	218	477	259	0	3	3	0	3
NITE-922	218	434	216	1	3	4	1	1
NITE-922	218	220	2	1	3	1	1	0
NITE-922	218	477	259	0	3	1	0	0
NITE-922	218	227	9	1	3	1	1	0
NITE-922	218	280	62	1	3	4	1	0
NITE-922	219	477	258	0	2	1	0	0
NITE-923	219	477	258	0	3	1	0	0
NITE-923	219	221	2	1	3	1	1	0
NITE-923	219	231	12	1	4	3	1	0
NITE-923	219	238	19	1	3	1	1	1
NITE-923	219	288	69	1	4	3	1	0
NITE-923	219	234	15	1	3	1	1	0
NITE-923	219	221	2	1	3	1	1	0
NITE-923	219	241	22	1	3	4	1	1
NITE-923	219	247	28	1	3	1	1	0
NITE-923	220	227	7	1	3	1	0	1
NITE-924	220	477	257	0	4	1	0	0
NITE-924	220	224	4	1	3	1	1	2
NITE-924	220	477	257	0	3	1	0	0
NITE-924	220	261	41	1	3	4	1	0
NITE-924	221	224	3	1	3	1	1	1
NITE-924	221	477	256	0	3	3	0	0
NITE-924	221	238	17	1	3	4	1	0
NITE-924	221	283	62	1	3	2	1	1
NITE-924	221	233	12	1	3	4	1	1
NITE-924	221	477	256	0	3	1	0	0
NITE-925	221	477	256	0	3	4	0	0
NITE-925	223	224	1	1	3	1	1	1
NITE-925	224	225	1	1	4	3	1	0
NITE-925	224	270	46	1	4	3	1	2
NITE-925	224	410	186	1	3	4	0	1
NITE-925	224	477	253	0	3	1	1	0
NITE-925	224	239	15	1	3	1	1	1
NITE-925	224	477	253	0	2	1	1	0
NITE-925	224	227	3	1	3	1	1	0
NITE-925	224	231	7	1	5	1	1	0
NITE-926	224	225	1	1	3	1	1	1
NITE-926	225	226	1	1	3	2	1	2
NITE-926	225	233	8	1	3	1	1	0
NITE-926	225	226	1	1	4	1	1	0
NITE-926	225	228	3	1	3	1	1	3
NITE-926	225	477	252	0	3	1	1	0
NITE-926	225	477	252	0	3	1	0	0
NITE-926	225	238	13	1	3	1	1	0
NITE-926	225	228	3	1	3	5	1	0
NITE-926	225	477	252	0	3	4	0	0
NITE-927	225	477	252	0	3	5	1	0
NITE-927	225	477	252	0	3	5	1	0
NITE-927	225	289	64	1	3	4	1	0
NITE-927	226	242	16	1	3	1	1	0
NITE-927	226	318	92	1	3	3	1	2
NITE-927	226	477	251	0	3	5	1	0
NITE-927	226	452	226	1	3	1	0	0
NITE-927	226	228	2	1	3	4	1	1
NITE-927	226	228	2	1	3	1	1	0
NITE-927	226	233	7	1	3	5	1	3
NITE-928	226	228	2	1	3	4	1	0
NITE-928	227	477	250	0	4	5	1	0
NITE-928	227	295	68	1	3	5	1	1
NITE-928	227	477	250	0	3	5	0	0
NITE-928	227	330	103	1	3	5	1	0
NITE-928	227	249	22	1	3	5	1	1
NITE-928	227	262	35	1	3	4	1	3
NITE-928	227	281	54	1	3	3	1	1
NITE-928	227	291	64	1	3	3	1	0
NITE-928	227	340	113	1	3	3	1	0
NITE-929	227	375	148	1	2	1	1	2
NITE-929	227	477	250	0	3	1	1	0
NITE-929	227	288	61	1	3	1	1	0
NITE-929	227	477	250	0	3	2	1	0
NITE-929	227	231	4	1	3	4	1	0
NITE-929	227	477	250	0	3	4	1	0
NITE-929	227	233	6	1	3	1	1	0
NITE-929	227	231	4	1	3	3	1	1
NITE-929	227	333	106	1	3	1	1	3
NITE-929	227	477	250	0	3	4	0	0
NITE-930	227	477	250	0	3	1	0	0
NITE-930	227	235	8	1	3	3	1	1
NITE-930	227	241	14	1	3	1	1	0
NITE-930	227	354	127	1	3	1	1	4
NITE-930	227	477	250	0	3	1	0	0
NITE-930	228	268	40	1	1	3	1	2
NITE-930	228	477	249	0	4	1	0	0
NITE-930	228	229	1	1	3	1	1	1
NITE-930	228	351	123	1	3	1	1	1
NITE-930	228	324	96	1	3	1	0	1
NITE-931	228	409	181	1	4	3	0	0
NITE-931	228	254	26	1	4	1	1	0
NITE-931	228	305	77	1	4	1	1	0
NITE-931	228	232	4	1	3	1	1	0
NITE-931	228	477	249	0	3	3	1	2
NITE-931	228	231	3	1	3	1	1	0
NITE-931	229	231	2	1	3	3	1	1
NITE-931	230	477	247	0	3	1	1	0
NITE-931	230	234	4	1	3	3	1	1
NITE-931	231	477	246	0	3	1	1	0
NITE-932	231	259	28	1	3	3	1	2
NITE-932	231	477	246	0	3	3	1	2
NITE-932	231	386	155	1	3	3	1	4
NITE-932	231	477	246	0	3	3	0	0
NITE-932	231	434	203	1	3	3	0	0
NITE-932	231	477	246	0	3	4	1	0
NITE-932	231	241	10	1	3	5	1	1
NITE-932	231	233	2	1	3	5	1	1
NITE-932	231	477	246	0	3	1	0	0
NITE-932	231	477	246	0	3	5	0	2
NITE-933	231	260	29	1	3	1	1	0
NITE-933	231	232	1	1	3	1	0	1
NITE-933	231	329	98	1	3	3	0	0
NITE-933	231	253	22	1	3	5	0	0
NITE-933	231	477	246	0	3	1	0	0
NITE-933	231	232	1	1	3	1	1	0
NITE-933	232	233	1	1	3	1	1	0
NITE-933	232	233	1	1	3	3	1	0
NITE-933	232	234	2	1	3	1	1	0
NITE-933	232	323	91	1	4	4	1	1
NITE-934	232	262	30	1	3	4	1	0
NITE-934	232	301	69	1	3	1	1	0
NITE-934	233	234	1	1	4	1	0	0
NITE-934	233	477	244	0	3	1	0	0
NITE-934	233	298	65	1	2	3	1	1
NITE-934	233	275	42	1	3	3	1	0
NITE-934	233	332	99	1	1	1	1	3
NITE-934	233	242	9	1	3	3	1	3
NITE-935	233	239	6	1	3	1	1	0
NITE-935	233	235	2	1	4	3	1	0
NITE-935	234	477	243	0	3	1	0	0
NITE-935	234	235	1	1	5	3	0	0
NITE-935	234	477	243	0	3	1	0	0
NITE-935	234	326	92	1	3	3	1	4
NITE-935	234	336	102	1	4	4	1	0
NITE-935	234	477	243	0	3	2	0	0
NITE-935	234	477	243	0	3	1	0	2
NITE-935	234	477	243	0	3	1	0	0
NITE-936	234	246	12	1	4	4	1	1
NITE-936	234	247	13	1	4	4	1	1
NITE-936	234	239	5	1	3	3	1	0
NITE-936	234	235	1	1	3	4	1	0
NITE-936	234	235	1	1	3	1	1	1
NITE-936	234	263	29	1	4	4	1	1
NITE-936	235	249	14	1	3	3	1	2
NITE-936	235	239	4	1	3	1	1	0
NITE-936	235	259	24	1	3	1	1	0
NITE-936	235	254	19	1	3	1	1	0
NITE-937	235	238	3	1	3	1	1	0
NITE-937	235	254	19	1	3	1	1	0
NITE-937	235	477	242	0	3	1	0	0
NITE-937	235	242	7	1	3	1	1	3
NITE-937	235	236	1	1	3	1	1	0
NITE-937	235	284	49	1	3	4	0	0
NITE-937	235	248	13	1	3	5	0	1
NITE-937	235	255	20	1	4	5	0	1
NITE-937	235	284	49	1	4	5	0	0
NITE-937	235	477	242	0	3	1	1	0
NITE-938	235	477	242	0	3	1	0	0
NITE-938	235	268	33	1	3	1	1	0
NITE-938	238	246	8	1	2	1	1	0
NITE-938	238	477	239	0	3	4	0	0
NITE-938	238	258	20	1	3	1	1	0
NITE-938	238	477	239	0	3	4	0	3
NITE-938	238	477	239	0	3	4	0	0
NITE-938	238	246	8	1	3	4	1	1
NITE-938	238	254	16	1	3	1	1	0
NITE-938	238	239	1	1	3	1	1	0
NITE-939	238	274	36	1	1	3	1	2
NITE-939	238	477	239	0	3	5	0	1
NITE-939	238	256	18	1	3	1	1	0
NITE-939	238	239	1	1	3	1	1	1
NITE-939	239	255	16	1	2	1	1	1
NITE-939	239	242	3	1	4	3	0	0
NITE-939	239	245	6	1	3	1	1	1
NITE-939	239	477	238	0	3	1	0	1
NITE-939	239	256	17	1	3	1	1	1
NITE-939	239	287	48	1	3	3	1	1
NITE-940	239	477	238	0	3	4	0	0
NITE-940	239	240	1	1	3	1	1	0
NITE-940	239	247	8	1	3	5	1	0
NITE-940	240	477	237	0	1	5	0	0
NITE-940	240	477	237	0	3	1	0	0
NITE-940	240	477	237	0	3	3	0	1
NITE-940	240	477	237	0	3	3	1	1
NITE-940	240	477	237	0	3	5	0	1
NITE-940	240	247	7	1	3	3	1	0
NITE-940	240	477	237	0	3	1	0	0
NITE-941	240	477	237	0	3	3	1	4
NITE-941	240	266	26	1	3	3	1	0
NITE-941	240	248	8	1	3	4	1	0
NITE-941	240	477	237	0	3	4	1	0
NITE-941	240	477	237	0	4	4	1	0
NITE-941	240	477	237	0	4	4	1	0
NITE-941	240	267	27	1	3	4	1	1
NITE-941	240	477	237	0	3	1	0	0
NITE-941	240	304	64	1	2	1	1	1
NITE-941	240	268	28	1	3	4	1	0
NITE-942	240	304	64	1	3	4	1	1
NITE-942	240	241	1	1	3	1	1	1
NITE-942	240	248	8	1	3	1	1	0
NITE-942	240	241	1	1	3	3	1	1
NITE-942	240	242	2	1	3	5	1	0
NITE-942	240	245	5	1	3	1	1	0
NITE-942	240	253	13	1	3	4	1	1
NITE-942	241	242	1	1	3	1	1	0
NITE-942	241	387	146	1	3	1	1	2
NITE-942	241	242	1	1	3	5	1	0
NITE-943	241	288	47	1	3	4	1	0
NITE-943	241	477	236	0	3	4	0	0
NITE-943	241	477	236	0	3	4	1	0
NITE-943	241	246	5	1	3	3	1	0
NITE-943	241	265	24	1	1	3	1	1
NITE-943	241	326	85	1	3	3	1	2
NITE-943	241	477	236	0	3	1	0	0
NITE-943	241	477	236	0	3	4	1	1
NITE-943	241	247	6	1	3	1	1	0
NITE-943	241	255	14	1	1	1	1	1
NITE-944	242	245	3	1	3	1	0	0
NITE-944	242	260	18	1	3	5	1	0
NITE-944	242	329	87	1	3	1	1	1
NITE-944	242	243	1	1	3	1	0	1
NITE-944	242	477	235	0	3	5	1	0
NITE-944	242	252	10	1	3	1	1	0
NITE-944	242	283	41	1	4	1	1	1
NITE-944	242	297	55	1	4	1	1	0
NITE-944	242	246	4	1	3	5	1	0
NITE-944	245	477	232	0	3	4	1	0
NITE-945	245	394	149	1	4	4	0	0
NITE-945	245	269	24	1	3	3	1	3
NITE-945	245	477	232	0	4	5	1	0
NITE-945	245	477	232	0	3	1	0	0
NITE-945	245	298	53	1	3	1	1	1
NITE-945	245	340	95	1	3	1	1	1
NITE-945	245	477	232	0	3	4	0	1
NITE-945	245	477	232	0	3	2	0	1
NITE-945	245	270	25	1	4	1	0	0
NITE-945	246	248	2	1	3	1	0	1
NITE-946	246	280	34	1	4	1	1	0
NITE-946	246	477	231	0	3	3	1	1
NITE-946	246	477	231	0	3	3	0	0
NITE-946	246	477	231	0	5	2	1	1
NITE-946	246	253	7	1	3	2	0	1
NITE-946	246	259	13	1	3	4	1	0
NITE-946	246	477	231	0	3	1	0	0
NITE-946	246	477	231	0	3	1	0	0
NITE-946	247	477	230	0	3	1	0	0
NITE-946	247	477	230	0	4	1	0	0
NITE-947	247	427	180	1	3	1	1	1
NITE-947	247	302	55	1	3	1	0	1
NITE-947	247	249	2	1	3	1	1	0
NITE-947	247	477	230	0	3	1	0	0
NITE-947	247	477	230	0	3	1	0	0
NITE-947	247	249	2	1	3	1	1	0
NITE-947	248	477	229	0	4	4	0	0
NITE-947	248	477	229	0	4	4	0	0
NITE-947	248	477	229	0	3	3	1	1
NITE-947	248	249	1	1	2	1	1	0
NITE-948	248	477	229	0	3	4	1	2
NITE-948	248	477	229	0	3	4	0	1
NITE-948	248	249	1	1	3	5	1	1
NITE-948	248	249	1	1	3	1	1	0
NITE-948	248	434	186	1	3	3	0	1
NITE-948	248	477	229	0	3	3	1	1
NITE-948	248	477	229	0	3	1	0	0
NITE-948	248	259	11	1	3	4	1	1
NITE-948	248	477	229	0	4	1	0	0
NITE-948	248	477	229	0	1	1	1	0
NITE-949	249	477	228	0	3	1	0	0
NITE-949	249	477	228	0	3	4	1	0
NITE-949	249	268	19	1	3	4	1	1
NITE-949	249	358	109	1	3	1	1	0
NITE-949	249	477	228	0	3	1	1	0
NITE-949	249	254	5	1	3	4	1	2
NITE-949	249	477	228	0	3	4	1	0
NITE-949	249	452	203	1	3	2	1	0
NITE-949	249	250	1	1	3	5	1	0
NITE-949	249	477	228	0	4	1	0	0
NITE-950	249	282	33	1	3	3	1	1
NITE-950	249	267	18	1	3	4	1	0
NITE-950	251	477	226	0	3	4	0	0
NITE-950	251	255	4	1	2	3	1	0
NITE-950	252	477	225	0	4	1	0	0
NITE-950	252	477	225	0	3	1	0	0
NITE-950	252	477	225	0	3	1	0	0
NITE-950	252	477	225	0	3	1	0	0
NITE-950	252	254	2	1	3	3	1	0
NITE-950	252	256	4	1	3	4	1	0
NITE-951	252	259	7	1	3	4	1	0
NITE-951	252	260	8	1	3	4	1	0
NITE-951	252	477	225	0	3	1	0	1
NITE-951	252	477	225	0	5	4	0	0
NITE-951	252	267	15	1	3	3	1	0
NITE-951	252	477	225	0	3	4	0	0
NITE-951	252	253	1	1	3	1	0	1
NITE-951	252	329	77	1	3	4	1	0
NITE-951	252	253	1	1	3	1	1	0
NITE-951	252	262	10	1	3	4	1	1
NITE-952	252	477	225	0	3	3	0	1
NITE-952	252	253	1	1	4	1	0	0
NITE-952	252	277	25	1	2	3	1	0
NITE-952	252	277	25	1	2	3	1	0
NITE-952	252	477	225	0	3	3	1	0
NITE-952	252	319	67	1	3	3	1	0
NITE-952	252	253	1	1	3	1	0	1
NITE-952	252	253	1	1	3	1	0	0
NITE-952	253	254	1	1	3	1	1	0
NITE-952	253	477	224	0	3	4	0	0
NITE-953	253	422	169	1	3	3	0	0
NITE-953	253	254	1	1	3	1	1	1
NITE-953	253	346	93	1	3	2	1	1
NITE-953	253	477	224	0	3	4	0	0
NITE-953	253	287	34	1	4	1	1	1
NITE-953	253	254	1	1	3	1	1	1
NITE-953	253	259	6	1	3	3	1	1
NITE-953	253	255	2	1	3	3	1	1
NITE-953	253	267	14	1	3	3	1	1
NITE-953	253	477	224	0	3	1	0	1
NITE-954	253	275	22	1	3	3	1	1
NITE-954	253	269	16	1	3	5	0	0
NITE-954	253	344	91	1	3	1	0	2
NITE-954	253	477	224	0	3	5	0	0
NITE-954	253	266	13	1	3	4	1	0
NITE-954	253	254	1	1	3	1	1	0
NITE-954	253	298	45	1	3	3	1	0
NITE-954	253	477	224	0	3	3	1	1
NITE-954	253	477	224	0	3	1	0	0
NITE-954	253	269	16	1	3	4	1	1
NITE-955	253	283	30	1	2	1	1	1
NITE-955	253	477	224	0	3	5	0	0
NITE-955	254	261	7	1	4	4	1	0
NITE-955	254	268	14	1	3	1	0	0
NITE-955	254	323	69	1	4	4	1	0
NITE-955	254	257	3	1	3	1	1	0
NITE-955	254	255	1	1	3	1	1	0
NITE-955	254	316	62	1	3	1	1	0
NITE-955	254	322	68	1	3	4	1	1
NITE-955	254	282	28	1	1	4	1	0
NITE-956	254	283	29	1	3	4	1	0
NITE-956	254	477	223	0	2	1	1	1
NITE-956	254	477	223	0	3	1	0	1
NITE-956	254	477	223	0	3	3	1	0
NITE-956	255	259	4	1	3	4	1	0
NITE-956	255	256	1	1	3	1	1	0
NITE-956	255	259	4	1	3	1	1	0
NITE-956	255	477	222	0	3	1	0	0
NITE-956	255	273	18	1	4	4	1	0
NITE-957	255	256	1	1	3	3	1	0
NITE-957	255	256	1	1	3	1	0	0
NITE-957	255	256	1	1	3	1	1	0
NITE-957	255	267	12	1	4	1	1	1
NITE-957	255	304	49	1	3	3	1	1
NITE-957	255	317	62	1	3	3	1	1
NITE-957	255	317	62	1	3	3	1	1
NITE-957	255	317	62	1	3	3	1	1
NITE-957	255	317	62	1	3	3	0	1
NITE-957	255	304	49	1	3	3	1	1
NITE-958	255	263	8	1	3	1	1	0
NITE-958	255	304	49	1	3	3	1	1
NITE-958	255	304	49	1	3	3	0	1
NITE-958	255	283	28	1	1	4	1	1
NITE-958	255	256	1	1	3	5	1	0
NITE-958	255	260	5	1	4	1	1	1
NITE-958	255	477	222	0	3	4	0	1
NITE-958	255	477	222	0	3	2	0	0
NITE-958	255	259	4	1	3	5	0	1
NITE-958	255	263	8	1	3	1	1	0
NITE-959	255	434	179	1	3	4	0	0
NITE-959	255	477	222	0	4	3	0	0
NITE-959	255	434	179	1	3	4	0	2
NITE-959	256	257	1	1	1	1	1	0
NITE-959	256	257	1	1	2	1	1	2
NITE-959	256	257	1	1	4	1	0	0
NITE-959	256	280	24	1	4	1	1	0
NITE-959	256	262	6	1	4	1	1	0
NITE-959	256	259	3	1	3	1	1	0
NITE-959	256	269	13	1	4	4	1	1
NITE-960	256	288	32	1	4	1	0	0
NITE-960	256	284	28	1	3	3	1	1
NITE-960	256	477	221	0	3	1	0	0
NITE-960	256	477	221	0	3	1	0	0
NITE-960	256	259	3	1	3	1	0	1
NITE-960	256	386	130	1	3	1	1	2
NITE-960	257	284	27	1	3	1	1	1
NITE-960	258	359	101	1	3	4	1	4
NITE-960	259	260	1	1	4	1	1	0
NITE-960	259	261	2	1	4	4	1	0
NITE-961	259	290	31	1	3	5	1	2
NITE-961	259	477	218	0	3	1	0	0
NITE-961	259	269	10	1	3	4	1	1
NITE-961	259	477	218	0	4	4	0	0
NITE-961	259	260	1	1	3	3	0	1
NITE-961	259	477	218	0	3	1	0	0
NITE-961	259	477	218	0	3	4	0	2
NITE-961	259	260	1	1	4	5	0	0
NITE-961	259	354	95	1	3	2	0	0
NITE-961	259	324	65	1	4	4	1	1
NITE-962	259	287	28	1	3	1	1	1
NITE-962	259	270	11	1	3	1	1	0
NITE-962	259	324	65	1	3	1	1	0
NITE-962	260	477	217	0	2	1	0	0
NITE-962	260	269	9	1	3	1	1	0
NITE-962	260	261	1	1	1	1	1	0
NITE-962	260	445	185	1	3	1	0	1
NITE-962	260	261	1	1	3	1	1	0
NITE-962	260	261	1	1	3	3	1	1
NITE-962	260	268	8	1	3	1	1	1
NITE-963	260	343	83	1	3	4	1	0
NITE-963	260	261	1	1	3	1	1	0
NITE-963	260	295	35	1	3	4	1	0
NITE-963	260	477	217	0	4	2	1	0
NITE-963	260	477	217	0	3	5	1	0
NITE-963	260	477	217	0	3	1	0	0
NITE-963	260	477	217	0	3	5	0	0
NITE-963	260	297	37	1	3	3	1	1
NITE-963	260	477	217	0	3	1	1	1
NITE-963	260	269	9	1	3	3	1	0
NITE-964	260	477	217	0	4	3	0	0
NITE-964	261	477	216	0	4	1	0	0
NITE-964	261	477	216	0	3	1	0	0
NITE-964	261	277	16	1	4	3	0	0
NITE-964	261	409	148	1	3	1	1	0
NITE-964	261	296	35	1	3	3	0	0
NITE-964	261	262	1	1	1	1	1	2
NITE-964	261	477	216	0	3	1	0	0
NITE-964	261	477	216	0	3	3	0	0
NITE-964	261	268	7	1	3	4	1	0
NITE-965	261	477	216	0	3	1	0	0
NITE-965	261	477	216	0	3	1	0	0
NITE-965	262	289	27	1	4	1	1	0
NITE-965	262	477	215	0	3	1	1	0
NITE-965	262	269	7	1	3	1	1	0
NITE-965	262	297	35	1	3	3	1	0
NITE-965	262	477	215	0	3	3	0	0
NITE-965	262	263	1	1	1	1	1	0
NITE-965	262	273	11	1	3	4	1	0
NITE-965	262	294	32	1	3	5	1	0
NITE-966	262	477	215	0	3	3	1	1
NITE-966	263	276	13	1	3	4	1	0
NITE-966	263	264	1	1	3	3	1	0
NITE-966	263	295	32	1	3	1	1	3
NITE-966	263	477	214	0	3	1	1	0
NITE-966	263	266	3	1	1	1	1	0
NITE-966	265	477	212	0	3	1	1	0
NITE-966	266	477	211	0	3	1	0	0
NITE-966	266	267	1	1	4	5	0	0
NITE-966	266	268	2	1	3	1	1	0
NITE-967	266	269	3	1	3	3	1	2
NITE-967	266	477	211	0	3	1	0	0
NITE-967	266	407	141	1	3	4	1	1
NITE-967	266	302	36	1	3	1	1	1
NITE-967	266	477	211	0	3	1	0	0
NITE-967	266	277	11	1	3	1	1	0
NITE-967	266	477	211	0	4	2	1	0
NITE-967	266	378	112	1	3	1	0	0
NITE-967	266	477	211	0	4	1	0	0
NITE-967	266	324	58	1	3	3	1	2
NITE-968	267	290	23	1	4	4	1	0
NITE-968	267	268	1	1	1	1	1	0
NITE-968	267	345	78	1	3	4	1	0
NITE-968	267	269	2	1	3	4	1	0
NITE-968	267	280	13	1	3	3	1	2
NITE-968	267	287	20	1	3	2	1	1
NITE-968	267	269	2	1	3	3	1	1
NITE-968	267	270	3	1	3	3	1	1
NITE-968	267	477	210	0	3	3	1	1
NITE-968	267	477	210	0	3	3	1	0
NITE-969	267	477	210	0	3	3	1	1
NITE-969	267	275	8	1	3	1	1	0
NITE-969	267	477	210	0	3	1	0	0
NITE-969	267	270	3	1	3	4	1	0
NITE-969	267	294	27	1	3	4	1	0
NITE-969	267	324	57	1	3	3	1	0
NITE-969	268	283	15	1	3	3	1	1
NITE-969	268	276	8	1	4	1	0	0
NITE-969	268	335	67	1	3	4	0	1
NITE-969	268	374	106	1	2	2	1	1
NITE-970	268	466	198	1	4	1	1	0
NITE-970	268	477	209	0	4	4	0	0
NITE-970	268	477	209	0	1	1	1	0
NITE-970	268	269	1	1	3	3	1	0
NITE-970	268	269	1	1	3	3	1	0
NITE-970	268	276	8	1	3	4	1	0
NITE-970	268	270	2	1	1	4	1	0
NITE-970	268	322	54	1	3	5	0	1
NITE-970	268	302	34	1	2	1	1	1
NITE-970	268	477	209	0	3	1	0	0
NITE-971	268	289	21	1	3	1	1	1
NITE-971	268	270	2	1	3	4	1	1
NITE-971	269	315	46	1	3	3	1	0
NITE-971	269	270	1	1	3	1	1	0
NITE-971	269	298	29	1	3	3	1	1
NITE-971	269	294	25	1	3	3	1	1
NITE-971	269	477	208	0	3	3	1	1
NITE-971	269	270	1	1	3	1	1	0
NITE-971	269	270	1	1	3	1	1	0
NITE-971	269	295	26	1	4	4	1	0
NITE-972	269	477	208	0	3	3	1	2
NITE-972	269	277	8	1	3	1	1	0
NITE-972	269	275	6	1	2	1	1	2
NITE-972	269	273	4	1	1	1	1	0
NITE-972	269	282	13	1	3	1	1	0
NITE-972	269	477	208	0	3	2	1	0
NITE-972	269	283	14	1	3	1	1	0
NITE-972	269	275	6	1	3	3	1	1
NITE-972	269	281	12	1	3	3	1	2
NITE-972	269	477	208	0	3	4	0	1
NITE-973	269	477	208	0	4	1	0	0
NITE-973	269	270	1	1	2	1	1	1
NITE-973	269	477	208	0	3	4	1	0
NITE-973	270	271	1	1	3	3	1	0
NITE-973	270	410	140	1	3	1	1	0
NITE-973	270	422	152	1	3	4	0	0
NITE-973	270	273	3	1	2	1	1	1
NITE-973	270	289	19	1	1	1	1	1
NITE-973	270	294	24	1	3	1	1	0
NITE-973	270	380	110	1	3	1	1	1
NITE-974	270	477	207	0	4	1	1	1
NITE-974	271	273	2	1	2	1	1	1
NITE-974	271	280	9	1	3	1	0	0
NITE-974	272	477	205	0	4	1	0	0
NITE-974	272	276	4	1	3	1	1	0
NITE-974	272	399	127	1	3	5	0	1
NITE-974	272	477	205	0	3	5	0	0
NITE-974	272	351	79	1	3	5	1	2
NITE-974	273	281	8	1	3	1	1	0
NITE-974	273	284	11	1	2	1	1	0
NITE-975	273	275	2	1	3	3	1	0
NITE-975	273	477	204	0	3	1	0	0
NITE-975	273	276	3	1	1	1	1	0
NITE-975	273	301	28	1	3	1	1	2
NITE-975	273	325	52	1	3	1	1	1
NITE-975	273	295	22	1	3	1	1	0
NITE-975	273	289	16	1	3	1	1	0
NITE-975	273	477	204	0	3	1	0	1
NITE-975	274	477	203	0	3	3	1	0
NITE-975	274	477	203	0	3	1	0	0
NITE-976	274	275	1	1	2	1	1	1
NITE-976	274	275	1	1	1	1	1	0
NITE-976	274	477	203	0	3	1	0	0
NITE-976	274	310	36	1	3	3	1	3
NITE-976	274	477	203	0	2	1	1	0
NITE-976	274	477	203	0	3	1	0	0
NITE-976	274	477	203	0	3	1	0	0
NITE-976	274	477	203	0	3	1	0	0
NITE-976	274	477	203	0	3	1	0	0
NITE-976	274	302	28	1	5	3	1	0
NITE-977	274	282	8	1	4	5	0	0
NITE-977	274	409	135	1	3	1	1	1
NITE-977	274	275	1	1	3	3	1	1
NITE-977	274	477	203	0	3	1	0	0
NITE-977	274	352	78	1	3	1	1	3
NITE-977	274	325	51	1	3	1	0	1
NITE-977	274	291	17	1	3	1	1	1
NITE-977	275	347	72	1	3	3	1	4
NITE-977	275	477	202	0	3	3	1	1
NITE-977	275	477	202	0	3	1	0	3
NITE-978	275	297	22	1	3	3	1	1
NITE-978	275	477	202	0	3	1	1	0
NITE-978	275	477	202	0	3	1	0	0
NITE-978	275	282	7	1	3	1	1	0
NITE-978	275	291	16	1	1	1	1	1
NITE-978	275	281	6	1	3	2	1	1
NITE-978	275	318	43	1	3	3	0	0
NITE-978	275	477	202	0	3	1	0	0
NITE-978	276	277	1	1	1	1	1	0
NITE-978	276	280	4	1	4	1	1	0
NITE-979	276	301	25	1	2	1	1	2
NITE-979	276	477	201	0	3	3	1	1
NITE-979	276	277	1	1	2	1	1	0
NITE-979	276	330	54	1	3	1	0	1
NITE-979	276	277	1	1	3	1	1	0
NITE-979	276	277	1	1	3	1	1	0
NITE-979	276	283	7	1	3	1	1	0
NITE-979	277	324	47	1	3	3	1	0
NITE-979	277	347	70	1	3	3	1	0
NITE-979	277	448	171	1	4	4	1	0
NITE-980	277	282	5	1	3	3	0	0
NITE-980	277	459	182	1	4	1	1	0
NITE-980	277	294	17	1	3	1	1	0
NITE-980	277	279	2	1	3	1	1	0
NITE-980	277	290	13	1	3	1	0	1
NITE-980	278	284	6	1	4	5	0	0
NITE-980	279	477	198	0	3	4	1	1
NITE-980	280	281	1	1	3	3	1	0
NITE-980	280	281	1	1	3	3	1	0
NITE-980	280	281	1	1	3	3	1	0
NITE-981	280	282	2	1	3	3	1	0
NITE-981	280	323	43	1	3	3	1	0
NITE-981	280	450	170	1	4	5	1	1
NITE-981	280	477	197	0	3	1	0	0
NITE-981	280	281	1	1	3	1	1	2
NITE-981	280	282	2	1	3	1	0	0
NITE-981	280	477	197	0	3	4	0	0
NITE-981	280	361	81	1	3	5	1	0
NITE-981	280	329	49	1	3	1	1	1
NITE-981	281	298	17	1	3	3	1	0
NITE-982	281	477	196	0	4	4	0	0
NITE-982	281	282	1	1	3	1	1	0
NITE-982	281	282	1	1	3	1	1	0
NITE-982	281	283	2	1	3	3	1	2
NITE-982	281	477	196	0	3	5	0	2
NITE-982	281	477	196	0	3	5	0	0
NITE-982	281	345	64	1	3	1	1	0
NITE-982	281	477	196	0	3	1	1	1
NITE-982	281	323	42	1	3	3	1	1
NITE-982	281	477	196	0	3	4	1	1
NITE-983	281	289	8	1	3	4	1	0
NITE-983	281	294	13	1	3	3	1	1
NITE-983	281	282	1	1	3	1	1	0
NITE-983	282	284	2	1	4	5	0	0
NITE-983	282	283	1	1	3	1	1	1
NITE-983	282	477	195	0	3	3	1	1
NITE-983	282	477	195	0	3	1	1	0
NITE-983	282	294	12	1	3	1	1	0
NITE-983	282	477	195	0	4	5	1	0
NITE-983	282	352	70	1	3	3	1	0
NITE-984	282	311	29	1	2	1	1	0
NITE-984	282	305	23	1	3	1	1	0
NITE-984	282	477	195	0	4	1	0	1
NITE-984	282	312	30	1	3	1	1	1
NITE-984	282	477	195	0	3	1	0	1
NITE-984	283	360	77	1	3	4	1	1
NITE-984	283	284	1	1	4	4	1	0
NITE-984	283	477	194	0	3	1	0	0
NITE-984	283	298	15	1	3	3	0	1
NITE-984	283	305	22	1	4	5	0	0
NITE-985	283	303	20	1	3	3	1	2
NITE-985	283	477	194	0	3	3	0	0
NITE-985	283	289	6	1	3	3	1	0
NITE-985	283	297	14	1	3	4	1	1
NITE-985	283	374	91	1	2	1	1	0
NITE-985	283	477	194	0	4	1	0	0
NITE-985	283	477	194	0	3	4	1	1
NITE-985	283	284	1	1	3	5	0	1
NITE-985	283	375	92	1	3	1	1	1
NITE-985	283	375	92	1	3	4	1	0
NITE-986	283	477	194	0	4	1	1	0
NITE-986	283	477	194	0	3	4	1	0
NITE-986	284	287	3	1	3	3	1	0
NITE-986	284	285	1	1	3	3	1	0
NITE-986	284	297	13	1	3	1	1	2
NITE-986	284	285	1	1	1	1	1	0
NITE-986	284	477	193	0	3	4	1	0
NITE-986	284	477	193	0	2	4	1	0
NITE-986	284	289	5	1	3	4	1	0
NITE-986	284	285	1	1	3	1	0	0
NITE-987	284	312	28	1	3	4	1	0
NITE-987	284	477	193	0	3	1	1	0
NITE-987	284	324	40	1	3	1	1	0
NITE-987	284	477	193	0	4	1	0	0
NITE-987	284	477	193	0	3	4	0	0
NITE-987	286	289	3	1	3	4	1	1
NITE-987	286	477	191	0	3	2	0	0
NITE-987	286	289	3	1	2	1	1	0
NITE-987	287	477	190	0	3	1	0	0
NITE-987	287	399	112	1	4	4	1	1
NITE-988	287	324	37	1	3	3	1	1
NITE-988	287	296	9	1	3	2	1	1
NITE-988	287	289	2	1	1	1	1	0
NITE-988	287	477	190	0	3	5	1	1
NITE-988	287	299	12	1	3	1	1	1
NITE-988	287	477	190	0	3	4	0	0
NITE-988	287	315	28	1	3	4	1	0
NITE-988	287	288	1	1	1	1	1	0
NITE-988	287	326	39	1	3	3	1	2
NITE-988	287	288	1	1	3	1	1	0
NITE-989	287	311	24	1	4	4	1	1
NITE-989	287	288	1	1	3	1	1	0
NITE-989	287	387	100	1	3	1	1	3
NITE-989	287	352	65	1	3	2	1	3
NITE-989	288	297	9	1	3	3	0	0
NITE-989	288	289	1	1	2	1	1	0
NITE-989	288	477	189	0	3	1	1	0
NITE-989	288	318	30	1	3	1	0	1
NITE-989	288	289	1	1	1	1	1	0
NITE-989	288	296	8	1	3	1	1	1
NITE-990	288	294	6	1	3	4	1	0
NITE-990	288	296	8	1	3	3	0	0
NITE-990	288	351	63	1	3	1	1	0
NITE-990	288	396	108	1	3	4	1	0
NITE-990	288	381	93	1	3	2	1	0
NITE-990	288	477	189	0	2	1	0	0
NITE-990	288	477	189	0	3	4	0	0
NITE-990	289	381	92	1	2	1	1	2
NITE-990	289	290	1	1	3	1	1	0
NITE-990	289	312	23	1	3	4	1	0
NITE-991	289	298	9	1	3	4	1	2
NITE-991	289	295	6	1	3	3	1	0
NITE-991	289	477	188	0	3	4	1	0
NITE-991	289	477	188	0	3	4	1	0
NITE-991	289	296	7	1	3	1	1	0
NITE-991	289	477	188	0	3	5	1	1
NITE-991	289	477	188	0	3	5	0	0
NITE-991	289	301	12	1	3	5	1	0
NITE-991	289	290	1	1	1	1	1	0
NITE-991	289	409	120	1	3	3	0	0
NITE-992	289	409	120	1	3	3	0	0
NITE-992	289	477	188	0	3	1	1	0
NITE-992	289	290	1	1	1	1	1	1
NITE-992	289	296	7	1	4	1	1	0
NITE-992	290	319	29	1	4	4	0	1
NITE-992	290	477	187	0	3	4	1	0
NITE-992	290	380	90	1	3	4	1	0
NITE-992	290	429	139	1	3	1	1	1
NITE-992	290	324	34	1	3	1	1	4
NITE-992	290	291	1	1	3	1	1	1
NITE-993	290	312	22	1	3	4	1	0
NITE-993	290	477	187	0	3	3	0	0
NITE-993	290	294	4	1	2	1	1	0
NITE-993	290	477	187	0	3	4	0	0
NITE-993	290	477	187	0	3	4	0	0
NITE-993	290	302	12	1	3	1	1	0
NITE-993	290	477	187	0	4	4	1	0
NITE-993	291	329	38	1	3	1	1	0
NITE-993	291	297	6	1	3	1	1	0
NITE-993	291	313	22	1	4	3	0	0
NITE-994	291	297	6	1	3	3	0	0
NITE-994	291	301	10	1	3	1	1	1
NITE-994	291	292	1	1	3	4	1	0
NITE-994	291	350	59	1	3	3	1	1
NITE-994	291	294	3	1	3	1	1	0
NITE-994	291	294	3	1	3	1	1	0
NITE-994	291	323	32	1	3	1	1	0
NITE-994	291	416	125	1	3	1	0	0
NITE-994	291	330	39	1	3	1	1	0
NITE-994	291	477	186	0	3	1	1	4
NITE-995	291	294	3	1	3	1	1	0
NITE-995	291	295	4	1	3	1	1	0
NITE-995	291	477	186	0	3	1	0	0
NITE-995	291	295	4	1	3	3	1	0
NITE-995	292	295	3	1	3	1	0	1
NITE-995	293	477	184	0	3	1	0	2
NITE-995	294	477	183	0	3	1	0	0
NITE-995	294	326	32	1	3	4	1	1
NITE-995	294	477	183	0	3	4	1	0
NITE-995	294	329	35	1	3	4	1	1
NITE-996	294	295	1	1	3	3	1	2
NITE-996	294	296	2	1	4	5	1	0
NITE-996	294	344	50	1	3	1	1	1
NITE-996	294	297	3	1	3	1	0	0
NITE-996	294	477	183	0	3	1	0	1
NITE-996	294	477	183	0	3	4	1	0
NITE-996	294	477	183	0	3	4	1	0
NITE-996	295	477	182	0	4	1	0	0
NITE-996	295	477	182	0	3	4	0	0
NITE-996	295	477	182	0	3	1	1	0
NITE-997	295	312	17	1	3	4	1	0
NITE-997	295	477	182	0	3	1	0	0
NITE-997	295	305	10	1	3	1	1	0
NITE-997	295	434	139	1	3	3	1	0
NITE-997	295	477	182	0	3	4	1	0
NITE-997	295	310	15	1	3	1	1	2
NITE-997	295	312	17	1	4	1	1	1
NITE-997	295	477	182	0	3	3	0	0
NITE-997	295	477	182	0	3	3	1	1
NITE-997	295	399	104	1	3	5	1	1
NITE-998	295	339	44	1	3	4	1	1
NITE-998	295	465	170	1	3	4	1	0
NITE-998	296	301	5	1	3	1	1	0
NITE-998	296	298	2	1	3	3	0	2
NITE-998	296	477	181	0	3	3	1	1
NITE-998	296	302	6	1	3	3	1	1
NITE-998	296	305	9	1	4	1	1	0
NITE-998	296	477	181	0	3	5	0	0
NITE-998	296	396	100	1	3	1	1	4
NITE-999	296	302	6	1	3	2	1	2
NITE-999	296	477	181	0	4	1	0	0
NITE-999	296	394	98	1	3	4	0	0
NITE-999	296	428	132	1	3	1	1	1
NITE-999	297	301	4	1	3	1	0	0
NITE-999	297	477	180	0	3	1	0	0
NITE-999	297	326	29	1	3	3	1	1
NITE-999	297	309	12	1	3	1	1	0
NITE-999	297	402	105	1	3	4	1	1
NITE-999	297	323	26	1	3	3	1	0
AGING-21	0	1	1	1	5	4	1	0
AGING-21	1	2	1	1	5	4	1	0
AGING-21	1	2	1	1	5	4	1	0
AGING-21	37	40	3	1	3	1	1	0
AGING-21	121	477	356	0	3	1	0	0
AGING-21	155	477	322	0	1	1	0	0
AGING-21	330	477	147	0	3	1	1	0
AP-38	92	477	385	0	3	1	0	0
PALA-635	1	477	476	0	3	2	0	0
PALA-635	1	11	10	1	2	5	1	1
PALA-636	1	477	476	0	4	4	0	0
PALA-636	1	477	476	0	3	4	0	0
PALA-636	2	4	2	1	2	1	1	1
PALA-636	2	15	13	1	2	1	1	0
PALA-636	2	4	2	1	1	1	1	0
PALA-636	3	477	474	0	3	1	0	0
PALA-636	3	477	474	0	3	4	0	0
PALA-636	3	477	474	0	3	1	0	0
PALA-636	3	18	15	1	3	1	1	0
PALA-636	3	477	474	0	4	1	0	1
PALA-637	3	4	1	1	2	1	1	0
PALA-637	4	92	88	1	4	1	1	0
PALA-637	5	105	100	1	3	1	1	0
PALA-637	5	234	229	1	3	2	1	1
PALA-637	6	302	296	1	2	5	1	0
PALA-637	7	477	470	0	4	1	0	1
PALA-637	7	477	470	0	4	4	0	0
PALA-637	8	24	16	1	2	1	1	0
PALA-637	8	477	469	0	4	5	0	0
PALA-637	8	15	7	1	3	5	1	0
PALA-638	8	477	469	0	4	4	0	0
PALA-638	9	106	97	1	2	1	1	1
PALA-638	9	18	9	1	2	1	1	0
PALA-638	9	32	23	1	3	1	1	1
PALA-638	9	10	1	1	3	1	1	0
PALA-638	10	477	467	0	4	1	0	0
PALA-638	10	17	7	1	2	1	1	1
PALA-638	10	15	5	1	1	4	1	0
PALA-638	10	16	6	1	2	1	1	0
PALA-638	10	241	231	1	1	1	1	1
PALA-639	10	477	467	0	4	5	0	0
PALA-639	11	15	4	1	3	5	1	1
PALA-639	11	44	33	1	4	1	2	0
PALA-639	11	477	466	0	4	4	0	2
PALA-639	11	106	95	1	2	1	1	1
PALA-639	12	23	11	1	4	4	1	0
PALA-639	12	41	29	1	3	5	1	0
PALA-639	12	302	290	1	3	1	1	0
PALA-639	15	477	462	0	4	2	0	0
PALA-639	15	22	7	1	1	1	1	0
PALA-640	15	126	111	1	3	4	0	1
PALA-640	15	23	8	1	3	1	0	0
PALA-640	15	17	2	1	1	1	0	0
PALA-640	16	477	461	0	3	4	0	1
PALA-640	16	477	461	0	3	4	0	0
PALA-640	16	65	49	1	1	1	2	0
PALA-640	16	477	461	0	3	4	0	0
PALA-640	16	116	100	1	3	4	0	0
PALA-640	16	162	146	1	4	1	2	0
PALA-640	16	137	121	1	5	1	0	0
PALA-641	16	477	461	0	3	5	0	0
PALA-641	16	17	1	1	3	4	0	1
PALA-641	16	477	461	0	3	1	0	4
PALA-641	17	24	7	1	2	1	0	1
PALA-641	17	18	1	1	2	1	1	1
PALA-641	17	79	62	1	1	5	1	1
PALA-641	17	75	58	1	3	5	1	0
PALA-641	17	477	460	0	3	5	0	0
PALA-641	17	22	5	1	1	1	1	0
PALA-641	17	18	1	1	1	1	1	1
PALA-642	17	477	460	0	4	1	0	0
PALA-642	18	477	459	0	3	1	0	0
PALA-642	18	19	1	1	3	4	1	0
PALA-642	18	51	33	1	2	1	0	0
PALA-642	18	51	33	1	2	4	1	0
PALA-642	18	176	158	1	3	4	2	0
PALA-642	18	142	124	1	2	1	0	0
PALA-642	18	21	3	1	3	1	1	0
PALA-642	18	477	459	0	3	1	0	0
PALA-642	18	32	14	1	1	1	1	0
PALA-643	19	31	12	1	3	5	1	0
PALA-643	19	477	458	0	3	4	0	0
PALA-643	21	60	39	1	2	5	1	2
PALA-643	21	477	456	0	3	2	0	2
PALA-643	21	477	456	0	3	2	0	1
PALA-643	22	23	1	1	1	1	1	2
PALA-643	22	308	286	1	2	1	1	0
PALA-643	23	44	21	1	3	4	2	4
PALA-643	23	24	1	1	1	5	0	0
PALA-643	23	477	454	0	3	4	0	0
PALA-644	23	477	454	0	3	1	0	0
PALA-644	24	31	7	1	3	1	1	1
PALA-644	24	255	231	1	4	1	1	0
PALA-644	24	50	26	1	1	1	0	1
PALA-644	24	477	453	0	3	4	0	0
PALA-644	24	477	453	0	4	4	0	1
PALA-644	28	29	1	1	1	1	1	1
PALA-644	28	35	7	1	2	5	1	0
PALA-644	28	72	44	1	4	1	2	0
PALA-645	28	31	3	1	1	1	1	2
PALA-645	29	102	73	1	2	1	2	0
PALA-645	29	477	448	0	4	2	0	0
PALA-645	29	477	448	0	4	4	0	0
PALA-645	29	42	13	1	2	1	2	0
PALA-645	29	30	1	1	1	1	1	0
PALA-645	29	37	8	1	1	5	0	1
PALA-645	29	95	66	1	3	5	1	1
PALA-645	30	477	447	0	3	4	0	0
PALA-645	30	108	78	1	2	5	2	1
PALA-646	30	477	447	0	3	5	0	4
PALA-646	30	52	22	1	4	4	1	0
PALA-646	30	79	49	1	3	5	1	0
PALA-646	30	105	75	1	3	5	1	0
PALA-646	30	105	75	1	3	5	2	0
PALA-646	30	477	447	0	3	4	0	0
PALA-646	30	100	70	1	3	1	1	0
PALA-646	30	56	26	1	1	1	0	0
PALA-646	31	84	53	1	3	1	1	1
PALA-646	31	477	446	0	3	4	0	0
PALA-647	31	64	33	1	3	5	1	0
PALA-647	31	35	4	1	4	1	1	0
PALA-647	32	33	1	1	1	1	1	0
PALA-647	32	36	4	1	2	1	1	0
PALA-647	33	137	104	1	2	1	0	0
PALA-647	33	116	83	1	3	1	1	0
PALA-647	33	35	2	1	1	1	1	0
PALA-647	33	65	32	1	1	5	1	0
PALA-647	33	37	4	1	5	1	1	0
PALA-647	35	92	57	1	3	4	2	0
PALA-648	35	101	66	1	3	5	1	0
PALA-648	36	341	305	1	3	5	1	0
PALA-648	36	53	17	1	3	5	2	4
PALA-648	36	103	67	1	3	5	2	0
PALA-648	36	39	3	1	1	1	1	2
PALA-648	36	37	1	1	1	1	1	1
PALA-648	36	40	4	1	1	1	1	1
PALA-648	37	477	440	0	3	4	0	0
PALA-648	37	73	36	1	1	1	2	2
PALA-648	37	43	6	1	1	1	2	2
PALA-649	37	212	175	1	4	4	1	0
PALA-649	37	477	440	0	3	4	0	0
PALA-649	38	477	439	0	3	1	0	0
PALA-649	38	64	26	1	2	1	0	0
PALA-649	39	477	438	0	3	1	0	1
PALA-649	39	40	1	1	3	1	2	1
PALA-649	39	42	3	1	4	1	0	0
PALA-649	39	50	11	1	3	4	2	0
PALA-649	39	74	35	1	3	1	2	0
PALA-649	40	51	11	1	3	1	1	0
PALA-650	42	67	25	1	2	1	2	0
PALA-650	42	477	435	0	3	4	0	1
PALA-650	42	432	390	1	3	2	1	2
PALA-650	42	477	435	0	3	2	0	0
PALA-650	42	477	435	0	3	2	0	0
PALA-650	42	477	435	0	3	4	0	0
PALA-650	42	123	81	1	3	4	2	0
PALA-650	42	46	4	1	1	5	2	0
PALA-650	42	64	22	1	3	3	1	0
PALA-651	43	85	42	1	3	5	2	0
PALA-651	43	44	1	1	3	1	2	0
PALA-651	43	60	17	1	3	5	2	0
PALA-651	43	74	31	1	3	5	1	0
PALA-651	43	105	62	1	3	5	2	0
PALA-651	43	67	24	1	3	1	1	1
PALA-651	43	44	1	1	4	1	2	0
PALA-651	43	52	9	1	4	1	1	0
PALA-651	43	119	76	1	3	1	2	1
PALA-651	43	45	2	1	3	4	2	1
PALA-652	44	45	1	1	1	5	1	1
PALA-652	44	368	324	1	3	1	1	0
PALA-652	44	119	75	1	3	1	0	0
PALA-652	44	67	23	1	3	5	1	0
PALA-652	44	477	433	0	3	5	0	1
PALA-652	44	45	1	1	4	5	0	0
PALA-652	45	50	5	1	1	1	2	0
PALA-652	45	66	21	1	1	1	2	1
PALA-652	45	477	432	0	3	4	0	1
PALA-652	45	115	70	1	3	5	1	0
PALA-653	45	58	13	1	3	1	1	0
PALA-653	46	477	431	0	3	5	0	0
PALA-653	46	234	188	1	2	1	1	1
PALA-653	46	403	357	1	2	4	1	1
PALA-653	46	477	431	0	3	4	0	0
PALA-653	47	50	3	1	3	1	0	1
PALA-653	47	477	430	0	2	4	0	0
PALA-653	48	53	5	1	3	2	2	0
PALA-653	49	52	3	1	3	5	2	0
PALA-653	49	477	428	0	3	3	0	1
PALA-654	49	477	428	0	3	1	0	0
PALA-654	50	91	41	1	3	1	1	0
PALA-654	50	66	16	1	3	5	2	0
PALA-654	50	58	8	1	3	1	1	0
PALA-654	50	477	427	0	3	3	0	2
PALA-654	50	91	41	1	3	4	1	0
PALA-654	50	92	42	1	3	5	2	0
PALA-654	50	61	11	1	3	1	0	0
PALA-654	50	477	427	0	3	1	0	1
PALA-654	51	55	4	1	2	1	1	0
PALA-655	51	477	426	0	3	4	0	0
PALA-655	51	177	126	1	3	4	1	2
PALA-655	51	477	426	0	3	5	0	1
PALA-655	51	64	13	1	3	1	1	0
PALA-655	51	60	9	1	1	5	2	0
PALA-655	51	477	426	0	4	4	0	1
PALA-655	51	477	426	0	3	5	0	0
PALA-655	52	477	425	0	3	5	0	0
PALA-655	52	477	425	0	3	5	0	0
PALA-655	52	477	425	0	4	5	0	0
PALA-656	52	119	67	1	3	5	2	0
PALA-656	52	477	425	0	4	5	0	0
PALA-656	52	477	425	0	3	5	0	0
PALA-656	52	154	102	1	2	1	0	0
PALA-656	52	53	1	1	1	1	0	1
PALA-656	52	60	8	1	1	5	2	0
PALA-656	53	60	7	1	3	1	1	1
PALA-656	53	54	1	1	1	1	1	1
PALA-656	53	256	203	1	3	4	1	0
PALA-656	53	74	21	1	3	1	0	0
PALA-657	53	54	1	1	2	1	0	0
PALA-657	53	93	40	1	3	1	3	0
PALA-657	53	99	46	1	2	4	0	3
PALA-657	53	477	424	0	4	1	0	0
PALA-657	53	54	1	1	3	5	1	1
PALA-657	53	477	424	0	3	4	0	0
PALA-657	53	71	18	1	3	5	2	0
PALA-657	53	56	3	1	1	1	2	0
PALA-657	53	54	1	1	3	1	0	0
PALA-657	53	55	2	1	1	1	1	0
PALA-658	53	55	2	1	1	1	1	1
PALA-658	53	477	424	0	3	4	0	0
PALA-658	53	79	26	1	2	1	2	1
PALA-658	53	60	7	1	1	1	2	1
PALA-658	54	57	3	1	1	1	2	1
PALA-658	55	60	5	1	2	1	2	1
PALA-658	55	57	2	1	1	1	2	0
PALA-658	55	119	64	1	3	5	2	4
PALA-658	55	58	3	1	1	1	2	1
PALA-658	56	79	23	1	2	1	2	0
PALA-659	56	477	421	0	3	1	0	0
PALA-659	57	346	289	1	1	1	1	2
PALA-659	57	66	9	1	3	5	2	2
PALA-659	57	58	1	1	3	1	0	1
PALA-659	57	73	16	1	3	5	1	4
PALA-659	57	66	9	1	1	1	2	1
PALA-659	58	477	419	0	2	1	0	2
PALA-659	59	304	245	1	3	1	0	2
PALA-659	59	119	60	1	3	5	2	2
PALA-659	60	64	4	1	2	1	2	1
PALA-660	60	143	83	1	3	1	0	1
PALA-660	61	64	3	1	1	1	1	0
PALA-660	61	66	5	1	1	1	2	0
PALA-660	63	64	1	1	3	1	1	0
PALA-660	63	477	414	0	3	3	0	0
PALA-660	63	477	414	0	4	1	0	0
PALA-660	63	66	3	1	2	1	1	0
PALA-660	63	477	414	0	3	3	0	0
PALA-660	63	477	414	0	3	4	0	0
PALA-660	63	71	8	1	1	5	2	1
PALA-661	64	91	27	1	4	1	0	1
PALA-661	64	142	78	1	1	1	0	0
PALA-661	64	126	62	1	3	5	1	0
PALA-661	64	77	13	1	3	1	1	0
PALA-661	64	84	20	1	4	1	1	1
PALA-661	64	66	2	1	5	1	2	0
PALA-661	65	477	412	0	3	1	0	0
PALA-661	65	128	63	1	1	1	0	2
PALA-661	65	477	412	0	4	4	0	0
PALA-661	65	72	7	1	3	1	3	0
PALA-662	65	91	26	1	3	1	0	1
PALA-662	65	87	22	1	3	4	1	1
PALA-662	65	81	16	1	3	3	1	0
PALA-662	65	100	35	1	3	5	1	0
PALA-662	65	72	7	1	1	5	2	1
PALA-662	66	187	121	1	2	4	2	1
PALA-662	66	477	411	0	3	4	0	1
PALA-662	66	67	1	1	3	4	1	0
PALA-662	66	477	411	0	3	4	0	0
PALA-662	66	70	4	1	2	4	2	0
PALA-663	67	72	5	1	4	5	1	0
PALA-663	67	477	410	0	3	5	0	0
PALA-663	67	396	329	1	3	4	0	0
PALA-663	67	71	4	1	3	4	1	0
PALA-663	67	275	208	1	3	5	0	0
PALA-663	67	72	5	1	2	1	1	0
PALA-663	68	477	409	0	3	4	0	1
PALA-663	68	70	2	1	1	1	1	1
PALA-663	69	71	2	1	3	1	1	0
PALA-663	70	71	1	1	1	1	0	1
PALA-664	70	477	407	0	3	1	0	0
PALA-664	70	85	15	1	3	4	2	1
PALA-664	70	194	124	1	2	1	0	1
PALA-664	70	78	8	1	3	5	1	0
PALA-664	70	241	171	1	4	4	1	1
PALA-664	70	135	65	1	3	4	2	2
PALA-664	70	477	407	0	4	2	0	0
PALA-664	71	83	12	1	3	5	1	0
PALA-664	71	144	73	1	3	5	1	0
PALA-664	71	93	22	1	3	5	1	0
PALA-665	71	93	22	1	3	5	1	0
PALA-665	71	108	37	1	3	5	2	0
PALA-665	71	73	2	1	3	5	1	0
PALA-665	71	477	406	0	3	1	0	0
PALA-665	71	79	8	1	2	1	1	0
PALA-665	71	74	3	1	3	4	3	0
PALA-665	71	336	265	1	3	4	1	0
PALA-665	72	178	106	1	3	3	0	0
PALA-665	72	344	272	1	4	4	1	0
PALA-665	72	477	405	0	3	5	0	1
PALA-666	72	477	405	0	3	1	0	2
PALA-666	72	305	233	1	3	1	1	3
PALA-666	72	416	344	1	3	4	1	2
PALA-666	72	477	405	0	3	4	0	0
PALA-666	72	389	317	1	3	4	1	1
PALA-666	72	477	405	0	3	4	0	0
PALA-666	72	94	22	1	3	5	1	0
PALA-666	72	93	21	1	3	5	1	0
PALA-666	72	100	28	1	3	5	0	0
PALA-666	72	79	7	1	3	5	2	0
PALA-667	72	81	9	1	1	1	2	1
PALA-667	73	477	404	0	2	1	0	3
PALA-667	73	87	14	1	4	1	0	0
PALA-667	73	477	404	0	3	4	0	2
PALA-667	73	92	19	1	3	4	0	0
PALA-667	73	74	1	1	3	4	2	1
PALA-667	73	127	54	1	3	5	2	0
PALA-667	73	200	127	1	3	5	1	0
PALA-667	73	119	46	1	3	5	2	0
PALA-667	73	119	46	1	3	5	2	0
PALA-668	73	119	46	1	3	5	0	0
PALA-668	73	477	404	0	3	4	0	1
PALA-668	73	80	7	1	3	4	2	0
PALA-668	74	75	1	1	1	1	2	1
PALA-668	74	477	403	0	3	5	0	0
PALA-668	74	87	13	1	3	5	2	4
PALA-668	74	477	403	0	4	4	0	0
PALA-668	74	79	5	1	2	1	1	0
PALA-668	74	95	21	1	3	5	2	0
PALA-668	74	477	403	0	3	5	0	0
PALA-669	74	77	3	1	1	1	2	0
PALA-669	74	80	6	1	2	5	1	0
PALA-669	74	477	403	0	2	5	0	4
PALA-669	74	75	1	1	1	1	0	0
PALA-669	75	87	12	1	2	1	2	0
PALA-669	76	77	1	1	1	1	2	0
PALA-669	76	477	401	0	3	4	0	0
PALA-669	76	77	1	1	1	1	2	0
PALA-669	76	477	401	0	3	5	0	1
PALA-669	77	86	9	1	3	1	1	0
PALA-670	77	477	400	0	3	4	0	0
PALA-670	77	477	400	0	2	1	0	0
PALA-670	77	477	400	0	3	4	0	0
PALA-670	77	78	1	1	3	1	0	0
PALA-670	77	95	18	1	3	1	0	0
PALA-670	77	477	400	0	2	1	0	0
PALA-670	78	79	1	1	3	3	0	0
PALA-670	78	144	66	1	3	5	0	0
PALA-670	78	105	27	1	3	1	0	0
PALA-670	78	238	160	1	4	4	1	0
PALA-671	78	100	22	1	3	1	1	0
PALA-671	79	99	20	1	2	1	2	1
PALA-671	79	148	69	1	2	1	0	0
PALA-671	79	102	23	1	2	1	0	0
PALA-671	79	383	304	1	3	5	0	0
PALA-671	79	84	5	1	3	1	2	1
PALA-671	79	80	1	1	3	1	1	1
PALA-671	80	87	7	1	3	1	2	0
PALA-671	80	477	397	0	2	5	0	0
PALA-671	80	92	12	1	3	1	3	0
PALA-672	80	477	397	0	3	1	0	3
PALA-672	80	81	1	1	3	1	0	0
PALA-672	80	81	1	1	1	1	2	1
PALA-672	80	105	25	1	3	5	2	0
PALA-672	80	92	12	1	3	1	1	0
PALA-672	80	85	5	1	3	5	0	0
PALA-672	81	87	6	1	1	5	1	1
PALA-672	81	477	396	0	4	1	0	1
PALA-672	81	85	4	1	1	5	2	0
PALA-672	81	477	396	0	3	2	0	1
PALA-673	81	477	396	0	3	1	0	0
PALA-673	81	87	6	1	1	1	2	1
PALA-673	81	108	27	1	3	3	1	0
PALA-673	81	113	32	1	3	3	1	0
PALA-673	82	477	395	0	3	4	0	0
PALA-673	82	93	11	1	3	1	0	0
PALA-673	82	84	2	1	3	3	2	0
PALA-673	83	477	394	0	3	1	0	0
PALA-673	84	477	393	0	3	3	0	0
PALA-673	84	91	7	1	4	1	3	0
PALA-674	84	114	30	1	1	1	0	0
PALA-674	84	337	253	1	3	4	1	2
PALA-674	84	373	289	1	4	4	1	1
PALA-674	84	85	1	1	3	1	1	0
PALA-674	84	85	1	1	3	1	0	1
PALA-674	85	477	392	0	3	4	0	0
PALA-674	85	87	2	1	3	4	1	2
PALA-674	85	108	23	1	3	5	2	0
PALA-674	85	107	22	1	3	2	0	0
PALA-675	85	107	22	1	3	5	0	0
PALA-675	85	86	1	1	4	1	0	0
PALA-675	85	86	1	1	1	1	2	1
PALA-675	86	94	8	1	3	4	0	0
PALA-675	86	337	251	1	4	1	2	0
PALA-675	86	477	391	0	3	5	0	0
PALA-675	86	477	391	0	3	4	0	0
PALA-675	86	477	391	0	3	4	0	0
PALA-675	86	477	391	0	3	4	0	0
PALA-675	86	87	1	1	3	1	2	0
PALA-676	86	87	1	1	3	1	0	1
PALA-676	86	96	10	1	1	1	1	1
PALA-676	86	298	212	1	3	1	0	0
PALA-676	86	477	391	0	3	4	0	1
PALA-676	86	247	161	1	2	1	2	1
PALA-676	87	88	1	1	1	1	0	2
PALA-676	87	477	390	0	3	5	0	0
PALA-676	87	119	32	1	3	1	0	0
PALA-676	87	105	18	1	3	3	0	0
PALA-676	87	119	32	1	3	1	0	0
PALA-677	88	477	389	0	3	4	0	0
PALA-677	88	95	7	1	1	1	1	1
PALA-677	88	477	389	0	3	1	0	4
PALA-677	88	93	5	1	3	3	0	0
PALA-677	88	102	14	1	1	1	2	0
PALA-677	88	106	18	1	3	1	0	1
PALA-677	88	148	60	1	1	1	2	3
PALA-677	88	477	389	0	5	1	0	0
PALA-677	88	477	389	0	3	1	0	1
PALA-677	88	92	4	1	3	4	2	0
PALA-678	88	92	4	1	3	3	2	0
PALA-678	88	128	40	1	2	1	1	0
PALA-678	88	224	136	1	3	4	0	0
PALA-678	89	477	388	0	2	5	0	0
PALA-678	89	477	388	0	2	4	0	0
PALA-678	90	94	4	1	2	1	2	3
PALA-678	91	92	1	1	2	1	0	1
PALA-678	91	477	386	0	3	5	0	1
PALA-678	91	477	386	0	3	5	0	1
PALA-678	91	233	142	1	3	1	1	0
PALA-679	91	108	17	1	3	1	2	0
PALA-679	91	92	1	1	3	4	2	0
PALA-679	91	94	3	1	2	1	1	4
PALA-679	92	107	15	1	1	1	2	1
PALA-679	92	477	385	0	3	5	0	0
PALA-679	92	477	385	0	3	1	0	0
PALA-679	92	477	385	0	3	5	0	0
PALA-679	92	477	385	0	3	5	0	0
PALA-679	92	246	154	1	3	5	0	1
PALA-679	92	477	385	0	3	5	0	1
PALA-680	92	93	1	1	4	5	1	0
PALA-680	92	95	3	1	3	4	1	0
PALA-680	93	180	87	1	2	4	2	0
PALA-680	93	94	1	1	3	1	0	0
PALA-680	93	102	9	1	3	5	1	0
PALA-680	93	100	7	1	4	4	2	0
PALA-680	93	95	2	1	1	1	1	1
PALA-680	93	95	2	1	3	5	1	0
PALA-680	94	477	383	0	3	4	0	2
PALA-680	94	102	8	1	3	4	2	0
PALA-681	94	193	99	1	2	1	1	0
PALA-681	94	101	7	1	1	1	1	0
PALA-681	94	169	75	1	2	1	2	1
PALA-681	94	143	49	1	1	1	2	1
PALA-681	94	298	204	1	2	1	0	0
PALA-681	94	477	383	0	3	4	0	0
PALA-681	94	177	83	1	4	1	2	0
PALA-681	95	99	4	1	3	4	2	0
PALA-681	95	477	382	0	3	5	0	2
PALA-681	95	178	83	1	3	3	0	0
PALA-682	95	100	5	1	4	4	2	0
PALA-682	95	116	21	1	3	4	0	0
PALA-682	95	106	11	1	2	4	2	1
PALA-682	97	105	8	1	3	1	0	0
PALA-682	98	99	1	1	1	1	2	2
PALA-682	98	99	1	1	1	1	1	0
PALA-682	98	477	379	0	3	3	0	1
PALA-682	98	136	38	1	3	1	2	0
PALA-682	98	477	379	0	3	4	0	0
PALA-682	99	100	1	1	3	5	0	0
PALA-683	99	100	1	1	3	1	0	0
PALA-683	99	100	1	1	3	5	0	0
PALA-683	99	341	242	1	3	5	1	0
PALA-683	99	477	378	0	3	3	0	1
PALA-683	99	477	378	0	3	4	0	0
PALA-683	100	168	68	1	3	4	1	0
PALA-683	100	477	377	0	3	3	0	0
PALA-683	100	108	8	1	4	4	2	0
PALA-683	100	477	377	0	3	4	0	1
PALA-683	101	199	98	1	3	4	0	1
PALA-684	101	477	376	0	3	4	0	0
PALA-684	101	477	376	0	3	1	0	0
PALA-684	101	102	1	1	3	5	1	0
PALA-684	101	477	376	0	3	4	0	2
PALA-684	101	238	137	1	2	1	1	0
PALA-684	101	102	1	1	3	1	0	0
PALA-684	102	296	194	1	2	1	0	0
PALA-684	102	107	5	1	3	4	2	2
PALA-684	102	317	215	1	3	1	0	1
PALA-684	102	103	1	1	2	1	0	1
PALA-685	102	105	3	1	4	4	2	1
PALA-685	102	103	1	1	3	1	1	1
PALA-685	102	448	346	1	3	4	1	1
PALA-685	102	402	300	1	5	1	0	0
PALA-685	102	477	375	0	4	4	0	0
PALA-685	105	477	372	0	3	1	0	2
PALA-685	105	220	115	1	3	4	1	1
PALA-685	105	106	1	1	3	3	0	1
PALA-685	105	298	193	1	3	3	1	0
PALA-686	105	109	4	1	3	3	1	0
PALA-686	105	477	372	0	3	3	0	0
PALA-686	105	107	2	1	3	1	1	0
PALA-686	106	107	1	1	3	3	0	0
PALA-686	106	477	371	0	3	1	0	1
PALA-686	106	142	36	1	3	1	0	1
PALA-686	106	127	21	1	2	1	2	1
PALA-686	106	108	2	1	3	5	2	0
PALA-686	106	113	7	1	3	5	1	0
PALA-686	106	113	7	1	3	3	1	1
PALA-687	107	477	370	0	3	4	0	0
PALA-687	107	477	370	0	3	1	0	0
PALA-687	107	113	6	1	3	3	1	1
PALA-687	107	169	62	1	1	1	1	1
PALA-687	107	477	370	0	3	5	0	1
PALA-687	107	477	370	0	3	4	0	2
PALA-687	107	477	370	0	3	1	0	0
PALA-687	107	183	76	1	3	4	0	1
PALA-687	107	108	1	1	4	4	2	0
PALA-687	107	141	34	1	1	1	0	0
PALA-688	107	109	2	1	1	1	0	0
PALA-688	107	198	91	1	4	1	1	0
PALA-688	107	120	13	1	1	1	2	0
PALA-688	107	183	76	1	3	4	1	0
PALA-688	107	112	5	1	1	1	2	0
PALA-688	107	116	9	1	1	1	1	1
PALA-688	107	108	1	1	3	3	2	0
PALA-688	108	109	1	1	4	1	1	0
PALA-688	108	159	51	1	3	3	1	0
PALA-688	108	114	6	1	2	1	2	0
PALA-689	108	477	369	0	2	1	0	0
PALA-689	108	280	172	1	4	1	0	0
PALA-689	108	115	7	1	3	1	2	0
PALA-689	108	477	369	0	4	4	0	0
PALA-689	108	477	369	0	3	5	0	1
PALA-689	108	477	369	0	4	4	0	0
PALA-689	109	110	1	1	1	1	2	0
PALA-689	109	430	321	1	3	4	1	0
PALA-689	109	112	3	1	3	1	2	0
PALA-689	109	114	5	1	3	1	2	0
PALA-690	109	437	328	1	1	1	1	1
PALA-690	109	477	368	0	3	4	0	0
PALA-690	110	116	6	1	1	1	2	0
PALA-690	112	477	365	0	4	4	0	0
PALA-690	112	113	1	1	3	4	2	0
PALA-690	112	115	3	1	4	4	2	0
PALA-690	112	115	3	1	2	1	2	0
PALA-690	112	133	21	1	3	1	2	1
PALA-690	112	127	15	1	3	1	1	1
PALA-690	112	155	43	1	3	5	1	0
PALA-691	112	477	365	0	2	1	1	2
PALA-691	112	115	3	1	2	1	0	1
PALA-691	112	115	3	1	3	5	1	0
PALA-691	112	115	3	1	4	3	0	0
PALA-691	113	114	1	1	2	1	0	1
PALA-691	113	477	364	0	3	5	0	0
PALA-691	113	134	21	1	4	5	2	0
PALA-691	113	165	52	1	4	5	2	0
PALA-691	113	185	72	1	4	5	2	0
PALA-691	113	341	228	1	3	5	1	0
PALA-692	113	122	9	1	3	1	2	0
PALA-692	113	477	364	0	3	1	0	0
PALA-692	113	142	29	1	2	1	0	0
PALA-692	113	477	364	0	3	3	0	0
PALA-692	113	338	225	1	3	4	1	0
PALA-692	113	295	182	1	2	1	0	0
PALA-692	113	477	364	0	3	4	0	0
PALA-692	114	115	1	1	1	1	2	0
PALA-692	114	148	34	1	1	1	0	0
PALA-692	114	163	49	1	3	1	2	0
PALA-693	114	477	363	0	4	1	0	0
PALA-693	114	123	9	1	1	1	2	0
PALA-693	114	395	281	1	2	3	1	0
PALA-693	114	148	34	1	2	1	2	0
PALA-693	114	121	7	1	1	1	2	0
PALA-693	114	288	174	1	2	1	0	0
PALA-693	114	115	1	1	2	1	1	1
PALA-693	115	154	39	1	2	1	0	0
PALA-693	115	116	1	1	3	1	0	1
PALA-693	115	477	362	0	3	4	0	0
PALA-694	115	121	6	1	3	4	0	1
PALA-694	115	137	22	1	3	4	2	4
PALA-694	115	165	50	1	3	4	2	0
PALA-694	116	477	361	0	3	5	0	0
PALA-694	116	477	361	0	3	5	0	0
PALA-694	116	117	1	1	1	1	1	0
PALA-694	116	126	10	1	2	1	2	1
PALA-694	116	155	39	1	2	1	2	0
PALA-694	116	130	14	1	1	1	0	2
PALA-694	116	128	12	1	3	5	1	0
PALA-695	119	477	358	0	4	5	0	0
PALA-695	119	477	358	0	3	1	0	0
PALA-695	119	477	358	0	3	1	0	0
PALA-695	119	158	39	1	3	4	2	0
PALA-695	119	121	2	1	2	1	1	1
PALA-695	119	350	231	1	2	1	1	0
PALA-695	120	156	36	1	1	1	2	0
PALA-695	120	135	15	1	3	4	2	1
PALA-695	120	477	357	0	4	5	0	0
PALA-695	121	122	1	1	3	3	2	0
PALA-696	121	142	21	1	3	1	0	3
PALA-696	121	122	1	1	3	5	2	0
PALA-696	121	477	356	0	3	1	0	0
PALA-696	121	477	356	0	3	2	0	1
PALA-696	122	381	259	1	3	4	1	0
PALA-696	122	477	355	0	3	3	0	0
PALA-696	122	130	8	1	3	1	2	1
PALA-696	122	477	355	0	3	3	0	0
PALA-696	122	123	1	1	2	1	2	0
PALA-696	122	169	47	1	3	4	2	1
PALA-697	122	127	5	1	1	1	2	1
PALA-697	122	477	355	0	4	4	0	1
PALA-697	122	129	7	1	1	1	1	0
PALA-697	123	477	354	0	3	1	0	0
PALA-697	123	129	6	1	3	1	1	0
PALA-697	123	127	4	1	2	1	1	1
PALA-697	123	178	55	1	3	3	0	0
PALA-697	123	477	354	0	3	4	0	0
PALA-697	123	477	354	0	4	1	0	0
PALA-697	123	477	354	0	4	4	0	0
PALA-698	123	128	5	1	3	1	2	0
PALA-698	124	477	353	0	4	4	0	0
PALA-698	124	170	46	1	3	3	1	0
PALA-698	126	135	9	1	3	1	1	0
PALA-698	126	477	351	0	3	5	0	3
PALA-698	126	477	351	0	3	4	0	1
PALA-698	126	127	1	1	3	1	0	0
PALA-698	127	159	32	1	3	1	2	0
PALA-698	127	195	68	1	3	5	2	1
PALA-698	127	231	104	1	3	5	1	1
PALA-699	127	150	23	1	1	1	2	0
PALA-699	127	200	73	1	3	5	0	0
PALA-699	127	477	350	0	3	3	0	0
PALA-699	127	128	1	1	3	4	2	0
PALA-699	127	477	350	0	3	4	0	0
PALA-699	127	135	8	1	2	1	2	1
PALA-699	127	130	3	1	2	1	0	2
PALA-699	127	150	23	1	3	1	2	3
PALA-699	127	143	16	1	2	1	1	0
PALA-699	128	129	1	1	4	4	2	0
PALA-700	128	136	8	1	3	1	2	0
PALA-700	128	477	349	0	3	1	0	0
PALA-700	128	477	349	0	3	1	0	0
PALA-700	128	477	349	0	2	4	0	0
PALA-700	128	137	9	1	3	5	1	0
PALA-700	129	161	32	1	3	1	1	0
PALA-700	129	192	63	1	3	4	1	2
PALA-700	129	477	348	0	3	1	0	0
PALA-700	129	155	26	1	1	1	2	1
PALA-700	129	477	348	0	3	1	0	0
PALA-701	129	130	1	1	1	1	2	0
PALA-701	129	156	27	1	4	4	1	0
PALA-701	129	156	27	1	2	1	1	1
PALA-701	129	276	147	1	2	1	0	0
PALA-701	130	198	68	1	2	4	1	0
PALA-701	130	477	347	0	3	1	0	1
PALA-701	130	164	34	1	3	5	2	1
PALA-701	130	136	6	1	1	1	2	0
PALA-701	130	134	4	1	2	4	2	1
PALA-701	131	141	10	1	3	5	1	0
PALA-702	133	477	344	0	3	4	0	0
PALA-702	133	477	344	0	3	1	0	0
PALA-702	133	135	2	1	1	1	2	0
PALA-702	133	143	10	1	1	1	2	0
PALA-702	133	136	3	1	3	4	2	0
PALA-702	133	135	2	1	2	1	2	0
PALA-702	133	134	1	1	1	1	1	0
PALA-702	133	477	344	0	3	1	0	1
PALA-702	133	142	9	1	2	1	0	1
PALA-702	134	137	3	1	4	1	0	0
PALA-703	134	135	1	1	1	1	0	2
PALA-703	134	477	343	0	3	2	0	0
PALA-703	134	141	7	1	1	1	2	1
PALA-703	134	135	1	1	1	1	1	3
PALA-703	134	477	343	0	3	4	0	0
PALA-703	134	136	2	1	3	3	0	0
PALA-703	134	142	8	1	1	1	0	1
PALA-703	134	477	343	0	3	1	0	0
PALA-703	134	477	343	0	4	4	0	0
PALA-703	134	141	7	1	1	1	1	0
PALA-704	135	136	1	1	1	1	0	1
PALA-704	135	477	342	0	4	1	0	0
PALA-704	135	145	10	1	3	1	0	0
PALA-704	135	143	8	1	1	1	2	1
PALA-704	135	176	41	1	2	1	2	0
PALA-704	136	477	341	0	3	1	0	0
PALA-704	136	171	35	1	3	3	1	0
PALA-704	137	464	327	1	3	1	1	0
PALA-704	137	143	6	1	1	1	2	0
PALA-704	137	138	1	1	2	1	1	0
PALA-705	138	168	30	1	3	3	2	0
PALA-705	138	141	3	1	3	3	0	0
PALA-705	140	477	337	0	3	2	0	0
PALA-705	140	477	337	0	3	4	0	0
PALA-705	140	141	1	1	4	1	0	0
PALA-705	140	143	3	1	1	1	2	1
PALA-705	140	169	29	1	3	1	2	0
PALA-705	141	142	1	1	3	1	0	1
PALA-705	141	142	1	1	1	1	2	3
PALA-705	142	198	56	1	3	1	1	0
PALA-706	142	183	41	1	3	4	0	2
PALA-706	142	150	8	1	1	1	2	4
PALA-706	142	157	15	1	3	1	2	1
PALA-706	142	143	1	1	3	3	0	0
PALA-706	142	477	335	0	3	1	0	0
PALA-706	142	477	335	0	3	1	0	3
PALA-706	143	477	334	0	3	2	0	0
PALA-706	143	144	1	1	2	1	2	0
PALA-706	143	144	1	1	1	1	1	1
PALA-706	143	192	49	1	1	1	1	1
PALA-707	143	477	334	0	2	1	0	1
PALA-707	143	158	15	1	4	4	2	0
PALA-707	143	477	334	0	3	2	0	0
PALA-707	144	149	5	1	1	1	2	0
PALA-707	144	256	112	1	3	5	1	3
PALA-707	144	289	145	1	3	5	1	0
PALA-707	144	341	197	1	3	5	1	1
PALA-707	144	477	333	0	3	4	0	0
PALA-707	144	161	17	1	3	4	2	1
PALA-707	144	149	5	1	3	3	1	0
PALA-708	145	146	1	1	1	1	0	0
PALA-708	145	477	332	0	3	4	0	0
PALA-708	145	175	30	1	4	4	2	0
PALA-708	146	477	331	0	2	1	0	2
PALA-708	147	149	2	1	3	1	0	0
PALA-708	147	477	330	0	3	4	0	1
PALA-708	147	477	330	0	3	4	0	0
PALA-708	148	477	329	0	3	5	0	1
PALA-708	148	151	3	1	1	1	2	0
PALA-708	148	156	8	1	2	1	2	1
PALA-709	148	155	7	1	2	1	2	1
PALA-709	148	477	329	0	3	3	0	0
PALA-709	149	477	328	0	3	5	0	0
PALA-709	149	477	328	0	3	1	0	0
PALA-709	149	477	328	0	4	4	0	4
PALA-709	149	191	42	1	3	1	2	0
PALA-709	149	227	78	1	1	1	1	4
PALA-709	149	477	328	0	4	5	0	1
PALA-709	149	477	328	0	3	5	0	0
PALA-709	150	158	8	1	3	1	2	1
PALA-710	150	155	5	1	3	1	2	0
PALA-710	150	157	7	1	1	1	2	1
PALA-710	150	294	144	1	3	3	1	0
PALA-710	150	341	191	1	3	5	1	0
PALA-710	150	151	1	1	1	1	2	0
PALA-710	151	157	6	1	3	1	2	0
PALA-710	151	197	46	1	3	1	1	1
PALA-710	151	423	272	1	4	1	1	0
PALA-710	151	161	10	1	3	1	2	0
PALA-710	151	161	10	1	4	1	2	0
PALA-711	151	477	326	0	4	1	0	0
PALA-711	151	165	14	1	1	1	2	0
PALA-711	151	477	326	0	3	4	0	1
PALA-711	151	152	1	1	1	1	0	2
PALA-711	151	477	326	0	3	2	0	2
PALA-711	151	172	21	1	3	4	2	2
PALA-711	154	477	323	0	3	4	0	0
PALA-711	154	477	323	0	1	4	0	0
PALA-711	154	477	323	0	3	4	0	0
PALA-711	154	172	18	1	3	1	2	1
PALA-712	154	155	1	1	2	1	2	0
PALA-712	155	175	20	1	3	4	2	0
PALA-712	155	197	42	1	2	1	0	0
PALA-712	155	341	186	1	3	3	0	1
PALA-712	155	156	1	1	2	1	2	0
PALA-712	155	165	10	1	3	4	0	0
PALA-712	156	157	1	1	2	1	0	0
PALA-712	156	477	321	0	3	2	1	2
PALA-712	156	186	30	1	3	5	2	0
PALA-712	156	477	321	0	3	1	0	0
PALA-713	156	167	11	1	2	1	2	2
PALA-713	156	477	321	0	4	5	0	1
PALA-713	156	197	41	1	3	1	1	0
PALA-713	156	477	321	0	3	1	0	2
PALA-713	156	477	321	0	3	4	0	0
PALA-713	156	172	16	1	3	5	2	0
PALA-713	156	477	321	0	3	5	0	2
PALA-713	156	186	30	1	3	5	2	0
PALA-713	156	477	321	0	3	1	0	0
PALA-713	156	171	15	1	3	1	0	0
PALA-714	157	218	61	1	3	5	1	0
PALA-714	157	172	15	1	3	5	2	0
PALA-714	157	477	320	0	3	2	0	0
PALA-714	157	158	1	1	1	1	2	1
PALA-714	157	162	5	1	1	1	2	1
PALA-714	157	162	5	1	1	1	2	1
PALA-714	157	158	1	1	3	4	2	0
PALA-714	157	164	7	1	2	1	1	1
PALA-714	157	311	154	1	2	5	1	1
PALA-714	157	477	320	0	3	3	0	0
PALA-715	158	171	13	1	2	1	2	2
PALA-715	158	170	12	1	2	1	1	2
PALA-715	158	477	319	0	4	4	0	1
PALA-715	158	477	319	0	3	4	0	1
PALA-715	158	477	319	0	2	1	0	0
PALA-715	158	477	319	0	3	4	0	0
PALA-715	158	162	4	1	1	1	1	0
PALA-715	158	168	10	1	4	4	1	0
PALA-715	159	162	3	1	4	1	2	0
PALA-715	161	477	316	0	4	1	0	0
PALA-716	161	162	1	1	3	3	0	1
PALA-716	161	172	11	1	3	1	2	0
PALA-716	162	204	42	1	4	5	1	0
PALA-716	162	219	57	1	3	5	1	3
PALA-716	162	477	315	0	3	4	0	1
PALA-716	162	164	2	1	3	1	2	0
PALA-716	162	302	140	1	3	1	1	0
PALA-716	162	163	1	1	4	1	0	1
PALA-716	163	477	314	0	3	1	0	0
PALA-716	163	171	8	1	2	1	2	0
PALA-717	164	210	46	1	3	1	1	0
PALA-717	164	168	4	1	3	4	2	0
PALA-717	164	477	313	0	3	2	0	0
PALA-717	164	203	39	1	4	1	1	1
PALA-717	164	165	1	1	1	1	2	0
PALA-717	164	172	8	1	2	1	2	0
PALA-717	164	306	142	1	2	1	1	0
PALA-717	165	166	1	1	2	1	0	1
PALA-717	165	477	312	0	3	4	0	1
PALA-717	165	167	2	1	2	5	2	0
PALA-718	167	175	8	1	3	4	1	0
PALA-718	168	169	1	1	1	1	2	1
PALA-718	168	169	1	1	2	3	1	0
PALA-718	168	373	205	1	2	4	1	1
PALA-718	168	477	309	0	3	4	0	0
PALA-718	168	182	14	1	3	4	2	0
PALA-718	169	341	172	1	3	3	1	1
PALA-718	169	172	3	1	3	1	2	0
PALA-718	170	477	307	0	3	3	0	0
PALA-718	170	477	307	0	3	1	0	0
PALA-719	170	183	13	1	3	3	2	0
PALA-719	170	175	5	1	3	4	2	0
PALA-719	171	260	89	1	2	1	0	1
PALA-719	171	172	1	1	2	1	2	0
PALA-719	171	477	306	0	2	1	0	0
PALA-719	171	341	170	1	3	5	1	0
PALA-719	171	477	306	0	3	2	0	1
PALA-719	172	477	305	0	3	4	0	0
PALA-719	172	173	1	1	3	1	1	0
PALA-719	172	197	25	1	3	1	1	0
PALA-720	172	175	3	1	1	1	1	1
PALA-720	172	218	46	1	3	5	1	0
PALA-720	172	228	56	1	2	3	1	2
PALA-720	173	248	75	1	3	5	1	0
PALA-720	173	477	304	0	3	2	0	4
PALA-720	175	179	4	1	3	5	2	0
PALA-720	175	341	166	1	3	5	1	1
PALA-720	175	176	1	1	3	5	2	0
PALA-720	175	311	136	1	3	4	0	1
PALA-720	175	211	36	1	3	1	1	0
PALA-721	175	177	2	1	3	1	2	0
PALA-721	175	192	17	1	2	1	1	2
PALA-721	176	204	28	1	3	5	1	0
PALA-721	176	304	128	1	3	5	1	4
PALA-721	176	407	231	1	3	1	1	0
PALA-721	176	178	2	1	3	4	2	0
PALA-721	176	191	15	1	3	1	2	0
PALA-721	177	477	300	0	4	1	0	0
PALA-721	178	341	163	1	3	5	1	0
PALA-721	178	477	299	0	3	4	0	0
PALA-722	178	477	299	0	3	4	0	0
PALA-722	178	477	299	0	3	1	0	0
PALA-722	179	211	32	1	4	1	1	0
PALA-722	179	477	298	0	5	1	0	0
PALA-722	179	186	7	1	3	1	2	0
PALA-722	179	207	28	1	2	1	1	0
PALA-722	179	269	90	1	3	1	0	0
PALA-722	179	477	298	0	3	2	0	2
PALA-722	179	193	14	1	4	3	0	0
PALA-722	179	477	298	0	3	5	0	0
PALA-723	179	477	298	0	3	5	0	0
PALA-723	179	221	42	1	3	5	1	0
PALA-723	180	477	297	0	3	3	0	4
PALA-723	182	341	159	1	3	5	1	0
PALA-723	182	212	30	1	3	1	1	1
PALA-723	182	477	295	0	3	4	0	1
PALA-723	182	185	3	1	1	1	1	0
PALA-723	183	184	1	1	3	1	2	0
PALA-723	183	197	14	1	2	1	1	0
PALA-723	183	191	8	1	2	1	2	0
PALA-724	183	185	2	1	1	1	2	1
PALA-724	183	306	123	1	1	1	1	1
PALA-724	183	218	35	1	2	1	1	1
PALA-724	183	218	35	1	2	1	1	1
PALA-724	183	341	158	1	3	5	1	0
PALA-724	183	477	294	0	2	1	0	1
PALA-724	183	276	93	1	3	1	0	2
PALA-724	185	186	1	1	2	5	0	0
PALA-724	185	477	292	0	4	2	0	1
PALA-724	185	477	292	0	4	2	0	2
PALA-725	185	477	292	0	3	1	0	1
PALA-725	185	197	12	1	1	1	1	1
PALA-725	185	199	14	1	3	4	1	1
PALA-725	185	477	292	0	3	4	0	0
PALA-725	186	191	5	1	3	1	2	0
PALA-725	186	191	5	1	3	1	0	1
PALA-725	186	200	14	1	1	1	1	0
PALA-725	186	205	19	1	3	5	1	0
PALA-725	186	218	32	1	3	5	1	0
PALA-725	186	199	13	1	3	1	1	1
PALA-726	187	192	5	1	3	1	2	0
PALA-726	189	477	288	0	3	4	0	0
PALA-726	189	477	288	0	3	5	0	0
PALA-726	189	477	288	0	3	5	0	0
PALA-726	189	198	9	1	3	5	0	0
PALA-726	189	402	213	1	2	4	1	0
PALA-726	189	301	112	1	3	1	0	1
PALA-726	189	477	288	0	3	4	0	0
PALA-726	189	477	288	0	3	4	0	0
PALA-726	189	191	2	1	3	1	0	0
PALA-727	189	477	288	0	3	5	0	0
PALA-727	190	192	2	1	3	1	1	1
PALA-727	190	290	100	1	1	1	1	1
PALA-727	190	477	287	0	3	4	0	0
PALA-727	190	477	287	0	3	4	0	0
PALA-727	190	192	2	1	3	1	2	0
PALA-727	190	205	15	1	3	5	1	0
PALA-727	190	205	15	1	3	5	1	0
PALA-727	191	192	1	1	2	1	0	0
PALA-727	191	193	2	1	3	1	2	0
PALA-728	191	477	286	0	4	1	0	0
PALA-728	191	477	286	0	3	1	0	0
PALA-728	191	477	286	0	2	1	0	0
PALA-728	191	477	286	0	3	4	0	1
PALA-728	192	477	285	0	3	4	0	1
PALA-728	192	477	285	0	3	1	0	0
PALA-728	192	240	48	1	4	1	0	0
PALA-728	192	477	285	0	4	4	0	0
PALA-728	192	196	4	1	1	1	1	0
PALA-728	192	477	285	0	3	4	0	2
PALA-729	192	477	285	0	3	4	0	0
PALA-729	192	204	12	1	3	4	1	0
PALA-729	192	477	285	0	3	4	0	1
PALA-729	192	477	285	0	3	4	0	0
PALA-729	192	197	5	1	4	1	1	0
PALA-729	192	195	3	1	3	4	1	0
PALA-729	193	211	18	1	3	4	1	1
PALA-729	193	213	20	1	3	4	1	1
PALA-729	193	200	7	1	2	1	1	0
PALA-729	193	196	3	1	2	3	1	0
PALA-730	195	477	282	0	3	3	0	0
PALA-730	195	477	282	0	3	4	0	0
PALA-730	196	200	4	1	1	1	1	0
PALA-730	196	477	281	0	3	4	0	0
PALA-730	196	199	3	1	1	1	2	1
PALA-730	196	197	1	1	2	1	2	2
PALA-730	196	267	71	1	2	1	1	1
PALA-730	197	218	21	1	3	5	1	0
PALA-730	197	218	21	1	3	5	1	0
PALA-730	197	477	280	0	3	1	0	0
PALA-731	197	477	280	0	3	1	0	0
PALA-731	197	218	21	1	4	1	1	0
PALA-731	197	477	280	0	3	5	0	4
PALA-731	197	477	280	0	4	4	0	1
PALA-731	198	199	1	1	4	4	1	0
PALA-731	198	199	1	1	2	1	1	1
PALA-731	198	199	1	1	1	1	1	0
PALA-731	198	212	14	1	3	3	1	0
PALA-731	198	477	279	0	4	5	0	1
PALA-731	198	477	279	0	4	4	0	0
PALA-732	199	477	278	0	3	4	0	1
PALA-732	199	477	278	0	4	1	0	1
PALA-732	199	477	278	0	3	4	0	1
PALA-732	199	477	278	0	3	4	0	0
PALA-732	199	207	8	1	3	5	1	0
PALA-732	199	218	19	1	3	1	1	2
PALA-732	199	477	278	0	2	1	0	0
PALA-732	199	477	278	0	3	2	0	0
PALA-732	200	221	21	1	2	1	0	1
PALA-732	200	211	11	1	3	1	1	0
PALA-733	200	204	4	1	3	4	1	1
PALA-733	200	477	277	0	3	5	0	0
PALA-733	200	477	277	0	3	5	0	0
PALA-733	200	221	21	1	3	5	1	1
PALA-733	203	477	274	0	3	2	0	0
PALA-733	203	263	60	1	1	1	1	4
PALA-733	203	207	4	1	3	1	0	0
PALA-733	203	212	9	1	3	5	1	0
PALA-733	203	477	274	0	3	5	0	0
PALA-733	203	214	11	1	3	5	0	1
PALA-734	203	206	3	1	4	4	1	0
PALA-734	203	214	11	1	3	5	0	1
PALA-734	203	226	23	1	3	5	1	0
PALA-734	203	231	28	1	3	5	1	0
PALA-734	204	233	29	1	3	5	1	0
PALA-734	204	231	27	1	3	5	1	0
PALA-734	205	405	200	1	3	4	0	2
PALA-734	205	225	20	1	1	1	1	0
PALA-734	205	260	55	1	1	1	1	0
PALA-734	205	280	75	1	3	4	1	1
PALA-735	205	477	272	0	3	4	0	0
PALA-735	205	477	272	0	3	5	0	1
PALA-735	205	267	62	1	3	5	1	0
PALA-735	205	347	142	1	3	5	1	0
PALA-735	205	218	13	1	3	5	1	0
PALA-735	205	477	272	0	3	5	0	0
PALA-735	205	477	272	0	3	5	0	1
PALA-735	205	477	272	0	3	4	0	0
PALA-735	205	477	272	0	3	5	0	0
PALA-735	206	477	271	0	3	4	0	1
PALA-736	206	207	1	1	1	1	1	2
PALA-736	206	220	14	1	3	1	1	0
PALA-736	206	247	41	1	3	4	1	2
PALA-736	206	304	98	1	2	1	1	1
PALA-736	207	233	26	1	3	4	1	1
PALA-736	207	477	270	0	3	4	0	0
PALA-736	207	477	270	0	3	5	0	0
PALA-736	210	322	112	1	3	4	1	2
PALA-736	211	477	266	0	3	5	0	0
PALA-736	211	477	266	0	3	5	0	0
PALA-737	211	477	266	0	3	5	0	0
PALA-737	211	477	266	0	2	1	0	0
PALA-737	211	477	266	0	3	5	0	0
PALA-737	211	212	1	1	3	4	0	0
PALA-737	211	477	266	0	3	5	0	0
PALA-737	211	477	266	0	3	5	0	0
PALA-737	211	219	8	1	2	1	1	0
PALA-737	211	214	3	1	3	5	1	0
PALA-737	211	217	6	1	1	1	0	3
PALA-737	211	304	93	1	3	1	1	0
PALA-738	211	477	266	0	3	1	0	0
PALA-738	212	214	2	1	3	4	1	0
PALA-738	212	477	265	0	3	4	0	1
PALA-738	212	224	12	1	5	4	1	0
PALA-738	212	477	265	0	5	4	0	0
PALA-738	212	407	195	1	3	3	1	1
PALA-738	213	219	6	1	3	1	1	0
PALA-738	213	217	4	1	4	1	1	0
PALA-738	213	225	12	1	3	1	1	0
PALA-738	213	477	264	0	3	4	0	1
PALA-739	213	477	264	0	3	3	0	0
PALA-739	214	215	1	1	3	5	0	0
PALA-739	214	341	127	1	3	5	1	2
PALA-739	214	218	4	1	3	4	1	0
PALA-739	214	219	5	1	4	4	1	0
PALA-739	214	215	1	1	3	1	1	0
PALA-739	214	217	3	1	3	1	1	1
PALA-739	216	218	2	1	1	1	1	1
PALA-739	217	224	7	1	3	4	1	0
PALA-739	217	234	17	1	3	2	0	0
PALA-740	217	219	2	1	3	1	1	0
PALA-740	217	218	1	1	1	1	0	1
PALA-740	217	233	16	1	1	1	1	2
PALA-740	218	219	1	1	1	1	1	1
PALA-740	218	477	259	0	1	1	0	0
PALA-740	218	477	259	0	3	1	0	0
PALA-740	218	228	10	1	3	4	1	0
PALA-740	218	231	13	1	1	1	0	0
PALA-740	218	226	8	1	3	4	1	0
PALA-740	218	477	259	0	3	4	0	0
PALA-741	219	220	1	1	1	4	1	0
PALA-741	219	253	34	1	1	4	0	1
PALA-741	219	238	19	1	3	1	1	1
PALA-741	219	220	1	1	1	1	0	1
PALA-741	219	477	258	0	4	1	0	2
PALA-741	219	221	2	1	2	1	1	1
PALA-741	220	477	257	0	3	4	0	1
PALA-741	220	247	27	1	3	4	0	2
PALA-741	220	235	15	1	1	1	1	2
PALA-741	220	225	5	1	2	1	1	1
PALA-742	220	261	41	1	3	4	1	1
PALA-742	221	241	20	1	3	1	1	0
PALA-742	221	262	41	1	1	1	1	1
PALA-742	221	225	4	1	3	1	1	0
PALA-742	221	242	21	1	3	5	1	1
PALA-742	222	248	26	1	3	5	1	1
PALA-742	222	254	32	1	3	1	1	0
PALA-742	224	477	253	0	4	4	0	0
PALA-742	224	225	1	1	3	1	1	1
PALA-742	224	477	253	0	3	4	0	0
PALA-743	224	263	39	1	1	3	1	0
PALA-743	224	341	117	1	3	5	0	0
PALA-743	224	341	117	1	3	5	1	0
PALA-743	224	234	10	1	3	1	1	0
PALA-743	224	341	117	1	3	5	1	0
PALA-743	224	477	253	0	3	1	0	1
PALA-743	225	239	14	1	3	5	1	0
PALA-743	225	233	8	1	3	5	1	0
PALA-743	225	477	252	0	3	5	0	0
PALA-743	225	241	16	1	3	1	1	0
PALA-744	225	227	2	1	3	3	1	0
PALA-744	225	477	252	0	3	3	0	0
PALA-744	225	227	2	1	2	1	1	1
PALA-744	225	226	1	1	3	1	1	0
PALA-744	225	231	6	1	4	4	1	0
PALA-744	225	226	1	1	1	1	1	0
PALA-744	225	373	148	1	2	1	1	2
PALA-744	226	233	7	1	3	5	1	0
PALA-744	226	322	96	1	3	4	1	1
PALA-744	226	232	6	1	2	1	1	1
PALA-745	226	464	238	1	3	4	1	0
PALA-745	226	227	1	1	1	1	0	0
PALA-745	226	227	1	1	1	1	1	0
PALA-745	226	240	14	1	3	4	1	0
PALA-745	226	477	251	0	3	4	0	0
PALA-745	227	228	1	1	3	3	0	0
PALA-745	227	268	41	1	3	5	1	1
PALA-745	228	233	5	1	3	4	1	0
PALA-745	228	477	249	0	3	1	0	0
PALA-745	228	229	1	1	1	1	1	2
PALA-746	228	235	7	1	2	1	1	0
PALA-746	228	229	1	1	1	1	0	1
PALA-746	229	276	47	1	3	1	0	0
PALA-746	231	232	1	1	1	1	0	1
PALA-746	231	256	25	1	2	1	1	0
PALA-746	231	232	1	1	2	1	1	2
PALA-746	231	233	2	1	5	4	1	0
PALA-746	232	477	245	0	3	5	0	2
PALA-746	232	373	141	1	3	5	1	0
PALA-746	232	248	16	1	3	5	1	0
PALA-747	232	233	1	1	4	1	1	0
PALA-747	232	477	245	0	2	1	0	1
PALA-747	232	477	245	0	4	1	0	0
PALA-747	232	339	107	1	2	1	1	2
PALA-747	232	477	245	0	3	4	0	0
PALA-747	232	477	245	0	3	4	0	0
PALA-747	233	238	5	1	3	1	1	1
PALA-747	234	309	75	1	3	5	1	2
PALA-747	234	477	243	0	3	4	0	1
PALA-747	234	477	243	0	3	3	0	0
PALA-748	234	235	1	1	3	1	0	0
PALA-748	234	341	107	1	3	5	1	0
PALA-748	235	477	242	0	2	1	0	2
PALA-748	235	238	3	1	3	5	1	0
PALA-748	235	477	242	0	3	1	0	0
PALA-748	235	298	63	1	2	1	0	2
PALA-748	235	477	242	0	3	4	0	0
PALA-748	235	256	21	1	3	1	1	1
PALA-748	235	262	27	1	2	1	1	1
PALA-748	235	477	242	0	3	1	0	0
PALA-749	237	263	26	1	3	1	2	0
PALA-749	238	477	239	0	3	1	0	0
PALA-749	238	273	35	1	3	5	0	1
PALA-749	238	269	31	1	2	1	0	0
PALA-749	238	269	31	1	2	1	1	0
PALA-749	238	477	239	0	3	4	0	0
PALA-749	239	477	238	0	3	2	0	0
PALA-749	239	341	102	1	3	4	1	1
PALA-749	239	266	27	1	3	5	1	0
PALA-749	239	253	14	1	3	4	1	0
PALA-750	239	240	1	1	3	1	1	0
PALA-750	239	477	238	0	4	5	0	0
PALA-750	239	241	2	1	3	1	1	0
PALA-750	239	270	31	1	3	5	1	0
PALA-750	239	477	238	0	4	4	0	0
PALA-750	240	246	6	1	3	1	0	1
PALA-750	240	477	237	0	3	5	0	0
PALA-750	240	477	237	0	3	5	0	0
PALA-750	240	451	211	1	4	4	0	0
PALA-750	240	345	105	1	2	5	1	0
PALA-751	240	249	9	1	3	5	1	0
PALA-751	241	243	2	1	3	3	0	1
PALA-751	241	269	28	1	2	1	0	1
PALA-751	241	242	1	1	3	1	1	0
PALA-751	241	477	236	0	3	5	0	0
PALA-751	241	477	236	0	3	4	0	0
PALA-751	241	252	11	1	2	1	1	0
PALA-751	241	242	1	1	2	1	1	0
PALA-751	242	477	235	0	3	3	0	0
PALA-751	242	266	24	1	3	4	1	0
PALA-752	244	274	30	1	3	1	1	0
PALA-752	245	277	32	1	3	4	0	4
PALA-752	246	249	3	1	3	1	1	1
PALA-752	246	477	231	0	2	3	0	1
PALA-752	246	477	231	0	3	4	0	0
PALA-752	246	341	95	1	3	5	1	1
PALA-752	247	387	140	1	3	1	0	0
PALA-752	247	276	29	1	2	5	1	0
PALA-752	247	311	64	1	2	1	1	0
PALA-752	247	248	1	1	4	2	1	0
PALA-753	247	260	13	1	2	5	1	2
PALA-753	247	270	23	1	3	5	1	0
PALA-753	247	298	51	1	3	5	1	0
PALA-753	247	477	230	0	3	5	0	0
PALA-753	247	381	134	1	3	5	1	0
PALA-753	247	477	230	0	3	5	0	0
PALA-753	247	477	230	0	3	5	0	0
PALA-753	247	268	21	1	3	1	1	1
PALA-753	247	477	230	0	3	5	0	0
PALA-753	247	477	230	0	3	5	0	0
PALA-754	248	464	216	1	3	4	1	0
PALA-754	248	477	229	0	2	1	0	0
PALA-754	248	252	4	1	3	1	1	0
PALA-754	248	308	60	1	3	5	1	2
PALA-754	248	477	229	0	3	4	0	0
PALA-754	248	289	41	1	2	1	1	0
PALA-754	248	341	93	1	3	5	1	0
PALA-754	249	477	228	0	3	4	0	1
PALA-754	252	253	1	1	4	1	0	0
PALA-754	252	253	1	1	2	1	1	0
PALA-755	252	477	225	0	3	4	0	2
PALA-755	252	477	225	0	3	4	0	0
PALA-755	253	477	224	0	5	1	0	0
PALA-755	253	477	224	0	3	4	0	0
PALA-755	253	284	31	1	5	4	1	0
PALA-755	253	318	65	1	3	1	1	4
PALA-755	253	477	224	0	3	4	0	1
PALA-755	253	477	224	0	4	4	0	0
PALA-755	253	477	224	0	4	4	0	0
PALA-755	253	256	3	1	1	1	1	1
PALA-756	253	477	224	0	3	1	0	2
PALA-756	253	477	224	0	3	4	0	2
PALA-756	254	255	1	1	3	1	0	0
PALA-756	254	255	1	1	3	5	0	0
PALA-756	255	477	222	0	3	1	0	2
PALA-756	255	400	145	1	1	4	1	3
PALA-756	255	268	13	1	1	4	1	4
PALA-756	255	256	1	1	3	1	0	1
PALA-756	255	323	68	1	3	4	1	4
PALA-756	255	256	1	1	3	1	1	0
PALA-757	255	274	19	1	3	1	1	0
PALA-757	256	477	221	0	4	2	0	0
PALA-757	256	477	221	0	3	1	0	0
PALA-757	256	260	4	1	2	4	1	0
PALA-757	256	477	221	0	3	5	0	0
PALA-757	256	276	20	1	3	1	1	1
PALA-757	256	260	4	1	3	4	1	0
PALA-757	257	477	220	0	4	4	0	0
PALA-757	259	477	218	0	3	4	0	0
PALA-757	259	262	3	1	1	1	1	0
PALA-758	259	260	1	1	1	1	1	0
PALA-758	259	276	17	1	2	1	1	0
PALA-758	259	477	218	0	3	3	0	0
PALA-758	259	288	29	1	2	1	0	0
PALA-758	260	263	3	1	3	1	0	0
PALA-758	260	274	14	1	3	1	1	1
PALA-758	260	304	44	1	1	1	1	4
PALA-758	260	477	217	0	3	4	0	0
PALA-758	260	261	1	1	1	1	1	1
PALA-758	260	266	6	1	3	5	1	0
PALA-759	260	291	31	1	1	1	0	0
PALA-759	261	264	3	1	4	1	1	0
PALA-759	261	477	216	0	3	4	0	0
PALA-759	261	269	8	1	1	1	1	1
PALA-759	261	415	154	1	2	1	0	3
PALA-759	261	275	14	1	1	1	1	2
PALA-759	261	269	8	1	3	3	0	0
PALA-759	261	291	30	1	2	1	1	1
PALA-759	261	477	216	0	3	1	0	0
PALA-759	261	273	12	1	3	4	1	1
PALA-760	262	268	6	1	1	1	1	1
PALA-760	262	477	215	0	3	4	0	1
PALA-760	262	477	215	0	3	4	0	0
PALA-760	262	477	215	0	4	1	0	0
PALA-760	263	477	214	0	3	1	0	0
PALA-760	263	273	10	1	1	1	0	1
PALA-760	263	322	59	1	3	1	1	0
PALA-760	263	281	18	1	3	3	1	0
PALA-760	263	477	214	0	3	4	0	0
PALA-760	264	477	213	0	3	2	0	1
PALA-761	265	477	212	0	3	4	0	0
PALA-761	265	477	212	0	3	2	0	0
PALA-761	266	477	211	0	4	1	0	0
PALA-761	266	477	211	0	3	1	0	1
PALA-761	266	341	75	1	3	3	1	4
PALA-761	266	477	211	0	3	4	0	0
PALA-761	267	269	2	1	4	1	1	0
PALA-761	267	268	1	1	3	1	1	0
PALA-761	267	477	210	0	3	1	0	0
PALA-761	267	268	1	1	4	4	0	1
PALA-762	267	477	210	0	3	4	0	0
PALA-762	267	477	210	0	3	4	0	0
PALA-762	267	285	18	1	3	4	1	0
PALA-762	267	280	13	1	3	5	1	0
PALA-762	267	269	2	1	3	3	1	0
PALA-762	268	372	104	1	3	5	1	0
PALA-762	268	280	12	1	3	1	1	0
PALA-762	268	477	209	0	3	4	0	0
PALA-762	268	296	28	1	1	1	1	0
PALA-762	268	274	6	1	1	1	0	0
PALA-763	268	477	209	0	3	2	0	0
PALA-763	268	269	1	1	3	5	1	0
PALA-763	268	271	3	1	1	1	1	0
PALA-763	268	282	14	1	2	1	1	1
PALA-763	268	341	73	1	3	5	1	0
PALA-763	268	477	209	0	3	4	0	0
PALA-763	268	477	209	0	3	4	0	0
PALA-763	269	477	208	0	3	4	0	0
PALA-763	269	477	208	0	3	1	1	3
PALA-763	269	289	20	1	2	4	1	0
PALA-764	269	461	192	1	3	4	1	0
PALA-764	270	396	126	1	4	1	0	0
PALA-764	270	477	207	0	3	4	0	0
PALA-764	271	295	24	1	3	5	1	0
PALA-764	273	290	17	1	3	4	1	0
PALA-764	273	422	149	1	3	2	1	1
PALA-764	273	274	1	1	3	1	1	0
PALA-764	273	295	22	1	3	5	1	1
PALA-764	274	360	86	1	3	5	1	1
PALA-764	274	276	2	1	4	1	0	0
PALA-765	274	477	203	0	3	3	0	0
PALA-765	275	277	2	1	3	1	1	0
PALA-765	275	477	202	0	3	4	0	0
PALA-765	276	477	201	0	3	4	0	0
PALA-765	276	281	5	1	3	1	1	0
PALA-765	276	477	201	0	3	4	0	2
PALA-765	276	477	201	0	3	5	0	0
PALA-765	276	403	127	1	3	4	1	1
PALA-765	276	477	201	0	3	4	0	1
PALA-765	276	341	65	1	3	1	1	3
PALA-766	276	289	13	1	3	4	1	0
PALA-766	276	295	19	1	2	1	1	0
PALA-766	276	336	60	1	1	1	1	2
PALA-766	276	280	4	1	2	1	1	1
PALA-766	276	477	201	0	4	4	0	0
PALA-766	277	477	200	0	2	1	0	2
PALA-766	277	477	200	0	3	4	0	0
PALA-766	277	278	1	1	2	1	1	0
PALA-766	277	295	18	1	3	1	1	0
PALA-766	277	291	14	1	2	1	1	0
PALA-767	277	477	200	0	2	1	0	0
PALA-767	277	280	3	1	3	1	1	0
PALA-767	277	477	200	0	3	5	0	0
PALA-767	277	288	11	1	4	4	1	0
PALA-767	277	477	200	0	3	4	0	0
PALA-767	278	322	44	1	3	1	1	0
PALA-767	280	282	2	1	3	1	1	0
PALA-767	280	296	16	1	1	1	1	0
PALA-767	280	289	9	1	1	1	1	0
PALA-767	280	382	102	1	3	4	1	0
PALA-768	280	282	2	1	3	4	1	0
PALA-768	281	292	11	1	3	1	1	2
PALA-768	281	283	2	1	3	1	1	0
PALA-768	281	477	196	0	4	4	0	0
PALA-768	281	291	10	1	3	1	1	0
PALA-768	282	283	1	1	3	1	1	0
PALA-768	282	477	195	0	4	4	0	0
PALA-768	282	341	59	1	3	5	1	0
PALA-768	282	283	1	1	3	1	1	0
PALA-768	282	291	9	1	3	4	1	0
PALA-769	282	284	2	1	1	1	1	0
PALA-769	282	310	28	1	1	4	1	1
PALA-769	282	477	195	0	4	1	0	0
PALA-769	282	283	1	1	3	1	1	0
PALA-769	282	402	120	1	3	4	1	3
PALA-769	283	477	194	0	4	4	0	0
PALA-769	283	345	62	1	2	1	0	0
PALA-769	283	295	12	1	1	1	1	0
PALA-769	283	477	194	0	3	3	0	1
PALA-769	283	295	12	1	2	1	1	0
PALA-770	283	290	7	1	1	1	0	0
PALA-770	283	284	1	1	3	1	1	0
PALA-770	284	289	5	1	3	4	1	0
PALA-770	284	287	3	1	3	4	1	0
PALA-770	284	287	3	1	1	1	1	0
PALA-770	284	341	57	1	3	5	1	1
PALA-770	284	341	57	1	3	3	1	0
PALA-770	287	477	190	0	3	1	0	0
PALA-770	287	291	4	1	3	4	1	0
PALA-770	287	288	1	1	3	4	1	0
PALA-771	287	308	21	1	1	1	1	1
PALA-771	287	477	190	0	4	4	0	0
PALA-771	288	477	189	0	3	5	0	0
PALA-771	288	289	1	1	3	4	1	0
PALA-771	288	298	10	1	1	1	1	2
PALA-771	288	289	1	1	4	4	1	1
PALA-771	288	289	1	1	3	1	0	0
PALA-771	288	291	3	1	2	1	1	0
PALA-771	289	449	160	1	3	5	1	0
PALA-771	289	302	13	1	3	1	0	0
PALA-772	289	477	188	0	4	3	0	0
PALA-772	290	294	4	1	3	1	1	0
PALA-772	290	477	187	0	4	4	0	0
PALA-772	290	291	1	1	4	4	0	1
PALA-772	290	477	187	0	3	5	0	4
PALA-772	290	449	159	1	3	5	1	0
PALA-772	290	477	187	0	3	1	0	1
PALA-772	290	302	12	1	1	1	1	1
PALA-772	291	346	55	1	3	3	1	0
PALA-772	291	294	3	1	1	1	1	0
PALA-773	291	477	186	0	3	3	0	0
PALA-773	291	389	98	1	3	4	1	0
PALA-773	291	477	186	0	2	3	0	0
PALA-773	291	477	186	0	1	1	0	1
PALA-773	294	477	183	0	4	1	0	0
PALA-773	294	302	8	1	2	4	1	0
PALA-773	294	333	39	1	2	1	0	0
PALA-773	294	477	183	0	3	4	0	1
PALA-773	294	376	82	1	2	4	1	4
PALA-773	294	296	2	1	4	4	1	1
PALA-774	294	296	2	1	3	1	1	1
PALA-774	294	477	183	0	3	4	0	1
PALA-774	294	301	7	1	2	1	1	0
PALA-774	294	341	47	1	3	5	1	0
PALA-774	295	344	49	1	4	1	0	0
PALA-774	295	477	182	0	3	1	0	0
PALA-774	295	296	1	1	1	1	0	2
PALA-774	295	477	182	0	4	4	0	4
PALA-774	295	297	2	1	4	4	0	0
PALA-774	296	301	5	1	2	5	1	0
PALA-775	296	477	181	0	5	4	0	1
PALA-775	296	477	181	0	3	4	0	0
PALA-775	297	477	180	0	4	1	0	2
PALA-775	297	477	180	0	4	1	0	2
PALA-775	297	477	180	0	3	1	0	2
PALA-775	297	477	180	0	4	1	0	1
PALA-775	297	477	180	0	4	4	0	1
PALA-775	297	477	180	0	3	4	0	2
PALA-775	297	301	4	1	3	1	1	0
PALA-775	297	336	39	1	3	2	1	0
PALA-776	297	299	2	1	2	1	1	0
PALA-776	297	316	19	1	1	4	1	0
PALA-776	297	477	180	0	3	4	0	1
PALA-776	297	477	180	0	3	4	0	0
PALA-776	297	317	20	1	3	4	1	0
PALA-776	297	341	44	1	3	5	1	0
PALA-776	297	477	180	0	4	4	0	0
PALA-776	297	477	180	0	3	1	0	0
PALA-776	298	477	179	0	3	4	0	0
PALA-776	298	477	179	0	4	4	0	1
PALA-777	298	477	179	0	3	4	0	0
PALA-777	298	397	99	1	3	1	1	0
PALA-777	298	477	179	0	3	4	0	0
PALA-777	298	477	179	0	3	1	0	0
PALA-777	298	299	1	1	3	4	0	0
PALA-777	299	308	9	1	2	1	1	2
PALA-777	301	302	1	1	3	4	0	1
PALA-777	301	308	7	1	3	1	1	2
PALA-777	301	477	176	0	4	1	0	0
PALA-777	301	477	176	0	3	1	0	0
PALA-778	301	477	176	0	5	4	0	0
PALA-778	301	477	176	0	4	1	0	1
PALA-778	301	477	176	0	3	1	0	0
PALA-778	302	303	1	1	3	1	0	0
PALA-778	302	477	175	0	2	1	0	1
PALA-778	302	477	175	0	4	1	0	3
PALA-778	302	304	2	1	4	4	1	0
PALA-778	302	477	175	0	3	1	0	0
PALA-778	302	341	39	1	3	5	1	0
PALA-778	302	341	39	1	3	5	1	0
PALA-779	302	337	35	1	3	1	1	0
PALA-779	302	311	9	1	1	5	1	0
PALA-779	303	304	1	1	1	1	1	0
PALA-779	303	477	174	0	3	1	0	1
PALA-779	303	305	2	1	2	1	1	1
PALA-779	303	368	65	1	3	2	1	0
PALA-779	303	304	1	1	2	1	0	1
PALA-779	304	305	1	1	4	1	0	0
PALA-779	304	305	1	1	2	1	0	2
PALA-779	304	477	173	0	2	4	0	0
PALA-780	304	455	151	1	3	4	1	0
PALA-780	304	344	40	1	4	4	0	0
PALA-780	305	477	172	0	2	4	0	0
PALA-780	305	477	172	0	2	1	0	0
PALA-780	305	427	122	1	1	1	1	2
PALA-780	308	418	110	1	4	4	0	1
PALA-780	308	341	33	1	3	3	1	0
PALA-780	308	418	110	1	4	4	1	0
PALA-780	308	424	116	1	4	4	0	0
PALA-780	308	309	1	1	1	1	1	0
PALA-781	308	309	1	1	1	1	1	1
PALA-781	308	337	29	1	3	5	1	0
PALA-781	308	477	169	0	3	5	0	0
PALA-781	309	477	168	0	3	1	0	1
PALA-781	309	477	168	0	3	5	0	0
PALA-781	309	341	32	1	3	3	1	0
PALA-781	309	477	168	0	3	1	0	0
PALA-781	309	477	168	0	3	1	0	0
PALA-781	309	424	115	1	4	4	0	0
PALA-781	309	316	7	1	3	4	1	0
PALA-782	309	477	168	0	3	5	0	1
PALA-782	309	424	115	1	4	4	0	0
PALA-782	309	310	1	1	2	1	1	0
PALA-782	309	477	168	0	5	4	0	1
PALA-782	310	311	1	1	2	1	1	0
PALA-782	310	477	167	0	3	4	0	0
PALA-782	310	427	117	1	4	1	0	1
PALA-782	310	477	167	0	3	4	0	0
PALA-782	310	311	1	1	1	1	1	0
PALA-782	310	329	19	1	2	1	1	0
PALA-783	310	477	167	0	3	4	0	0
PALA-783	310	477	167	0	3	4	0	4
PALA-783	310	388	78	1	4	2	1	0
PALA-783	311	477	166	0	2	1	0	0
PALA-783	311	477	166	0	2	1	0	0
PALA-783	311	312	1	1	2	1	1	0
PALA-783	311	341	30	1	3	5	1	0
PALA-783	311	318	7	1	1	1	1	0
PALA-783	311	477	166	0	4	4	0	1
PALA-783	311	330	19	1	4	4	1	0
PALA-784	311	316	5	1	2	1	1	0
PALA-784	311	424	113	1	4	4	0	0
PALA-784	314	402	88	1	4	4	1	0
PALA-784	315	477	162	0	3	4	0	0
PALA-784	316	477	161	0	4	1	0	0
PALA-784	316	477	161	0	4	1	0	1
PALA-784	316	477	161	0	5	4	0	0
PALA-784	316	418	102	1	5	4	0	0
PALA-784	316	317	1	1	3	1	1	0
PALA-784	317	477	160	0	3	4	0	0
PALA-785	317	318	1	1	3	1	0	0
PALA-785	317	324	7	1	1	1	1	0
PALA-785	317	329	12	1	2	1	1	0
PALA-785	318	379	61	1	3	4	1	0
PALA-785	318	477	159	0	2	4	0	0
PALA-785	318	477	159	0	4	4	0	0
PALA-785	318	323	5	1	2	1	1	1
PALA-785	318	322	4	1	3	1	1	0
PALA-785	319	477	158	0	4	4	0	0
PALA-786	319	477	158	0	3	1	0	1
PALA-786	319	341	22	1	5	1	1	0
PALA-786	319	477	158	0	3	1	0	0
PALA-786	320	321	1	1	3	1	1	0
PALA-786	321	352	31	1	2	1	1	0
PALA-786	321	477	156	0	4	4	0	0
PALA-786	321	424	103	1	4	4	0	0
PALA-786	321	477	156	0	4	4	0	0
PALA-786	322	424	102	1	4	4	0	0
PALA-786	322	330	8	1	3	4	1	0
PALA-787	322	382	60	1	2	1	1	1
PALA-787	322	323	1	1	3	4	1	0
PALA-787	322	477	155	0	3	4	0	1
PALA-787	323	324	1	1	1	1	1	1
PALA-787	323	477	154	0	3	1	0	0
PALA-787	323	331	8	1	3	5	1	1
PALA-787	323	477	154	0	1	1	0	0
PALA-787	324	477	153	0	3	4	0	0
PALA-787	324	477	153	0	3	4	0	0
PALA-787	324	477	153	0	3	4	0	0
PALA-788	324	477	153	0	3	2	0	0
PALA-788	324	424	100	1	4	4	1	0
PALA-788	325	330	5	1	1	1	1	0
PALA-788	325	477	152	0	2	1	0	0
PALA-788	326	327	1	1	3	1	0	0
PALA-788	329	477	148	0	3	4	0	0
PALA-788	329	362	33	1	4	1	0	1
PALA-788	329	362	33	1	4	1	0	1
PALA-788	329	362	33	1	4	1	0	1
PALA-788	329	381	52	1	3	4	1	1
PALA-789	329	477	148	0	4	1	0	0
PALA-789	329	362	33	1	4	1	0	2
PALA-789	329	424	95	1	4	1	0	0
PALA-789	329	331	2	1	4	1	1	0
PALA-789	330	362	32	1	4	1	0	1
PALA-789	330	396	66	1	4	1	1	0
PALA-789	330	362	32	1	4	4	0	1
PALA-789	330	477	147	0	4	1	0	0
PALA-789	330	477	147	0	4	1	0	0
PALA-789	330	477	147	0	4	1	0	0
PALA-790	330	477	147	0	4	1	0	0
PALA-790	330	331	1	1	3	1	1	1
PALA-790	330	424	94	1	4	4	1	4
PALA-790	330	343	13	1	2	4	1	1
PALA-790	331	477	146	0	3	2	0	0
PALA-790	331	424	93	1	4	1	1	1
PALA-790	331	345	14	1	2	1	0	1
PALA-790	331	424	93	1	4	1	1	0
PALA-790	332	341	9	1	3	5	1	0
PALA-790	332	333	1	1	3	4	0	1
PALA-791	332	477	145	0	2	1	0	0
PALA-791	333	477	144	0	3	2	0	0
PALA-791	333	477	144	0	3	4	0	1
PALA-791	333	347	14	1	3	1	1	0
PALA-791	333	418	85	1	4	4	1	0
PALA-791	333	418	85	1	4	4	1	0
PALA-791	334	477	143	0	2	5	1	0
PALA-791	334	445	111	1	2	5	1	0
PALA-791	334	450	116	1	2	5	1	0
PALA-791	335	394	59	1	3	4	1	1
PALA-792	336	449	113	1	3	5	1	0
PALA-792	336	427	91	1	2	1	0	0
PALA-792	336	337	1	1	1	1	0	0
PALA-792	337	477	140	0	3	4	0	1
PALA-792	337	381	44	1	3	3	1	1
PALA-792	337	366	29	1	2	1	1	1
PALA-792	337	346	9	1	3	1	1	0
PALA-792	337	424	87	1	4	4	0	0
PALA-792	338	401	63	1	2	1	1	0
PALA-792	338	403	65	1	3	1	1	0
PALA-793	339	477	138	0	2	1	0	0
PALA-793	339	380	41	1	2	1	1	0
PALA-793	339	340	1	1	3	1	0	1
PALA-793	339	477	138	0	3	5	0	0
PALA-793	339	396	57	1	3	1	1	0
PALA-793	339	477	138	0	3	1	0	0
PALA-793	339	477	138	0	3	4	0	0
PALA-793	339	477	138	0	4	4	0	0
PALA-793	339	346	7	1	1	1	0	0
PALA-793	339	344	5	1	2	1	1	0
PALA-794	339	393	54	1	3	5	0	1
PALA-794	339	391	52	1	3	2	1	1
PALA-794	340	477	137	0	3	2	0	0
PALA-794	340	382	42	1	3	1	1	0
PALA-794	341	477	136	0	4	1	0	0
PALA-794	343	344	1	1	1	1	1	1
PALA-794	343	353	10	1	1	1	1	0
PALA-794	343	477	134	0	3	2	0	0
PALA-794	343	375	32	1	3	5	1	0
PALA-794	343	477	134	0	4	1	0	0
PALA-795	343	477	134	0	4	1	0	0
PALA-795	343	477	134	0	4	1	0	0
PALA-795	343	477	134	0	4	1	0	0
PALA-795	343	477	134	0	4	1	0	0
PALA-795	343	477	134	0	3	4	0	0
PALA-795	344	477	133	0	4	1	0	0
PALA-795	344	477	133	0	3	4	0	0
PALA-795	344	477	133	0	1	1	0	1
PALA-795	344	477	133	0	3	4	0	0
PALA-795	344	477	133	0	3	4	0	1
PALA-796	344	345	1	1	1	1	1	1
PALA-796	344	410	66	1	2	1	1	1
PALA-796	345	350	5	1	3	5	0	0
PALA-796	345	351	6	1	1	1	1	0
PALA-796	345	477	132	0	4	1	0	0
PALA-796	345	477	132	0	4	1	0	0
PALA-796	346	477	131	0	3	1	0	0
PALA-796	346	477	131	0	3	1	0	0
PALA-796	346	424	78	1	4	4	0	0
PALA-796	346	477	131	0	3	4	0	0
PALA-797	346	394	48	1	3	5	1	2
PALA-797	346	477	131	0	3	5	0	0
PALA-797	346	435	89	1	3	5	1	0
PALA-797	346	477	131	0	3	5	0	1
PALA-797	346	449	103	1	3	5	1	1
PALA-797	346	422	76	1	3	5	1	1
PALA-797	346	411	65	1	3	5	1	1
PALA-797	347	351	4	1	3	5	0	0
PALA-797	347	348	1	1	3	1	1	0
PALA-797	347	416	69	1	3	5	1	0
PALA-798	347	437	90	1	3	3	1	0
PALA-798	347	477	130	0	3	2	0	1
PALA-798	347	458	111	1	3	2	1	1
PALA-798	347	357	10	1	3	1	0	0
PALA-798	347	477	130	0	3	3	0	0
PALA-798	347	406	59	1	3	5	1	1
PALA-798	347	387	40	1	3	5	1	0
PALA-798	347	387	40	1	3	5	1	0
PALA-798	347	387	40	1	3	5	1	0
PALA-798	348	351	3	1	1	1	1	0
PALA-799	350	351	1	1	1	1	1	0
PALA-799	350	477	127	0	3	5	0	0
PALA-799	350	437	87	1	1	1	1	0
PALA-799	350	477	127	0	3	4	0	0
PALA-799	351	366	15	1	1	1	1	2
PALA-799	351	477	126	0	3	5	0	0
PALA-799	352	477	125	0	4	1	0	0
PALA-799	352	477	125	0	4	1	0	0
PALA-799	352	477	125	0	4	1	0	0
PALA-799	352	400	48	1	3	5	1	1
PALA-800	352	477	125	0	3	1	0	0
PALA-800	352	477	125	0	4	1	0	0
PALA-800	352	477	125	0	4	1	0	0
PALA-800	352	477	125	0	3	4	0	0
PALA-800	352	477	125	0	4	1	0	0
PALA-800	352	477	125	0	3	4	0	0
PALA-800	352	477	125	0	3	4	0	0
PALA-800	352	377	25	1	3	1	1	0
PALA-800	352	367	15	1	3	1	1	0
PALA-800	353	477	124	0	3	5	0	0
PALA-801	353	477	124	0	4	1	0	0
PALA-801	353	477	124	0	3	4	0	0
PALA-801	353	477	124	0	3	4	0	0
PALA-801	354	477	123	0	5	4	0	0
PALA-801	357	477	120	0	3	1	0	2
PALA-801	358	477	119	0	3	1	0	1
PALA-801	359	360	1	1	2	3	0	0
PALA-801	359	477	118	0	3	5	0	0
PALA-801	359	477	118	0	4	4	0	1
PALA-801	360	477	117	0	3	4	0	0
PALA-802	360	477	117	0	4	1	0	1
PALA-802	360	402	42	1	4	4	1	4
PALA-802	361	394	33	1	4	4	0	1
PALA-802	361	394	33	1	4	4	1	1
PALA-802	361	477	116	0	3	1	0	0
PALA-802	361	477	116	0	4	1	0	0
PALA-802	361	372	11	1	3	1	1	0
PALA-802	362	422	60	1	2	1	0	1
PALA-802	362	477	115	0	3	1	0	0
PALA-802	362	477	115	0	3	1	0	0
CUBATOR-21	57	58	1	1	3	3	0	1
CUBATOR-21	102	103	1	1	3	3	0	0
CUBATOR-21	170	337	167	1	3	3	0	0
CUBATOR-21	203	206	3	1	3	3	0	0
CUBATOR-21	211	231	20	1	3	3	0	0
CUBATOR-21	229	231	2	1	3	5	0	0
CUBATOR-21	231	337	106	1	3	3	0	0
CUBATOR-21	232	337	105	1	3	3	0	0
CUBATOR-21	235	448	213	1	3	3	0	0
CUBATOR-22	252	337	85	1	3	3	0	0
CUBATOR-22	252	337	85	1	3	3	0	0
CUBATOR-22	275	292	17	1	3	2	0	1
CUBATOR-22	289	449	160	1	3	1	0	1
CUBATOR-22	298	299	1	1	3	3	0	0
CUBATOR-22	312	448	136	1	4	1	0	1
CUBATOR-22	312	448	136	1	3	3	0	0
CUBATOR-22	323	338	15	1	3	3	0	0
CUBATOR-22	330	336	6	1	3	3	0	0
FRA-1574	0	1	1	1	3	3	1	0
FRA-1574	0	1	1	1	3	3	1	0
FRA-1574	0	1	1	1	3	3	1	0
FRA-1574	0	1	1	1	3	3	1	0
FRA-1574	0	1	1	1	3	3	1	0
FRA-1574	0	1	1	1	3	1	1	0
FRA-1574	0	1	1	1	1	5	1	0
FRA-1574	0	1	1	1	3	3	1	0
FRA-1575	0	100	100	1	4	3	1	0
FRA-1575	1	19	18	1	3	4	1	1
FRA-1575	1	2	1	1	4	1	1	0
FRA-1575	1	17	16	1	3	5	1	0
FRA-1575	1	13	12	1	3	1	1	0
FRA-1575	1	2	1	1	3	3	1	0
FRA-1575	1	2	1	1	3	3	1	0
FRA-1575	1	168	167	1	3	3	1	2
FRA-1575	1	2	1	1	3	3	1	0
FRA-1575	1	2	1	1	3	3	1	0
FRA-1576	1	2	1	1	3	3	1	0
FRA-1576	1	2	1	1	3	3	1	0
FRA-1576	1	2	1	1	3	3	1	0
FRA-1576	1	8	7	1	3	5	1	0
FRA-1576	2	3	1	1	3	3	1	0
FRA-1576	2	3	1	1	3	3	1	0
FRA-1576	2	3	1	1	3	3	1	0
FRA-1576	2	5	3	1	3	3	1	1
FRA-1576	2	12	10	1	3	5	1	1
FRA-1576	2	3	1	1	3	3	1	0
FRA-1577	2	3	1	1	3	3	1	0
FRA-1577	2	3	1	1	1	5	1	0
FRA-1577	2	25	23	1	3	3	1	0
FRA-1577	2	3	1	1	2	1	1	0
FRA-1577	2	3	1	1	3	5	1	0
FRA-1577	2	138	136	1	3	1	1	0
FRA-1577	2	7	5	1	2	1	1	0
FRA-1577	2	3	1	1	4	1	1	0
FRA-1577	2	93	91	1	4	3	1	1
FRA-1577	2	3	1	1	3	3	1	0
FRA-1578	2	3	1	1	4	3	1	0
FRA-1578	2	3	1	1	3	3	1	0
FRA-1578	3	4	1	1	3	3	1	0
FRA-1578	3	4	1	1	3	3	1	0
FRA-1578	3	9	6	1	3	1	1	0
FRA-1578	3	9	6	1	3	1	1	1
FRA-1578	3	4	1	1	3	1	1	0
FRA-1578	3	4	1	1	3	3	1	0
FRA-1578	3	4	1	1	2	3	1	0
FRA-1578	3	233	230	1	3	3	1	1
FRA-1579	3	26	23	1	4	1	1	0
FRA-1579	3	4	1	1	3	3	1	0
FRA-1579	4	5	1	1	3	3	1	0
FRA-1579	4	5	1	1	3	1	1	1
FRA-1579	4	5	1	1	4	1	1	0
FRA-1579	5	6	1	1	3	5	1	0
FRA-1579	5	6	1	1	3	1	1	1
FRA-1579	5	6	1	1	3	1	1	0
FRA-1579	5	7	2	1	3	5	1	0
FRA-1579	6	7	1	1	3	5	1	1
FRA-1580	6	7	1	1	2	1	1	0
FRA-1580	6	375	369	1	4	5	0	1
FRA-1580	6	7	1	1	3	3	1	0
FRA-1580	6	7	1	1	3	1	1	0
FRA-1580	6	12	6	1	4	3	1	0
FRA-1580	7	21	14	1	3	5	1	0
FRA-1580	7	12	5	1	3	5	1	1
FRA-1580	7	8	1	1	3	3	1	0
FRA-1580	7	32	25	1	3	5	1	0
FRA-1580	7	8	1	1	3	3	1	0
FRA-1581	7	8	1	1	3	3	1	0
FRA-1581	7	24	17	1	4	4	1	0
FRA-1581	7	26	19	1	4	1	1	0
FRA-1581	7	109	102	1	3	3	1	0
FRA-1581	8	16	8	1	3	4	1	0
FRA-1581	8	26	18	1	3	5	1	0
FRA-1581	8	11	3	1	2	1	1	0
FRA-1581	8	49	41	1	3	5	1	0
FRA-1581	8	9	1	1	4	3	1	0
FRA-1581	8	9	1	1	5	5	1	0
FRA-1582	8	9	1	1	3	3	1	0
FRA-1582	8	9	1	1	3	5	1	0
FRA-1582	8	9	1	1	3	1	1	0
FRA-1582	8	9	1	1	3	3	1	0
FRA-1582	8	9	1	1	1	1	1	0
FRA-1582	9	13	4	1	5	3	1	0
FRA-1582	9	477	468	0	3	1	0	0
FRA-1582	9	21	12	1	3	5	1	0
FRA-1582	9	11	2	1	3	1	1	0
FRA-1582	10	12	2	1	3	1	1	0
FRA-1583	10	11	1	1	3	4	1	0
FRA-1583	10	11	1	1	4	4	1	0
FRA-1583	11	12	1	1	3	3	1	0
FRA-1583	11	12	1	1	3	3	1	0
FRA-1583	11	12	1	1	3	5	1	0
FRA-1583	11	12	1	1	3	1	1	0
FRA-1583	12	40	28	1	3	1	1	0
FRA-1583	14	15	1	1	3	5	1	0
FRA-1583	14	15	1	1	3	5	1	0
FRA-1583	14	15	1	1	2	4	1	0
FRA-1584	14	24	10	1	4	5	1	0
FRA-1584	14	15	1	1	3	1	1	0
FRA-1584	14	15	1	1	4	4	1	0
FRA-1584	14	15	1	1	3	1	1	0
FRA-1584	15	24	9	1	3	1	1	0
FRA-1584	15	16	1	1	4	3	1	0
FRA-1584	15	16	1	1	4	5	1	0
FRA-1584	15	24	9	1	4	1	1	0
FRA-1584	15	16	1	1	3	4	1	0
FRA-1584	15	16	1	1	1	5	1	0
FRA-1585	15	16	1	1	3	1	0	1
FRA-1585	15	44	29	1	3	5	1	0
FRA-1585	16	219	203	1	5	1	1	0
FRA-1585	16	20	4	1	3	5	1	0
FRA-1585	16	44	28	1	3	1	1	0
FRA-1585	16	63	47	1	3	3	1	1
FRA-1585	16	17	1	1	3	1	1	0
FRA-1585	16	18	2	1	3	5	1	0
FRA-1585	16	42	26	1	2	5	1	0
FRA-1585	16	21	5	1	3	1	1	0
FRA-1586	17	26	9	1	3	5	1	0
FRA-1586	17	49	32	1	3	1	1	0
FRA-1586	17	54	37	1	3	1	1	0
FRA-1586	17	93	76	1	3	1	1	0
FRA-1586	17	23	6	1	3	5	1	0
FRA-1586	17	18	1	1	3	5	1	0
FRA-1586	18	19	1	1	1	1	1	0
FRA-1586	18	21	3	1	3	5	1	0
FRA-1586	18	28	10	1	3	3	1	0
FRA-1586	18	19	1	1	3	1	1	0
FRA-1587	18	19	1	1	3	1	1	0
FRA-1587	19	20	1	1	3	3	1	0
FRA-1587	19	20	1	1	3	3	1	0
FRA-1587	19	20	1	1	4	1	1	0
FRA-1587	19	23	4	1	3	1	0	0
FRA-1587	20	21	1	1	3	3	1	0
FRA-1587	20	21	1	1	4	5	1	0
FRA-1587	20	21	1	1	3	1	1	0
FRA-1587	20	54	34	1	3	1	1	0
FRA-1587	20	21	1	1	1	1	1	0
FRA-1588	21	22	1	1	3	3	1	0
FRA-1588	21	22	1	1	3	3	1	0
FRA-1588	21	25	4	1	3	5	1	0
FRA-1588	21	22	1	1	3	5	1	0
FRA-1588	21	44	23	1	4	3	1	0
FRA-1588	22	23	1	1	3	5	1	0
FRA-1588	22	23	1	1	3	1	1	0
FRA-1588	22	23	1	1	3	5	1	0
FRA-1588	22	23	1	1	3	3	1	0
FRA-1588	22	23	1	1	3	3	1	0
FRA-1589	22	23	1	1	3	5	1	0
FRA-1589	22	23	1	1	4	1	1	0
FRA-1589	22	23	1	1	3	1	1	0
FRA-1589	22	26	4	1	3	5	1	0
FRA-1589	22	23	1	1	3	5	1	0
FRA-1589	23	24	1	1	3	3	1	0
FRA-1589	23	421	398	1	3	5	0	0
FRA-1589	23	26	3	1	3	1	1	0
FRA-1589	23	24	1	1	3	1	1	0
FRA-1589	23	24	1	1	3	3	1	0
FRA-1590	23	24	1	1	3	3	1	0
FRA-1590	23	24	1	1	3	3	1	0
FRA-1590	23	24	1	1	3	5	1	0
FRA-1590	23	63	40	1	3	1	1	0
FRA-1590	23	24	1	1	3	5	1	0
FRA-1590	23	24	1	1	3	5	1	0
FRA-1590	24	251	227	1	4	5	0	1
FRA-1590	24	25	1	1	3	3	1	0
FRA-1590	24	25	1	1	3	3	1	0
FRA-1590	24	66	42	1	3	5	1	0
FRA-1591	24	25	1	1	3	3	1	0
FRA-1591	24	25	1	1	3	1	1	0
FRA-1591	24	30	6	1	3	3	1	0
FRA-1591	25	45	20	1	3	5	1	1
FRA-1591	25	28	3	1	4	1	1	0
FRA-1591	25	26	1	1	3	1	1	0
FRA-1591	25	30	5	1	3	3	1	2
FRA-1591	26	27	1	1	3	1	1	0
FRA-1591	26	27	1	1	3	3	1	0
FRA-1591	26	27	1	1	3	3	0	0
FRA-1592	26	31	5	1	2	4	1	0
FRA-1592	26	27	1	1	3	3	1	0
FRA-1592	26	82	56	1	3	3	1	0
FRA-1592	26	27	1	1	2	1	1	0
FRA-1592	26	41	15	1	3	3	1	0
FRA-1592	26	27	1	1	3	3	1	0
FRA-1592	27	28	1	1	3	5	1	0
FRA-1592	27	28	1	1	3	1	1	0
FRA-1592	27	477	450	0	3	5	0	3
FRA-1592	27	477	450	0	3	5	0	3
FRA-1593	27	44	17	1	1	1	1	1
FRA-1593	27	28	1	1	3	3	1	0
FRA-1593	27	29	2	1	2	5	1	0
FRA-1593	28	29	1	1	3	1	1	0
FRA-1593	28	29	1	1	3	1	1	0
FRA-1593	28	65	37	1	3	5	1	0
FRA-1593	28	29	1	1	3	3	1	0
FRA-1593	29	30	1	1	3	5	1	0
FRA-1593	29	30	1	1	3	1	1	0
FRA-1593	29	38	9	1	3	5	1	0
FRA-1594	29	31	2	1	3	3	1	0
FRA-1594	29	30	1	1	3	1	1	0
FRA-1594	29	30	1	1	3	3	1	0
FRA-1594	29	30	1	1	3	5	1	0
FRA-1594	29	44	15	1	3	2	1	0
FRA-1594	30	31	1	1	3	3	1	0
FRA-1594	30	35	5	1	3	3	1	0
FRA-1594	30	477	447	0	3	5	0	2
FRA-1594	30	63	33	1	3	3	1	0
FRA-1594	30	31	1	1	3	5	1	0
FRA-1595	30	251	221	1	2	3	0	0
FRA-1595	31	32	1	1	3	3	1	0
FRA-1595	31	44	13	1	5	4	1	0
FRA-1595	31	41	10	1	4	1	1	0
FRA-1595	31	33	2	1	4	1	1	0
FRA-1595	31	32	1	1	3	3	1	0
FRA-1595	31	32	1	1	3	3	1	0
FRA-1595	31	32	1	1	3	4	1	2
FRA-1595	31	32	1	1	3	3	1	0
FRA-1595	31	46	15	1	3	5	1	0
FRA-1596	31	38	7	1	3	1	1	0
FRA-1596	31	32	1	1	3	3	1	0
FRA-1596	31	32	1	1	3	5	1	0
FRA-1596	31	232	201	1	4	5	1	0
FRA-1596	31	33	2	1	3	4	1	0
FRA-1596	31	63	32	1	3	5	1	0
FRA-1596	31	100	69	1	4	3	1	1
FRA-1596	32	35	3	1	3	5	1	0
FRA-1596	32	35	3	1	1	1	1	0
FRA-1596	32	302	270	1	4	2	0	1
FRA-1597	32	35	3	1	5	1	1	0
FRA-1597	32	41	9	1	3	3	1	0
FRA-1597	32	33	1	1	4	3	1	0
FRA-1597	32	58	26	1	3	1	1	1
FRA-1597	32	477	445	0	4	5	0	0
FRA-1597	32	81	49	1	1	1	1	0
FRA-1597	32	33	1	1	3	3	1	0
FRA-1597	33	34	1	1	4	3	1	0
FRA-1597	33	51	18	1	3	5	1	0
FRA-1597	33	58	25	1	3	3	1	1
FRA-1598	33	34	1	1	3	1	1	0
FRA-1598	33	44	11	1	5	1	1	0
FRA-1598	34	74	40	1	3	5	1	0
FRA-1598	34	43	9	1	3	3	1	1
FRA-1598	34	39	5	1	3	1	1	0
FRA-1598	34	237	203	1	3	5	1	2
FRA-1598	34	55	21	1	4	1	1	0
FRA-1598	34	51	17	1	3	5	1	0
FRA-1598	35	107	72	1	3	1	1	0
FRA-1598	35	36	1	1	3	3	1	0
FRA-1599	35	396	361	1	4	3	0	0
FRA-1599	35	133	98	1	3	1	1	0
FRA-1599	35	52	17	1	3	1	1	0
FRA-1599	36	37	1	1	3	3	1	1
FRA-1599	36	80	44	1	4	3	1	2
FRA-1599	36	41	5	1	3	5	1	0
FRA-1599	36	37	1	1	3	4	1	0
FRA-1599	37	38	1	1	3	4	1	0
FRA-1599	37	38	1	1	3	5	1	0
FRA-1599	37	38	1	1	3	5	1	0
FRA-1600	37	38	1	1	3	1	1	0
FRA-1600	37	112	75	1	3	5	1	0
FRA-1600	37	235	198	1	4	2	1	0
FRA-1600	37	41	4	1	3	1	1	0
FRA-1600	37	39	2	1	3	1	1	0
FRA-1600	39	40	1	1	3	3	1	0
FRA-1600	39	58	19	1	3	1	1	0
FRA-1600	40	44	4	1	3	1	1	0
FRA-1600	40	41	1	1	3	3	1	0
FRA-1600	40	219	179	1	4	3	1	0
FRA-1601	41	42	1	1	3	3	1	0
FRA-1601	41	56	15	1	3	3	1	0
FRA-1601	41	42	1	1	4	1	1	0
FRA-1601	41	42	1	1	3	1	1	0
FRA-1601	42	43	1	1	3	3	1	0
FRA-1601	42	50	8	1	3	5	1	0
FRA-1601	42	43	1	1	3	3	1	0
FRA-1601	42	44	2	1	3	4	1	0
FRA-1601	42	235	193	1	3	1	1	0
FRA-1601	42	43	1	1	3	3	1	0
FRA-1602	42	477	435	0	4	5	0	0
FRA-1602	43	44	1	1	3	4	1	0
FRA-1602	43	44	1	1	3	5	1	0
FRA-1602	43	44	1	1	3	5	1	0
FRA-1602	43	44	1	1	3	3	1	0
FRA-1602	43	50	7	1	3	5	1	0
FRA-1602	43	45	2	1	3	3	1	1
FRA-1602	43	48	5	1	4	3	1	0
FRA-1602	43	100	57	1	3	3	1	0
FRA-1602	43	63	20	1	3	1	1	0
FRA-1603	44	51	7	1	3	3	1	0
FRA-1603	44	45	1	1	3	3	1	0
FRA-1603	44	244	200	1	4	4	0	0
FRA-1603	44	477	433	0	4	5	0	0
FRA-1603	44	62	18	1	3	5	1	0
FRA-1603	44	51	7	1	3	5	1	0
FRA-1603	44	45	1	1	3	3	1	0
FRA-1603	44	45	1	1	3	3	1	0
FRA-1603	44	46	2	1	3	1	1	0
FRA-1603	45	46	1	1	3	5	1	0
FRA-1604	45	46	1	1	1	1	1	0
FRA-1604	45	60	15	1	3	4	1	0
FRA-1604	45	46	1	1	3	3	1	0
FRA-1604	45	46	1	1	3	3	1	0
FRA-1604	45	47	2	1	4	1	1	0
FRA-1604	45	46	1	1	3	3	1	0
FRA-1604	46	49	3	1	3	5	1	0
FRA-1604	46	53	7	1	3	1	1	0
FRA-1604	46	47	1	1	3	1	1	0
FRA-1604	46	47	1	1	1	3	1	0
FRA-1605	47	50	3	1	4	4	1	0
FRA-1605	47	243	196	1	3	3	1	1
FRA-1605	47	48	1	1	3	3	1	0
FRA-1605	48	58	10	1	3	1	1	0
FRA-1605	48	54	6	1	3	3	1	0
FRA-1605	48	49	1	1	3	3	1	0
FRA-1605	48	49	1	1	3	3	1	0
FRA-1605	49	50	1	1	3	3	1	0
FRA-1605	49	58	9	1	3	1	1	1
FRA-1605	49	50	1	1	3	3	1	0
FRA-1606	49	84	35	1	4	4	1	0
FRA-1606	49	50	1	1	4	3	1	0
FRA-1606	49	276	227	1	3	3	0	0
FRA-1606	50	54	4	1	3	1	1	0
FRA-1606	50	51	1	1	3	3	1	0
FRA-1606	50	58	8	1	3	5	1	0
FRA-1606	50	55	5	1	3	5	1	0
FRA-1606	50	52	2	1	3	1	1	1
FRA-1606	50	217	167	1	4	4	1	0
FRA-1606	50	51	1	1	3	1	1	0
FRA-1607	50	54	4	1	3	1	1	0
FRA-1607	51	63	12	1	3	5	1	0
FRA-1607	51	52	1	1	3	3	1	0
FRA-1607	51	52	1	1	3	1	1	2
FRA-1607	51	52	1	1	3	3	1	0
FRA-1607	51	52	1	1	4	4	1	0
FRA-1607	51	52	1	1	3	1	1	0
FRA-1607	52	56	4	1	3	5	1	0
FRA-1607	52	63	11	1	3	3	1	0
FRA-1607	52	62	10	1	3	3	1	0
FRA-1608	52	81	29	1	4	5	1	0
FRA-1608	52	53	1	1	3	4	1	1
FRA-1608	52	53	1	1	3	3	1	0
FRA-1608	52	74	22	1	3	3	1	1
FRA-1608	52	63	11	1	3	5	1	0
FRA-1608	52	63	11	1	3	5	1	0
FRA-1608	52	56	4	1	4	3	1	0
FRA-1608	52	82	30	1	3	3	1	4
FRA-1608	52	106	54	1	3	3	1	2
FRA-1608	52	54	2	1	3	4	1	0
FRA-1609	53	56	3	1	3	5	1	0
FRA-1609	53	54	1	1	3	5	1	0
FRA-1609	53	144	91	1	3	5	1	1
FRA-1609	53	234	181	1	4	5	1	0
FRA-1609	53	178	125	1	3	1	1	2
FRA-1609	53	278	225	1	4	5	0	0
FRA-1609	53	54	1	1	3	3	1	0
FRA-1609	53	477	424	0	4	5	0	0
FRA-1609	54	56	2	1	3	1	1	0
FRA-1609	54	66	12	1	1	1	1	0
FRA-1610	54	55	1	1	3	3	1	0
FRA-1610	55	83	28	1	3	3	1	0
FRA-1610	55	56	1	1	3	3	1	0
FRA-1610	56	57	1	1	3	4	1	1
FRA-1610	56	376	320	1	4	3	1	1
FRA-1610	56	59	3	1	3	5	1	0
FRA-1610	57	62	5	1	3	5	1	0
FRA-1610	57	58	1	1	2	1	1	0
FRA-1610	57	450	393	1	4	4	0	0
FRA-1610	57	112	55	1	3	3	1	0
FRA-1611	57	62	5	1	3	3	1	0
FRA-1611	57	59	2	1	3	4	1	0
FRA-1611	57	71	14	1	5	1	1	0
FRA-1611	57	60	3	1	3	1	1	0
FRA-1611	58	59	1	1	3	3	1	0
FRA-1611	58	59	1	1	3	5	1	0
FRA-1611	58	59	1	1	3	5	1	0
FRA-1611	58	102	44	1	3	5	1	0
FRA-1611	58	276	218	1	3	3	0	0
FRA-1611	58	477	419	0	4	1	0	0
FRA-1612	58	62	4	1	3	5	1	0
FRA-1612	58	219	161	1	5	3	1	0
FRA-1612	58	59	1	1	3	5	1	0
FRA-1612	58	477	419	0	3	3	0	0
FRA-1612	58	396	338	1	3	3	0	0
FRA-1612	58	59	1	1	3	1	1	1
FRA-1612	59	61	2	1	3	1	1	0
FRA-1612	59	84	25	1	3	1	1	0
FRA-1612	59	62	3	1	3	4	1	0
FRA-1612	59	73	14	1	3	1	1	0
FRA-1613	60	63	3	1	3	3	1	0
FRA-1613	60	71	11	1	3	3	1	0
FRA-1613	60	62	2	1	3	3	1	0
FRA-1613	60	81	21	1	4	1	1	0
FRA-1613	60	61	1	1	3	3	1	0
FRA-1613	60	61	1	1	3	1	1	0
FRA-1613	62	63	1	1	3	3	1	1
FRA-1613	62	73	11	1	3	3	1	0
FRA-1613	62	63	1	1	3	3	1	0
FRA-1613	63	64	1	1	3	5	1	0
FRA-1614	63	64	1	1	3	3	1	0
FRA-1614	63	64	1	1	3	1	1	0
FRA-1614	63	64	1	1	3	1	1	0
FRA-1614	63	64	1	1	3	5	1	0
FRA-1614	63	64	1	1	3	3	1	0
FRA-1614	64	65	1	1	3	3	1	0
FRA-1614	64	65	1	1	3	5	1	0
FRA-1614	64	65	1	1	3	3	1	0
FRA-1614	64	70	6	1	3	5	1	0
FRA-1614	64	65	1	1	3	1	1	0
FRA-1615	64	65	1	1	4	1	1	0
FRA-1615	64	73	9	1	3	4	1	0
FRA-1615	64	127	63	1	3	1	1	1
FRA-1615	65	70	5	1	3	1	1	0
FRA-1615	65	144	79	1	3	1	1	0
FRA-1615	65	66	1	1	3	4	1	0
FRA-1615	65	66	1	1	4	3	1	0
FRA-1615	65	83	18	1	3	5	1	1
FRA-1615	65	134	69	1	3	1	1	0
FRA-1615	66	77	11	1	3	4	1	0
FRA-1616	66	94	28	1	3	1	1	0
FRA-1616	66	70	4	1	4	5	1	0
FRA-1616	67	477	410	0	3	3	0	1
FRA-1616	67	92	25	1	3	4	1	0
FRA-1616	67	68	1	1	3	3	1	0
FRA-1616	68	69	1	1	3	5	1	0
FRA-1616	69	70	1	1	4	4	1	0
FRA-1616	69	90	21	1	1	4	1	0
FRA-1616	70	77	7	1	1	1	1	0
FRA-1616	70	81	11	1	3	1	1	1
FRA-1617	70	71	1	1	3	3	1	0
FRA-1617	70	289	219	1	3	1	0	0
FRA-1617	70	71	1	1	3	1	1	0
FRA-1617	70	73	3	1	3	3	1	0
FRA-1617	70	71	1	1	3	1	1	0
FRA-1617	70	71	1	1	3	5	1	0
FRA-1617	71	72	1	1	3	5	1	0
FRA-1617	71	84	13	1	3	5	1	0
FRA-1617	71	72	1	1	3	3	1	0
FRA-1617	71	104	33	1	3	4	1	0
FRA-1618	71	72	1	1	1	1	1	0
FRA-1618	72	73	1	1	3	5	1	0
FRA-1618	72	87	15	1	3	3	1	0
FRA-1618	72	73	1	1	3	5	1	0
FRA-1618	72	73	1	1	3	3	1	0
FRA-1618	72	73	1	1	3	3	1	0
FRA-1618	72	73	1	1	3	3	1	0
FRA-1618	72	81	9	1	3	3	1	1
FRA-1618	72	437	365	1	3	5	0	2
FRA-1618	73	79	6	1	3	2	1	0
FRA-1619	73	477	404	0	3	3	0	0
FRA-1619	73	181	108	1	1	1	1	1
FRA-1619	73	74	1	1	5	1	1	0
FRA-1619	73	81	8	1	3	4	1	0
FRA-1619	74	75	1	1	3	5	1	1
FRA-1619	74	179	105	1	3	5	1	0
FRA-1619	74	75	1	1	1	1	1	0
FRA-1619	74	75	1	1	3	4	1	0
FRA-1619	74	77	3	1	3	2	1	0
FRA-1619	75	76	1	1	3	3	1	1
FRA-1620	75	76	1	1	3	3	1	1
FRA-1620	75	76	1	1	3	1	1	0
FRA-1620	75	76	1	1	3	3	1	0
FRA-1620	75	162	87	1	3	3	1	0
FRA-1620	76	77	1	1	2	4	1	0
FRA-1620	76	77	1	1	3	3	1	0
FRA-1620	77	112	35	1	3	2	1	0
FRA-1620	77	78	1	1	3	3	1	0
FRA-1620	77	182	105	1	3	5	1	0
FRA-1620	77	78	1	1	4	3	1	0
FRA-1621	77	78	1	1	3	1	1	0
FRA-1621	77	78	1	1	5	3	1	0
FRA-1621	77	78	1	1	4	1	1	0
FRA-1621	77	81	4	1	5	3	1	0
FRA-1621	77	78	1	1	3	3	1	0
FRA-1621	78	79	1	1	3	5	1	0
FRA-1621	78	79	1	1	4	5	1	0
FRA-1621	78	79	1	1	3	3	1	0
FRA-1621	79	80	1	1	3	3	1	0
FRA-1621	79	81	2	1	3	3	1	0
FRA-1622	79	92	13	1	3	5	0	0
FRA-1622	80	81	1	1	5	3	1	0
FRA-1622	80	81	1	1	3	5	1	0
FRA-1622	80	81	1	1	3	1	1	0
FRA-1622	81	107	26	1	3	5	1	0
FRA-1622	81	82	1	1	3	1	1	0
FRA-1622	81	82	1	1	3	1	1	0
FRA-1622	81	84	3	1	3	1	1	0
FRA-1622	81	477	396	0	4	5	0	0
FRA-1622	81	82	1	1	4	4	1	0
FRA-1623	81	82	1	1	2	3	1	0
FRA-1623	82	83	1	1	3	3	1	0
FRA-1623	82	83	1	1	3	3	1	0
FRA-1623	82	83	1	1	3	3	1	0
FRA-1623	82	83	1	1	4	4	1	0
FRA-1623	82	88	6	1	4	5	1	0
FRA-1623	82	88	6	1	3	5	1	0
FRA-1623	82	87	5	1	3	5	1	0
FRA-1623	83	87	4	1	3	5	1	0
FRA-1623	83	84	1	1	3	5	1	0
FRA-1624	83	84	1	1	3	1	1	0
FRA-1624	84	89	5	1	3	1	1	0
FRA-1624	84	477	393	0	3	5	0	0
FRA-1624	84	85	1	1	3	3	1	0
FRA-1624	84	105	21	1	5	1	1	0
FRA-1624	84	91	7	1	3	3	1	0
FRA-1624	85	86	1	1	3	3	1	0
FRA-1624	85	168	83	1	4	1	1	0
FRA-1624	85	88	3	1	4	3	1	0
FRA-1624	86	219	133	1	3	1	1	0
FRA-1625	86	87	1	1	1	3	1	0
FRA-1625	86	87	1	1	3	1	1	0
FRA-1625	86	92	6	1	3	4	1	0
FRA-1625	86	233	147	1	3	1	1	0
FRA-1625	87	92	5	1	3	1	1	0
FRA-1625	87	88	1	1	3	3	1	1
FRA-1625	87	88	1	1	3	3	1	0
FRA-1625	87	88	1	1	3	3	1	0
FRA-1625	87	88	1	1	3	3	1	0
FRA-1625	87	88	1	1	3	3	1	0
FRA-1626	87	88	1	1	3	3	1	0
FRA-1626	87	88	1	1	3	3	1	0
FRA-1626	88	89	1	1	3	3	1	0
FRA-1626	88	89	1	1	4	4	1	0
FRA-1626	88	89	1	1	3	3	1	0
FRA-1626	88	89	1	1	3	3	1	0
FRA-1626	88	89	1	1	3	1	1	1
FRA-1626	88	89	1	1	3	1	1	0
FRA-1626	88	161	73	1	3	1	1	0
FRA-1626	88	100	12	1	3	3	1	0
FRA-1627	88	89	1	1	3	3	1	0
FRA-1627	88	113	25	1	3	2	0	0
FRA-1627	89	90	1	1	3	5	1	0
FRA-1627	90	126	36	1	3	5	1	0
FRA-1627	90	91	1	1	3	5	1	0
FRA-1627	90	91	1	1	3	3	1	0
FRA-1627	91	93	2	1	3	4	1	0
FRA-1627	91	92	1	1	4	3	1	0
FRA-1627	91	145	54	1	3	3	1	2
FRA-1627	91	231	140	1	3	3	1	0
FRA-1628	91	107	16	1	3	4	1	0
FRA-1628	91	477	386	0	4	5	0	0
FRA-1628	91	92	1	1	3	1	1	0
FRA-1628	91	477	386	0	4	5	0	0
FRA-1628	91	178	87	1	4	1	1	0
FRA-1628	92	93	1	1	3	3	1	0
FRA-1628	92	477	385	0	3	5	0	0
FRA-1628	92	93	1	1	4	5	1	0
FRA-1628	92	95	3	1	3	3	1	0
FRA-1628	92	94	2	1	3	1	1	0
FRA-1629	93	94	1	1	3	3	1	0
FRA-1629	93	94	1	1	3	3	1	0
FRA-1629	93	94	1	1	3	5	1	0
FRA-1629	93	477	384	0	3	3	0	0
FRA-1629	93	94	1	1	4	3	1	0
FRA-1629	93	168	75	1	3	5	1	0
FRA-1629	93	94	1	1	3	3	1	0
FRA-1629	93	94	1	1	3	1	1	0
FRA-1629	94	95	1	1	3	3	1	0
FRA-1629	94	95	1	1	3	1	1	0
FRA-1630	94	95	1	1	3	4	1	0
FRA-1630	94	95	1	1	4	5	1	0
FRA-1630	94	219	125	1	4	1	1	0
FRA-1630	95	96	1	1	1	1	1	1
FRA-1630	95	112	17	1	3	5	1	0
FRA-1630	96	97	1	1	4	1	1	0
FRA-1630	96	97	1	1	3	3	1	0
FRA-1630	96	97	1	1	3	3	1	0
FRA-1630	97	164	67	1	3	5	1	0
FRA-1630	97	131	34	1	4	3	1	0
FRA-1631	97	105	8	1	4	3	1	0
FRA-1631	97	100	3	1	3	3	1	0
FRA-1631	97	104	7	1	3	3	1	0
FRA-1631	98	99	1	1	3	3	1	0
FRA-1631	98	99	1	1	4	5	1	0
FRA-1631	98	99	1	1	4	1	1	0
FRA-1631	98	107	9	1	3	3	1	0
FRA-1631	98	99	1	1	3	1	1	0
FRA-1631	98	99	1	1	3	3	1	0
FRA-1631	98	99	1	1	3	5	1	0
FRA-1632	98	131	33	1	1	1	1	0
FRA-1632	98	99	1	1	4	4	1	0
FRA-1632	98	100	2	1	3	3	1	0
FRA-1632	99	131	32	1	3	1	1	0
FRA-1632	99	108	9	1	3	3	1	0
FRA-1632	99	112	13	1	4	3	1	1
FRA-1632	99	100	1	1	3	3	1	0
FRA-1632	99	100	1	1	3	3	1	0
FRA-1632	99	100	1	1	3	3	1	0
FRA-1632	99	102	3	1	4	3	1	0
FRA-1633	100	130	30	1	3	3	1	0
FRA-1633	100	114	14	1	3	5	1	0
FRA-1633	100	183	83	1	3	5	1	0
FRA-1633	100	101	1	1	3	5	1	0
FRA-1633	100	112	12	1	3	1	1	0
FRA-1633	100	112	12	1	3	3	1	0
FRA-1633	100	112	12	1	3	5	1	0
FRA-1633	100	112	12	1	3	5	1	0
FRA-1633	100	105	5	1	3	5	1	0
FRA-1633	100	103	3	1	3	5	1	0
FRA-1634	101	103	2	1	3	5	1	0
FRA-1634	101	107	6	1	3	1	1	1
FRA-1634	101	477	376	0	3	1	0	0
FRA-1634	101	114	13	1	4	3	1	2
FRA-1634	101	102	1	1	3	3	1	0
FRA-1634	101	168	67	1	3	1	1	0
FRA-1634	101	166	65	1	2	1	1	0
FRA-1634	102	134	32	1	3	5	1	0
FRA-1634	102	103	1	1	3	5	1	0
FRA-1634	102	109	7	1	2	1	1	0
FRA-1635	102	111	9	1	3	3	1	0
FRA-1635	102	136	34	1	3	1	1	1
FRA-1635	102	104	2	1	3	3	1	0
FRA-1635	102	113	11	1	3	5	1	0
FRA-1635	102	103	1	1	3	4	1	0
FRA-1635	102	233	131	1	3	5	1	2
FRA-1635	103	105	2	1	2	1	1	0
FRA-1635	103	112	9	1	3	1	1	0
FRA-1635	103	104	1	1	3	3	1	0
FRA-1635	103	104	1	1	3	3	1	0
FRA-1636	104	105	1	1	5	3	1	2
FRA-1636	104	120	16	1	3	5	1	2
FRA-1636	104	105	1	1	1	5	1	0
FRA-1636	104	111	7	1	3	1	1	2
FRA-1636	104	477	373	0	3	3	0	0
FRA-1636	105	106	1	1	5	3	1	0
FRA-1636	105	168	63	1	4	1	1	0
FRA-1636	105	106	1	1	3	1	1	0
FRA-1636	105	106	1	1	3	1	1	0
FRA-1636	105	106	1	1	3	5	1	0
FRA-1637	105	106	1	1	3	3	1	0
FRA-1637	105	107	2	1	3	3	1	1
FRA-1637	105	106	1	1	3	5	1	0
FRA-1637	105	106	1	1	3	5	1	0
FRA-1637	105	106	1	1	3	5	1	0
FRA-1637	105	106	1	1	3	5	1	0
FRA-1637	105	106	1	1	3	5	1	0
FRA-1637	105	112	7	1	3	1	1	1
FRA-1637	105	141	36	1	3	3	1	0
FRA-1638	105	161	56	1	3	1	1	2
FRA-1638	106	107	1	1	3	5	1	0
FRA-1638	106	113	7	1	4	1	1	0
FRA-1638	106	107	1	1	5	1	1	0
FRA-1638	106	113	7	1	3	2	1	0
FRA-1638	106	168	62	1	3	5	1	0
FRA-1638	106	244	138	1	4	3	0	1
FRA-1638	106	112	6	1	3	3	1	0
FRA-1638	107	108	1	1	4	5	1	0
FRA-1639	107	108	1	1	5	3	1	0
FRA-1639	107	112	5	1	3	4	1	0
FRA-1639	107	168	61	1	3	4	1	0
FRA-1639	107	121	14	1	3	5	1	0
FRA-1639	107	151	44	1	3	5	1	0
FRA-1639	107	108	1	1	4	1	1	0
FRA-1639	107	109	2	1	4	1	1	0
FRA-1639	107	108	1	1	3	5	1	0
FRA-1639	107	108	1	1	4	1	1	0
FRA-1639	108	109	1	1	3	3	1	0
FRA-1640	108	112	4	1	2	3	1	0
FRA-1640	108	112	4	1	3	3	1	0
FRA-1640	108	133	25	1	3	5	1	0
FRA-1640	109	110	1	1	3	3	1	0
FRA-1640	109	112	3	1	3	3	1	0
FRA-1640	109	121	12	1	2	3	1	0
FRA-1640	109	114	5	1	3	5	1	0
FRA-1640	109	110	1	1	3	3	1	0
FRA-1640	109	112	3	1	3	3	1	0
FRA-1640	109	168	59	1	4	5	1	0
FRA-1641	109	110	1	1	4	3	1	0
FRA-1641	109	121	12	1	3	5	1	0
FRA-1641	110	272	162	1	3	5	0	0
FRA-1641	110	278	168	1	3	5	0	0
FRA-1641	111	112	1	1	4	1	1	0
FRA-1641	111	123	12	1	3	1	1	0
FRA-1641	111	112	1	1	3	1	1	0
FRA-1641	112	166	54	1	3	1	1	0
FRA-1641	112	113	1	1	3	3	1	0
FRA-1641	112	114	2	1	3	1	1	0
FRA-1642	112	117	5	1	3	4	1	0
FRA-1642	112	113	1	1	3	2	1	0
FRA-1642	112	113	1	1	3	1	1	0
FRA-1642	112	114	2	1	3	5	1	0
FRA-1642	112	143	31	1	3	1	1	0
FRA-1642	112	136	24	1	3	1	1	0
FRA-1642	112	113	1	1	4	5	1	0
FRA-1642	112	113	1	1	4	5	1	0
FRA-1642	112	113	1	1	3	1	1	0
FRA-1642	112	113	1	1	4	3	1	0
FRA-1643	113	114	1	1	3	3	1	0
FRA-1643	113	135	22	1	3	5	1	0
FRA-1643	113	409	296	1	3	5	0	0
FRA-1643	113	114	1	1	2	1	1	0
FRA-1643	113	114	1	1	4	3	1	0
FRA-1643	114	135	21	1	3	3	1	1
FRA-1643	114	115	1	1	3	3	1	0
FRA-1643	114	190	76	1	3	5	1	0
FRA-1643	114	116	2	1	3	5	1	0
FRA-1643	114	183	69	1	4	5	1	0
FRA-1644	114	121	7	1	3	3	1	0
FRA-1644	114	131	17	1	3	3	1	0
FRA-1644	114	115	1	1	3	3	1	0
FRA-1644	114	115	1	1	3	3	1	0
FRA-1644	115	180	65	1	5	1	1	0
FRA-1644	115	168	53	1	3	1	1	1
FRA-1644	115	135	20	1	3	1	1	2
FRA-1644	115	116	1	1	3	5	1	0
FRA-1644	115	116	1	1	3	3	1	0
FRA-1644	115	116	1	1	4	1	1	0
FRA-1645	116	121	5	1	3	5	1	0
FRA-1645	116	130	14	1	3	3	1	0
FRA-1645	116	119	3	1	3	4	1	0
FRA-1645	116	119	3	1	4	4	1	0
FRA-1645	116	146	30	1	3	5	1	1
FRA-1645	116	135	19	1	3	5	1	2
FRA-1645	116	168	52	1	3	1	1	0
FRA-1645	116	162	46	1	3	4	1	0
FRA-1645	117	119	2	1	3	5	1	0
FRA-1645	117	119	2	1	5	1	1	0
FRA-1646	117	118	1	1	4	3	1	0
FRA-1646	117	119	2	1	4	3	1	1
FRA-1646	118	120	2	1	3	5	1	0
FRA-1646	118	135	17	1	3	3	1	0
FRA-1646	119	120	1	1	3	4	1	1
FRA-1646	119	120	1	1	3	1	1	0
FRA-1646	119	162	43	1	3	3	1	0
FRA-1646	120	169	49	1	3	3	1	1
FRA-1646	120	121	1	1	3	1	1	0
FRA-1646	120	121	1	1	4	4	1	0
FRA-1647	120	121	1	1	3	3	1	0
FRA-1647	120	129	9	1	3	1	1	0
FRA-1647	120	131	11	1	4	3	1	0
FRA-1647	121	168	47	1	3	1	1	0
FRA-1647	121	137	16	1	3	3	1	1
FRA-1647	121	298	177	1	4	3	0	1
FRA-1647	122	144	22	1	1	1	1	0
FRA-1647	122	135	13	1	3	3	1	0
FRA-1647	122	123	1	1	2	3	1	0
FRA-1647	123	144	21	1	1	1	1	0
FRA-1648	123	131	8	1	2	3	1	0
FRA-1648	123	167	44	1	4	2	1	0
FRA-1648	123	124	1	1	3	5	1	0
FRA-1648	123	183	60	1	3	3	1	0
FRA-1648	123	168	45	1	3	1	1	0
FRA-1648	123	124	1	1	3	3	1	0
FRA-1648	123	178	55	1	2	1	1	0
FRA-1648	124	128	4	1	3	4	1	1
FRA-1648	124	125	1	1	3	3	1	0
FRA-1648	125	158	33	1	3	4	1	0
FRA-1649	126	131	5	1	3	3	1	0
FRA-1649	126	181	55	1	1	3	1	0
FRA-1649	126	134	8	1	1	3	1	0
FRA-1649	126	135	9	1	3	1	1	1
FRA-1649	126	138	12	1	4	5	1	0
FRA-1649	126	127	1	1	3	3	1	0
FRA-1649	126	144	18	1	3	1	1	0
FRA-1649	127	128	1	1	1	1	1	0
FRA-1649	127	134	7	1	4	3	1	0
FRA-1649	127	141	14	1	3	3	1	0
FRA-1650	127	134	7	1	3	3	1	1
FRA-1650	127	128	1	1	4	3	1	0
FRA-1650	127	168	41	1	4	5	1	0
FRA-1650	128	129	1	1	3	3	1	0
FRA-1650	128	129	1	1	3	1	1	1
FRA-1650	128	166	38	1	3	1	1	0
FRA-1650	128	137	9	1	3	1	1	0
FRA-1650	128	166	38	1	4	1	1	0
FRA-1650	128	129	1	1	3	1	1	0
FRA-1650	129	137	8	1	3	1	1	1
FRA-1651	129	168	39	1	3	5	1	0
FRA-1651	129	278	149	1	3	4	0	0
FRA-1651	130	168	38	1	5	1	1	0
FRA-1651	130	137	7	1	3	1	1	0
FRA-1651	130	131	1	1	3	4	1	0
FRA-1651	130	131	1	1	3	3	1	0
FRA-1651	131	216	85	1	3	5	1	0
FRA-1651	131	132	1	1	3	4	1	0
FRA-1651	131	144	13	1	3	5	1	0
FRA-1651	132	133	1	1	1	5	1	0
FRA-1652	133	161	28	1	3	3	1	0
FRA-1652	133	134	1	1	3	3	1	0
FRA-1652	133	134	1	1	4	3	1	0
FRA-1652	133	184	51	1	5	1	1	0
FRA-1652	133	181	48	1	3	2	1	1
FRA-1652	133	134	1	1	3	4	1	0
FRA-1652	133	168	35	1	3	5	1	0
FRA-1652	133	183	50	1	3	1	1	0
FRA-1652	134	166	32	1	4	4	1	0
FRA-1652	134	135	1	1	3	1	1	0
FRA-1653	134	135	1	1	3	4	1	0
FRA-1653	134	178	44	1	4	4	1	0
FRA-1653	134	150	16	1	2	1	1	0
FRA-1653	134	183	49	1	3	5	1	0
FRA-1653	135	136	1	1	3	1	1	1
FRA-1653	135	137	2	1	3	3	1	0
FRA-1653	136	139	3	1	3	4	1	0
FRA-1653	136	152	16	1	3	1	1	0
FRA-1653	136	163	27	1	3	4	1	0
FRA-1653	136	183	47	1	3	3	1	2
FRA-1654	136	137	1	1	1	1	1	0
FRA-1654	137	168	31	1	4	5	1	0
FRA-1654	137	138	1	1	3	1	1	0
FRA-1654	137	138	1	1	5	4	1	0
FRA-1654	138	139	1	1	5	5	1	0
FRA-1654	138	183	45	1	3	5	1	0
FRA-1654	138	139	1	1	4	5	1	0
FRA-1654	138	189	51	1	2	5	1	0
FRA-1654	138	139	1	1	4	3	1	0
FRA-1654	138	139	1	1	3	5	1	0
FRA-1655	139	140	1	1	5	3	1	0
FRA-1655	140	141	1	1	3	5	1	0
FRA-1655	140	141	1	1	4	3	1	0
FRA-1655	140	165	25	1	4	3	1	1
FRA-1655	140	141	1	1	4	1	1	0
FRA-1655	140	141	1	1	3	3	1	0
FRA-1655	141	144	3	1	3	4	1	0
FRA-1655	141	142	1	1	3	5	1	0
FRA-1655	141	143	2	1	3	1	1	0
FRA-1655	141	148	7	1	3	5	1	0
FRA-1656	142	146	4	1	3	3	1	0
FRA-1656	142	143	1	1	3	3	1	0
FRA-1656	142	143	1	1	3	3	1	0
FRA-1656	142	144	2	1	3	4	1	0
FRA-1656	142	143	1	1	3	3	1	0
FRA-1656	142	210	68	1	3	5	1	0
FRA-1656	143	151	8	1	3	4	1	0
FRA-1656	143	146	3	1	3	3	1	0
FRA-1656	143	168	25	1	3	3	1	0
FRA-1656	143	168	25	1	3	5	1	0
FRA-1657	143	168	25	1	3	5	1	0
FRA-1657	143	168	25	1	3	5	1	0
FRA-1657	143	168	25	1	3	5	1	0
FRA-1657	143	168	25	1	3	5	1	0
FRA-1657	143	144	1	1	3	1	1	0
FRA-1657	144	145	1	1	3	3	1	0
FRA-1657	144	146	2	1	3	1	1	0
FRA-1657	144	232	88	1	3	5	1	2
FRA-1657	144	155	11	1	3	5	1	0
FRA-1657	144	149	5	1	3	3	1	0
FRA-1658	145	157	12	1	3	3	1	3
FRA-1658	145	146	1	1	3	3	1	0
FRA-1658	145	180	35	1	3	5	1	0
FRA-1658	146	148	2	1	3	1	1	0
FRA-1658	146	209	63	1	3	5	1	0
FRA-1658	147	231	84	1	3	1	1	0
FRA-1658	148	149	1	1	4	1	1	0
FRA-1658	148	154	6	1	3	1	1	0
FRA-1658	148	151	3	1	3	3	1	0
FRA-1658	148	151	3	1	3	4	1	1
FRA-1659	148	162	14	1	3	1	1	0
FRA-1659	148	392	244	1	3	1	0	0
FRA-1659	148	149	1	1	3	3	1	0
FRA-1659	149	150	1	1	3	5	1	0
FRA-1659	149	155	6	1	3	3	1	0
FRA-1659	149	150	1	1	3	3	1	0
FRA-1659	149	169	20	1	3	5	1	0
FRA-1659	149	154	5	1	3	1	1	0
FRA-1659	149	176	27	1	3	5	1	0
FRA-1659	149	150	1	1	1	3	1	0
FRA-1660	150	162	12	1	3	5	1	0
FRA-1660	150	151	1	1	4	3	1	0
FRA-1660	150	278	128	1	4	5	0	0
FRA-1660	150	151	1	1	4	1	1	0
FRA-1660	150	163	13	1	4	5	1	0
FRA-1660	150	162	12	1	4	3	1	0
FRA-1660	150	162	12	1	3	5	1	0
FRA-1660	150	168	18	1	3	1	1	1
FRA-1660	150	161	11	1	3	5	1	0
FRA-1660	151	154	3	1	3	1	1	0
FRA-1661	151	280	129	1	3	3	0	0
FRA-1661	151	152	1	1	3	1	1	1
FRA-1661	151	160	9	1	4	1	1	0
FRA-1661	152	159	7	1	3	4	1	0
FRA-1661	152	183	31	1	3	5	1	0
FRA-1661	152	163	11	1	3	5	1	0
FRA-1661	153	154	1	1	4	5	1	0
FRA-1661	153	154	1	1	3	3	1	0
FRA-1661	154	168	14	1	3	3	1	0
FRA-1661	154	175	21	1	5	1	1	0
FRA-1662	154	178	24	1	3	3	1	0
FRA-1662	154	156	2	1	4	4	1	1
FRA-1662	154	157	3	1	3	5	1	0
FRA-1662	155	158	3	1	3	1	1	0
FRA-1662	156	157	1	1	3	3	1	0
FRA-1662	156	161	5	1	3	1	1	0
FRA-1662	156	157	1	1	3	3	1	0
FRA-1662	156	161	5	1	1	1	1	0
FRA-1662	157	158	1	1	3	1	1	0
FRA-1662	157	163	6	1	3	3	1	0
FRA-1663	157	158	1	1	3	2	1	0
FRA-1663	157	167	10	1	3	3	1	1
FRA-1663	157	165	8	1	3	5	1	0
FRA-1663	157	163	6	1	3	5	1	0
FRA-1663	158	175	17	1	4	1	1	0
FRA-1663	159	160	1	1	3	1	1	0
FRA-1663	159	160	1	1	4	4	1	0
FRA-1663	160	161	1	1	3	4	1	2
FRA-1663	160	168	8	1	4	1	1	0
FRA-1663	161	477	316	0	4	1	0	0
FRA-1664	162	163	1	1	3	1	1	0
FRA-1664	162	163	1	1	3	1	1	0
FRA-1664	162	164	2	1	3	1	0	0
FRA-1664	162	189	27	1	3	1	1	0
FRA-1664	162	165	3	1	4	4	1	0
FRA-1664	163	164	1	1	3	3	1	0
FRA-1664	163	164	1	1	3	1	1	1
FRA-1664	164	175	11	1	3	3	1	2
FRA-1664	164	165	1	1	3	3	1	0
FRA-1664	164	280	116	1	3	1	0	0
FRA-1665	165	388	223	1	3	1	0	1
FRA-1665	165	181	16	1	3	1	1	1
FRA-1665	165	166	1	1	3	2	1	0
FRA-1665	167	335	168	1	3	5	0	0
FRA-1665	167	168	1	1	3	1	1	0
FRA-1665	167	168	1	1	1	1	1	0
FRA-1665	168	169	1	1	4	1	1	0
FRA-1665	168	298	130	1	3	1	0	0
FRA-1665	168	175	7	1	4	1	1	1
FRA-1665	168	183	15	1	3	3	1	0
FRA-1666	169	176	7	1	3	1	1	0
FRA-1666	169	170	1	1	4	1	1	0
FRA-1666	169	175	6	1	4	3	1	0
FRA-1666	169	170	1	1	3	3	1	0
FRA-1666	169	171	2	1	3	5	1	0
FRA-1666	169	399	230	1	3	1	0	0
FRA-1666	169	170	1	1	4	3	1	0
FRA-1666	169	214	45	1	3	5	1	0
FRA-1666	170	310	140	1	3	3	0	0
FRA-1666	170	171	1	1	3	3	1	0
FRA-1667	170	171	1	1	3	1	1	0
FRA-1667	171	176	5	1	3	3	1	0
FRA-1667	171	172	1	1	3	3	1	0
FRA-1667	171	172	1	1	3	3	1	0
FRA-1667	172	236	64	1	3	3	1	0
FRA-1667	172	173	1	1	4	3	1	1
FRA-1667	172	212	40	1	3	3	1	0
FRA-1667	174	175	1	1	3	3	1	0
FRA-1667	175	176	1	1	5	3	1	0
FRA-1667	175	176	1	1	5	5	1	0
FRA-1668	175	176	1	1	3	1	1	0
FRA-1668	175	176	1	1	1	1	1	1
FRA-1668	175	180	5	1	3	1	1	0
FRA-1668	176	182	6	1	3	4	1	0
FRA-1668	176	177	1	1	3	3	1	0
FRA-1668	176	210	34	1	3	3	1	0
FRA-1668	176	210	34	1	3	1	1	1
FRA-1668	177	178	1	1	4	1	1	0
FRA-1668	177	178	1	1	4	3	1	0
FRA-1668	177	178	1	1	3	5	0	0
FRA-1669	178	179	1	1	3	5	1	0
FRA-1669	178	179	1	1	4	1	1	0
FRA-1669	178	198	20	1	3	5	1	0
FRA-1669	178	181	3	1	3	3	1	0
FRA-1669	178	180	2	1	3	3	1	0
FRA-1669	179	181	2	1	3	3	1	0
FRA-1669	179	180	1	1	4	4	1	0
FRA-1669	179	180	1	1	4	4	1	0
FRA-1669	179	382	203	1	3	3	0	0
FRA-1669	179	477	298	0	3	3	0	0
FRA-1670	179	180	1	1	3	3	1	0
FRA-1670	179	180	1	1	3	2	1	0
FRA-1670	180	387	207	1	3	3	0	1
FRA-1670	180	183	3	1	3	1	0	0
FRA-1670	180	395	215	1	3	1	0	0
FRA-1670	180	399	219	1	4	3	0	0
FRA-1670	180	477	297	0	3	5	0	0
FRA-1670	182	211	29	1	3	5	1	0
FRA-1670	182	183	1	1	3	3	1	0
FRA-1670	182	183	1	1	3	5	1	0
FRA-1671	183	184	1	1	3	1	1	0
FRA-1671	183	195	12	1	3	1	1	0
FRA-1671	183	190	7	1	3	1	1	1
FRA-1671	183	210	27	1	4	5	1	0
FRA-1671	183	198	15	1	3	1	1	0
FRA-1671	184	190	6	1	2	1	1	1
FRA-1671	184	361	177	1	4	1	0	1
FRA-1671	184	271	87	1	4	5	0	1
FRA-1671	184	185	1	1	4	3	1	1
FRA-1671	184	203	19	1	3	1	1	0
FRA-1672	185	186	1	1	3	1	0	0
FRA-1672	185	186	1	1	3	1	1	0
FRA-1672	185	186	1	1	3	3	1	0
FRA-1672	185	194	9	1	3	1	1	0
FRA-1672	185	210	25	1	3	5	1	0
FRA-1672	185	187	2	1	1	1	1	0
FRA-1672	185	186	1	1	3	3	1	0
FRA-1672	185	186	1	1	1	5	1	0
FRA-1672	186	221	35	1	3	4	1	1
FRA-1672	186	231	45	1	4	5	1	1
FRA-1673	186	477	291	0	4	5	0	0
FRA-1673	186	210	24	1	4	5	1	0
FRA-1673	187	189	2	1	4	4	1	0
FRA-1673	187	188	1	1	4	1	1	0
FRA-1673	187	205	18	1	3	3	1	0
FRA-1673	188	194	6	1	3	1	1	0
FRA-1673	188	190	2	1	3	1	1	2
FRA-1673	189	190	1	1	3	1	1	0
FRA-1673	189	200	11	1	2	3	1	0
FRA-1673	189	190	1	1	3	5	1	0
FRA-1674	189	190	1	1	4	5	1	0
FRA-1674	189	210	21	1	3	3	1	0
FRA-1674	189	192	3	1	3	5	1	0
FRA-1674	189	190	1	1	3	1	1	0
FRA-1674	190	191	1	1	4	3	1	0
FRA-1674	190	194	4	1	3	5	1	1
FRA-1674	190	191	1	1	2	3	1	0
FRA-1674	190	231	41	1	3	5	1	1
FRA-1674	191	193	2	1	3	3	1	0
FRA-1674	191	210	19	1	3	1	1	1
FRA-1675	191	193	2	1	4	3	1	0
FRA-1675	191	192	1	1	3	1	1	0
FRA-1675	191	209	18	1	3	1	1	0
FRA-1675	192	477	285	0	4	5	0	0
FRA-1675	192	193	1	1	5	5	1	0
FRA-1675	192	216	24	1	3	3	1	0
FRA-1675	192	211	19	1	3	5	1	1
FRA-1675	192	195	3	1	3	5	1	0
FRA-1675	192	193	1	1	5	1	1	0
FRA-1675	193	278	85	1	3	3	0	0
FRA-1676	193	213	20	1	3	1	1	0
FRA-1676	193	194	1	1	4	3	1	0
FRA-1676	193	195	2	1	3	4	1	0
FRA-1676	193	363	170	1	3	5	0	0
FRA-1676	193	207	14	1	3	3	1	0
FRA-1676	193	194	1	1	4	4	1	0
FRA-1676	193	231	38	1	3	5	1	0
FRA-1676	193	310	117	1	3	4	0	0
FRA-1676	193	231	38	1	1	3	1	0
FRA-1676	194	195	1	1	3	3	1	0
FRA-1677	194	210	16	1	3	3	1	0
FRA-1677	194	196	2	1	3	1	1	0
FRA-1677	194	195	1	1	4	3	1	0
FRA-1677	195	197	2	1	3	3	1	0
FRA-1677	196	477	281	0	3	5	0	0
FRA-1677	196	197	1	1	3	3	1	0
FRA-1677	196	231	35	1	4	3	1	0
FRA-1677	197	198	1	1	3	1	1	0
FRA-1677	197	198	1	1	3	3	1	0
FRA-1677	197	198	1	1	4	3	1	0
FRA-1678	197	210	13	1	3	1	1	0
FRA-1678	197	198	1	1	3	1	1	0
FRA-1678	197	210	13	1	3	5	1	0
FRA-1678	198	199	1	1	3	1	1	0
FRA-1678	198	199	1	1	2	1	1	0
FRA-1678	198	276	78	1	3	1	0	0
FRA-1678	198	204	6	1	3	3	1	0
FRA-1678	198	205	7	1	3	3	1	0
FRA-1678	199	203	4	1	3	5	1	1
FRA-1678	199	212	13	1	3	4	1	0
FRA-1679	200	201	1	1	3	1	1	0
FRA-1679	200	222	22	1	3	5	1	0
FRA-1679	200	203	3	1	3	1	1	2
FRA-1679	200	203	3	1	3	3	1	1
FRA-1679	200	231	31	1	3	1	1	0
FRA-1679	200	203	3	1	2	1	1	1
FRA-1679	201	203	2	1	3	3	1	4
FRA-1679	202	233	31	1	3	1	1	0
FRA-1679	202	204	2	1	3	3	0	0
FRA-1680	202	203	1	1	3	1	1	0
FRA-1680	203	204	1	1	3	4	1	0
FRA-1680	203	205	2	1	3	1	1	0
FRA-1680	203	205	2	1	3	4	1	0
FRA-1680	203	204	1	1	3	3	1	0
FRA-1680	204	231	27	1	3	4	1	0
FRA-1680	204	205	1	1	3	1	1	0
FRA-1680	204	226	22	1	3	1	1	0
FRA-1680	204	206	2	1	3	1	1	0
FRA-1680	205	206	1	1	4	3	1	0
FRA-1681	205	210	5	1	3	4	1	0
FRA-1681	205	206	1	1	3	1	1	0
FRA-1681	205	206	1	1	4	5	1	0
FRA-1681	205	233	28	1	3	5	1	1
FRA-1681	205	278	73	1	3	5	0	2
FRA-1681	205	210	5	1	3	1	1	0
FRA-1681	205	206	1	1	3	3	1	0
FRA-1681	205	210	5	1	5	4	0	1
FRA-1681	205	210	5	1	5	4	1	1
FRA-1681	205	206	1	1	5	4	1	0
FRA-1682	206	207	1	1	3	1	1	0
FRA-1682	206	210	4	1	3	1	1	0
FRA-1682	206	220	14	1	2	5	1	1
FRA-1682	206	212	6	1	3	3	1	0
FRA-1682	206	210	4	1	3	1	1	0
FRA-1682	206	239	33	1	3	4	1	0
FRA-1682	207	208	1	1	3	2	1	0
FRA-1682	207	208	1	1	3	1	1	0
FRA-1682	207	231	24	1	4	1	1	0
FRA-1682	207	210	3	1	3	4	1	0
FRA-1683	207	208	1	1	3	1	1	0
FRA-1683	207	208	1	1	4	3	1	0
FRA-1683	207	235	28	1	3	3	1	0
FRA-1683	207	278	71	1	3	3	0	0
FRA-1683	207	211	4	1	3	1	1	0
FRA-1683	208	209	1	1	3	1	1	0
FRA-1683	209	221	12	1	1	1	1	0
FRA-1683	210	211	1	1	2	5	1	0
FRA-1683	210	211	1	1	3	5	1	0
FRA-1683	210	477	267	0	3	5	0	0
FRA-1684	210	211	1	1	3	1	1	0
FRA-1684	210	222	12	1	1	3	1	0
FRA-1684	211	254	43	1	3	5	0	0
FRA-1684	211	212	1	1	4	1	1	0
FRA-1684	211	218	7	1	3	1	1	0
FRA-1684	211	212	1	1	3	1	1	0
FRA-1684	211	212	1	1	4	1	1	0
FRA-1684	211	218	7	1	3	3	1	0
FRA-1684	211	216	5	1	3	3	1	0
FRA-1684	211	233	22	1	3	3	1	0
FRA-1685	212	213	1	1	3	5	1	0
FRA-1685	212	213	1	1	3	3	1	1
FRA-1685	212	213	1	1	3	4	1	0
FRA-1685	212	213	1	1	3	5	1	0
FRA-1685	212	233	21	1	3	4	1	0
FRA-1685	212	213	1	1	3	5	1	0
FRA-1685	212	213	1	1	3	3	1	0
FRA-1685	212	214	2	1	1	3	1	0
FRA-1685	212	213	1	1	3	3	1	0
FRA-1685	212	363	151	1	4	2	0	0
FRA-1686	212	214	2	1	3	1	1	0
FRA-1686	212	214	2	1	3	3	1	0
FRA-1686	212	213	1	1	3	1	1	0
FRA-1686	212	219	7	1	3	1	1	0
FRA-1686	213	477	264	0	3	4	0	0
FRA-1686	213	214	1	1	3	1	1	0
FRA-1686	213	214	1	1	3	1	1	0
FRA-1686	213	214	1	1	3	2	1	0
FRA-1686	213	214	1	1	3	3	1	0
FRA-1686	213	267	54	1	3	4	0	1
FRA-1687	214	225	11	1	3	3	1	0
FRA-1687	214	215	1	1	3	4	1	0
FRA-1687	214	215	1	1	3	1	1	0
FRA-1687	214	217	3	1	3	3	1	0
FRA-1687	214	220	6	1	3	3	1	0
FRA-1687	217	225	8	1	3	5	1	0
FRA-1687	217	218	1	1	3	3	1	0
FRA-1687	217	451	234	1	3	4	0	0
FRA-1687	217	222	5	1	4	3	1	0
FRA-1687	217	219	2	1	3	5	1	0
FRA-1688	218	222	4	1	3	4	1	0
FRA-1688	218	219	1	1	2	3	1	0
FRA-1688	218	452	234	1	4	3	0	0
FRA-1688	218	220	2	1	3	3	1	0
FRA-1688	219	222	3	1	3	3	1	0
FRA-1688	219	220	1	1	4	3	1	0
FRA-1688	219	233	14	1	3	3	1	1
FRA-1688	220	221	1	1	3	5	1	1
FRA-1688	220	221	1	1	4	5	1	0
FRA-1688	220	303	83	1	3	3	0	0
FRA-1689	220	221	1	1	4	4	1	1
FRA-1689	220	222	2	1	4	5	1	0
FRA-1689	221	222	1	1	3	1	1	0
FRA-1689	221	249	28	1	3	5	0	0
FRA-1689	221	222	1	1	3	5	1	0
FRA-1689	221	225	4	1	4	4	1	0
FRA-1689	221	222	1	1	4	4	1	0
FRA-1689	221	231	10	1	4	3	1	0
FRA-1689	222	225	3	1	3	1	1	0
FRA-1689	223	236	13	1	3	5	1	0
FRA-1690	223	224	1	1	3	5	1	0
FRA-1690	223	244	21	1	3	4	0	0
FRA-1690	223	224	1	1	3	3	1	0
FRA-1690	223	231	8	1	1	1	1	0
FRA-1690	224	225	1	1	3	1	1	0
FRA-1690	224	225	1	1	3	5	1	0
FRA-1690	224	249	25	1	3	1	0	0
FRA-1690	224	227	3	1	3	1	1	0
FRA-1690	224	226	2	1	3	1	1	0
FRA-1690	225	233	8	1	4	3	1	0
FRA-1691	225	233	8	1	3	4	1	0
FRA-1691	226	276	50	1	3	5	0	1
FRA-1691	226	232	6	1	3	5	1	0
FRA-1691	227	233	6	1	3	3	1	0
FRA-1691	227	228	1	1	3	3	1	0
FRA-1691	227	231	4	1	3	3	1	0
FRA-1691	227	228	1	1	3	5	1	0
FRA-1691	227	281	54	1	3	1	0	0
FRA-1691	228	229	1	1	3	3	1	0
FRA-1691	228	229	1	1	4	3	1	0
FRA-1692	229	230	1	1	3	3	1	0
FRA-1692	229	230	1	1	3	1	1	0
FRA-1692	229	230	1	1	3	3	1	0
FRA-1692	230	304	74	1	3	3	0	0
FRA-1692	230	234	4	1	3	3	1	0
FRA-1692	230	231	1	1	3	1	1	1
FRA-1692	231	232	1	1	3	1	1	0
FRA-1692	231	233	2	1	3	5	1	0
FRA-1692	231	237	6	1	3	5	1	0
FRA-1692	231	232	1	1	3	1	1	0
FRA-1693	231	233	2	1	3	3	1	2
FRA-1693	231	298	67	1	5	3	0	0
FRA-1693	231	232	1	1	3	5	1	0
FRA-1693	232	233	1	1	3	3	1	0
FRA-1693	232	256	24	1	3	3	0	0
FRA-1693	233	234	1	1	3	1	1	0
FRA-1693	233	234	1	1	3	4	1	0
FRA-1693	233	240	7	1	4	5	1	1
FRA-1693	233	234	1	1	4	3	1	0
FRA-1693	233	234	1	1	2	1	1	0
FRA-1694	233	314	81	1	3	3	0	0
FRA-1694	233	234	1	1	3	3	1	0
FRA-1694	233	249	16	1	3	3	0	0
FRA-1694	233	278	45	1	3	3	0	0
FRA-1694	233	234	1	1	3	2	1	0
FRA-1694	234	235	1	1	3	3	1	0
FRA-1694	234	477	243	0	3	3	0	1
FRA-1694	234	249	15	1	3	4	0	0
FRA-1694	235	382	147	1	4	4	0	0
FRA-1694	237	238	1	1	3	3	1	0
FRA-1695	237	238	1	1	3	4	1	0
FRA-1695	238	269	31	1	3	1	0	0
FRA-1695	238	247	9	1	3	5	0	0
FRA-1695	238	244	6	1	3	3	0	0
FRA-1695	238	239	1	1	3	5	1	0
FRA-1695	238	239	1	1	3	5	1	0
FRA-1695	238	239	1	1	3	5	1	0
FRA-1695	238	239	1	1	3	5	1	0
FRA-1695	238	239	1	1	3	5	1	0
FRA-1695	238	244	6	1	3	5	0	0
FRA-1696	238	239	1	1	3	1	1	0
FRA-1696	239	240	1	1	3	4	1	0
FRA-1696	239	244	5	1	3	1	0	0
FRA-1696	239	240	1	1	1	1	1	0
FRA-1696	239	261	22	1	4	5	0	0
FRA-1696	239	240	1	1	2	1	1	0
FRA-1696	240	242	2	1	1	1	1	0
FRA-1696	240	326	86	1	3	4	0	0
FRA-1696	241	242	1	1	3	1	1	0
FRA-1696	241	249	8	1	3	4	0	0
FRA-1697	241	245	4	1	3	5	0	0
FRA-1697	241	276	35	1	3	1	0	0
FRA-1697	241	246	5	1	3	3	0	0
FRA-1697	241	276	35	1	3	1	0	0
FRA-1697	242	250	8	1	2	3	0	0
FRA-1697	242	244	2	1	3	3	1	0
FRA-1697	242	243	1	1	3	3	1	0
FRA-1697	243	388	145	1	3	4	0	1
FRA-1697	243	245	2	1	4	5	0	0
FRA-1697	244	280	36	1	2	5	0	1
FRA-1698	245	246	1	1	3	5	0	0
FRA-1698	246	249	3	1	3	3	0	0
FRA-1698	248	249	1	1	3	5	0	0
FRA-1698	248	259	11	1	3	3	0	0
FRA-1698	248	249	1	1	5	3	0	0
FRA-1698	248	251	3	1	4	4	0	0
FRA-1698	248	267	19	1	3	5	0	1
FRA-1698	248	249	1	1	3	3	0	0
FRA-1698	248	253	5	1	3	4	0	0
FRA-1698	249	477	228	0	3	3	0	1
FRA-1699	249	252	3	1	3	1	0	0
FRA-1699	249	250	1	1	3	1	0	0
FRA-1699	250	477	227	0	3	1	0	0
FRA-1699	250	251	1	1	3	3	0	0
FRA-1699	251	252	1	1	5	5	0	0
FRA-1699	251	310	59	1	5	1	0	0
FRA-1699	252	276	24	1	4	3	0	0
FRA-1699	252	279	27	1	4	4	0	0
FRA-1699	252	269	17	1	3	3	0	0
FRA-1699	252	253	1	1	3	3	0	1
FRA-1700	252	253	1	1	3	3	0	0
FRA-1700	253	276	23	1	3	2	0	0
FRA-1700	253	254	1	1	3	3	0	0
FRA-1700	253	254	1	1	4	3	1	0
FRA-1700	253	254	1	1	3	3	0	1
FRA-1700	253	260	7	1	4	2	0	1
FRA-1700	254	255	1	1	3	3	0	0
FRA-1700	254	255	1	1	4	3	0	0
FRA-1700	254	255	1	1	3	4	0	0
FRA-1700	254	255	1	1	4	3	0	0
FRA-1701	254	263	9	1	3	4	0	0
FRA-1701	254	269	15	1	5	3	0	0
FRA-1701	254	383	129	1	3	5	0	0
FRA-1701	254	269	15	1	4	1	0	0
FRA-1701	255	256	1	1	3	3	0	0
FRA-1701	255	278	23	1	3	1	1	1
FRA-1701	255	256	1	1	3	5	0	0
FRA-1701	255	276	21	1	3	2	0	0
FRA-1701	255	261	6	1	3	5	0	0
FRA-1701	255	256	1	1	3	3	0	0
FRA-1702	255	256	1	1	3	1	0	0
FRA-1702	255	301	46	1	3	3	0	0
FRA-1702	256	262	6	1	3	3	0	0
FRA-1702	256	257	1	1	3	4	0	0
FRA-1702	257	259	2	1	3	1	0	0
FRA-1702	257	259	2	1	3	3	0	0
FRA-1702	258	259	1	1	3	3	0	0
FRA-1702	258	308	50	1	3	5	0	0
FRA-1702	259	261	2	1	3	3	0	0
FRA-1702	259	260	1	1	4	3	0	0
FRA-1703	259	477	218	0	3	5	0	1
FRA-1703	260	261	1	1	3	3	0	0
FRA-1703	260	298	38	1	4	3	0	1
FRA-1703	260	261	1	1	3	2	0	0
FRA-1703	260	261	1	1	3	3	0	0
FRA-1703	261	269	8	1	3	1	0	0
FRA-1703	261	269	8	1	3	2	0	0
FRA-1703	261	262	1	1	4	5	0	0
FRA-1703	261	262	1	1	3	1	0	0
FRA-1703	261	264	3	1	3	5	0	0
FRA-1704	262	278	16	1	3	5	0	0
FRA-1704	262	263	1	1	3	1	0	0
FRA-1704	262	263	1	1	3	1	0	0
FRA-1704	262	264	2	1	3	3	0	0
FRA-1704	262	280	18	1	3	1	0	0
FRA-1704	262	278	16	1	3	3	0	0
FRA-1704	263	278	15	1	3	1	0	0
FRA-1704	263	267	4	1	3	5	0	0
FRA-1704	263	264	1	1	2	3	0	0
FRA-1704	263	264	1	1	3	5	0	1
FRA-1705	265	266	1	1	3	1	0	0
FRA-1705	266	276	10	1	3	1	0	0
FRA-1705	266	309	43	1	3	1	0	0
FRA-1705	266	269	3	1	3	1	0	0
FRA-1705	266	267	1	1	3	3	0	0
FRA-1705	266	267	1	1	3	1	0	0
FRA-1705	266	297	31	1	3	5	0	0
FRA-1705	266	267	1	1	3	5	0	0
FRA-1705	267	268	1	1	3	3	0	0
FRA-1705	267	269	2	1	3	3	0	0
FRA-1706	267	298	31	1	3	3	0	0
FRA-1706	267	268	1	1	3	3	0	0
FRA-1706	267	268	1	1	3	1	0	0
FRA-1706	267	276	9	1	3	5	0	0
FRA-1706	268	269	1	1	4	1	0	1
FRA-1706	268	284	16	1	3	3	0	1
FRA-1706	269	270	1	1	3	1	0	1
FRA-1706	269	270	1	1	4	1	0	0
FRA-1706	270	271	1	1	3	1	0	0
FRA-1706	270	273	3	1	2	1	0	0
FRA-1707	270	271	1	1	4	3	0	0
FRA-1707	270	273	3	1	3	3	0	0
FRA-1707	270	271	1	1	3	3	0	1
FRA-1707	271	289	18	1	3	4	0	1
FRA-1707	272	273	1	1	2	5	0	0
FRA-1707	272	284	12	1	3	4	0	0
FRA-1707	272	273	1	1	3	4	0	0
FRA-1707	273	276	3	1	3	3	0	0
FRA-1707	273	278	5	1	3	5	0	0
FRA-1707	273	279	6	1	3	4	0	0
FRA-1708	273	274	1	1	3	1	0	0
FRA-1708	273	279	6	1	4	4	0	0
FRA-1708	274	276	2	1	3	3	0	0
FRA-1708	274	297	23	1	3	1	0	0
FRA-1708	274	276	2	1	3	1	0	0
FRA-1708	274	276	2	1	3	3	0	0
FRA-1708	274	276	2	1	3	3	0	0
FRA-1708	275	280	5	1	3	1	0	0
FRA-1708	275	276	1	1	3	1	0	0
FRA-1708	275	278	3	1	3	1	0	0
FRA-1709	275	278	3	1	3	1	0	0
FRA-1709	275	276	1	1	4	3	0	0
FRA-1709	275	276	1	1	3	1	0	0
FRA-1709	275	308	33	1	3	1	0	0
FRA-1709	275	278	3	1	3	1	0	0
FRA-1709	275	278	3	1	3	3	0	0
FRA-1709	275	276	1	1	3	3	0	0
FRA-1709	276	277	1	1	3	3	0	0
FRA-1709	276	277	1	1	4	3	0	0
FRA-1709	276	278	2	1	3	3	0	0
FRA-1710	276	477	201	0	3	3	0	1
FRA-1710	276	278	2	1	3	4	0	0
FRA-1710	276	308	32	1	3	3	0	0
FRA-1710	276	278	2	1	3	5	0	0
FRA-1710	276	277	1	1	4	3	0	0
FRA-1710	276	277	1	1	3	1	0	0
FRA-1710	276	291	15	1	3	1	0	0
FRA-1710	277	298	21	1	3	1	0	0
FRA-1710	277	291	14	1	4	1	0	0
FRA-1710	277	278	1	1	3	5	0	0
FRA-1711	277	281	4	1	4	1	0	0
FRA-1711	279	280	1	1	3	3	0	0
FRA-1711	280	296	16	1	3	1	0	0
FRA-1711	280	281	1	1	3	1	0	0
FRA-1711	280	477	197	0	3	3	0	2
FRA-1711	280	285	5	1	3	5	1	0
FRA-1711	280	286	6	1	3	3	0	0
FRA-1711	280	297	17	1	3	5	0	1
FRA-1711	280	281	1	1	3	1	0	0
FRA-1711	280	409	129	1	3	1	0	0
FRA-1712	280	477	197	0	3	1	0	0
FRA-1712	280	287	7	1	3	5	0	0
FRA-1712	281	412	131	1	3	1	0	0
FRA-1712	281	282	1	1	3	3	0	0
FRA-1712	281	302	21	1	3	3	0	0
FRA-1712	281	287	6	1	3	3	0	0
FRA-1712	281	284	3	1	2	1	0	0
FRA-1712	282	332	50	1	3	3	0	2
FRA-1712	282	297	15	1	3	3	0	0
FRA-1712	282	284	2	1	4	5	0	0
FRA-1713	282	292	10	1	3	3	0	0
FRA-1713	283	295	12	1	3	5	0	1
FRA-1713	283	284	1	1	3	5	0	1
FRA-1713	283	303	20	1	3	3	0	1
FRA-1713	283	284	1	1	3	1	0	0
FRA-1713	283	284	1	1	3	3	0	0
FRA-1713	283	284	1	1	3	1	0	0
FRA-1713	283	297	14	1	3	3	0	0
FRA-1713	284	287	3	1	3	3	0	1
FRA-1713	284	285	1	1	4	4	0	0
FRA-1714	284	285	1	1	3	3	0	0
FRA-1714	284	289	5	1	3	5	0	0
FRA-1714	285	286	1	1	3	3	0	0
FRA-1714	286	297	11	1	3	3	0	1
FRA-1714	287	288	1	1	3	1	0	0
FRA-1714	287	393	106	1	4	4	0	0
FRA-1714	287	288	1	1	2	1	0	0
FRA-1714	282	298	16	1	4	1	0	0
FRA-1714	287	288	1	1	4	3	0	0
FRA-1714	287	288	1	1	4	2	0	0
FRA-1715	287	288	1	1	4	3	0	0
FRA-1715	287	297	10	1	3	5	0	0
FRA-1715	287	289	2	1	4	3	0	0
FRA-1715	288	289	1	1	3	3	0	0
FRA-1715	288	420	132	1	3	3	0	0
FRA-1715	288	290	2	1	3	1	0	0
FRA-1715	288	289	1	1	3	3	0	1
FRA-1715	289	290	1	1	3	3	0	0
FRA-1715	290	293	3	1	3	3	0	0
FRA-1715	290	294	4	1	3	3	0	0
FRA-1716	290	294	4	1	3	3	0	0
FRA-1716	291	296	5	1	3	1	0	0
FRA-1716	291	292	1	1	3	1	0	0
FRA-1716	294	316	22	1	3	3	0	0
FRA-1716	294	303	9	1	4	3	0	0
FRA-1716	294	296	2	1	3	1	0	0
FRA-1716	294	295	1	1	3	5	0	0
FRA-1716	294	295	1	1	3	1	0	0
FRA-1716	294	321	27	1	3	3	0	0
FRA-1716	294	297	3	1	3	3	0	0
FRA-1717	294	295	1	1	3	1	0	0
FRA-1717	294	297	3	1	3	5	0	0
FRA-1717	295	296	1	1	3	3	0	0
FRA-1717	296	375	79	1	3	2	0	0
FRA-1717	296	297	1	1	3	5	0	0
FRA-1717	296	302	6	1	3	1	0	0
FRA-1717	297	308	11	1	3	3	0	0
FRA-1717	297	298	1	1	3	2	0	0
FRA-1717	297	298	1	1	3	3	0	0
FRA-1717	298	299	1	1	3	3	0	1
FRA-1718	298	477	179	0	3	3	0	0
FRA-1718	298	303	5	1	3	5	0	0
FRA-1718	299	303	4	1	3	1	0	0
FRA-1718	299	301	2	1	3	1	0	0
FRA-1718	299	300	1	1	4	3	0	0
FRA-1718	300	312	12	1	3	5	0	1
FRA-1718	300	301	1	1	3	3	0	0
FRA-1718	302	304	2	1	3	3	0	0
FRA-1718	303	308	5	1	3	1	0	0
FRA-1718	303	308	5	1	3	5	0	1
FRA-1719	303	304	1	1	1	3	0	1
FRA-1719	303	310	7	1	3	3	0	0
FRA-1719	303	304	1	1	3	1	0	0
FRA-1719	303	304	1	1	1	5	0	1
FRA-1719	304	308	4	1	3	3	0	0
FRA-1719	304	345	41	1	3	5	0	0
FRA-1719	304	308	4	1	3	3	0	0
FRA-1719	304	305	1	1	4	3	0	0
FRA-1719	304	305	1	1	3	5	0	0
FRA-1719	305	312	7	1	3	3	0	1
FRA-1720	305	306	1	1	4	5	0	1
FRA-1720	305	306	1	1	3	5	0	0
FRA-1720	305	312	7	1	3	3	0	2
FRA-1720	306	309	3	1	4	1	0	0
FRA-1720	306	307	1	1	3	3	0	0
FRA-1720	306	307	1	1	1	5	0	0
FRA-1720	307	308	1	1	3	5	0	0
FRA-1720	307	308	1	1	3	5	0	0
FRA-1720	307	308	1	1	3	5	0	0
FRA-1720	307	308	1	1	3	5	0	0
FRA-1721	307	308	1	1	3	5	0	0
FRA-1721	307	308	1	1	3	4	0	0
FRA-1721	308	327	19	1	3	5	0	0
FRA-1721	308	344	36	1	3	3	0	0
FRA-1721	308	340	32	1	3	5	0	0
FRA-1721	308	309	1	1	3	3	0	0
FRA-1721	308	477	169	0	3	5	0	0
FRA-1721	309	319	10	1	3	5	0	0
FRA-1721	309	477	168	0	3	5	0	0
FRA-1721	309	330	21	1	4	1	0	0
FRA-1722	309	310	1	1	3	4	0	0
FRA-1722	310	311	1	1	3	3	0	0
FRA-1722	310	311	1	1	3	3	0	0
FRA-1722	310	314	4	1	3	1	0	0
FRA-1722	310	312	2	1	3	5	0	1
FRA-1722	311	312	1	1	3	4	0	0
FRA-1722	311	425	114	1	3	5	0	0
FRA-1722	311	312	1	1	3	3	0	0
FRA-1722	311	312	1	1	3	1	0	0
FRA-1722	311	312	1	1	3	5	0	0
FRA-1723	311	322	11	1	3	1	0	0
FRA-1723	311	312	1	1	4	1	0	0
FRA-1723	312	313	1	1	3	3	0	0
FRA-1723	312	313	1	1	3	3	0	0
FRA-1723	312	477	165	0	3	5	0	0
FRA-1723	312	313	1	1	3	5	0	0
FRA-1723	313	323	10	1	3	3	0	0
FRA-1723	313	324	11	1	3	5	0	0
FRA-1723	313	314	1	1	2	1	0	0
FRA-1723	315	316	1	1	3	3	0	0
FRA-1724	315	316	1	1	1	1	0	0
FRA-1724	315	318	3	1	3	3	0	0
FRA-1724	315	316	1	1	3	5	0	0
FRA-1724	316	321	5	1	3	5	0	0
FRA-1724	316	317	1	1	3	4	0	0
FRA-1724	316	477	161	0	3	3	0	0
FRA-1724	316	326	10	1	3	3	0	1
FRA-1724	317	335	18	1	3	1	0	0
FRA-1724	317	322	5	1	3	4	0	0
FRA-1724	317	321	4	1	4	3	0	0
FRA-1725	317	318	1	1	4	5	0	0
FRA-1725	317	318	1	1	3	1	0	0
FRA-1725	318	320	2	1	3	1	0	0
FRA-1725	318	477	159	0	3	4	0	0
FRA-1725	319	322	3	1	3	3	0	0
FRA-1725	319	322	3	1	2	1	0	0
FRA-1725	319	320	1	1	3	1	0	0
FRA-1725	319	321	2	1	3	3	0	0
FRA-1725	320	323	3	1	3	2	0	0
FRA-1725	320	324	4	1	3	1	0	0
FRA-1726	321	322	1	1	3	1	0	0
FRA-1726	321	322	1	1	3	4	0	0
FRA-1726	322	325	3	1	3	3	0	0
FRA-1726	322	327	5	1	3	3	0	0
FRA-1726	322	477	155	0	3	5	0	0
FRA-1726	322	327	5	1	3	5	0	0
FRA-1726	322	332	10	1	3	1	0	0
FRA-1726	322	323	1	1	3	1	0	0
FRA-1726	322	327	5	1	3	5	0	0
FRA-1726	322	323	1	1	3	1	0	0
FRA-1727	322	323	1	1	3	1	0	2
FRA-1727	322	323	1	1	3	3	0	0
FRA-1727	322	328	6	1	3	3	0	0
FRA-1727	322	323	1	1	3	1	0	0
FRA-1727	322	323	1	1	4	3	0	0
FRA-1727	322	323	1	1	3	1	0	0
FRA-1727	322	323	1	1	4	5	0	0
FRA-1727	323	324	1	1	1	2	0	0
FRA-1727	323	332	9	1	3	1	0	0
FRA-1727	323	347	24	1	4	3	0	0
FRA-1728	323	326	3	1	4	1	0	0
FRA-1728	323	324	1	1	3	5	0	0
FRA-1728	323	324	1	1	3	3	0	0
FRA-1728	323	324	1	1	2	3	0	0
FRA-1728	323	477	154	0	4	3	0	0
FRA-1728	323	326	3	1	4	1	0	0
FRA-1728	324	325	1	1	5	4	0	0
FRA-1728	324	325	1	1	3	3	0	0
FRA-1728	324	363	39	1	3	4	0	0
FRA-1728	324	380	56	1	3	5	0	0
FRA-1729	324	361	37	1	3	5	0	0
FRA-1729	324	340	16	1	3	5	0	0
FRA-1729	324	343	19	1	3	5	0	0
FRA-1729	324	325	1	1	4	3	0	0
FRA-1729	324	343	19	1	3	2	0	0
FRA-1729	325	326	1	1	3	5	0	0
FRA-1729	325	412	87	1	3	3	0	0
FRA-1729	325	326	1	1	3	5	0	0
FRA-1729	326	327	1	1	3	5	0	1
FRA-1729	326	340	14	1	3	3	0	1
FRA-1730	326	340	14	1	3	5	0	0
FRA-1730	326	336	10	1	3	5	0	0
FRA-1730	326	329	3	1	3	3	0	1
FRA-1730	326	327	1	1	3	3	0	0
FRA-1730	326	327	1	1	1	1	0	0
FRA-1730	326	327	1	1	4	1	0	0
FRA-1730	326	327	1	1	3	5	0	0
FRA-1730	326	327	1	1	3	5	0	0
FRA-1730	327	332	5	1	3	3	0	0
FRA-1730	328	332	4	1	4	3	0	0
FRA-1731	328	332	4	1	4	3	0	0
FRA-1731	329	336	7	1	3	1	0	0
FRA-1731	329	330	1	1	3	1	0	1
FRA-1731	329	330	1	1	4	5	0	0
FRA-1731	329	394	65	1	3	1	1	1
FRA-1731	329	336	7	1	4	1	0	0
FRA-1731	329	330	1	1	4	4	0	0
FRA-1731	329	437	108	1	3	5	0	1
FRA-1731	329	331	2	1	4	4	0	0
FRA-1731	329	330	1	1	3	3	0	0
FRA-1732	329	330	1	1	3	1	0	0
FRA-1732	329	331	2	1	3	3	0	1
FRA-1732	330	332	2	1	3	3	0	0
FRA-1732	330	332	2	1	4	4	0	0
FRA-1732	330	331	1	1	3	1	0	0
FRA-1732	331	362	31	1	3	3	0	0
FRA-1732	331	340	9	1	3	3	0	0
FRA-1732	331	332	1	1	3	3	0	0
FRA-1732	331	344	13	1	3	3	0	0
FRA-1732	331	332	1	1	4	1	0	0
FRA-1733	331	332	1	1	4	3	0	0
FRA-1733	331	332	1	1	3	1	0	0
FRA-1733	331	336	5	1	5	5	0	0
FRA-1733	331	336	5	1	3	4	0	0
FRA-1733	331	335	4	1	2	3	0	1
FRA-1733	332	452	120	1	3	3	0	0
FRA-1733	332	344	12	1	4	3	0	0
FRA-1733	332	336	4	1	3	5	0	0
FRA-1733	332	333	1	1	3	5	0	0
FRA-1733	332	336	4	1	3	1	0	0
FRA-1734	332	415	83	1	4	5	0	0
FRA-1734	333	337	4	1	3	5	0	0
FRA-1734	333	335	2	1	4	3	0	0
FRA-1734	333	336	3	1	4	3	0	0
FRA-1734	333	334	1	1	3	3	0	0
FRA-1734	334	335	1	1	3	5	0	0
FRA-1734	334	335	1	1	3	5	0	0
FRA-1734	335	337	2	1	3	5	0	1
FRA-1734	335	344	9	1	4	3	0	1
FRA-1734	336	337	1	1	3	3	0	0
FRA-1735	336	338	2	1	3	1	0	0
FRA-1735	336	344	8	1	4	3	0	1
FRA-1735	336	344	8	1	3	3	0	0
FRA-1735	337	338	1	1	3	3	0	0
FRA-1735	337	345	8	1	3	3	0	0
FRA-1735	337	338	1	1	3	5	0	0
FRA-1735	337	355	18	1	4	3	0	0
FRA-1735	337	340	3	1	3	5	0	0
FRA-1735	337	339	2	1	3	3	0	0
FRA-1735	337	338	1	1	3	3	0	0
FRA-1736	337	338	1	1	3	3	0	0
FRA-1736	338	380	42	1	3	3	0	0
FRA-1736	338	362	24	1	3	5	0	0
FRA-1736	338	382	44	1	3	3	0	0
FRA-1736	338	339	1	1	3	3	0	0
FRA-1736	338	351	13	1	3	5	0	0
FRA-1736	338	359	21	1	4	5	0	0
FRA-1736	338	403	65	1	4	2	0	0
FRA-1736	338	339	1	1	3	1	0	0
FRA-1736	338	350	12	1	3	3	0	0
FRA-1737	339	340	1	1	2	1	0	0
FRA-1737	339	340	1	1	3	3	0	0
FRA-1737	340	369	29	1	3	3	0	0
FRA-1737	340	341	1	1	3	1	0	0
FRA-1737	340	376	36	1	3	3	0	0
FRA-1737	340	347	7	1	3	5	0	0
FRA-1737	340	343	3	1	3	3	0	0
FRA-1737	342	344	2	1	3	3	0	0
FRA-1737	342	354	12	1	3	1	0	1
FRA-1737	342	343	1	1	4	5	0	0
FRA-1738	342	343	1	1	4	5	0	0
FRA-1738	342	343	1	1	4	5	0	0
FRA-1738	342	345	3	1	4	5	0	0
FRA-1738	343	386	43	1	3	3	0	0
FRA-1738	343	375	32	1	3	1	0	2
FRA-1738	343	344	1	1	3	3	0	2
FRA-1738	343	344	1	1	3	3	0	0
FRA-1738	343	383	40	1	3	1	0	0
FRA-1738	343	344	1	1	3	3	0	0
FRA-1738	343	345	2	1	3	3	0	1
FRA-1739	343	364	21	1	4	1	0	0
FRA-1739	344	345	1	1	5	3	1	1
FRA-1739	344	345	1	1	4	5	0	0
FRA-1739	344	345	1	1	4	5	0	0
FRA-1739	344	345	1	1	3	5	0	0
FRA-1739	344	345	1	1	3	5	0	0
FRA-1739	344	345	1	1	3	5	0	0
FRA-1739	344	359	15	1	3	3	0	0
FRA-1739	344	345	1	1	3	5	0	0
FRA-1739	344	345	1	1	3	3	0	0
FRA-1740	344	345	1	1	3	3	0	0
FRA-1740	344	345	1	1	3	1	0	0
FRA-1740	344	347	3	1	4	3	0	0
FRA-1740	345	363	18	1	3	1	0	2
FRA-1740	345	346	1	1	3	3	0	0
FRA-1740	345	346	1	1	3	2	0	0
FRA-1740	345	382	37	1	3	1	0	0
FRA-1740	345	346	1	1	3	5	0	0
FRA-1740	345	346	1	1	3	5	0	0
FRA-1740	345	380	35	1	3	1	0	0
FRA-1741	343	443	100	1	3	3	0	0
FRA-1741	343	443	100	1	3	3	0	0
FRA-1741	345	347	2	1	3	5	0	0
FRA-1741	345	347	2	1	3	3	0	0
FRA-1741	345	346	1	1	3	4	0	2
FRA-1741	346	349	3	1	3	3	0	0
FRA-1741	346	348	2	1	3	3	0	0
FRA-1741	346	367	21	1	4	5	0	0
FRA-1741	346	348	2	1	3	3	0	0
FRA-1741	346	347	1	1	3	3	0	0
FRA-1742	346	355	9	1	4	5	0	0
FRA-1742	346	349	3	1	4	5	0	0
FRA-1742	346	349	3	1	4	5	0	0
FRA-1742	346	349	3	1	4	5	0	0
FRA-1742	346	349	3	1	4	5	0	0
FRA-1742	346	349	3	1	4	5	0	0
FRA-1742	346	349	3	1	4	5	0	0
FRA-1742	346	349	3	1	4	5	0	0
FRA-1742	346	349	3	1	4	5	0	0
FRA-1742	346	349	3	1	4	5	0	0
FRA-1743	346	349	3	1	4	5	0	0
FRA-1743	346	349	3	1	4	5	0	0
FRA-1743	346	349	3	1	4	5	0	0
FRA-1743	346	349	3	1	4	5	0	0
FRA-1743	346	349	3	1	4	5	0	0
FRA-1743	346	349	3	1	4	5	0	0
FRA-1743	346	349	3	1	4	5	0	0
FRA-1743	346	349	3	1	4	5	0	0
FRA-1743	346	347	1	1	3	5	0	0
FRA-1743	347	348	1	1	3	3	0	0
FRA-1744	347	348	1	1	3	3	0	0
FRA-1744	347	348	1	1	3	4	0	0
FRA-1744	347	348	1	1	3	3	0	0
FRA-1744	347	363	16	1	3	3	0	0
FRA-1744	347	361	14	1	3	2	0	0
FRA-1744	347	350	3	1	3	4	0	0
FRA-1744	347	348	1	1	3	5	0	0
FRA-1744	348	349	1	1	3	4	0	0
FRA-1744	348	368	20	1	3	3	0	1
FRA-1744	348	361	13	1	3	5	0	1
FRA-1745	348	349	1	1	3	3	0	0
FRA-1745	348	349	1	1	3	4	0	0
FRA-1745	348	349	1	1	3	3	0	0
FRA-1745	348	349	1	1	3	3	0	1
FRA-1745	349	403	54	1	3	1	0	0
FRA-1745	349	350	1	1	4	5	0	0
FRA-1745	349	354	5	1	3	5	0	0
FRA-1745	349	355	6	1	3	5	0	0
FRA-1745	350	354	4	1	3	5	0	0
FRA-1745	350	379	29	1	4	4	0	0
FRA-1746	350	364	14	1	4	4	0	0
FRA-1746	350	351	1	1	3	3	0	0
FRA-1746	350	354	4	1	3	3	0	0
FRA-1746	350	355	5	1	3	4	0	1
FRA-1746	350	351	1	1	3	1	0	0
FRA-1746	350	368	18	1	4	5	0	0
FRA-1746	351	352	1	1	4	3	0	0
FRA-1746	351	352	1	1	3	3	0	0
FRA-1746	351	352	1	1	3	3	0	0
FRA-1746	352	363	11	1	3	1	0	2
FRA-1747	352	425	73	1	3	1	0	0
FRA-1747	352	363	11	1	3	4	0	0
FRA-1747	352	353	1	1	4	3	0	0
FRA-1747	352	353	1	1	3	3	0	0
FRA-1747	352	353	1	1	3	3	0	1
FRA-1747	352	354	2	1	4	3	0	0
FRA-1747	352	377	25	1	3	3	0	0
FRA-1747	353	354	1	1	3	5	0	0
FRA-1747	353	355	2	1	3	1	0	0
FRA-1747	353	354	1	1	3	3	0	0
FRA-1748	353	354	1	1	3	3	0	0
FRA-1748	353	354	1	1	3	3	0	1
FRA-1748	353	354	1	1	3	3	0	0
FRA-1748	354	355	1	1	3	3	0	0
FRA-1748	354	383	29	1	3	3	0	0
FRA-1748	354	378	24	1	3	1	0	1
FRA-1748	354	355	1	1	1	1	0	0
FRA-1748	354	355	1	1	4	3	0	0
FRA-1748	354	355	1	1	4	3	0	0
FRA-1748	354	355	1	1	3	4	0	0
FRA-1749	354	371	17	1	3	3	0	0
FRA-1749	355	368	13	1	3	3	0	0
FRA-1749	356	357	1	1	3	3	0	1
FRA-1749	356	357	1	1	3	1	0	0
FRA-1749	357	361	4	1	3	3	0	0
FRA-1749	357	358	1	1	3	3	0	0
FRA-1749	357	363	6	1	3	3	0	1
FRA-1749	358	359	1	1	3	5	0	0
FRA-1749	358	359	1	1	3	5	0	0
FRA-1749	359	394	35	1	3	5	0	0
FRA-1750	359	363	4	1	3	3	0	2
FRA-1750	359	361	2	1	5	4	0	0
FRA-1750	359	360	1	1	4	3	0	0
FRA-1750	359	360	1	1	3	3	0	0
FRA-1750	359	360	1	1	3	5	0	0
FRA-1750	360	361	1	1	3	1	0	0
FRA-1750	360	361	1	1	3	1	0	0
FRA-1750	360	361	1	1	3	3	0	0
FRA-1750	360	361	1	1	3	5	0	0
FRA-1750	360	361	1	1	3	3	0	0
FRA-1751	361	363	2	1	3	1	0	0
FRA-1751	361	363	2	1	3	3	0	0
FRA-1751	361	362	1	1	3	3	0	0
FRA-1751	361	363	2	1	3	3	0	0
FRA-1751	361	379	18	1	3	3	0	1
FRA-1751	361	362	1	1	2	1	1	1
FRA-1751	362	363	1	1	4	3	0	1
FRA-1751	363	477	114	0	3	2	0	0
FRA-1813	168	452	284	1	3	1	0	0
FRATEST1-	169	477	308	0	3	1	0	0
FRATEST1-	169	477	308	0	3	1	0	0
FRATEST1-	170	172	2	1	5	1	0	0
FRATEST1-	249	477	228	0	5	5	0	0
FRATEST1-	249	477	228	0	5	5	0	0
FRATEST1-	257	477	220	0	3	1	0	0
FRATEST1-	289	290	1	1	3	1	0	0
FRATEST3-	166	477	311	0	3	1	0	0
-56	0	477	477	0	4	2	0	2
-56	29	477	448	0	4	1	0	0
-56	37	477	440	0	4	1	1	1
-56	50	477	427	0	4	1	0	0
-57	66	67	1	1	3	1	1	0
-57	66	67	1	1	3	4	1	0
-57	66	68	2	1	4	4	1	0
-57	66	477	411	0	3	1	0	0
-57	72	477	405	0	3	2	0	0
-57	76	477	401	0	4	1	0	0
-57	77	477	400	0	3	4	0	0
-57	140	141	1	1	3	2	1	1
-57	151	477	326	0	3	1	1	0
-57	158	477	319	0	3	1	0	0
-58	158	159	1	1	3	4	1	0
-58	178	477	299	0	3	1	0	0
-58	207	208	1	1	4	1	1	0
-58	210	211	1	1	3	2	0	1
-58	270	477	207	0	4	4	1	0
-58	275	477	202	0	4	1	0	0
-58	276	477	201	0	3	1	0	0
-58	281	477	196	0	3	4	0	0
-58	283	477	194	0	4	4	0	0
-58	288	289	1	1	3	1	0	0
-59	293	477	184	0	3	1	0	0
-59	295	477	182	0	3	1	0	0
-59	332	477	145	0	4	3	1	0
-59	338	339	1	1	3	1	1	0
-59	341	342	1	1	3	1	1	0
-59	354	477	123	0	3	2	0	0
-59	359	477	118	0	3	2	0	0
IS-180	3	477	474	0	3	1	1	0
IS-180	4	477	473	0	3	4	1	0
IS-180	4	10	6	1	3	4	1	0
IS-180	4	7	3	1	3	2	1	0
IS-181	7	223	216	1	3	3	1	0
IS-181	7	386	379	1	3	3	1	0
IS-181	10	11	1	1	3	1	1	0
IS-181	10	52	42	1	4	3	1	0
IS-181	10	11	1	1	3	4	1	0
IS-181	10	477	467	0	4	4	1	0
IS-181	11	14	3	1	3	5	1	0
IS-181	11	12	1	1	3	4	1	0
IS-181	11	12	1	1	3	4	1	0
IS-181	11	46	35	1	3	5	1	0
IS-182	13	39	26	1	3	1	1	0
IS-182	14	15	1	1	3	1	1	0
IS-182	14	29	15	1	4	1	1	0
IS-182	15	60	45	1	4	4	1	1
IS-182	16	17	1	1	3	5	1	0
IS-182	16	17	1	1	4	1	1	0
IS-182	16	29	13	1	3	4	1	0
IS-182	16	60	44	1	3	4	1	0
IS-182	16	17	1	1	4	3	1	2
IS-182	16	43	27	1	3	1	1	0
IS-183	16	20	4	1	4	4	1	2
IS-183	17	23	6	1	3	1	1	0
IS-183	17	31	14	1	4	1	1	0
IS-183	17	30	13	1	4	1	1	0
IS-183	18	31	13	1	3	4	1	0
IS-183	18	19	1	1	5	4	1	0
IS-183	18	19	1	1	5	4	1	0
IS-183	18	23	5	1	4	4	1	0
IS-183	18	281	263	1	5	4	1	1
IS-183	18	281	263	1	3	4	1	1
IS-184	21	477	456	0	4	4	1	0
IS-184	21	322	301	1	3	3	1	0
IS-184	21	22	1	1	3	4	1	0
IS-184	21	49	28	1	3	4	1	0
IS-184	21	22	1	1	3	4	1	0
IS-184	21	322	301	1	3	5	1	0
IS-184	21	44	23	1	3	4	1	0
IS-184	22	53	31	1	3	1	1	0
IS-184	23	24	1	1	3	1	1	0
IS-184	23	30	7	1	4	5	1	1
IS-185	24	31	7	1	3	4	1	0
IS-185	24	25	1	1	4	1	1	0
IS-185	24	28	4	1	3	1	1	0
IS-185	24	25	1	1	4	1	1	0
IS-185	28	31	3	1	3	1	1	0
IS-185	29	30	1	1	3	1	1	0
IS-185	29	30	1	1	3	2	1	0
IS-185	30	31	1	1	3	1	1	0
IS-185	31	32	1	1	3	1	1	0
IS-185	37	43	6	1	5	5	1	0
IS-186	38	44	6	1	3	5	1	0
IS-186	38	39	1	1	3	2	1	0
IS-186	39	477	438	0	3	4	1	0
IS-186	39	477	438	0	3	4	1	0
IS-186	47	477	430	0	3	4	1	0
IS-186	49	50	1	1	3	1	1	0
IS-186	49	52	3	1	3	1	1	0
IS-186	51	53	2	1	3	4	1	0
IS-186	52	53	1	1	3	1	1	0
IS-186	52	53	1	1	3	1	1	0
IS-187	52	53	1	1	3	1	1	0
IS-187	53	54	1	1	3	3	1	0
IS-187	53	54	1	1	3	4	1	0
IS-187	53	477	424	0	3	4	1	0
IS-187	53	54	1	1	1	1	1	0
IS-187	53	63	10	1	3	3	1	0
IS-187	53	54	1	1	3	4	1	0
IS-187	53	54	1	1	3	4	1	0
IS-187	54	477	423	0	3	5	1	0
IS-187	54	55	1	1	3	4	1	0
IS-188	54	55	1	1	3	1	1	0
IS-188	55	56	1	1	3	4	1	0
IS-188	58	59	1	1	4	2	1	0
IS-188	58	477	419	0	4	4	1	0
IS-188	58	59	1	1	3	4	1	0
IS-188	58	67	9	1	3	5	1	0
IS-188	59	60	1	1	3	5	1	0
IS-188	59	73	14	1	1	1	1	0
IS-188	60	361	301	1	4	4	1	0
IS-188	60	61	1	1	3	5	1	0
IS-189	60	67	7	1	3	5	1	0
IS-189	60	67	7	1	3	4	1	0
IS-189	60	276	216	1	4	5	1	0
IS-189	60	67	7	1	3	5	1	0
IS-189	61	322	261	1	4	5	1	0
IS-189	61	262	201	1	3	4	1	0
IS-189	62	63	1	1	4	4	1	0
IS-189	63	64	1	1	3	4	1	0
IS-189	63	477	414	0	3	4	1	0
IS-189	63	370	307	1	3	3	1	0
IS-190	63	73	10	1	3	3	1	0
IS-190	64	239	175	1	4	4	1	0
IS-190	65	73	8	1	1	1	1	0
IS-190	66	223	157	1	3	3	1	0
IS-190	67	223	156	1	3	4	1	0
IS-190	67	296	229	1	3	4	1	0
IS-190	67	73	6	1	1	4	1	1
IS-190	67	72	5	1	3	5	1	0
IS-190	67	223	156	1	3	5	1	0
IS-190	67	223	156	1	3	5	1	0
IS-191	68	72	4	1	2	4	1	0
IS-191	68	69	1	1	4	4	1	0
IS-191	69	73	4	1	4	4	1	0
IS-191	71	72	1	1	3	4	1	0
IS-191	71	477	406	0	3	5	1	0
IS-191	72	223	151	1	3	5	1	0
IS-191	73	361	288	1	4	4	1	0
IS-191	73	262	189	1	4	4	1	1
IS-191	74	238	164	1	4	4	1	0
IS-191	74	477	403	0	4	3	1	3
IS-192	74	262	188	1	4	4	1	0
IS-192	74	477	403	0	4	5	1	0
IS-192	74	477	403	0	4	5	1	0
IS-192	74	262	188	1	4	4	1	0
IS-192	74	477	403	0	4	5	1	0
IS-192	74	77	3	1	2	1	1	0
IS-192	74	477	403	0	4	4	1	0
IS-192	74	477	403	0	4	1	1	0
IS-192	77	223	146	1	5	4	1	0
IS-192	77	136	59	1	4	1	1	0
IS-193	83	84	1	1	4	4	1	0
IS-193	83	84	1	1	4	4	1	1
IS-193	83	101	18	1	4	4	1	2
IS-193	88	477	389	0	4	1	1	0
IS-193	94	248	154	1	4	4	1	0
IS-193	101	102	1	1	4	4	1	0
IS-193	113	477	364	0	3	1	1	0
IS-193	115	477	362	0	3	1	1	0
IS-193	116	477	361	0	4	1	1	0
IS-193	116	117	1	1	3	1	1	0
IS-194	116	117	1	1	3	1	1	1
IS-194	116	117	1	1	5	1	1	0
IS-194	116	117	1	1	4	4	1	0
IS-194	123	124	1	1	3	4	1	0
IS-194	123	127	4	1	3	4	1	0
IS-194	123	477	354	0	3	4	1	0
IS-194	132	223	91	1	3	1	1	0
IS-194	134	136	2	1	3	1	1	0
IS-194	137	149	12	1	3	4	1	3
IS-194	138	139	1	1	3	4	1	1
IS-195	138	149	11	1	3	4	1	1
IS-195	138	139	1	1	3	5	1	0
IS-195	141	477	336	0	3	4	1	0
IS-195	144	477	333	0	5	4	1	1
IS-195	145	146	1	1	4	4	1	0
IS-195	147	148	1	1	4	4	1	0
IS-195	149	150	1	1	3	4	1	0
IS-195	149	150	1	1	3	1	1	0
IS-195	150	151	1	1	3	4	1	0
IS-195	152	153	1	1	4	4	1	1
IS-196	153	477	324	0	3	4	1	1
IS-196	154	155	1	1	4	4	1	0
IS-196	158	322	164	1	3	4	1	2
IS-196	161	165	4	1	1	1	1	2
IS-196	170	361	191	1	3	1	1	0
IS-196	185	189	4	1	3	1	1	0
IS-196	189	361	172	1	3	4	1	0
IS-196	190	198	8	1	4	5	0	0
IS-196	199	477	278	0	3	1	1	0
IS-196	202	223	21	1	3	2	1	0
IS-197	202	477	275	0	3	1	1	0
IS-197	202	477	275	0	3	1	1	0
IS-197	202	281	79	1	3	4	1	0
IS-197	206	477	271	0	3	1	1	0
IS-197	233	278	45	1	3	4	1	1
IS-197	240	283	43	1	4	4	1	0
IS-197	242	359	117	1	3	4	1	2
IS-197	242	271	29	1	4	4	1	0
IS-197	247	368	121	1	3	1	1	0
IS-197	247	276	29	1	3	1	1	0
IS-198	247	477	230	0	3	1	1	0
IS-198	247	248	1	1	3	1	1	0
IS-198	249	250	1	1	4	4	1	0
IS-198	249	322	73	1	3	4	1	0
IS-198	250	477	227	0	4	4	1	0
IS-198	255	256	1	1	3	1	1	0
IS-198	256	257	1	1	3	2	1	0
IS-198	260	261	1	1	3	4	1	0
IS-198	260	261	1	1	4	4	1	2
IS-198	262	477	215	0	3	5	1	1
IS-199	262	477	215	0	3	5	1	0
IS-199	266	321	55	1	3	1	1	2
IS-199	270	361	91	1	3	2	1	1
IS-199	270	477	207	0	3	2	1	0
IS-199	270	477	207	0	3	2	1	0
IS-199	270	477	207	0	3	2	1	0
IS-199	271	361	90	1	3	2	1	1
IS-199	271	361	90	1	3	2	1	0
IS-199	271	477	206	0	3	2	1	0
IS-199	271	477	206	0	3	2	1	0
IS-200	271	477	206	0	3	2	1	0
IS-200	271	477	206	0	3	2	1	0
IS-200	271	477	206	0	3	2	1	0
IS-200	275	284	9	1	3	2	1	0
IS-200	280	477	197	0	5	1	1	0
IS-200	280	281	1	1	3	1	1	0
IS-200	287	477	190	0	3	4	1	0
IS-200	289	291	2	1	3	4	1	0
IS-200	289	290	1	1	5	4	1	0
IS-200	289	298	9	1	5	4	1	0
IS-201	291	477	186	0	3	4	1	0
IS-201	291	477	186	0	3	4	1	0
IS-201	291	477	186	0	3	4	1	0
IS-201	291	368	77	1	3	4	1	0
IS-201	291	292	1	1	3	4	1	0
IS-201	294	477	183	0	5	1	1	0
IS-201	294	477	183	0	3	4	1	0
IS-201	295	297	2	1	4	4	1	0
IS-201	295	368	73	1	4	4	1	0
IS-201	295	297	2	1	3	4	1	0
IS-202	295	477	182	0	4	2	1	0
IS-202	298	299	1	1	3	4	1	0
IS-202	298	299	1	1	3	4	1	0
IS-202	298	299	1	1	4	4	1	0
IS-202	298	345	47	1	4	4	1	0
IS-202	299	361	62	1	4	4	1	0
IS-202	300	301	1	1	3	1	1	1
IS-202	301	304	3	1	3	2	1	0
IS-202	303	309	6	1	3	1	1	0
IS-202	306	477	171	0	3	1	1	0
IS-203	310	311	1	1	3	4	1	0
IS-203	311	477	166	0	4	4	1	0
IS-203	312	313	1	1	4	4	1	0
IS-203	317	477	160	0	3	3	1	2
IS-203	319	323	4	1	4	1	1	0
IS-203	320	321	1	1	3	1	1	0
IS-203	320	321	1	1	3	1	1	1
IS-203	321	322	1	1	3	1	1	0
IS-203	322	370	48	1	4	1	1	0
IS-203	322	477	155	0	3	4	1	1
IS-204	322	477	155	0	4	2	1	0
IS-204	323	477	154	0	3	4	1	0
IS-204	323	324	1	1	3	4	1	0
IS-204	324	361	37	1	3	2	1	0
IS-204	326	477	151	0	4	2	1	0
IS-204	329	330	1	1	3	1	1	0
IS-204	329	330	1	1	3	1	1	0
IS-204	338	339	1	1	4	4	1	0
IS-204	345	346	1	1	3	4	1	0
IS-204	345	346	1	1	3	4	1	0
IS-205	345	354	9	1	4	4	1	0
IS-205	351	361	10	1	5	5	1	0
IS-205	352	353	1	1	5	4	0	0
IS-205	353	354	1	1	3	4	1	0
IS-205	354	477	123	0	4	4	1	0
IS-205	357	477	120	0	4	4	0	1
IS-205	357	477	120	0	3	4	1	1
IS-205	361	362	1	1	3	4	1	0
IS-205	361	477	116	0	4	4	1	0
IS-205	363	477	114	0	4	4	1	0
IS-206	363	477	114	0	3	4	1	0
Y-157	3	477	474	0	3	1	0	0
Y-157	4	477	473	0	3	1	0	0
Y-157	4	477	473	0	3	4	0	0
Y-157	29	62	33	1	3	1	1	1
Y-157	31	477	446	0	3	3	0	0
Y-157	37	38	1	1	4	1	1	0
Y-157	47	60	13	1	3	1	1	1
Y-157	54	56	2	1	3	1	1	0
Y-157	76	78	2	1	3	2	0	1
Y-157	136	165	29	1	5	1	0	0
Y-158	142	477	335	0	3	1	0	2
Y-158	171	477	306	0	3	1	0	1
Y-158	175	477	302	0	4	1	0	0
Y-158	189	477	288	0	3	1	0	0
Y-158	189	477	288	0	3	1	0	0
Y-158	191	477	286	0	2	1	0	0
Y-158	219	477	258	0	1	1	0	1
Y-158	219	477	258	0	3	1	0	0
Y-158	224	225	1	1	3	1	1	1
Y-158	226	227	1	1	3	1	1	0
Y-159	240	477	237	0	3	1	0	0
Y-159	244	477	233	0	3	5	0	0
Y-159	266	477	211	0	3	1	0	0
Y-159	280	477	197	0	3	1	0	1
Y-159	281	339	58	1	3	1	1	0
Y-159	284	477	193	0	2	4	0	0
Y-159	331	477	146	0	4	4	0	0
Y-159	335	336	1	1	3	1	0	0
Y-159	355	477	122	0	3	1	0	0
YDE-38	146	477	331	0	3	1	0	1
YDE-38	168	169	1	1	1	1	1	0
MES-227	1	28	27	1	3	4	0	0
MES-227	3	477	474	0	3	1	0	0
MES-227	4	477	473	0	3	2	0	0
MES-228	4	28	24	1	3	2	0	0
MES-228	7	28	21	1	3	4	1	0
MES-228	8	25	17	1	4	1	0	0
MES-228	9	28	19	1	3	1	2	0
MES-228	9	21	12	1	3	4	1	0
MES-228	9	18	9	1	3	4	1	0
MES-228	9	28	19	1	3	4	1	0
MES-228	9	28	19	1	3	4	1	0
MES-228	9	28	19	1	3	4	1	0
MES-228	9	18	9	1	3	2	1	0
MES-229	9	18	9	1	3	2	0	0
MES-229	9	28	19	1	3	2	1	0
MES-229	9	28	19	1	3	2	1	0
MES-229	9	24	15	1	3	2	1	0
MES-229	9	25	16	1	3	2	1	0
MES-229	10	477	467	0	3	1	0	0
MES-229	10	191	181	1	3	1	0	0
MES-229	10	14	4	1	3	1	0	0
MES-229	10	477	467	0	3	1	0	0
MES-229	10	477	467	0	3	1	0	0
MES-230	10	191	181	1	3	1	0	0
MES-230	10	191	181	1	3	1	1	0
MES-230	10	477	467	0	3	1	0	0
MES-230	14	210	196	1	3	1	1	0
MES-230	14	205	191	1	3	1	1	0
MES-230	14	21	7	1	3	4	0	0
MES-230	14	29	15	1	3	4	1	0
MES-230	15	477	462	0	3	3	0	0
MES-230	15	477	462	0	3	1	0	0
MES-230	15	191	176	1	3	1	0	0
MES-231	16	18	2	1	3	4	0	0
MES-231	17	18	1	1	3	3	0	0
MES-231	18	477	459	0	3	3	0	0
MES-231	22	28	6	1	3	3	0	0
MES-231	24	147	123	1	3	4	0	0
MES-231	24	32	8	1	3	1	1	0
MES-231	24	31	7	1	3	1	0	0
MES-231	24	25	1	1	3	1	0	0
MES-231	25	296	271	1	3	4	1	0
MES-231	25	144	119	1	3	4	0	0
MES-232	25	140	115	1	3	4	0	0
MES-232	27	168	141	1	3	4	0	0
MES-232	28	29	1	1	3	4	0	0
MES-232	28	477	449	0	3	4	0	0
MES-232	30	31	1	1	3	4	0	0
MES-232	31	296	265	1	3	4	1	0
MES-232	31	295	264	1	3	2	0	0
MES-232	31	32	1	1	3	2	0	0
MES-232	31	32	1	1	3	1	0	0
MES-232	32	39	7	1	3	3	0	0
MES-233	33	477	444	0	3	1	0	0
MES-233	35	38	3	1	3	3	0	0
MES-233	35	477	442	0	3	4	0	0
MES-233	37	477	440	0	3	4	0	0
MES-233	37	150	113	1	3	2	0	0
MES-233	38	477	439	0	3	4	0	0
MES-233	38	39	1	1	3	4	2	0
MES-233	39	40	1	1	3	4	0	0
MES-233	45	85	40	1	5	1	0	0
MES-233	50	51	1	1	3	2	0	0
MES-234	50	57	7	1	3	2	0	0
MES-234	50	148	98	1	3	2	0	0
MES-234	50	148	98	1	3	2	0	0
MES-234	54	477	423	0	3	4	0	0
MES-234	56	175	119	1	3	1	0	0
MES-234	64	66	2	1	3	4	0	0
MES-234	66	71	5	1	3	2	1	0
MES-234	70	72	2	1	3	5	0	0
MES-234	70	199	129	1	3	1	0	0
MES-234	71	73	2	1	3	2	0	0
MES-235	72	73	1	1	3	1	1	0
MES-235	72	73	1	1	3	1	0	0
MES-235	72	85	13	1	3	4	0	0
MES-235	72	73	1	1	3	1	1	0
MES-235	74	175	101	1	3	1	0	0
MES-235	75	107	32	1	3	1	0	0
MES-235	77	175	98	1	5	1	0	0
MES-235	77	80	3	1	3	4	0	0
MES-235	77	80	3	1	3	4	0	0
MES-235	77	80	3	1	3	4	0	0
MES-236	78	81	3	1	3	1	0	0
MES-236	79	106	27	1	3	4	0	0
MES-236	79	85	6	1	3	2	0	0
MES-236	80	87	7	1	3	2	0	0
MES-236	81	477	396	0	3	1	0	0
MES-236	84	86	2	1	3	2	0	0
MES-236	85	95	10	1	3	2	0	0
MES-236	85	87	2	1	3	2	0	0
MES-236	91	123	32	1	3	2	1	0
MES-236	91	93	2	1	3	2	0	0
MES-237	98	107	9	1	3	4	0	0
MES-237	98	477	379	0	3	2	0	0
MES-237	105	477	372	0	3	1	0	0
MES-237	105	477	372	0	3	4	0	0
MES-237	105	116	11	1	3	1	0	0
MES-237	105	477	372	0	3	1	0	0
MES-237	106	185	79	1	3	1	0	0
MES-237	106	155	49	1	3	1	0	0
MES-237	108	123	15	1	3	4	0	0
MES-237	108	109	1	1	3	2	0	0
MES-238	108	477	369	0	3	4	0	0
MES-238	109	148	39	1	3	4	0	0
MES-238	110	116	6	1	3	4	0	0
MES-238	112	122	10	1	5	4	0	0
MES-238	112	123	11	1	4	1	1	0
MES-238	113	116	3	1	3	4	0	0
MES-238	120	127	7	1	4	4	1	0
MES-238	122	123	1	1	3	2	0	0
MES-238	123	124	1	1	3	2	0	0
MES-238	124	477	353	0	3	1	0	0
MES-239	125	127	2	1	3	2	0	0
MES-239	127	477	350	0	3	5	0	0
MES-239	128	129	1	1	3	2	0	0
MES-239	128	138	10	1	3	2	0	0
MES-239	129	477	348	0	3	2	0	0
MES-239	129	477	348	0	3	2	0	0
MES-239	130	148	18	1	3	2	0	0
MES-239	133	477	344	0	3	2	0	0
MES-239	135	140	5	1	3	2	0	0
MES-239	135	141	6	1	3	4	0	0
MES-240	136	142	6	1	3	2	0	0
MES-240	137	138	1	1	3	2	0	0
MES-240	140	148	8	1	3	1	0	0
MES-240	141	147	6	1	3	2	0	0
MES-240	144	175	31	1	3	2	0	0
MES-240	148	175	27	1	3	4	0	0
MES-240	150	156	6	1	3	4	0	0
MES-240	154	191	37	1	3	2	0	0
MES-240	155	156	1	1	3	4	0	0
MES-240	155	156	1	1	3	4	0	0
MES-241	155	477	322	0	3	1	0	0
MES-241	155	162	7	1	3	2	0	0
MES-241	155	157	2	1	3	2	0	0
MES-241	156	163	7	1	4	2	0	0
MES-241	156	162	6	1	3	4	0	0
MES-241	156	163	7	1	3	4	0	0
MES-241	157	175	18	1	3	2	0	0
MES-241	157	477	320	0	3	2	0	0
MES-241	158	164	6	1	3	4	0	0
MES-241	158	477	319	0	3	1	0	0
MES-242	161	164	3	1	3	4	0	0
MES-242	162	175	13	1	4	2	0	0
MES-242	162	171	9	1	3	2	0	0
MES-242	162	164	2	1	4	1	0	0
MES-242	163	164	1	1	3	1	0	0
MES-242	163	178	15	1	4	1	0	0
MES-242	163	169	6	1	3	2	0	0
MES-242	164	477	313	0	3	4	0	0
MES-242	164	170	6	1	3	2	0	0
MES-242	164	169	5	1	3	3	0	0
MES-243	165	170	5	1	3	4	0	0
MES-243	169	170	1	1	5	1	0	0
MES-243	170	193	23	1	4	2	0	0
MES-243	170	477	307	0	3	2	0	0
MES-243	170	477	307	0	3	2	0	0
MES-243	170	477	307	0	3	3	0	0
MES-243	170	177	7	1	3	2	0	0
MES-243	171	176	5	1	4	1	0	0
MES-243	172	477	305	0	3	1	0	0
MES-243	175	176	1	1	3	3	0	0
MES-244	176	177	1	1	3	2	0	0
MES-244	177	183	6	1	3	5	0	0
MES-244	177	477	300	0	3	2	0	0
MES-244	177	184	7	1	3	2	0	0
MES-244	178	184	6	1	2	1	0	0
MES-244	182	183	1	1	3	5	0	0
MES-244	182	183	1	1	3	2	0	0
MES-244	183	185	2	1	3	4	0	0
MES-244	183	185	2	1	3	4	0	0
MES-244	183	184	1	1	3	4	0	0
MES-245	183	184	1	1	3	4	1	0
MES-245	183	185	2	1	4	1	0	0
MES-245	184	477	293	0	3	3	0	0
MES-245	184	477	293	0	3	3	0	0
MES-245	184	477	293	0	3	3	0	0
MES-245	185	186	1	1	3	1	0	0
MES-245	185	191	6	1	3	2	0	0
MES-245	186	234	48	1	5	5	1	0
MES-245	188	192	4	1	3	5	0	0
MES-245	189	190	1	1	3	2	0	0
MES-246	190	191	1	1	3	2	0	0
MES-246	190	477	287	0	5	3	0	0
MES-246	191	192	1	1	3	1	0	0
MES-246	191	192	1	1	3	4	0	0
MES-246	191	295	104	1	4	4	0	0
MES-246	192	368	176	1	3	1	1	0
MES-246	192	477	285	0	3	4	0	0
MES-246	192	193	1	1	3	2	0	0
MES-246	193	214	21	1	3	2	1	0
MES-246	196	205	9	1	3	4	1	0
MES-247	196	214	18	1	3	4	1	0
MES-247	197	477	280	0	3	4	0	0
MES-247	198	204	6	1	3	4	1	0
MES-247	198	204	6	1	3	4	1	0
MES-247	198	204	6	1	3	4	1	0
MES-247	198	204	6	1	3	4	1	0
MES-247	198	204	6	1	4	4	1	0
MES-247	198	477	279	0	3	4	0	0
MES-247	198	204	6	1	5	4	1	0
MES-247	198	207	9	1	3	3	1	0
MES-248	199	204	5	1	5	4	1	0
MES-248	199	477	278	0	5	4	1	0
MES-248	199	204	5	1	5	4	1	0
MES-248	199	477	278	0	3	1	0	0
MES-248	199	205	6	1	5	4	1	0
MES-248	199	204	5	1	5	4	1	0
MES-248	199	211	12	1	4	4	1	0
MES-248	199	205	6	1	3	4	1	0
MES-248	202	205	3	1	5	4	1	0
MES-248	203	205	2	1	3	4	1	0
MES-249	203	204	1	1	3	4	1	0
MES-249	203	204	1	1	3	4	1	0
MES-249	203	477	274	0	3	2	0	0
MES-249	203	211	8	1	3	3	1	0
MES-249	203	205	2	1	5	4	1	0
MES-249	203	215	12	1	4	4	1	0
MES-249	203	205	2	1	3	1	1	0
MES-249	204	206	2	1	4	4	1	0
MES-249	204	210	6	1	3	4	1	0
MES-249	205	206	1	1	4	4	1	0
MES-250	205	206	1	1	4	4	1	0
MES-250	206	211	5	1	3	4	1	0
MES-250	206	212	6	1	3	3	1	0
MES-250	207	210	3	1	5	4	1	0
MES-250	207	212	5	1	3	3	1	0
MES-250	207	210	3	1	3	3	1	0
MES-250	210	214	4	1	4	4	1	0
MES-250	210	295	85	1	3	3	1	0
MES-250	211	212	1	1	3	4	1	0
MES-250	211	212	1	1	3	4	1	0
MES-251	211	477	266	0	3	3	0	0
MES-251	212	213	1	1	3	4	1	0
MES-251	212	477	265	0	3	1	0	0
MES-251	213	214	1	1	3	1	1	0
MES-251	213	215	2	1	3	1	1	0
MES-251	213	217	4	1	3	1	0	0
MES-251	214	301	87	1	3	2	0	0
MES-251	214	215	1	1	3	2	1	0
MES-251	214	477	263	0	3	2	0	0
MES-251	214	477	263	0	3	1	0	0
MES-252	214	477	263	0	3	3	0	0
MES-252	226	240	14	1	3	2	1	0
MES-252	227	232	5	1	3	4	1	0
MES-252	228	232	4	1	4	1	1	0
MES-252	228	232	4	1	4	1	1	0
MES-252	233	303	70	1	3	2	1	0
MES-252	233	240	7	1	3	2	1	0
MES-252	234	235	1	1	3	4	1	0
MES-252	234	235	1	1	3	4	1	0
MES-252	234	241	7	1	3	4	1	0
MES-253	234	239	5	1	3	4	1	0
MES-253	234	238	4	1	3	1	1	0
MES-253	235	477	242	0	4	3	0	0
MES-253	235	239	4	1	3	1	1	0
MES-253	238	477	239	0	3	1	0	0
MES-253	239	477	238	0	4	3	0	0
MES-253	245	247	2	1	5	4	1	0
MES-253	246	248	2	1	3	2	1	0
MES-253	246	247	1	1	3	2	1	0
MES-253	246	477	231	0	3	3	0	0
MES-254	247	249	2	1	3	4	1	0
MES-254	247	477	230	0	3	3	1	0
MES-254	247	477	230	0	2	1	0	0
MES-254	248	477	229	0	3	3	0	0
MES-254	249	368	119	1	3	4	1	0
MES-254	252	256	4	1	3	4	1	0
MES-254	254	256	2	1	3	1	1	0
MES-254	255	259	4	1	3	4	1	0
MES-254	255	256	1	1	3	1	1	0
MES-254	259	260	1	1	3	2	1	0
MES-255	260	270	10	1	3	2	1	0
MES-255	262	303	41	1	3	4	1	0
MES-255	268	477	209	0	3	2	0	0
MES-255	276	477	201	0	3	4	0	0
MES-255	280	477	197	0	3	2	0	0
MES-255	281	295	14	1	3	1	1	0
MES-255	281	282	1	1	4	1	1	0
MES-255	281	282	1	1	3	1	1	0
MES-255	282	317	35	1	4	4	1	0
MES-255	282	284	2	1	3	2	1	0
MES-256	283	284	1	1	4	4	1	0
MES-256	283	287	4	1	3	2	1	0
MES-256	284	287	3	1	3	2	1	0
MES-256	288	477	189	0	3	2	0	0
MES-256	288	477	189	0	3	2	0	0
MES-256	288	477	189	0	3	2	0	0
MES-256	289	295	6	1	3	4	0	0
MES-256	291	292	1	1	3	4	1	0
MES-256	292	477	185	0	4	1	0	0
MES-256	292	477	185	0	4	4	0	0
MES-257	295	296	1	1	3	4	0	0
MES-257	295	477	182	0	3	2	0	0
MES-257	295	296	1	1	3	2	1	0
MES-257	296	477	181	0	3	2	0	0
MES-257	297	304	7	1	3	2	1	0
MES-257	297	303	6	1	3	2	0	0
MES-257	297	305	8	1	3	2	1	0
MES-257	298	477	179	0	5	4	0	0
MES-257	298	477	179	0	3	4	0	0
MES-257	303	317	14	1	3	3	1	0
MES-258	303	310	7	1	3	4	1	0
MES-258	304	312	8	1	3	4	0	0
MES-258	307	308	1	1	3	4	1	0
MES-258	307	310	3	1	3	4	1	0
MES-258	308	312	4	1	3	2	0	0
MES-258	309	317	8	1	3	4	0	0
MES-258	309	477	168	0	3	2	0	0
MES-258	310	315	5	1	3	4	1	0
MES-258	311	312	1	1	3	2	1	0
MES-258	315	317	2	1	3	2	1	0
MES-259	315	318	3	1	3	2	1	0
MES-259	316	319	3	1	3	4	1	0
MES-259	316	318	2	1	3	2	1	0
MES-259	317	318	1	1	3	4	1	0
MES-259	318	319	1	1	3	4	1	0
MES-259	319	368	49	1	3	4	1	0
MES-259	319	338	19	1	3	4	1	0
MES-259	323	477	154	0	3	2	0	0
MES-259	323	331	8	1	3	2	1	0
MES-259	323	330	7	1	3	2	1	0
MES-260	323	477	154	0	3	2	0	0
MES-260	323	477	154	0	3	2	0	0
MES-260	323	477	154	0	3	2	0	0
MES-260	323	477	154	0	3	2	0	0
MES-260	323	477	154	0	4	1	0	0
MES-260	324	477	153	0	3	1	0	0
MES-260	326	477	151	0	3	1	0	0
MES-260	329	477	148	0	3	4	0	0
MES-260	329	477	148	0	3	1	0	0
MES-260	330	331	1	1	3	1	1	0
MES-261	330	368	38	1	3	2	1	0
MES-261	330	368	38	1	5	4	1	0
MES-261	331	336	5	1	3	2	1	0
MES-261	331	345	14	1	3	2	1	0
MES-261	332	477	145	0	3	1	0	0
MES-261	332	336	4	1	3	4	1	0
MES-261	333	340	7	1	3	4	1	0
MES-261	333	345	12	1	3	2	1	0
MES-261	337	368	31	1	4	4	1	0
MES-261	338	339	1	1	3	4	1	0
MES-262	338	368	30	1	3	2	1	0
MES-262	338	477	139	0	3	2	0	0
MES-262	339	477	138	0	3	2	0	0
MES-262	339	477	138	0	3	4	0	0
MES-262	343	353	10	1	3	1	1	0
MES-262	344	368	24	1	5	4	1	0
MES-262	344	368	24	1	5	4	1	0
MES-262	345	346	1	1	3	2	1	0
MES-262	345	477	132	0	5	4	0	0
MES-262	345	368	23	1	5	4	1	0
MES-263	345	413	68	1	5	4	1	0
MES-263	346	477	131	0	3	1	0	0
MES-263	350	477	127	0	3	2	0	0
MES-263	352	368	16	1	3	4	1	0
LOUDS-136	3	8	5	1	3	1	2	1
LOUDS-136	3	8	5	1	3	4	1	1
LOUDS-137	4	8	4	1	4	2	1	0
LOUDS-137	4	477	473	0	3	4	0	0
LOUDS-137	9	15	6	1	3	4	2	1
LOUDS-137	10	15	5	1	3	1	2	0
LOUDS-137	10	477	467	0	3	2	0	0
LOUDS-137	10	477	467	0	3	2	0	0
LOUDS-137	16	477	461	0	3	1	0	0
LOUDS-137	18	32	14	1	3	4	0	0
LOUDS-137	24	477	453	0	3	1	0	0
LOUDS-137	35	477	442	0	3	1	0	0
LOUDS-138	44	45	1	1	3	5	0	0
LOUDS-138	44	46	2	1	3	1	2	0
LOUDS-138	45	46	1	1	3	4	1	0
LOUDS-138	49	477	428	0	3	2	0	0
LOUDS-138	49	84	35	1	3	1	0	0
LOUDS-138	49	84	35	1	3	1	0	0
LOUDS-138	50	477	427	0	3	4	0	0
LOUDS-138	56	212	156	1	3	4	2	3
LOUDS-138	57	477	420	0	3	3	0	0
LOUDS-138	63	110	47	1	3	1	2	0
LOUDS-139	65	66	1	1	3	4	2	0
LOUDS-139	65	66	1	1	3	1	2	0
LOUDS-139	65	67	2	1	3	1	2	0
LOUDS-139	66	477	411	0	3	1	0	0
LOUDS-139	66	67	1	1	4	4	2	0
LOUDS-139	77	477	400	0	3	4	0	0
LOUDS-139	80	477	397	0	3	1	0	0
LOUDS-139	81	477	396	0	3	1	0	0
LOUDS-139	85	477	392	0	3	3	0	0
LOUDS-139	93	95	2	1	3	2	2	0
LOUDS-140	94	102	8	1	3	1	2	0
LOUDS-140	94	191	97	1	5	1	2	3
LOUDS-140	94	477	383	0	3	1	0	0
LOUDS-140	95	477	382	0	3	1	0	0
LOUDS-140	96	98	2	1	4	4	2	0
LOUDS-140	98	99	1	1	3	1	2	0
LOUDS-140	101	108	7	1	3	3	2	0
LOUDS-140	102	477	375	0	3	3	0	0
LOUDS-140	103	477	374	0	3	4	0	0
LOUDS-140	106	477	371	0	4	1	0	0
LOUDS-141	106	107	1	1	3	1	2	0
LOUDS-141	106	477	371	0	3	1	0	0
LOUDS-141	107	477	370	0	3	1	0	1
LOUDS-141	112	114	2	1	3	1	0	1
LOUDS-141	116	129	13	1	4	4	2	0
LOUDS-141	119	477	358	0	4	1	0	0
LOUDS-141	126	325	199	1	3	1	0	0
LOUDS-141	133	477	344	0	3	1	0	0
LOUDS-141	134	135	1	1	3	2	2	0
LOUDS-141	135	255	120	1	3	1	2	1
LOUDS-142	136	477	341	0	3	1	0	0
LOUDS-142	137	141	4	1	3	2	2	0
LOUDS-142	142	157	15	1	3	1	2	1
LOUDS-142	148	477	329	0	4	1	2	1
LOUDS-142	149	156	7	1	3	1	0	0
LOUDS-142	151	477	326	0	4	2	0	0
LOUDS-142	163	477	314	0	3	1	0	0
LOUDS-142	169	170	1	1	3	1	2	0
LOUDS-142	171	477	306	0	3	4	2	0
LOUDS-142	175	477	302	0	4	1	0	0
LOUDS-143	182	477	295	0	3	5	0	0
LOUDS-143	183	291	108	1	3	3	2	0
LOUDS-143	184	197	13	1	3	3	1	0
LOUDS-143	190	191	1	1	3	1	2	1
LOUDS-143	200	477	277	0	3	1	0	0
LOUDS-143	204	477	273	0	4	4	0	0
LOUDS-143	210	212	2	1	3	4	2	1
LOUDS-143	220	221	1	1	3	1	0	0
LOUDS-143	220	221	1	1	1	1	0	0
LOUDS-143	220	225	5	1	3	3	0	0
LOUDS-144	224	477	253	0	3	4	0	0
LOUDS-144	226	248	22	1	3	1	1	0
LOUDS-144	228	229	1	1	3	1	0	0
LOUDS-144	228	234	6	1	4	1	2	0
LOUDS-144	233	477	244	0	3	1	0	0
LOUDS-144	235	477	242	0	3	4	0	0
LOUDS-144	235	236	1	1	3	4	0	0
LOUDS-144	249	254	5	1	4	1	2	1
LOUDS-144	262	477	215	0	3	4	0	0
LOUDS-144	262	477	215	0	3	1	0	0
LOUDS-145	263	296	33	1	4	4	1	0
LOUDS-145	268	477	209	0	3	1	0	0
LOUDS-145	270	365	95	1	4	4	1	0
LOUDS-145	273	477	204	0	3	1	0	0
LOUDS-145	274	322	48	1	4	3	1	0
LOUDS-145	275	277	2	1	3	3	2	0
LOUDS-145	276	477	201	0	3	3	0	0
LOUDS-145	279	290	11	1	3	3	2	0
LOUDS-145	281	477	196	0	3	3	1	0
LOUDS-145	285	477	192	0	4	1	0	0
LOUDS-146	287	296	9	1	3	4	2	0
LOUDS-146	290	477	187	0	4	1	0	0
LOUDS-146	290	291	1	1	3	1	2	0
LOUDS-146	295	296	1	1	3	1	2	0
LOUDS-146	298	302	4	1	3	4	2	0
LOUDS-146	305	477	172	0	3	1	0	0
LOUDS-146	323	361	38	1	4	1	1	0
LOUDS-146	323	337	14	1	3	1	2	1
LOUDS-146	326	338	12	1	3	2	2	0
LOUDS-146	337	477	140	0	3	1	0	0
LOUDS-147	338	477	139	0	3	1	0	0
LOUDS-147	339	477	138	0	3	2	0	0
LOUDS-147	341	368	27	1	4	1	2	0
LOUDS-147	345	477	132	0	4	2	0	0
LOUDS-147	346	361	15	1	4	4	1	0
LOUDS-147	347	477	130	0	3	1	0	0
LOUDS-147	351	477	126	0	3	1	0	0
LOUDS-147	352	353	1	1	3	4	2	0
LOUDS-147	352	477	125	0	3	1	0	0
R-423	1	2	1	1	4	4	4	2
R-424	1	2	1	1	4	3	4	2
R-424	3	4	1	1	4	1	4	1
R-424	3	4	1	1	4	1	4	2
R-424	4	477	473	0	4	3	0	0
R-424	7	8	1	1	3	3	4	0
R-424	8	78	70	1	3	3	2	3
R-424	15	16	1	1	4	3	4	0
R-424	17	18	1	1	5	3	4	0
R-424	17	28	11	1	3	4	2	2
R-425	18	19	1	1	4	3	4	3
R-425	21	32	11	1	3	3	0	1
R-425	21	22	1	1	5	3	4	0
R-425	24	31	7	1	4	4	4	0
R-425	29	30	1	1	3	3	4	0
R-425	30	477	447	0	4	4	0	0
R-425	32	33	1	1	4	3	4	1
R-425	34	39	5	1	4	3	0	1
R-425	38	43	5	1	3	5	2	2
R-425	38	39	1	1	5	5	0	2
R-426	46	47	1	1	4	1	0	0
R-426	49	50	1	1	5	3	4	0
R-426	49	50	1	1	3	3	4	0
R-426	49	50	1	1	4	3	4	0
R-426	49	50	1	1	4	3	4	0
R-426	50	51	1	1	4	3	0	0
R-426	50	51	1	1	3	3	2	0
R-426	52	281	229	1	3	4	0	1
R-426	52	53	1	1	5	3	3	0
R-426	56	163	107	1	5	3	0	1
R-427	56	172	116	1	3	3	0	1
R-427	65	66	1	1	4	3	3	1
R-427	65	66	1	1	3	3	4	1
R-427	66	67	1	1	4	3	4	1
R-427	71	72	1	1	4	3	4	0
R-427	74	75	1	1	1	3	4	1
R-427	74	75	1	1	3	3	0	0
R-427	74	75	1	1	4	3	4	1
R-427	78	477	399	0	3	4	1	1
R-427	80	477	397	0	3	1	0	0
R-428	80	92	12	1	3	5	4	1
R-428	84	90	6	1	3	1	0	0
R-428	92	98	6	1	3	3	0	1
R-428	99	218	119	1	3	1	0	0
R-428	99	477	378	0	5	4	0	0
R-428	102	108	6	1	3	3	0	1
R-428	105	106	1	1	5	4	2	0
R-428	114	115	1	1	3	3	4	1
R-429	115	116	1	1	5	3	4	0
R-429	119	120	1	1	5	1	4	0
R-429	121	122	1	1	4	4	4	0
R-429	122	123	1	1	4	3	4	1
R-429	122	123	1	1	4	3	4	1
R-429	123	129	6	1	3	3	0	2
R-429	124	125	1	1	3	3	4	0
R-429	127	135	8	1	3	3	0	1
R-429	127	128	1	1	4	3	3	0
R-430	128	133	5	1	3	1	0	0
R-430	134	143	9	1	3	3	3	4
R-430	137	186	49	1	4	3	4	0
R-430	137	477	340	0	4	3	0	0
R-430	137	138	1	1	3	3	4	1
R-430	141	477	336	0	3	5	0	1
R-430	141	142	1	1	3	5	4	4
R-430	141	142	1	1	3	3	4	0
R-430	142	477	335	0	3	3	0	3
R-431	151	157	6	1	3	3	0	0
R-431	151	152	1	1	4	3	1	2
R-431	151	152	1	1	4	3	2	3
R-431	155	156	1	1	3	1	0	1
R-431	156	157	1	1	3	1	0	2
R-431	161	165	4	1	3	3	0	2
R-431	165	166	1	1	4	3	2	2
R-431	168	169	1	1	3	1	4	1
R-431	170	186	16	1	5	3	4	1
R-432	175	176	1	1	4	3	4	1
R-432	175	176	1	1	4	3	4	0
R-432	176	177	1	1	4	3	4	0
R-432	176	177	1	1	4	3	4	0
R-432	176	177	1	1	3	1	4	0
R-432	179	186	7	1	4	3	0	1
R-432	179	180	1	1	4	3	4	1
R-432	183	184	1	1	4	3	4	0
R-432	184	189	5	1	4	3	3	0
R-432	186	193	7	1	4	3	0	1
R-433	186	187	1	1	3	1	2	1
R-433	189	190	1	1	4	3	4	0
R-433	189	190	1	1	4	3	4	0
R-433	189	190	1	1	4	3	4	0
R-433	193	199	6	1	4	3	0	1
R-433	198	204	6	1	3	2	2	2
R-433	200	201	1	1	4	3	3	0
R-433	200	268	68	1	3	3	2	2
R-433	200	201	1	1	4	5	4	0
R-433	202	205	3	1	3	1	3	1
R-434	204	210	6	1	3	3	0	1
R-434	205	206	1	1	3	3	0	0
R-434	206	269	63	1	5	3	3	1
R-434	206	207	1	1	4	3	3	0
R-434	206	207	1	1	4	3	3	0
R-434	206	207	1	1	5	3	3	0
R-434	207	208	1	1	5	3	3	0
R-434	207	208	1	1	4	3	3	0
R-434	207	208	1	1	4	3	3	0
R-434	207	208	1	1	4	3	3	0
R-435	207	208	1	1	5	3	3	0
R-435	207	214	7	1	3	3	0	4
R-435	207	477	270	0	3	3	0	1
R-435	214	215	1	1	4	3	2	1
R-435	217	241	24	1	3	4	2	1
R-435	220	233	13	1	3	4	2	1
R-435	235	238	3	1	2	1	0	0
R-435	241	242	1	1	4	5	3	1
R-435	241	248	7	1	3	3	0	1
R-435	245	246	1	1	4	3	3	0
R-436	245	246	1	1	4	3	3	0
R-436	245	246	1	1	4	3	3	1
R-436	245	246	1	1	4	3	3	0
R-436	245	246	1	1	4	3	3	0
R-436	245	246	1	1	4	3	3	0
R-436	245	267	22	1	4	3	3	0
R-436	245	477	232	0	4	1	0	0
R-436	246	247	1	1	4	3	3	0
R-436	246	247	1	1	4	3	3	0
R-436	246	249	3	1	4	4	2	0
R-437	249	250	1	1	4	1	2	0
R-437	262	263	1	1	4	3	3	1
R-437	266	267	1	1	4	3	3	0
R-437	266	267	1	1	4	3	3	0
R-437	267	268	1	1	4	3	3	0
R-437	267	268	1	1	4	3	3	0
R-437	268	477	209	0	3	3	0	1
R-437	269	276	7	1	3	3	0	1
R-437	270	271	1	1	3	1	0	1
R-437	282	283	1	1	3	3	3	1
R-438	288	289	1	1	5	3	3	0
R-438	288	289	1	1	5	3	3	0
R-438	288	315	27	1	5	3	3	0
R-438	288	289	1	1	5	3	3	0
R-438	288	289	1	1	5	3	3	0
R-438	289	290	1	1	5	3	3	0
R-438	290	322	32	1	4	1	3	0
R-438	290	291	1	1	5	3	3	0
R-438	302	308	6	1	3	3	0	1
R-439	325	331	6	1	3	3	0	1
R-439	331	332	1	1	3	3	0	2
R-439	331	338	7	1	3	3	0	3
R-439	331	399	68	1	3	3	0	2
R-439	331	338	7	1	3	3	3	2
R-439	339	345	6	1	4	3	0	0
R-439	344	345	1	1	4	3	0	0
RSITE-5	16	17	1	1	4	1	0	0
RVLT-25	6	8	2	1	2	1	1	3
RVLT-25	7	8	1	1	3	1	1	2
RVLT-25	7	477	470	0	3	2	0	0
RVLT-26	11	477	466	0	3	1	0	0
RVLT-26	14	477	463	0	3	1	0	0
RVLT-26	16	239	223	1	3	1	0	1
RVLT-26	21	29	8	1	3	1	0	1
RVLT-26	30	31	1	1	3	1	1	0
RVLT-26	32	35	3	1	3	1	1	0
RVLT-26	36	37	1	1	3	1	1	0
RVLT-26	39	240	201	1	4	1	1	0
RVLT-26	44	55	11	1	3	3	1	0
RVLT-27	44	45	1	1	3	4	1	0
RVLT-27	45	85	40	1	3	2	1	2
RVLT-27	46	240	194	1	4	1	1	0
RVLT-27	46	47	1	1	3	4	0	0
RVLT-27	46	94	48	1	3	4	1	0
RVLT-27	48	54	6	1	3	4	0	0
RVLT-27	52	94	42	1	3	1	1	1
RVLT-27	52	85	33	1	3	3	1	1
RVLT-27	53	56	3	1	3	1	0	1
RVLT-27	57	328	271	1	4	1	1	1
RVLT-28	64	477	413	0	3	4	0	0
RVLT-28	73	74	1	1	3	4	0	0
RVLT-28	80	81	1	1	3	4	1	0
RVLT-28	80	85	5	1	1	1	0	0
RVLT-28	91	92	1	1	4	4	1	0
RVLT-28	93	477	384	0	3	4	0	0
RVLT-28	99	170	71	1	3	4	1	0
RVLT-28	102	477	375	0	3	4	0	0
RVLT-28	105	239	134	1	3	2	1	2
RVLT-28	119	171	52	1	3	2	1	0
RVLT-29	122	477	355	0	3	1	0	0
RVLT-29	132	477	345	0	3	4	0	0
RVLT-29	148	170	22	1	3	1	1	2
RVLT-29	148	168	20	1	3	1	1	1
RVLT-29	149	150	1	1	4	1	1	0
RVLT-29	150	170	20	1	3	3	0	0
RVLT-29	150	170	20	1	3	5	0	1
RVLT-29	150	170	20	1	3	5	0	0
RVLT-29	150	170	20	1	3	5	0	0
RVLT-29	150	170	20	1	3	5	0	0
RVLT-30	155	217	62	1	3	1	1	2
RVLT-30	163	169	6	1	3	4	1	2
RVLT-30	163	477	314	0	4	4	0	1
RVLT-30	163	171	8	1	3	4	1	0
RVLT-30	163	168	5	1	3	4	1	1
RVLT-30	163	171	8	1	3	1	1	1
RVLT-30	164	168	4	1	3	4	1	0
RVLT-30	179	477	298	0	3	4	0	1
RVLT-30	183	477	294	0	3	1	0	0
RVLT-30	207	208	1	1	4	4	1	0
RVLT-31	207	263	56	1	3	4	1	0
RVLT-31	207	477	270	0	3	4	0	0
RVLT-31	207	220	13	1	3	4	1	1
RVLT-31	212	217	5	1	3	4	1	0
RVLT-31	212	217	5	1	3	4	1	0
RVLT-31	221	239	18	1	3	4	1	0
RVLT-31	221	477	256	0	3	4	0	1
RVLT-31	247	248	1	1	3	1	1	0
RVLT-31	247	248	1	1	3	4	1	0
RVLT-31	247	311	64	1	3	4	1	1
RVLT-32	298	311	13	1	3	1	1	1
RVLT-32	298	311	13	1	3	4	1	2
RVLT-32	316	317	1	1	4	1	0	0
RVLT-32	317	477	160	0	3	1	0	1
RVLT-32	319	477	158	0	3	1	0	0
RVLT-32	319	477	158	0	3	1	0	1
RVLT-32	330	434	104	1	3	1	1	0
RVLT-32	330	477	147	0	3	2	1	0
RVLT-32	338	477	139	0	3	1	0	0
S-18	63	477	414	0	3	1	0	0
S-18	65	477	412	0	3	1	0	0
S-18	72	477	405	0	2	1	0	0
S-18	108	109	1	1	4	5	0	0
S-19	141	142	1	1	3	1	1	0
S-19	171	477	306	0	3	5	0	0
S-19	178	245	67	1	2	1	0	0
S-19	183	477	294	0	3	4	1	0
S-19	209	477	268	0	3	1	0	0
S-19	329	477	148	0	3	4	0	0
KIM-3	161	176	15	1	3	2	0	0
KIM-4	165	477	312	0	3	2	0	0
KIM-4	203	204	1	1	3	2	0	0
KIM-4	346	477	131	0	3	5	0	0
O-77	11	17	6	1	2	1	1	0
O-77	92	121	29	1	3	4	1	0
O-77	142	159	17	1	3	4	1	1
O-77	337	374	37	1	2	4	1	0
NA-145	1	16	15	1	3	4	1	0
NA-146	5	6	1	1	5	3	1	0
NA-146	5	12	7	1	3	4	1	0
NA-146	10	14	4	1	3	1	1	3
NA-146	10	14	4	1	3	1	1	1
NA-146	11	12	1	1	4	4	1	0
NA-146	15	16	1	1	3	1	0	1
NA-146	15	19	4	1	3	1	0	1
NA-146	15	26	11	1	4	4	1	0
NA-146	18	29	11	1	3	1	1	0
NA-146	19	29	10	1	3	1	1	0
NA-147	24	38	14	1	4	5	0	0
NA-147	29	30	1	1	4	4	1	0
NA-147	29	31	2	1	3	1	1	0
NA-147	30	35	5	1	4	5	0	0
NA-147	32	42	10	1	3	3	1	0
NA-147	32	39	7	1	3	3	1	0
NA-147	33	35	2	1	3	3	1	0
NA-147	33	34	1	1	4	5	0	0
NA-147	35	42	7	1	3	1	1	0
NA-147	35	477	442	0	4	4	0	0
NA-148	37	68	31	1	3	1	1	0
NA-148	38	223	185	1	3	1	1	2
NA-148	38	41	3	1	4	4	1	1
NA-148	39	42	3	1	3	4	1	0
NA-148	40	41	1	1	3	1	1	0
NA-148	42	49	7	1	3	5	0	0
NA-148	42	50	8	1	3	1	1	0
NA-148	43	44	1	1	3	1	0	1
NA-148	43	114	71	1	3	4	1	2
NA-148	44	48	4	1	3	1	0	0
NA-149	46	57	11	1	3	4	1	0
NA-149	46	58	12	1	5	3	1	0
NA-149	50	64	14	1	3	1	1	1
NA-149	52	53	1	1	3	5	0	0
NA-149	54	57	3	1	3	4	1	1
NA-149	58	67	9	1	5	4	1	0
NA-149	58	59	1	1	4	5	0	0
NA-149	63	64	1	1	3	1	1	0
NA-149	63	64	1	1	3	4	1	0
NA-149	64	67	3	1	4	1	1	0
NA-150	66	67	1	1	3	1	1	0
NA-150	66	70	4	1	3	4	1	0
NA-150	67	477	410	0	3	4	0	0
NA-150	67	68	1	1	3	1	1	0
NA-150	67	68	1	1	3	1	1	0
NA-150	68	477	409	0	3	4	0	0
NA-150	70	80	10	1	3	2	1	2
NA-150	71	72	1	1	3	1	1	1
NA-150	74	76	2	1	4	4	1	0
NA-150	77	78	1	1	3	1	1	0
NA-151	80	86	6	1	4	5	1	0
NA-151	80	86	6	1	4	4	1	0
NA-151	81	477	396	0	4	4	0	0
NA-151	86	87	1	1	3	1	1	0
NA-151	90	123	33	1	4	1	0	0
NA-151	91	286	195	1	4	1	1	0
NA-151	92	94	2	1	2	1	1	1
NA-151	98	102	4	1	3	1	1	0
NA-151	98	477	379	0	3	1	0	0
NA-151	99	107	8	1	3	1	1	0
NA-152	101	102	1	1	4	1	1	0
NA-152	101	102	1	1	3	1	1	0
NA-152	101	213	112	1	2	1	0	1
NA-152	101	102	1	1	3	1	1	0
NA-152	104	114	10	1	3	1	1	0
NA-152	104	115	11	1	3	4	1	0
NA-152	105	114	9	1	3	5	0	0
NA-152	107	108	1	1	3	1	1	0
NA-152	108	112	4	1	4	1	1	0
NA-152	109	110	1	1	3	1	1	1
NA-153	109	110	1	1	3	3	1	0
NA-153	110	114	4	1	4	3	1	0
NA-153	112	123	11	1	3	1	1	0
NA-153	114	115	1	1	3	3	1	0
NA-153	116	118	2	1	3	1	1	2
NA-153	116	118	2	1	4	4	1	0
NA-153	117	118	1	1	3	1	0	0
NA-153	117	123	6	1	3	4	1	4
NA-153	117	123	6	1	4	4	1	0
NA-153	118	123	5	1	4	4	1	0
NA-154	123	124	1	1	3	1	1	0
NA-154	123	156	33	1	3	5	0	0
NA-154	123	130	7	1	3	4	1	1
NA-154	126	128	2	1	3	4	1	0
NA-154	126	131	5	1	3	1	1	0
NA-154	126	131	5	1	3	4	1	0
NA-154	128	129	1	1	3	4	1	0
NA-154	131	132	1	1	4	1	1	0
NA-154	131	132	1	1	3	4	1	0
NA-154	131	477	346	0	5	4	0	0
NA-155	137	141	4	1	3	4	1	0
NA-155	150	151	1	1	5	5	1	0
NA-155	151	156	5	1	3	4	1	0
NA-155	151	318	167	1	3	1	1	1
NA-155	151	155	4	1	3	4	1	0
NA-155	153	155	2	1	3	3	1	0
NA-155	155	172	17	1	3	2	1	0
NA-155	156	159	3	1	3	4	1	0
NA-155	157	158	1	1	3	3	1	0
NA-155	159	162	3	1	3	3	1	0
NA-156	159	162	3	1	4	2	1	0
NA-156	159	167	8	1	3	2	1	0
NA-156	160	163	3	1	3	1	1	0
NA-156	160	166	6	1	3	1	1	0
NA-156	167	169	2	1	3	1	1	0
NA-156	175	176	1	1	4	1	1	0
NA-156	177	178	1	1	3	1	1	0
NA-156	177	183	6	1	4	1	0	0
NA-156	178	180	2	1	4	4	1	0
NA-156	178	180	2	1	4	4	1	0
NA-157	179	198	19	1	4	1	0	0
NA-157	183	193	10	1	4	4	1	0
NA-157	183	477	294	0	3	4	0	1
NA-157	183	193	10	1	3	4	1	0
NA-157	192	193	1	1	4	1	1	1
NA-157	192	195	3	1	3	1	1	0
NA-157	196	209	13	1	3	5	0	0
NA-157	200	209	9	1	2	1	0	0
NA-157	207	216	9	1	4	2	1	0
NA-157	208	209	1	1	3	1	1	0
NA-158	209	210	1	1	4	4	1	0
NA-158	211	213	2	1	2	1	1	1
NA-158	212	213	1	1	3	5	0	0
NA-158	212	216	4	1	3	1	1	0
NA-158	216	218	2	1	4	4	1	0
NA-158	216	218	2	1	4	4	1	1
NA-158	217	223	6	1	4	1	1	1
NA-158	217	218	1	1	4	4	1	0
NA-158	217	219	2	1	4	5	0	0
NA-158	219	220	1	1	3	1	0	0
NA-159	222	223	1	1	4	4	1	0
NA-159	222	223	1	1	4	4	1	0
NA-159	231	242	11	1	3	4	1	0
NA-159	234	235	1	1	3	3	1	0
NA-159	234	320	86	1	3	3	1	0
NA-159	234	242	8	1	4	3	1	0
NA-159	242	243	1	1	4	4	1	0
NA-159	243	263	20	1	3	4	1	1
NA-159	246	263	17	1	3	3	1	0
NA-159	247	261	14	1	4	4	1	0
NA-160	249	250	1	1	3	1	1	1
NA-160	253	320	67	1	4	4	0	0
NA-160	254	286	32	1	4	4	1	0
NA-160	256	263	7	1	4	1	1	0
NA-160	256	257	1	1	4	4	1	0
NA-160	260	261	1	1	4	1	1	0
NA-160	261	275	14	1	4	4	1	0
NA-160	267	268	1	1	3	1	1	0
NA-160	269	304	35	1	4	1	0	0
NA-160	273	276	3	1	3	4	1	0
NA-161	275	281	6	1	4	1	1	0
NA-161	277	278	1	1	3	1	1	0
NA-161	278	283	5	1	4	4	1	0
NA-161	279	477	198	0	4	4	0	0
NA-161	281	283	2	1	3	1	1	0
NA-161	281	284	3	1	4	4	1	0
NA-161	282	283	1	1	3	5	1	0
NA-161	282	300	18	1	3	5	0	0
NA-161	295	297	2	1	3	1	1	0
NA-162	298	304	6	1	3	4	1	0
NA-162	301	309	8	1	3	4	1	0
NA-162	301	307	6	1	4	1	1	0
NA-162	306	320	14	1	3	3	1	0
NA-162	307	308	1	1	3	3	1	0
NA-162	307	320	13	1	3	3	1	0
NA-162	312	320	8	1	3	1	1	0
NA-162	312	320	8	1	3	4	1	0
NA-162	316	317	1	1	3	4	0	0
NA-162	316	320	4	1	3	4	1	0
NA-163	316	325	9	1	3	4	1	0
NA-163	316	320	4	1	3	4	1	0
NA-163	317	326	9	1	4	4	1	0
NA-163	317	326	9	1	3	1	1	0
NA-163	319	320	1	1	3	2	0	0
NA-163	319	320	1	1	3	4	1	0
NA-163	319	323	4	1	4	4	1	0
NA-163	326	327	1	1	4	1	1	0
NA-163	326	329	3	1	4	4	1	0
NA-163	328	329	1	1	4	4	1	0
NA-164	329	330	1	1	4	4	1	0
NA-164	330	332	2	1	4	4	1	0
NA-164	330	332	2	1	4	1	1	0
NA-164	333	334	1	1	3	1	1	0
NA-164	333	334	1	1	4	1	0	0
NA-164	337	339	2	1	3	5	1	0
NA-164	337	366	29	1	4	4	1	0
NA-164	340	353	13	1	4	4	1	0
NA-164	345	347	2	1	3	4	1	0
NA-164	346	350	4	1	2	3	1	1
NA-165	346	350	4	1	2	3	1	1
NA-165	347	348	1	1	4	3	1	0
NA-165	347	349	2	1	3	1	1	0
NA-165	359	360	1	1	3	1	1	0
NA-165	362	363	1	1	5	4	1	0
XL-24	11	12	1	1	3	1	0	0
XL-24	17	20	3	1	3	4	1	0
XL-24	21	22	1	1	4	2	0	0
XL-25	23	37	14	1	4	2	1	1
XL-25	23	24	1	1	4	2	0	0
XL-25	24	37	13	1	4	2	1	0
XL-25	24	477	453	0	3	2	0	1
XL-25	36	37	1	1	3	5	1	0
XL-25	55	100	45	1	3	4	1	0
XL-25	94	101	7	1	3	4	0	0
XL-25	100	477	377	0	3	1	0	0
XL-25	100	139	39	1	4	4	1	0
XL-25	112	147	35	1	3	1	1	0
XL-26	139	140	1	1	4	4	1	0
XL-26	139	214	75	1	3	1	1	0
XL-26	142	227	85	1	4	2	1	0
XL-26	177	214	37	1	3	1	0	0
XL-26	213	214	1	1	4	4	1	0
XL-26	215	217	2	1	4	1	1	0
XL-26	220	477	257	0	4	2	0	0
XL-26	227	228	1	1	3	1	1	0
XL-26	232	477	245	0	4	2	0	0
XL-26	239	477	238	0	4	2	0	0
XL-27	239	252	13	1	3	1	1	0
XL-27	241	252	11	1	3	1	1	0
XL-27	254	255	1	1	3	1	1	0
XL-27	255	256	1	1	4	4	1	0
XL-27	259	260	1	1	3	4	1	0
XL-27	259	260	1	1	3	4	1	1
XL-27	259	477	218	0	4	4	0	0
XL-27	274	477	203	0	4	4	0	0
XL-27	294	300	6	1	4	1	1	0
XL-27	331	359	28	1	3	1	1	0
XL-28	336	351	15	1	3	1	1	0
XL-28	345	350	5	1	3	1	1	0
XL-28	346	351	5	1	3	1	1	0
XL-28	350	351	1	1	3	1	0	0
XL-28	351	477	126	0	4	2	0	1
HNZON-15	16	17	1	1	3	4	0	0
HNZON-15	23	24	1	1	3	4	1	0
HNZON-15	31	34	3	1	3	1	1	0
HNZON-15	40	123	83	1	3	1	2	0
HNZON-15	42	44	2	1	3	1	1	0
HNZON-15	49	50	1	1	3	1	1	0
HNZON-15	51	56	5	1	4	1	0	0
HNZON-16	62	123	61	1	1	1	1	0
HNZON-16	66	477	411	0	3	3	1	1
HNZON-16	74	86	12	1	3	1	0	0
HNZON-16	85	86	1	1	3	2	1	0
HNZON-16	86	87	1	1	3	1	1	0
HNZON-16	88	89	1	1	3	1	1	0
HNZON-16	101	477	376	0	3	1	0	0
HNZON-16	101	477	376	0	3	1	0	0
HNZON-16	101	106	5	1	4	1	1	0
HNZON-16	108	240	132	1	1	1	1	0
HNZON-17	112	113	1	1	3	2	1	0
HNZON-17	118	119	1	1	3	2	1	0
HNZON-17	140	141	1	1	3	1	1	0
HNZON-17	163	164	1	1	3	1	1	0
HNZON-17	172	241	69	1	3	4	1	0
HNZON-17	182	183	1	1	3	1	0	0
HNZON-17	182	183	1	1	3	4	1	0
HNZON-17	185	477	292	0	4	1	1	0
HNZON-17	193	477	284	0	3	1	1	0
HNZON-17	193	194	1	1	3	4	1	0
HNZON-18	205	206	1	1	2	1	0	1
HNZON-18	205	206	1	1	4	1	1	1
HNZON-18	207	210	3	1	3	1	1	0
HNZON-18	211	212	1	1	4	1	1	0
HNZON-18	213	240	27	1	3	1	1	0
HNZON-18	240	241	1	1	3	4	1	0
HNZON-18	241	242	1	1	3	1	1	0
HNZON-18	256	257	1	1	3	1	1	0
HNZON-18	268	270	2	1	4	4	1	0
HNZON-18	270	477	207	0	3	4	1	0
HNZON-19	274	275	1	1	3	4	1	0
HNZON-19	277	477	200	0	3	1	1	0
HNZON-19	277	477	200	0	4	4	1	0
HNZON-19	297	298	1	1	3	1	1	0
HNZON-19	314	315	1	1	3	4	1	0
HNZON-19	325	326	1	1	4	1	1	0
HNZON-19	334	335	1	1	3	1	1	0
HNZON-19	350	351	1	1	3	4	1	0
HNZON-19	350	351	1	1	3	4	1	0
SHUA-33	3	7	4	1	3	1	0	0
SHUA-33	33	477	444	0	3	4	1	0
SHUA-33	248	477	229	0	4	4	0	0
SHUA-33	262	477	215	0	3	4	0	0
2-136	275	477	202	0	2	1	0	0
2-136	307	477	170	0	1	1	0	1
PWIKI-106	59	477	418	0	4	1	0	0
PWIKI-106	59	477	418	0	4	4	0	0
PWIKI-106	84	88	4	1	3	1	1	2
PWIKI-106	88	89	1	1	3	1	1	0
PWIKI-106	100	101	1	1	4	1	1	0
PWIKI-107	147	153	6	1	3	3	1	0
PWIKI-107	154	155	1	1	3	1	1	0
PWIKI-107	221	242	21	1	3	3	1	0
PWIKI-107	261	398	137	1	4	1	1	0
DDI-99	223	477	254	0	3	4	0	0
DDI-99	233	477	244	0	3	1	1	0
DDI-99	320	327	7	1	3	1	1	2
DDI-99	328	477	149	0	3	4	0	0
DDI-99	334	336	2	1	3	1	1	0
NEAU-7	9	17	8	1	3	1	1	0
NEAU-7	10	11	1	1	3	1	1	0
NEAU-8	32	35	3	1	3	1	1	0
NEAU-8	78	206	128	1	3	4	1	0
NEAU-8	91	102	11	1	3	1	1	1
NEAU-8	154	206	52	1	3	1	1	0
NEAU-8	254	255	1	1	3	4	1	0
NEAU-8	283	295	12	1	1	1	1	0
NEAU-8	284	295	11	1	3	1	1	0
NEAU-8	288	295	7	1	3	1	1	0
NEAU-8	288	306	18	1	3	1	1	0
NEAU-8	305	306	1	1	3	1	1	0
NEAU-9	306	307	1	1	3	1	1	0
NEAU-9	315	316	1	1	3	4	1	0
NEAU-9	334	335	1	1	3	4	0	0
NEAU-9	335	477	142	0	3	4	0	0
NEAU-9	338	477	139	0	3	1	0	0
NEAU-9	346	477	131	0	3	1	0	0
PATH-19	52	53	1	1	1	1	0	0
PATH-19	220	477	257	0	3	1	0	0
PATH-19	276	477	201	0	3	1	0	0
R-13	87	88	1	1	1	3	1	0
R-13	88	89	1	1	4	5	1	0
R-13	195	209	14	1	3	1	0	0
R-14	237	263	26	1	3	1	1	0
R-14	273	301	28	1	3	1	1	0
R-14	313	477	164	0	3	4	0	0
FKA-641	0	94	94	1	4	4	0	3
FKA-641	1	477	476	0	3	1	0	0
FKA-641	1	274	273	1	3	1	1	1
FKA-641	1	477	476	0	3	5	0	0
FKA-641	1	477	476	0	3	1	0	1
FKA-641	1	29	28	1	4	1	1	0
FKA-641	2	477	475	0	4	1	0	0
FKA-642	2	477	475	0	5	4	0	0
FKA-642	3	23	20	1	2	1	0	1
FKA-642	3	7	4	1	4	1	2	0
FKA-642	3	477	474	0	3	1	0	0
FKA-642	4	46	42	1	4	4	1	0
FKA-642	4	477	473	0	3	1	0	0
FKA-642	4	136	132	1	3	1	0	0
FKA-642	4	148	144	1	5	1	1	0
FKA-642	5	7	2	1	3	4	0	0
FKA-642	6	24	18	1	4	1	0	0
FKA-643	6	46	40	1	3	4	1	0
FKA-643	7	374	367	1	4	4	1	0
FKA-643	7	220	213	1	3	4	1	0
FKA-643	7	477	470	0	3	4	0	2
FKA-643	8	477	469	0	3	1	0	1
FKA-643	9	477	468	0	3	1	0	0
FKA-643	9	477	468	0	4	5	0	0
FKA-643	9	199	190	1	4	4	1	2
FKA-643	9	274	265	1	3	1	0	0
FKA-643	9	54	45	1	3	1	0	0
FKA-644	9	477	468	0	4	4	0	2
FKA-644	10	12	2	1	3	1	0	0
FKA-644	10	477	467	0	3	1	0	0
FKA-644	10	477	467	0	3	1	0	0
FKA-644	12	477	465	0	3	1	0	0
FKA-644	14	165	151	1	5	1	1	0
FKA-644	14	85	71	1	2	1	1	4
FKA-644	14	100	86	1	3	5	1	0
FKA-644	15	477	462	0	4	4	0	0
FKA-644	15	477	462	0	3	1	0	0
FKA-645	15	477	462	0	3	1	0	0
FKA-645	15	29	14	1	4	1	1	0
FKA-645	15	35	20	1	3	5	1	0
FKA-645	15	477	462	0	3	4	0	2
FKA-645	15	74	59	1	3	4	1	3
FKA-645	15	477	462	0	3	4	0	3
FKA-645	16	17	1	1	4	4	1	0
FKA-645	16	249	233	1	3	1	1	1
FKA-645	16	477	461	0	3	1	0	0
FKA-645	17	80	63	1	3	1	1	1
FKA-646	17	477	460	0	3	4	0	0
FKA-646	17	22	5	1	4	4	1	0
FKA-646	18	23	5	1	4	4	1	0
FKA-646	18	477	459	0	3	4	0	0
FKA-646	20	29	9	1	4	1	1	0
FKA-646	21	477	456	0	3	1	0	0
FKA-646	21	22	1	1	3	1	0	1
FKA-646	22	25	3	1	1	1	2	0
FKA-646	22	477	455	0	3	1	0	0
FKA-646	22	477	455	0	3	1	0	1
FKA-647	22	477	455	0	3	1	0	0
FKA-647	22	477	455	0	3	1	0	0
FKA-647	22	43	21	1	5	1	1	0
FKA-647	22	85	63	1	3	4	1	2
FKA-647	22	477	455	0	3	4	0	0
FKA-647	22	477	455	0	4	1	0	0
FKA-647	22	44	22	1	3	5	1	0
FKA-647	23	477	454	0	3	2	0	0
FKA-647	23	390	367	1	3	1	1	1
FKA-647	23	477	454	0	3	1	0	1
FKA-648	23	477	454	0	3	1	0	0
FKA-648	23	45	22	1	4	4	1	0
FKA-648	24	477	453	0	3	1	0	0
FKA-648	24	25	1	1	3	4	0	2
FKA-648	24	28	4	1	3	4	0	1
FKA-648	24	169	145	1	3	4	0	1
FKA-648	24	77	53	1	4	4	1	0
FKA-648	24	32	8	1	3	1	1	0
FKA-648	24	192	168	1	3	1	0	0
FKA-648	25	31	6	1	3	1	1	1
FKA-649	25	292	267	1	3	1	1	0
FKA-649	25	477	452	0	3	1	0	0
FKA-649	28	32	4	1	3	1	1	0
FKA-649	28	477	449	0	3	1	0	0
FKA-649	28	33	5	1	3	5	1	0
FKA-649	28	477	449	0	3	1	0	0
FKA-649	28	32	4	1	2	4	0	0
FKA-649	28	29	1	1	3	4	0	1
FKA-649	28	477	449	0	3	4	0	0
FKA-649	29	31	2	1	3	4	1	0
FKA-650	29	477	448	0	4	1	0	0
FKA-650	29	39	10	1	3	5	1	0
FKA-650	29	477	448	0	4	1	0	1
FKA-650	29	45	16	1	2	1	2	1
FKA-650	29	38	9	1	4	1	2	1
FKA-650	29	477	448	0	4	4	0	0
FKA-650	30	477	447	0	3	4	0	0
FKA-650	30	477	447	0	3	1	0	0
FKA-650	30	477	447	0	3	4	0	0
FKA-650	30	477	447	0	3	5	0	0
FKA-651	30	477	447	0	3	1	0	0
FKA-651	30	43	13	1	1	1	1	0
FKA-651	30	45	15	1	3	1	1	0
FKA-651	31	39	8	1	1	1	2	0
FKA-651	31	105	74	1	3	4	1	0
FKA-651	31	33	2	1	4	4	1	0
FKA-651	31	32	1	1	3	1	0	0
FKA-651	31	45	14	1	1	1	1	1
FKA-651	31	477	446	0	3	1	1	0
FKA-651	31	38	7	1	3	4	1	0
FKA-652	31	477	446	0	3	4	0	0
FKA-652	31	477	446	0	3	4	0	3
FKA-652	32	477	445	0	3	2	0	0
FKA-652	32	477	445	0	3	1	0	0
FKA-652	32	37	5	1	4	1	0	0
FKA-652	32	477	445	0	3	2	0	0
FKA-652	32	120	88	1	3	4	1	0
FKA-652	32	477	445	0	3	1	0	1
FKA-652	32	36	4	1	3	1	1	0
FKA-652	32	39	7	1	3	1	3	0
FKA-653	33	75	42	1	3	1	1	0
FKA-653	34	105	71	1	4	5	0	0
FKA-653	35	37	2	1	3	1	1	0
FKA-653	35	477	442	0	3	1	0	0
FKA-653	35	57	22	1	3	1	1	0
FKA-653	36	119	83	1	3	4	1	1
FKA-653	36	46	10	1	3	1	3	0
FKA-653	36	46	10	1	2	1	0	0
FKA-653	36	157	121	1	4	4	1	1
FKA-653	37	477	440	0	3	1	0	0
FKA-654	38	477	439	0	3	1	0	0
FKA-654	38	45	7	1	3	1	0	1
FKA-654	38	477	439	0	3	4	0	1
FKA-654	38	39	1	1	3	4	0	1
FKA-654	38	477	439	0	3	1	0	0
FKA-654	38	39	1	1	3	1	0	1
FKA-654	38	170	132	1	3	4	1	0
FKA-654	38	477	439	0	3	1	0	0
FKA-654	38	39	1	1	4	4	0	0
FKA-654	39	45	6	1	1	1	1	1
FKA-655	39	477	438	0	4	4	0	0
FKA-655	39	477	438	0	3	1	0	1
FKA-655	41	42	1	1	5	1	1	0
FKA-655	42	477	435	0	2	1	0	0
FKA-655	42	50	8	1	4	1	1	0
FKA-655	42	477	435	0	3	4	0	1
FKA-655	43	477	434	0	3	2	0	4
FKA-655	43	477	434	0	3	1	0	0
FKA-655	43	477	434	0	3	4	0	0
FKA-655	43	477	434	0	3	4	0	0
FKA-656	43	59	16	1	2	4	1	0
FKA-656	43	57	14	1	4	4	0	0
FKA-656	45	145	100	1	3	4	1	2
FKA-656	45	477	432	0	3	4	0	0
FKA-656	45	169	124	1	4	5	1	0
FKA-656	45	49	4	1	1	1	0	1
FKA-656	45	137	92	1	1	1	4	0
FKA-656	45	323	278	1	3	4	1	0
FKA-656	45	47	2	1	1	1	3	0
FKA-656	46	413	367	1	3	1	1	0
FKA-657	48	477	429	0	3	5	0	0
FKA-657	49	477	428	0	3	1	0	0
FKA-657	49	477	428	0	3	1	0	0
FKA-657	50	51	1	1	3	1	1	0
FKA-657	50	477	427	0	4	1	0	1
FKA-657	51	52	1	1	3	1	0	0
FKA-657	51	95	44	1	3	2	1	0
FKA-657	51	52	1	1	1	1	2	1
FKA-657	51	53	2	1	2	1	1	1
FKA-657	51	477	426	0	3	4	0	0
FKA-658	52	477	425	0	3	1	0	0
FKA-658	52	151	99	1	4	1	1	0
FKA-658	52	477	425	0	3	1	0	0
FKA-658	52	182	130	1	2	2	0	3
FKA-658	52	477	425	0	3	1	0	4
FKA-658	52	477	425	0	4	4	0	0
FKA-658	52	477	425	0	4	4	0	0
FKA-658	53	199	146	1	4	1	1	1
FKA-658	53	477	424	0	4	1	0	0
FKA-658	54	477	423	0	4	4	0	0
FKA-659	54	55	1	1	3	1	1	0
FKA-659	55	175	120	1	4	4	1	0
FKA-659	56	424	368	1	4	1	0	1
FKA-659	56	59	3	1	2	1	1	0
FKA-659	57	261	204	1	3	1	0	0
FKA-659	57	477	420	0	3	1	0	0
FKA-659	57	75	18	1	3	1	0	0
FKA-659	57	477	420	0	5	1	0	0
FKA-659	57	477	420	0	3	2	0	0
FKA-659	57	477	420	0	2	1	0	0
FKA-660	57	477	420	0	3	1	0	0
FKA-660	58	59	1	1	3	1	0	0
FKA-660	59	477	418	0	3	2	0	0
FKA-660	59	477	418	0	4	1	0	0
FKA-660	59	477	418	0	3	1	0	0
FKA-660	59	477	418	0	3	1	0	0
FKA-660	60	61	1	1	1	1	1	0
FKA-660	60	477	417	0	4	4	0	0
FKA-660	61	149	88	1	1	4	1	2
FKA-660	61	477	416	0	3	4	0	0
FKA-661	63	64	1	1	3	1	0	1
FKA-661	63	80	17	1	3	4	1	0
FKA-661	63	87	24	1	3	4	0	0
FKA-661	64	78	14	1	3	1	1	1
FKA-661	64	477	413	0	4	4	0	0
FKA-661	64	65	1	1	3	4	1	1
FKA-661	65	477	412	0	3	4	0	0
FKA-661	65	192	127	1	4	4	0	0
FKA-661	65	192	127	1	3	1	0	0
FKA-661	65	477	412	0	3	1	0	0
FKA-662	65	270	205	1	3	1	1	0
FKA-662	65	477	412	0	4	4	0	0
FKA-662	66	67	1	1	3	1	1	0
FKA-662	66	477	411	0	3	4	0	0
FKA-662	66	71	5	1	3	1	1	0
FKA-662	66	477	411	0	2	1	0	0
FKA-662	66	275	209	1	3	1	0	0
FKA-662	66	378	312	1	4	1	0	0
FKA-662	66	126	60	1	3	4	1	0
FKA-662	66	477	411	0	3	4	0	0
FKA-663	66	92	26	1	4	4	1	0
FKA-663	66	453	387	1	2	1	0	1
FKA-663	67	275	208	1	3	1	0	0
FKA-663	67	68	1	1	4	1	0	0
FKA-663	67	71	4	1	3	4	3	0
FKA-663	69	477	408	0	3	1	0	0
FKA-663	70	192	122	1	3	4	0	0
FKA-663	70	82	12	1	3	1	1	0
FKA-663	70	477	407	0	3	4	0	0
FKA-663	70	477	407	0	3	1	0	0
FKA-664	70	72	2	1	3	4	1	0
FKA-664	71	311	240	1	3	4	0	2
FKA-664	71	93	22	1	3	2	0	1
FKA-664	71	477	406	0	3	2	0	0
FKA-664	71	477	406	0	4	4	0	0
FKA-664	71	91	20	1	3	2	0	0
FKA-664	71	477	406	0	3	2	0	0
FKA-664	71	477	406	0	4	1	0	1
FKA-664	71	214	143	1	3	1	2	0
FKA-664	71	477	406	0	3	1	0	1
FKA-665	71	106	35	1	4	1	1	0
FKA-665	71	477	406	0	4	1	0	0
FKA-665	71	93	22	1	4	4	0	0
FKA-665	72	73	1	1	3	1	1	0
FKA-665	72	477	405	0	3	4	0	0
FKA-665	72	477	405	0	3	1	0	2
FKA-665	72	73	1	1	3	1	1	0
FKA-665	72	121	49	1	3	4	1	1
FKA-665	72	74	2	1	3	1	1	0
FKA-665	72	80	8	1	5	4	1	0
FKA-666	72	477	405	0	3	4	0	0
FKA-666	72	77	5	1	2	1	4	0
FKA-666	73	215	142	1	4	1	0	0
FKA-666	73	74	1	1	4	1	2	0
FKA-666	73	477	404	0	3	4	0	1
FKA-666	73	74	1	1	3	1	1	1
FKA-666	73	150	77	1	2	1	1	0
FKA-666	74	75	1	1	3	1	0	0
FKA-666	74	477	403	0	3	1	0	0
FKA-666	74	477	403	0	3	4	0	0
FKA-667	74	112	38	1	3	4	1	0
FKA-667	74	477	403	0	3	1	0	0
FKA-667	74	75	1	1	3	1	1	0
FKA-667	74	128	54	1	4	4	1	0
FKA-667	75	76	1	1	5	1	0	0
FKA-667	75	477	402	0	4	4	0	1
FKA-667	75	81	6	1	3	1	1	0
FKA-667	76	113	37	1	3	4	1	1
FKA-667	76	477	401	0	3	4	0	0
FKA-667	76	477	401	0	3	1	0	0
FKA-668	77	81	4	1	3	1	1	0
FKA-668	77	452	375	1	2	1	1	0
FKA-668	77	136	59	1	3	1	0	0
FKA-668	77	81	4	1	2	1	1	0
FKA-668	77	273	196	1	2	4	1	0
FKA-668	77	141	64	1	4	4	1	0
FKA-668	77	477	400	0	3	4	0	1
FKA-668	77	477	400	0	3	4	0	2
FKA-668	78	97	19	1	3	4	1	0
FKA-668	78	477	399	0	2	1	1	0
FKA-669	78	477	399	0	3	2	0	0
FKA-669	78	477	399	0	3	4	0	0
FKA-669	78	79	1	1	3	4	0	0
FKA-669	78	99	21	1	3	4	0	0
FKA-669	78	477	399	0	4	4	0	0
FKA-669	78	477	399	0	3	5	0	0
FKA-669	78	324	246	1	3	4	0	0
FKA-669	79	170	91	1	3	1	1	0
FKA-669	79	148	69	1	4	5	0	0
FKA-669	79	254	175	1	3	1	0	0
FKA-670	79	477	398	0	4	4	0	0
FKA-670	79	221	142	1	3	1	0	0
FKA-670	80	92	12	1	3	4	1	0
FKA-670	80	81	1	1	3	1	0	0
FKA-670	80	155	75	1	3	1	1	0
FKA-670	81	113	32	1	3	4	0	2
FKA-670	81	477	396	0	1	1	0	0
FKA-670	81	92	11	1	3	4	1	0
FKA-670	81	477	396	0	3	4	0	0
FKA-670	82	154	72	1	2	1	1	0
FKA-671	82	83	1	1	3	1	1	0
FKA-671	82	164	82	1	3	1	4	0
FKA-671	83	84	1	1	3	4	0	1
FKA-671	83	477	394	0	3	4	0	0
FKA-671	84	477	393	0	2	1	0	0
FKA-671	84	477	393	0	2	1	0	0
FKA-671	84	92	8	1	4	5	1	0
FKA-671	85	197	112	1	3	1	0	1
FKA-671	85	477	392	0	3	2	0	1
FKA-671	85	86	1	1	3	1	0	0
FKA-672	85	86	1	1	4	1	0	1
FKA-672	85	477	392	0	3	4	0	1
FKA-672	86	477	391	0	3	4	0	0
FKA-672	86	87	1	1	4	4	0	1
FKA-672	86	87	1	1	4	1	1	0
FKA-672	87	477	390	0	3	2	0	0
FKA-672	87	156	69	1	3	4	1	0
FKA-672	87	105	18	1	4	4	1	0
FKA-672	88	92	4	1	2	1	2	1
FKA-672	88	136	48	1	1	1	1	0
FKA-673	88	155	67	1	3	4	1	0
FKA-673	90	91	1	1	3	1	1	0
FKA-673	90	91	1	1	3	1	1	0
FKA-673	90	477	387	0	4	4	0	1
FKA-673	91	124	33	1	4	5	0	0
FKA-673	91	477	386	0	4	5	0	0
FKA-673	91	126	35	1	4	5	0	4
FKA-673	91	169	78	1	2	1	1	0
FKA-673	91	149	58	1	2	4	1	0
FKA-673	91	92	1	1	2	1	3	1
FKA-674	92	477	385	0	3	4	0	1
FKA-674	92	94	2	1	4	1	1	0
FKA-674	92	106	14	1	4	1	2	0
FKA-674	92	152	60	1	4	1	1	0
FKA-674	92	477	385	0	4	1	0	0
FKA-674	92	477	385	0	3	4	0	0
FKA-674	93	192	99	1	3	4	0	0
FKA-674	94	95	1	1	3	1	4	0
FKA-674	94	95	1	1	3	1	3	0
FKA-674	94	163	69	1	4	1	2	0
FKA-675	94	155	61	1	3	4	1	0
FKA-675	94	220	126	1	3	4	1	0
FKA-675	94	100	6	1	3	1	2	0
FKA-675	95	238	143	1	4	4	1	0
FKA-675	95	477	382	0	3	2	0	0
FKA-675	95	477	382	0	3	4	0	0
FKA-675	95	477	382	0	4	1	0	0
FKA-675	95	477	382	0	4	4	0	0
FKA-675	95	456	361	1	3	1	0	1
FKA-675	95	477	382	0	4	4	0	0
FKA-676	95	151	56	1	3	4	2	0
FKA-676	95	274	179	1	3	4	1	4
FKA-676	96	155	59	1	3	1	0	1
FKA-676	96	477	381	0	4	4	0	0
FKA-676	97	477	380	0	4	1	0	0
FKA-676	98	106	8	1	3	1	2	0
FKA-676	98	477	379	0	3	1	0	0
FKA-676	98	477	379	0	4	1	0	1
FKA-676	98	99	1	1	3	1	0	0
FKA-676	99	147	48	1	2	3	1	0
FKA-677	99	106	7	1	3	4	0	0
FKA-677	99	477	378	0	3	4	0	0
FKA-677	99	107	8	1	3	4	3	0
FKA-677	99	101	2	1	1	1	0	0
FKA-677	99	319	220	1	3	4	1	1
FKA-677	100	107	7	1	4	1	1	0
FKA-677	100	149	49	1	3	4	1	0
FKA-677	100	386	286	1	2	1	0	0
FKA-677	100	115	15	1	3	1	1	0
FKA-677	100	477	377	0	2	1	0	0
FKA-678	100	477	377	0	3	1	0	0
FKA-678	101	477	376	0	3	1	0	0
FKA-678	101	162	61	1	3	1	4	0
FKA-678	101	148	47	1	3	1	0	2
FKA-678	101	477	376	0	3	1	0	0
FKA-678	101	324	223	1	3	4	0	0
FKA-678	102	477	375	0	4	4	0	0
FKA-678	102	477	375	0	2	1	0	0
FKA-678	102	477	375	0	3	4	0	0
FKA-678	102	477	375	0	3	4	0	1
FKA-679	104	105	1	1	3	1	1	0
FKA-679	104	477	373	0	3	4	0	0
FKA-679	105	106	1	1	3	1	1	0
FKA-679	105	477	372	0	4	1	0	1
FKA-679	105	477	372	0	3	4	0	0
FKA-679	105	123	18	1	3	4	1	0
FKA-679	105	114	9	1	3	1	1	0
FKA-679	106	109	3	1	3	3	0	0
FKA-679	106	477	371	0	2	1	0	0
FKA-679	106	112	6	1	2	1	0	0
FKA-680	107	161	54	1	3	3	1	0
FKA-680	107	239	132	1	3	3	0	0
FKA-680	107	108	1	1	3	4	1	0
FKA-680	107	379	272	1	3	4	0	0
FKA-680	108	477	369	0	3	4	0	0
FKA-680	108	168	60	1	3	3	1	0
FKA-680	108	477	369	0	3	1	0	2
FKA-680	108	477	369	0	3	4	0	0
FKA-680	108	477	369	0	3	1	0	0
FKA-680	108	178	70	1	3	1	1	0
FKA-681	109	119	10	1	3	3	1	0
FKA-681	109	477	368	0	3	4	0	0
FKA-681	110	477	367	0	4	1	0	0
FKA-681	110	130	20	1	3	4	1	0
FKA-681	112	477	365	0	4	1	0	0
FKA-681	112	113	1	1	4	1	2	0
FKA-681	112	477	365	0	4	1	0	0
FKA-681	112	477	365	0	3	1	0	1
FKA-681	112	477	365	0	3	4	0	0
FKA-681	112	477	365	0	3	4	0	0
FKA-682	112	477	365	0	3	4	0	0
FKA-682	113	477	364	0	5	1	0	0
FKA-682	113	477	364	0	3	1	0	0
FKA-682	113	477	364	0	3	1	0	1
FKA-682	113	477	364	0	2	1	2	4
FKA-682	114	129	15	1	4	1	2	0
FKA-682	114	120	6	1	2	1	1	0
FKA-682	114	477	363	0	4	1	0	0
FKA-682	115	129	14	1	2	4	0	0
FKA-682	115	122	7	1	4	1	1	0
FKA-683	115	477	362	0	3	4	0	0
FKA-683	116	148	32	1	3	5	0	0
FKA-683	116	477	361	0	3	1	0	0
FKA-683	116	373	257	1	4	1	3	0
FKA-683	116	128	12	1	3	1	1	1
FKA-683	118	231	113	1	3	3	1	0
FKA-683	118	477	359	0	3	4	0	0
FKA-683	119	126	7	1	3	1	0	0
FKA-683	119	135	16	1	3	1	0	1
FKA-683	119	140	21	1	3	1	0	0
FKA-684	119	477	358	0	3	4	0	1
FKA-684	120	165	45	1	3	2	1	1
FKA-684	120	477	357	0	3	1	0	0
FKA-684	120	477	357	0	3	1	0	0
FKA-684	120	123	3	1	3	1	1	0
FKA-684	120	477	357	0	5	4	0	0
FKA-684	121	477	356	0	3	1	0	0
FKA-684	121	477	356	0	3	1	0	0
FKA-684	121	477	356	0	3	1	0	0
FKA-684	121	137	16	1	3	4	1	0
FKA-685	121	141	20	1	3	4	1	4
FKA-685	121	477	356	0	3	4	0	0
FKA-685	121	477	356	0	3	4	0	0
FKA-685	122	123	1	1	4	1	2	0
FKA-685	122	123	1	1	1	3	3	0
FKA-685	122	123	1	1	3	1	2	0
FKA-685	122	477	355	0	3	1	1	0
FKA-685	122	123	1	1	3	1	4	0
FKA-685	122	477	355	0	3	4	0	0
FKA-685	123	242	119	1	3	1	1	0
FKA-686	123	163	40	1	3	1	2	0
FKA-686	123	124	1	1	5	1	1	0
FKA-686	123	143	20	1	3	5	0	0
FKA-686	123	283	160	1	3	4	1	2
FKA-686	123	477	354	0	3	1	0	0
FKA-686	123	124	1	1	3	2	0	0
FKA-686	123	124	1	1	3	4	0	0
FKA-686	123	124	1	1	5	4	0	0
FKA-686	123	140	17	1	1	1	0	0
FKA-686	124	477	353	0	3	1	0	0
FKA-687	125	129	4	1	3	1	2	0
FKA-687	126	127	1	1	4	1	1	0
FKA-687	126	477	351	0	4	1	0	0
FKA-687	126	140	14	1	4	1	0	0
FKA-687	126	477	351	0	3	4	0	0
FKA-687	126	141	15	1	4	5	0	0
FKA-687	126	477	351	0	3	1	0	0
FKA-687	126	156	30	1	3	1	1	0
FKA-687	126	129	3	1	3	1	2	0
FKA-687	126	128	2	1	2	1	2	0
FKA-688	127	277	150	1	3	4	1	2
FKA-688	127	169	42	1	2	1	0	1
FKA-688	127	477	350	0	3	1	0	0
FKA-688	127	477	350	0	3	4	0	0
FKA-688	127	199	72	1	3	4	1	3
FKA-688	127	128	1	1	3	1	0	0
FKA-688	127	149	22	1	3	2	1	1
FKA-688	128	477	349	0	3	1	0	1
FKA-688	128	477	349	0	3	1	0	0
FKA-688	128	477	349	0	4	3	0	0
FKA-689	128	477	349	0	4	2	0	0
FKA-689	128	477	349	0	3	1	0	0
FKA-689	129	141	12	1	4	1	0	0
FKA-689	129	130	1	1	4	1	1	1
FKA-689	129	130	1	1	4	1	1	0
FKA-689	129	477	348	0	4	2	0	0
FKA-689	130	134	4	1	3	4	1	0
FKA-689	130	201	71	1	3	1	1	0
FKA-689	130	477	347	0	3	1	0	0
FKA-689	132	477	345	0	3	1	0	0
FKA-690	133	477	344	0	4	4	0	0
FKA-690	133	325	192	1	3	1	0	1
FKA-690	133	477	344	0	4	1	0	0
FKA-690	133	477	344	0	3	4	0	0
FKA-690	133	424	291	1	2	5	0	4
FKA-690	134	135	1	1	3	4	1	0
FKA-690	134	161	27	1	3	1	4	2
FKA-690	135	144	9	1	4	1	1	0
FKA-690	135	136	1	1	4	4	0	0
FKA-690	135	477	342	0	3	4	0	0
FKA-691	135	477	342	0	3	2	0	1
FKA-691	136	143	7	1	3	3	2	0
FKA-691	136	156	20	1	3	3	1	0
FKA-691	136	148	12	1	3	4	1	0
FKA-691	137	277	140	1	4	4	4	0
FKA-691	137	477	340	0	3	4	0	0
FKA-691	137	148	11	1	3	3	1	0
FKA-691	137	138	1	1	1	3	4	0
FKA-691	137	203	66	1	2	1	1	0
FKA-691	138	156	18	1	4	1	1	0
FKA-692	139	141	2	1	3	4	0	2
FKA-692	139	144	5	1	3	3	1	1
FKA-692	139	477	338	0	3	4	0	0
FKA-692	140	262	122	1	3	4	1	1
FKA-692	140	141	1	1	3	2	0	0
FKA-692	140	153	13	1	3	1	3	0
FKA-692	140	255	115	1	3	4	1	0
FKA-692	140	151	11	1	3	1	1	0
FKA-692	140	368	228	1	3	4	2	1
FKA-692	141	145	4	1	3	1	2	0
FKA-693	141	144	3	1	5	4	2	0
FKA-693	141	477	336	0	4	3	0	0
FKA-693	142	477	335	0	3	1	0	0
FKA-693	142	166	24	1	3	1	0	0
FKA-693	142	169	27	1	3	1	0	0
FKA-693	142	157	15	1	3	2	1	0
FKA-693	142	151	9	1	3	1	1	0
FKA-693	142	144	2	1	3	1	3	0
FKA-693	142	154	12	1	3	4	1	0
FKA-693	143	477	334	0	4	4	0	0
FKA-694	143	477	334	0	1	3	0	0
FKA-694	143	477	334	0	3	1	0	0
FKA-694	143	477	334	0	4	2	0	0
FKA-694	143	477	334	0	3	4	0	0
FKA-694	143	178	35	1	3	5	0	0
FKA-694	143	477	334	0	3	5	0	0
FKA-694	143	161	18	1	3	4	0	0
FKA-694	144	477	333	0	3	1	0	0
FKA-694	144	477	333	0	3	4	0	0
FKA-694	144	179	35	1	1	1	1	0
FKA-695	144	267	123	1	3	4	1	0
FKA-695	144	477	333	0	3	4	0	1
FKA-695	145	477	332	0	3	1	0	0
FKA-695	145	477	332	0	3	2	0	0
FKA-695	145	477	332	0	4	2	0	0
FKA-695	145	152	7	1	3	4	1	3
FKA-695	145	146	1	1	3	4	0	3
FKA-695	145	149	4	1	4	4	1	0
FKA-695	146	477	331	0	4	4	0	0
FKA-695	147	477	330	0	5	3	0	0
FKA-696	147	477	330	0	3	4	0	1
FKA-696	147	477	330	0	3	1	0	0
FKA-696	148	477	329	0	4	4	0	0
FKA-696	148	477	329	0	3	4	0	0
FKA-696	148	384	236	1	3	2	0	0
FKA-696	148	152	4	1	3	4	0	0
FKA-696	148	221	73	1	3	1	1	1
FKA-696	148	156	8	1	3	1	1	0
FKA-696	149	477	328	0	4	4	0	0
FKA-696	149	477	328	0	4	4	0	0
FKA-697	149	344	195	1	3	1	1	2
FKA-697	149	323	174	1	4	4	0	1
FKA-697	149	155	6	1	3	1	0	0
FKA-697	150	151	1	1	3	1	1	0
FKA-697	150	226	76	1	4	4	0	0
FKA-697	150	164	14	1	1	1	3	0
FKA-697	150	162	12	1	1	1	0	1
FKA-697	150	477	327	0	1	1	0	0
FKA-697	150	175	25	1	3	4	1	0
FKA-697	151	163	12	1	1	4	1	0
FKA-698	151	477	326	0	4	5	0	0
FKA-698	151	155	4	1	3	1	1	0
FKA-698	152	155	3	1	3	1	1	1
FKA-698	152	477	325	0	3	1	0	1
FKA-698	152	157	5	1	3	1	0	0
FKA-698	152	477	325	0	3	1	0	0
FKA-698	152	179	27	1	4	4	1	0
FKA-698	154	477	323	0	4	4	0	0
FKA-698	154	477	323	0	3	1	0	0
FKA-698	154	477	323	0	3	4	0	1
FKA-699	154	277	123	1	1	1	0	0
FKA-699	155	157	2	1	3	1	2	0
FKA-699	155	477	322	0	4	1	0	0
FKA-699	155	156	1	1	4	1	1	0
FKA-699	155	477	322	0	4	1	0	0
FKA-699	155	388	233	1	3	4	0	0
FKA-699	155	156	1	1	4	1	0	0
FKA-699	155	156	1	1	4	4	1	0
FKA-699	155	228	73	1	3	4	1	0
FKA-699	155	208	53	1	4	4	1	0
FKA-700	155	157	2	1	1	4	1	1
FKA-700	156	157	1	1	4	3	2	0
FKA-700	156	157	1	1	3	3	2	0
FKA-700	156	161	5	1	3	3	2	0
FKA-700	156	477	321	0	4	4	0	0
FKA-700	156	161	5	1	3	5	1	0
FKA-700	156	158	2	1	3	5	1	0
FKA-700	156	162	6	1	3	5	1	0
FKA-700	156	157	1	1	3	5	0	0
FKA-700	156	163	7	1	2	4	4	0
FKA-701	156	164	8	1	3	5	1	0
FKA-701	156	157	1	1	3	5	1	0
FKA-701	156	169	13	1	2	1	3	0
FKA-701	156	477	321	0	4	1	0	0
FKA-701	157	477	320	0	4	1	0	0
FKA-701	157	477	320	0	4	4	0	1
FKA-701	157	477	320	0	3	1	0	0
FKA-701	157	477	320	0	2	1	1	0
FKA-701	157	477	320	0	3	4	0	0
FKA-701	157	225	68	1	3	4	1	0
FKA-702	157	477	320	0	3	1	0	1
FKA-702	157	165	8	1	3	1	4	0
FKA-702	158	477	319	0	3	1	0	0
FKA-702	158	168	10	1	3	1	1	0
FKA-702	158	382	224	1	4	4	1	0
FKA-702	158	477	319	0	3	1	0	0
FKA-702	158	477	319	0	3	1	0	2
FKA-702	158	252	94	1	3	2	1	0
FKA-702	159	179	20	1	3	1	1	0
FKA-702	159	162	3	1	3	1	1	0
FKA-703	159	164	5	1	3	5	1	0
FKA-703	160	163	3	1	1	1	2	0
FKA-703	161	165	4	1	1	1	1	0
FKA-703	161	477	316	0	4	4	0	0
FKA-703	161	477	316	0	4	4	0	0
FKA-703	161	477	316	0	2	1	0	0
FKA-703	161	477	316	0	4	4	0	0
FKA-703	161	331	170	1	3	1	1	0
FKA-703	161	477	316	0	4	2	0	0
FKA-703	161	167	6	1	1	1	1	0
FKA-704	161	477	316	0	4	1	0	0
FKA-704	161	477	316	0	3	4	0	0
FKA-704	161	477	316	0	3	4	0	0
FKA-704	161	163	2	1	1	1	2	0
FKA-704	162	253	91	1	3	1	3	1
FKA-704	162	477	315	0	3	1	0	0
FKA-704	162	477	315	0	3	2	0	0
FKA-704	162	167	5	1	2	1	3	0
FKA-704	162	168	6	1	1	1	1	0
FKA-704	162	213	51	1	4	5	0	0
FKA-705	162	163	1	1	3	4	1	0
FKA-705	162	372	210	1	3	1	1	0
FKA-705	163	477	314	0	3	4	0	0
FKA-705	163	477	314	0	3	1	0	0
FKA-705	163	354	191	1	4	4	1	0
FKA-705	163	165	2	1	4	1	1	0
FKA-705	163	165	2	1	2	1	2	0
FKA-705	164	477	313	0	3	1	0	0
FKA-705	164	167	3	1	3	1	4	0
FKA-705	164	477	313	0	5	4	0	0
FKA-706	164	477	313	0	4	4	0	0
FKA-706	165	477	312	0	3	4	0	0
FKA-706	165	477	312	0	4	4	0	0
FKA-706	165	232	67	1	3	4	0	0
FKA-706	165	169	4	1	1	1	1	0
FKA-706	166	168	2	1	3	1	0	0
FKA-706	166	169	3	1	3	4	1	0
FKA-706	167	168	1	1	1	1	1	0
FKA-706	167	168	1	1	1	1	2	0
FKA-706	168	169	1	1	3	1	0	0
FKA-707	168	477	309	0	3	1	0	0
FKA-707	168	169	1	1	3	4	0	0
FKA-707	168	171	3	1	4	1	1	0
FKA-707	169	477	308	0	3	4	0	0
FKA-707	169	477	308	0	3	1	0	1
FKA-707	169	477	308	0	3	1	0	0
FKA-707	170	177	7	1	3	1	1	0
FKA-707	170	477	307	0	3	4	0	0
FKA-707	170	477	307	0	2	1	0	0
FKA-707	170	477	307	0	3	1	0	0
FKA-708	170	190	20	1	3	1	1	0
FKA-708	170	200	30	1	4	4	0	0
FKA-708	170	171	1	1	2	1	2	0
FKA-708	171	214	43	1	3	1	0	0
FKA-708	171	477	306	0	3	4	0	0
FKA-708	171	477	306	0	3	1	0	0
FKA-708	171	477	306	0	3	1	0	0
FKA-708	171	477	306	0	3	4	0	1
FKA-708	171	477	306	0	3	1	0	0
FKA-708	171	477	306	0	4	4	0	0
FKA-709	172	477	305	0	4	2	0	1
FKA-709	172	177	5	1	3	4	1	0
FKA-709	174	477	303	0	2	1	0	0
FKA-709	174	477	303	0	3	1	0	0
FKA-709	175	477	302	0	5	1	0	0
FKA-709	175	477	302	0	4	1	0	0
FKA-709	175	275	100	1	3	4	1	0
FKA-709	175	178	3	1	3	1	1	0
FKA-709	176	200	24	1	3	4	0	0
FKA-709	176	178	2	1	3	1	0	1
FKA-710	176	177	1	1	3	1	0	1
FKA-710	176	183	7	1	3	4	1	0
FKA-710	176	477	301	0	2	1	0	0
FKA-710	176	197	21	1	3	1	1	0
FKA-710	176	178	2	1	3	1	3	0
FKA-710	176	477	301	0	4	4	0	0
FKA-710	176	477	301	0	4	4	0	1
FKA-710	176	477	301	0	3	4	0	1
FKA-710	177	477	300	0	3	1	0	0
FKA-710	177	477	300	0	4	4	0	0
FKA-711	177	368	191	1	3	1	1	0
FKA-711	177	179	2	1	5	4	1	1
FKA-711	178	179	1	1	3	1	1	0
FKA-711	178	477	299	0	3	1	0	0
FKA-711	178	477	299	0	1	1	0	0
FKA-711	178	179	1	1	3	1	0	0
FKA-711	178	179	1	1	3	4	0	0
FKA-711	178	250	72	1	3	4	1	0
FKA-711	179	477	298	0	3	4	0	0
FKA-711	179	227	48	1	3	1	4	0
FKA-712	179	477	298	0	2	4	0	0
FKA-712	179	477	298	0	3	1	0	0
FKA-712	179	477	298	0	1	1	0	0
FKA-712	180	181	1	1	4	4	0	0
FKA-712	181	182	1	1	3	1	0	0
FKA-712	181	213	32	1	4	1	0	0
FKA-712	182	206	24	1	3	4	2	0
FKA-712	182	477	295	0	3	5	0	0
FKA-712	182	239	57	1	3	1	3	0
FKA-712	183	477	294	0	4	4	0	0
FKA-713	183	186	3	1	3	1	0	1
FKA-713	183	293	110	1	4	4	3	0
FKA-713	184	477	293	0	2	4	0	0
FKA-713	184	477	293	0	3	1	0	0
FKA-713	185	241	56	1	3	1	1	0
FKA-713	185	477	292	0	3	1	0	0
FKA-713	185	187	2	1	1	1	2	0
FKA-713	186	248	62	1	4	5	0	1
FKA-713	186	477	291	0	4	1	0	0
FKA-713	189	236	47	1	4	3	1	0
FKA-714	189	222	33	1	4	4	0	0
FKA-714	189	200	11	1	3	1	1	0
FKA-714	189	452	263	1	3	4	1	0
FKA-714	190	477	287	0	3	4	0	0
FKA-714	190	205	15	1	3	1	2	0
FKA-714	190	477	287	0	1	1	0	0
FKA-714	190	477	287	0	2	5	0	0
FKA-714	190	221	31	1	3	4	1	0
FKA-714	191	477	286	0	1	1	0	0
FKA-714	191	477	286	0	3	4	0	0
FKA-715	191	259	68	1	3	1	0	0
FKA-715	191	477	286	0	3	1	0	0
FKA-715	191	201	10	1	3	4	1	0
FKA-715	192	477	285	0	3	1	0	0
FKA-715	192	201	9	1	3	1	0	0
FKA-715	192	477	285	0	4	1	0	0
FKA-715	192	193	1	1	3	1	0	1
FKA-715	192	477	285	0	3	1	0	0
FKA-715	192	219	27	1	3	1	2	0
FKA-715	193	205	12	1	5	4	0	0
FKA-716	193	477	284	0	4	4	0	0
FKA-716	193	212	19	1	3	4	1	0
FKA-716	194	477	283	0	4	1	0	0
FKA-716	194	197	3	1	3	1	0	0
FKA-716	194	224	30	1	3	1	3	0
FKA-716	195	311	116	1	3	1	1	4
FKA-716	196	477	281	0	3	1	0	0
FKA-716	196	477	281	0	2	1	0	0
FKA-716	196	198	2	1	3	1	1	0
FKA-716	196	225	29	1	4	4	1	0
FKA-717	196	197	1	1	3	1	0	1
FKA-717	197	477	280	0	3	1	0	0
FKA-717	197	477	280	0	3	2	0	1
FKA-717	197	198	1	1	3	4	0	0
FKA-717	197	477	280	0	3	4	0	0
FKA-717	197	477	280	0	3	4	0	0
FKA-717	198	477	279	0	3	1	0	0
FKA-717	198	201	3	1	4	3	1	0
FKA-717	198	477	279	0	3	4	0	0
FKA-717	198	477	279	0	3	1	0	0
FKA-718	198	210	12	1	4	1	2	0
FKA-718	198	369	171	1	3	1	1	1
FKA-718	198	199	1	1	1	1	1	0
FKA-718	198	324	126	1	3	5	0	0
FKA-718	199	200	1	1	1	5	0	0
FKA-718	199	200	1	1	1	1	1	0
FKA-718	199	477	278	0	3	1	0	0
FKA-718	200	477	277	0	4	4	0	1
FKA-718	200	477	277	0	3	1	0	0
FKA-718	200	477	277	0	4	4	0	0
FKA-719	200	477	277	0	3	4	0	1
FKA-719	202	477	275	0	3	4	0	0
FKA-719	203	207	4	1	2	1	4	0
FKA-719	203	204	1	1	3	1	1	0
FKA-719	203	204	1	1	3	1	1	0
FKA-719	203	204	1	1	3	5	1	0
FKA-719	203	288	85	1	4	1	4	0
FKA-719	204	477	273	0	4	4	0	0
FKA-719	204	281	77	1	3	4	4	1
FKA-719	204	477	273	0	3	4	0	0
FKA-720	204	477	273	0	3	4	0	0
FKA-720	204	477	273	0	3	4	0	0
FKA-720	204	477	273	0	3	2	0	0
FKA-720	205	477	272	0	3	4	0	1
FKA-720	205	477	272	0	4	1	0	0
FKA-720	205	477	272	0	3	2	0	0
FKA-720	205	477	272	0	2	4	0	0
FKA-720	206	220	14	1	5	4	1	0
FKA-720	206	207	1	1	3	1	0	0
FKA-720	206	477	271	0	2	1	0	0
FKA-721	206	231	25	1	3	4	1	0
FKA-721	206	246	40	1	3	4	1	0
FKA-721	207	477	270	0	4	1	0	0
FKA-721	207	477	270	0	3	1	0	0
FKA-721	210	477	267	0	2	1	0	0
FKA-721	210	281	71	1	4	4	1	0
FKA-721	210	268	58	1	3	1	4	1
FKA-721	210	477	267	0	3	4	0	0
FKA-721	211	477	266	0	4	4	0	0
FKA-721	211	477	266	0	3	4	0	0
FKA-722	211	477	266	0	4	4	0	0
FKA-722	211	424	213	1	3	4	0	0
FKA-722	211	225	14	1	3	4	1	4
FKA-722	211	388	177	1	3	4	1	4
FKA-722	211	477	266	0	3	4	0	3
FKA-722	212	218	6	1	4	1	2	0
FKA-722	212	214	2	1	4	1	0	0
FKA-722	212	477	265	0	4	4	0	0
FKA-722	212	213	1	1	3	3	2	0
FKA-722	212	213	1	1	3	1	0	0
FKA-723	212	477	265	0	3	1	0	0
FKA-723	212	324	112	1	4	1	2	0
FKA-723	213	477	264	0	4	4	0	0
FKA-723	213	214	1	1	2	1	0	0
FKA-723	213	477	264	0	3	4	0	0
FKA-723	213	336	123	1	3	4	1	1
FKA-723	213	407	194	1	4	4	1	0
FKA-723	213	477	264	0	4	1	0	0
FKA-723	213	477	264	0	3	1	0	0
FKA-723	213	477	264	0	3	1	0	0
FKA-724	213	235	22	1	3	1	1	0
FKA-724	214	477	263	0	3	3	0	0
FKA-724	214	239	25	1	3	1	2	0
FKA-724	214	445	231	1	3	4	1	0
FKA-724	214	233	19	1	4	4	0	1
FKA-724	215	477	262	0	4	4	0	0
FKA-724	216	477	261	0	3	2	0	0
FKA-724	216	219	3	1	5	1	1	0
FKA-724	216	477	261	0	2	1	0	0
FKA-724	217	477	260	0	3	2	0	0
FKA-725	217	218	1	1	3	1	2	1
FKA-725	217	477	260	0	3	2	0	1
FKA-725	217	218	1	1	5	3	0	0
FKA-725	218	372	154	1	4	1	3	0
FKA-725	218	477	259	0	3	1	0	0
FKA-725	219	223	4	1	1	1	4	0
FKA-725	219	477	258	0	3	1	0	0
FKA-725	219	224	5	1	3	1	0	0
FKA-725	219	477	258	0	3	1	0	0
FKA-725	219	333	114	1	4	3	1	0
FKA-726	219	477	258	0	3	1	0	0
FKA-726	219	223	4	1	3	1	4	0
FKA-726	220	477	257	0	3	4	0	0
FKA-726	220	477	257	0	3	1	0	0
FKA-726	220	283	63	1	3	4	1	4
FKA-726	220	477	257	0	4	1	0	0
FKA-726	220	277	57	1	4	4	2	0
FKA-726	220	477	257	0	4	4	0	0
FKA-726	220	420	200	1	1	3	0	1
FKA-726	220	240	20	1	3	4	1	0
FKA-727	220	477	257	0	3	4	0	0
FKA-727	220	477	257	0	3	4	0	0
FKA-727	220	477	257	0	3	4	0	0
FKA-727	220	477	257	0	3	4	0	0
FKA-727	221	477	256	0	3	1	0	0
FKA-727	221	477	256	0	3	4	0	0
FKA-727	221	477	256	0	3	3	0	0
FKA-727	221	276	55	1	3	4	1	1
FKA-727	222	231	9	1	3	4	3	2
FKA-727	224	233	9	1	3	1	0	1
FKA-728	224	256	32	1	2	1	3	1
FKA-728	224	477	253	0	4	3	0	0
FKA-728	224	477	253	0	3	1	0	0
FKA-728	224	416	192	1	3	2	1	0
FKA-728	224	225	1	1	2	1	4	0
FKA-728	224	227	3	1	3	4	3	0
FKA-728	224	251	27	1	4	1	2	0
FKA-728	225	242	17	1	3	1	3	0
FKA-728	225	432	207	1	2	1	1	0
FKA-728	225	477	252	0	3	4	0	1
FKA-729	225	477	252	0	3	1	0	0
FKA-729	225	239	14	1	3	1	0	0
FKA-729	225	477	252	0	3	4	0	0
FKA-729	225	477	252	0	3	4	0	1
FKA-729	225	477	252	0	3	4	0	1
FKA-729	226	477	251	0	3	4	0	0
FKA-729	226	227	1	1	3	1	1	0
FKA-729	226	477	251	0	3	4	0	0
FKA-729	227	231	4	1	3	1	1	0
FKA-729	227	228	1	1	3	5	3	0
FKA-730	227	477	250	0	4	2	0	0
FKA-730	227	232	5	1	3	1	2	0
FKA-730	227	477	250	0	4	4	0	0
FKA-730	227	231	4	1	3	1	0	0
FKA-730	228	477	249	0	3	1	0	2
FKA-730	228	477	249	0	3	1	0	0
FKA-730	229	477	248	0	3	2	0	0
FKA-730	229	282	53	1	3	5	0	0
FKA-730	229	230	1	1	3	5	1	0
FKA-730	229	236	7	1	3	5	1	0
FKA-731	229	240	11	1	2	5	1	0
FKA-731	230	231	1	1	3	1	1	0
FKA-731	230	427	197	1	2	1	3	0
FKA-731	230	310	80	1	3	4	2	0
FKA-731	231	477	246	0	2	1	0	0
FKA-731	231	477	246	0	3	4	0	0
FKA-731	232	259	27	1	3	1	2	1
FKA-731	232	477	245	0	3	4	0	1
FKA-731	232	477	245	0	3	4	0	0
FKA-731	232	477	245	0	4	3	0	0
FKA-732	232	477	245	0	3	4	0	3
FKA-732	232	477	245	0	3	4	0	1
FKA-732	232	260	28	1	3	1	1	0
FKA-732	233	322	89	1	3	1	0	0
FKA-732	233	240	7	1	3	1	1	0
FKA-732	233	477	244	0	3	2	0	0
FKA-732	233	243	10	1	3	4	1	0
FKA-732	234	477	243	0	1	1	0	0
FKA-732	234	477	243	0	3	4	0	0
FKA-732	234	477	243	0	3	1	0	0
FKA-733	234	477	243	0	3	1	0	0
FKA-733	234	477	243	0	3	1	0	0
FKA-733	234	260	26	1	5	4	1	0
FKA-733	234	251	17	1	3	1	1	0
FKA-733	234	477	243	0	3	4	0	0
FKA-733	234	477	243	0	3	4	0	0
FKA-733	235	477	242	0	3	1	0	0
FKA-733	235	477	242	0	3	4	0	0
FKA-733	236	241	5	1	3	5	1	0
FKA-733	236	477	241	0	3	4	0	0
FKA-734	236	477	241	0	3	5	0	0
FKA-734	236	477	241	0	3	5	0	0
FKA-734	236	477	241	0	3	5	0	0
FKA-734	236	477	241	0	3	5	0	0
FKA-734	237	477	240	0	4	4	0	0
FKA-734	237	477	240	0	4	1	0	0
FKA-734	237	477	240	0	3	1	0	0
FKA-734	237	239	2	1	3	1	1	0
FKA-734	238	477	239	0	3	1	0	0
FKA-734	238	477	239	0	4	1	0	0
FKA-735	238	477	239	0	3	4	0	0
FKA-735	239	477	238	0	4	1	0	0
FKA-735	239	298	59	1	3	4	1	0
FKA-735	239	248	9	1	4	1	4	0
FKA-735	240	241	1	1	3	1	3	0
FKA-735	240	274	34	1	2	1	0	1
FKA-735	240	477	237	0	4	2	0	0
FKA-735	240	477	237	0	2	1	0	0
FKA-735	241	477	236	0	4	5	0	0
FKA-735	241	477	236	0	3	3	0	0
FKA-736	241	477	236	0	4	1	0	0
FKA-736	241	477	236	0	3	1	0	0
FKA-736	242	477	235	0	3	4	0	0
FKA-736	242	244	2	1	3	3	0	0
FKA-736	242	477	235	0	3	1	0	1
FKA-736	242	248	6	1	3	1	0	0
FKA-736	242	281	39	1	3	1	1	1
FKA-736	242	330	88	1	3	4	1	0
FKA-736	242	477	235	0	3	4	0	3
FKA-736	242	243	1	1	3	1	2	0
FKA-737	242	259	17	1	4	4	0	0
FKA-737	243	477	234	0	3	5	0	0
FKA-737	243	250	7	1	3	5	1	0
FKA-737	245	477	232	0	3	1	0	0
FKA-737	246	347	101	1	3	4	0	1
FKA-737	246	477	231	0	3	3	0	0
FKA-737	246	477	231	0	3	1	0	0
FKA-737	246	477	231	0	4	4	0	0
FKA-737	247	477	230	0	3	1	0	0
FKA-737	247	262	15	1	4	1	1	0
FKA-738	248	477	229	0	4	1	0	1
FKA-738	248	477	229	0	3	4	0	0
FKA-738	248	477	229	0	3	1	0	0
FKA-738	248	477	229	0	3	4	0	0
FKA-738	249	477	228	0	1	1	0	0
FKA-738	249	251	2	1	3	1	1	0
FKA-738	249	253	4	1	3	1	2	0
FKA-738	249	250	1	1	4	1	0	0
FKA-738	250	260	10	1	3	1	1	1
FKA-738	250	333	83	1	3	4	2	1
FKA-739	250	477	227	0	3	4	0	1
FKA-739	250	379	129	1	3	4	1	0
FKA-739	251	477	226	0	3	4	0	0
FKA-739	252	275	23	1	3	4	0	0
FKA-739	252	255	3	1	3	4	1	0
FKA-739	252	277	25	1	3	4	1	2
FKA-739	253	254	1	1	3	4	1	0
FKA-739	253	477	224	0	3	4	0	1
FKA-739	253	477	224	0	4	3	0	0
FKA-739	253	261	8	1	4	4	1	0
FKA-740	253	263	10	1	4	1	1	0
FKA-740	253	407	154	1	3	1	1	0
FKA-740	253	320	67	1	4	4	1	1
FKA-740	253	267	14	1	1	1	1	0
FKA-740	254	477	223	0	3	4	0	1
FKA-740	254	477	223	0	3	4	0	1
FKA-740	254	274	20	1	3	4	1	3
FKA-740	255	477	222	0	3	1	0	0
FKA-740	255	477	222	0	3	4	0	0
FKA-740	255	270	15	1	3	1	1	0
FKA-741	256	477	221	0	3	1	0	0
FKA-741	256	477	221	0	3	1	0	0
FKA-741	256	312	56	1	3	1	1	0
FKA-741	256	301	45	1	3	4	1	0
FKA-741	256	259	3	1	3	4	3	0
FKA-741	256	276	20	1	3	1	3	0
FKA-741	256	477	221	0	3	1	0	0
FKA-741	259	477	218	0	3	1	0	0
FKA-741	260	325	65	1	3	4	1	1
FKA-741	260	424	164	1	4	5	0	0
FKA-742	260	338	78	1	4	4	1	1
FKA-742	261	477	216	0	3	1	0	0
FKA-742	261	477	216	0	3	1	0	0
FKA-742	261	477	216	0	2	1	0	0
FKA-742	262	477	215	0	2	1	0	0
FKA-742	262	263	1	1	1	1	0	1
FKA-742	262	477	215	0	5	1	0	0
FKA-742	262	477	215	0	3	1	0	0
FKA-742	262	324	62	1	3	5	0	0
FKA-742	263	275	12	1	3	4	1	1
FKA-743	263	266	3	1	5	4	1	0
FKA-743	264	310	46	1	4	3	1	0
FKA-743	264	477	213	0	3	2	0	1
FKA-743	266	396	130	1	3	4	1	3
FKA-743	266	271	5	1	3	1	2	0
FKA-743	266	477	211	0	3	4	1	0
FKA-743	266	477	211	0	3	1	0	0
FKA-743	266	268	2	1	3	4	1	0
FKA-743	267	477	210	0	3	4	0	0
FKA-743	267	322	55	1	3	5	2	0
FKA-744	267	408	141	1	3	4	1	2
FKA-744	268	277	9	1	1	4	1	0
FKA-744	268	477	209	0	3	1	0	0
FKA-744	268	344	76	1	3	1	4	0
FKA-744	268	477	209	0	4	4	0	0
FKA-744	269	477	208	0	4	2	0	0
FKA-744	269	337	68	1	5	4	1	0
FKA-744	269	477	208	0	3	1	0	0
FKA-744	269	477	208	0	3	1	0	0
FKA-744	269	332	63	1	3	1	1	0
FKA-745	270	477	207	0	3	1	0	1
FKA-745	270	477	207	0	4	1	0	0
FKA-745	270	315	45	1	3	1	0	0
FKA-745	270	271	1	1	3	1	3	1
FKA-745	270	271	1	1	3	4	3	1
FKA-745	270	477	207	0	3	1	0	1
FKA-745	270	273	3	1	3	4	1	0
FKA-745	270	477	207	0	4	1	0	0
FKA-745	271	477	206	0	3	4	0	2
FKA-745	271	273	2	1	2	1	2	0
FKA-746	272	273	1	1	1	1	3	0
FKA-746	272	378	106	1	1	4	1	0
FKA-746	273	280	7	1	3	1	1	0
FKA-746	273	477	204	0	3	1	0	0
FKA-746	273	290	17	1	2	1	2	0
FKA-746	273	477	204	0	4	1	0	0
FKA-746	273	477	204	0	3	4	0	0
FKA-746	273	277	4	1	3	1	4	0
FKA-746	274	477	203	0	4	4	0	0
FKA-746	274	477	203	0	3	1	1	0
FKA-747	274	477	203	0	3	2	0	0
FKA-747	274	477	203	0	3	2	0	0
FKA-747	274	477	203	0	2	2	0	0
FKA-747	274	477	203	0	3	4	0	0
FKA-747	274	477	203	0	3	1	0	0
FKA-747	274	283	9	1	3	4	1	0
FKA-747	274	277	3	1	3	1	4	1
FKA-747	275	281	6	1	4	4	1	1
FKA-747	276	280	4	1	4	4	1	0
FKA-747	276	477	201	0	3	1	0	0
FKA-748	276	477	201	0	3	4	0	0
FKA-748	277	477	200	0	2	1	0	0
FKA-748	277	284	7	1	3	1	1	0
FKA-748	277	281	4	1	3	1	1	0
FKA-748	277	278	1	1	3	1	1	0
FKA-748	277	284	7	1	3	1	1	0
FKA-748	277	477	200	0	3	5	0	0
FKA-748	277	413	136	1	4	4	1	0
FKA-748	277	477	200	0	3	1	0	0
FKA-748	280	477	197	0	3	5	0	0
FKA-749	280	477	197	0	3	4	0	0
FKA-749	280	477	197	0	3	1	0	1
FKA-749	281	417	136	1	4	4	1	0
FKA-749	281	477	196	0	3	4	0	0
FKA-749	282	283	1	1	3	5	0	0
FKA-749	282	283	1	1	3	1	0	1
FKA-749	282	288	6	1	4	1	1	1
FKA-749	283	477	194	0	3	2	0	0
FKA-749	283	287	4	1	3	1	1	0
FKA-749	283	477	194	0	3	4	0	0
FKA-750	284	477	193	0	4	2	0	1
FKA-750	284	294	10	1	2	1	1	0
FKA-750	285	454	169	1	3	4	0	0
FKA-750	286	378	92	1	4	3	3	0
FKA-750	286	477	191	0	3	4	0	0
FKA-750	286	290	4	1	3	1	1	0
FKA-750	287	288	1	1	3	1	0	1
FKA-750	287	477	190	0	3	1	0	0
FKA-750	287	330	43	1	1	3	0	0
FKA-750	287	477	190	0	3	4	0	1
FKA-751	288	368	80	1	3	4	1	0
FKA-751	288	477	189	0	2	1	0	0
FKA-751	288	289	1	1	1	1	0	1
FKA-751	288	289	1	1	3	1	1	0
FKA-751	288	364	76	1	4	4	0	0
FKA-751	288	364	76	1	4	4	0	0
FKA-751	289	477	188	0	3	4	0	0
FKA-751	289	477	188	0	4	4	0	0
FKA-751	290	315	25	1	3	1	2	0
FKA-751	290	294	4	1	1	1	2	0
FKA-752	291	381	90	1	4	4	0	0
FKA-752	291	292	1	1	2	1	1	1
FKA-752	291	477	186	0	3	4	0	0
FKA-752	292	477	185	0	4	4	0	0
FKA-752	293	300	7	1	3	4	1	0
FKA-752	293	477	184	0	3	4	0	0
FKA-752	293	477	184	0	5	4	0	0
FKA-752	293	477	184	0	4	4	0	0
FKA-752	294	323	29	1	4	4	1	0
FKA-752	294	477	183	0	3	3	0	0
FKA-753	294	477	183	0	3	1	0	0
FKA-753	295	477	182	0	2	1	1	0
FKA-753	295	298	3	1	4	1	3	0
FKA-753	295	298	3	1	4	1	0	1
FKA-753	295	298	3	1	3	1	4	0
FKA-753	295	297	2	1	3	1	2	1
FKA-753	295	323	28	1	4	1	3	0
FKA-753	296	309	13	1	3	4	1	0
FKA-753	296	477	181	0	3	4	0	0
FKA-753	296	297	1	1	3	5	0	1
FKA-754	296	477	181	0	2	1	2	2
FKA-754	296	424	128	1	2	5	0	3
FKA-754	296	477	181	0	3	1	0	0
FKA-754	296	477	181	0	3	3	0	0
FKA-754	296	477	181	0	3	1	0	0
FKA-754	297	477	180	0	4	4	0	0
FKA-754	297	477	180	0	3	4	0	0
FKA-754	297	477	180	0	3	4	0	0
FKA-754	297	477	180	0	3	4	0	0
FKA-754	297	343	46	1	3	1	2	0
FKA-755	297	477	180	0	4	1	0	0
FKA-755	297	333	36	1	4	3	1	0
FKA-755	297	299	2	1	4	1	1	0
FKA-755	297	477	180	0	4	1	0	0
FKA-755	297	322	25	1	3	4	0	0
FKA-755	298	477	179	0	3	1	0	0
FKA-755	298	477	179	0	2	1	0	0
FKA-755	298	315	17	1	3	1	1	0
FKA-755	299	477	178	0	3	4	0	0
FKA-755	300	309	9	1	3	4	2	0
FKA-756	300	310	10	1	1	1	2	0
FKA-756	300	306	6	1	3	1	4	0
FKA-756	301	477	176	0	1	1	0	0
FKA-756	301	477	176	0	3	1	0	0
FKA-756	301	364	63	1	4	4	0	0
FKA-756	301	477	176	0	2	1	0	1
FKA-756	301	477	176	0	4	4	0	0
FKA-756	301	302	1	1	3	4	1	0
FKA-756	301	304	3	1	3	4	1	0
FKA-756	302	477	175	0	4	1	0	0
FKA-757	302	477	175	0	3	4	0	0
FKA-757	302	477	175	0	3	4	0	0
FKA-757	302	477	175	0	3	1	0	0
FKA-757	302	477	175	0	3	4	0	0
FKA-757	302	477	175	0	3	1	0	0
FKA-757	303	477	174	0	3	1	0	3
FKA-757	303	319	16	1	3	1	3	1
FKA-757	303	323	20	1	3	1	0	2
FKA-757	303	477	174	0	4	2	0	1
FKA-757	303	310	7	1	3	1	2	0
FKA-758	304	368	64	1	4	1	0	0
FKA-758	304	477	173	0	1	1	0	0
FKA-758	304	305	1	1	4	1	0	0
FKA-758	304	307	3	1	3	1	0	1
FKA-758	305	318	13	1	4	4	3	0
FKA-758	305	477	172	0	4	4	0	0
FKA-758	305	477	172	0	4	4	0	0
FKA-758	307	477	170	0	3	4	0	0
FKA-758	307	477	170	0	3	4	0	0
FKA-758	307	477	170	0	3	4	0	0
FKA-759	308	315	7	1	3	5	0	0
FKA-759	308	477	169	0	3	4	0	0
FKA-759	308	477	169	0	1	1	0	0
FKA-759	308	477	169	0	3	1	0	0
FKA-759	308	477	169	0	4	5	0	0
FKA-759	308	309	1	1	3	1	0	0
FKA-759	309	477	168	0	3	4	0	0
FKA-759	309	477	168	0	4	4	0	0
FKA-759	309	477	168	0	3	1	0	0
FKA-759	309	477	168	0	3	4	0	0
FKA-760	309	477	168	0	4	4	0	0
FKA-760	309	477	168	0	3	1	0	0
FKA-760	309	477	168	0	4	4	0	0
FKA-760	310	477	167	0	3	4	0	0
FKA-760	310	314	4	1	3	1	0	0
FKA-760	310	316	6	1	3	1	1	0
FKA-760	311	477	166	0	1	3	1	0
FKA-760	311	325	14	1	3	1	3	1
FKA-760	311	477	166	0	3	4	0	1
FKA-760	311	376	65	1	3	5	0	0
FKA-761	313	344	31	1	3	4	2	0
FKA-761	314	477	163	0	3	4	0	0
FKA-761	314	316	2	1	3	5	1	0
FKA-761	314	477	163	0	3	5	0	0
FKA-761	314	477	163	0	3	5	0	0
FKA-761	314	477	163	0	4	2	0	0
FKA-761	314	323	9	1	5	1	1	0
FKA-761	315	333	18	1	4	3	1	0
FKA-761	315	364	49	1	4	1	0	0
FKA-761	315	477	162	0	4	4	0	0
FKA-762	316	331	15	1	3	1	3	0
FKA-762	316	477	161	0	3	1	0	0
FKA-762	316	477	161	0	3	2	0	0
FKA-762	317	318	1	1	3	5	0	0
FKA-762	317	477	160	0	3	5	0	0
FKA-762	317	360	43	1	2	1	0	0
FKA-762	317	318	1	1	3	1	0	0
FKA-762	317	477	160	0	3	1	0	0
FKA-762	317	424	107	1	3	1	0	0
FKA-762	317	477	160	0	3	1	0	0
FKA-763	318	477	159	0	4	4	0	0
FKA-763	318	477	159	0	4	4	0	0
FKA-763	318	477	159	0	3	4	0	0
FKA-763	318	477	159	0	3	1	0	0
FKA-763	319	477	158	0	3	1	0	0
FKA-763	319	477	158	0	3	1	0	1
FKA-763	319	477	158	0	4	4	0	1
FKA-763	319	477	158	0	3	1	0	0
FKA-763	319	477	158	0	4	4	0	0
FKA-763	319	477	158	0	3	4	0	0
FKA-764	319	477	158	0	3	1	0	0
FKA-764	319	397	78	1	3	4	1	1
FKA-764	319	477	158	0	3	1	0	0
FKA-764	319	477	158	0	3	1	0	0
FKA-764	319	477	158	0	3	4	0	0
FKA-764	319	477	158	0	3	3	0	0
FKA-764	319	477	158	0	3	5	0	0
FKA-764	319	477	158	0	2	5	1	0
FKA-764	319	477	158	0	3	5	0	0
FKA-764	319	477	158	0	3	5	0	0
FKA-765	319	477	158	0	3	4	0	0
FKA-765	320	427	107	1	2	5	3	1
FKA-765	320	477	157	0	3	1	0	0
FKA-765	321	477	156	0	4	4	0	0
FKA-765	322	477	155	0	3	4	0	0
FKA-765	322	346	24	1	3	1	3	1
FKA-765	322	477	155	0	3	1	0	0
FKA-765	323	369	46	1	3	1	1	1
FKA-765	323	477	154	0	3	4	0	1
FKA-765	323	324	1	1	3	4	0	0
FKA-766	323	333	10	1	4	1	4	0
FKA-766	323	477	154	0	3	4	0	0
FKA-766	323	477	154	0	3	1	0	0
FKA-766	323	477	154	0	3	1	0	2
FKA-766	323	477	154	0	4	4	0	0
FKA-766	324	477	153	0	3	4	0	0
FKA-766	324	477	153	0	3	2	0	0
FKA-766	325	477	152	0	3	4	0	0
FKA-766	325	326	1	1	4	1	0	1
FKA-766	325	477	152	0	3	5	0	0
FKA-767	325	409	84	1	4	4	0	0
FKA-767	329	332	3	1	3	4	4	0
FKA-767	329	418	89	1	2	1	1	0
FKA-767	329	339	10	1	3	4	1	0
FKA-767	329	477	148	0	4	1	0	0
FKA-767	329	477	148	0	4	4	0	0
FKA-767	329	333	4	1	4	1	0	0
FKA-767	330	477	147	0	3	2	0	0
FKA-767	330	338	8	1	4	1	4	0
FKA-767	330	477	147	0	3	1	0	0
FKA-768	330	477	147	0	3	1	0	0
FKA-768	330	477	147	0	3	4	0	0
FKA-768	330	477	147	0	3	4	0	0
FKA-768	331	352	21	1	4	4	0	0
FKA-768	331	477	146	0	3	1	0	0
FKA-768	331	477	146	0	4	4	0	0
FKA-768	332	477	145	0	4	3	0	0
FKA-768	332	337	5	1	3	4	1	0
FKA-768	332	477	145	0	1	1	1	0
FKA-768	332	477	145	0	3	4	0	0
FKA-769	333	477	144	0	3	4	0	0
FKA-769	333	477	144	0	3	4	0	0
FKA-769	335	389	54	1	3	1	4	0
FKA-769	335	389	54	1	3	1	4	0
FKA-769	336	477	141	0	3	5	0	0
FKA-769	336	371	35	1	3	1	0	0
FKA-769	336	337	1	1	3	1	0	1
FKA-769	336	338	2	1	1	1	2	4
FKA-769	336	477	141	0	3	1	0	0
FKA-769	336	477	141	0	3	2	0	0
FKA-770	336	477	141	0	4	1	0	0
FKA-770	336	477	141	0	4	3	0	0
FKA-770	336	337	1	1	3	1	3	0
FKA-770	336	477	141	0	3	1	0	1
FKA-770	337	339	2	1	3	1	2	0
FKA-770	337	345	8	1	4	1	1	0
FKA-770	338	339	1	1	3	1	0	0
FKA-770	338	360	22	1	4	4	0	0
FKA-770	338	477	139	0	3	1	0	0
FKA-770	338	340	2	1	3	1	2	0
FKA-771	339	477	138	0	3	1	0	0
FKA-771	339	477	138	0	4	4	0	0
FKA-771	340	345	5	1	3	1	1	0
FKA-771	340	477	137	0	3	1	0	0
FKA-771	340	477	137	0	4	4	0	0
FKA-771	341	352	11	1	2	4	0	0
FKA-771	343	477	134	0	3	1	0	0
FKA-771	343	477	134	0	4	4	0	0
FKA-771	343	477	134	0	3	4	0	0
FKA-771	344	396	52	1	3	4	1	0
FKA-772	344	477	133	0	3	4	0	0
FKA-772	344	477	133	0	3	1	0	0
FKA-772	344	477	133	0	5	2	0	0
FKA-772	345	443	98	1	4	4	0	0
FKA-772	345	477	132	0	3	1	0	0
FKA-772	345	477	132	0	3	2	0	0
FKA-772	345	477	132	0	3	1	0	0
FKA-772	345	477	132	0	3	1	0	0
FKA-772	346	477	131	0	3	4	0	0
FKA-772	346	477	131	0	4	1	0	0
FKA-773	346	437	91	1	3	2	1	0
FKA-773	346	477	131	0	3	2	0	0
FKA-773	346	477	131	0	3	1	0	0
FKA-773	346	477	131	0	3	4	0	0
FKA-773	347	368	21	1	3	4	2	0
FKA-773	347	477	130	0	3	1	0	0
FKA-773	347	429	82	1	4	3	0	0
FKA-773	347	477	130	0	4	3	0	0
FKA-773	347	381	34	1	4	4	1	0
FKA-773	347	477	130	0	3	2	0	1
FKA-774	347	477	130	0	3	4	0	0
FKA-774	349	388	39	1	3	1	3	0
FKA-774	350	353	3	1	3	1	1	0
FKA-774	350	477	127	0	2	1	0	0
FKA-774	350	477	127	0	5	1	0	0
FKA-774	350	477	127	0	2	1	0	0
FKA-774	350	477	127	0	4	1	0	0
FKA-774	350	477	127	0	3	4	0	0
FKA-774	350	477	127	0	3	2	0	0
FKA-774	351	477	126	0	3	4	0	0
FKA-775	351	477	126	0	3	4	0	0
FKA-775	351	477	126	0	3	4	0	0
FKA-775	351	368	17	1	3	1	1	0
FKA-775	351	353	2	1	4	5	0	0
FKA-775	352	477	125	0	4	1	0	0
FKA-775	352	371	19	1	1	1	2	2
FKA-775	352	360	8	1	1	1	0	0
FKA-775	352	477	125	0	3	1	0	1
FKA-775	352	412	60	1	3	4	1	0
FKA-775	352	353	1	1	3	1	3	0
FKA-776	353	477	124	0	3	4	0	2
FKA-776	353	357	4	1	3	4	0	2
FKA-776	353	354	1	1	3	4	1	0
FKA-776	353	416	63	1	3	1	1	2
FKA-776	354	431	77	1	3	1	0	0
FKA-776	354	477	123	0	3	1	0	0
FKA-776	354	397	43	1	4	3	1	0
FKA-776	357	477	120	0	3	3	0	0
FKA-776	358	371	13	1	2	1	2	0
FKA-776	359	477	118	0	3	1	0	0
FKA-777	360	477	117	0	3	4	0	0
FKA-777	360	477	117	0	3	1	0	0
FKA-777	360	477	117	0	4	4	0	0
FKA-777	361	477	116	0	3	4	0	0
FKA-777	363	477	114	0	3	1	0	0
FKA-777	363	477	114	0	4	4	0	0
FKA-777	363	477	114	0	4	1	0	0
RAF-555	2	65	63	1	3	1	1	0
RAF-555	3	61	58	1	3	1	1	0
RAF-555	4	24	20	1	3	4	1	0
RAF-555	4	16	12	1	3	4	2	0
RAF-555	4	40	36	1	3	1	2	0
RAF-556	7	16	9	1	3	1	2	0
RAF-556	7	16	9	1	3	1	2	0
RAF-556	7	279	272	1	3	4	3	0
RAF-556	8	9	1	1	3	1	1	0
RAF-556	8	477	469	0	3	1	0	0
RAF-556	9	10	1	1	3	5	1	1
RAF-556	10	11	1	1	3	1	3	0
RAF-556	14	262	248	1	4	1	1	0
RAF-556	15	32	17	1	3	4	2	0
RAF-556	15	16	1	1	3	1	2	0
RAF-557	16	17	1	1	3	1	0	0
RAF-557	16	477	461	0	3	1	0	0
RAF-557	19	27	8	1	3	1	1	0
RAF-557	22	23	1	1	3	1	2	0
RAF-557	23	85	62	1	1	5	1	0
RAF-557	23	24	1	1	3	4	1	0
RAF-557	23	25	2	1	3	3	1	0
RAF-557	23	26	3	1	3	4	1	0
RAF-557	23	24	1	1	3	4	1	0
RAF-557	23	26	3	1	3	3	1	0
RAF-558	23	25	2	1	3	3	1	0
RAF-558	24	25	1	1	3	1	1	0
RAF-558	25	27	2	1	3	1	0	1
RAF-558	28	477	449	0	4	1	0	0
RAF-558	29	30	1	1	3	5	1	0
RAF-558	29	30	1	1	3	1	3	0
RAF-558	30	38	8	1	4	3	1	0
RAF-558	30	32	2	1	1	1	1	0
RAF-558	30	35	5	1	3	4	3	0
RAF-558	30	477	447	0	3	1	0	0
RAF-559	31	41	10	1	1	1	0	0
RAF-559	31	32	1	1	3	1	1	2
RAF-559	32	81	49	1	3	1	1	0
RAF-559	32	35	3	1	4	4	0	0
RAF-559	35	36	1	1	3	5	2	1
RAF-559	35	38	3	1	3	5	1	0
RAF-559	35	39	4	1	3	5	3	0
RAF-559	35	277	242	1	3	5	1	0
RAF-559	36	37	1	1	3	5	1	0
RAF-560	36	43	7	1	3	1	0	1
RAF-560	37	49	12	1	4	1	0	0
RAF-560	38	48	10	1	3	5	2	0
RAF-560	38	477	439	0	3	1	0	0
RAF-560	38	40	2	1	3	4	2	0
RAF-560	41	42	1	1	3	5	2	0
RAF-560	41	42	1	1	3	5	2	0
RAF-560	41	42	1	1	3	5	2	0
RAF-560	42	43	1	1	4	5	0	0
RAF-560	43	477	434	0	3	1	0	0
RAF-561	43	44	1	1	2	1	1	0
RAF-561	43	91	48	1	3	1	1	0
RAF-561	44	45	1	1	3	5	1	0
RAF-561	49	50	1	1	3	1	0	0
RAF-561	49	88	39	1	3	2	1	0
RAF-561	49	275	226	1	3	4	0	0
RAF-561	49	50	1	1	3	5	3	0
RAF-561	49	50	1	1	3	5	1	0
RAF-561	49	55	6	1	3	5	2	0
RAF-561	49	55	6	1	3	5	2	0
RAF-562	49	50	1	1	3	5	1	0
RAF-562	49	53	4	1	3	5	2	0
RAF-562	49	50	1	1	3	5	2	0
RAF-562	49	50	1	1	3	5	1	0
RAF-562	49	200	151	1	3	3	0	0
RAF-562	49	65	16	1	3	4	1	0
RAF-562	49	477	428	0	3	1	0	0
RAF-562	49	53	4	1	4	2	1	2
RAF-563	50	84	34	1	3	4	0	0
RAF-563	51	53	2	1	3	5	1	0
RAF-563	51	55	4	1	3	1	1	0
RAF-563	51	477	426	0	4	4	1	0
RAF-563	51	52	1	1	3	1	1	0
RAF-563	52	76	24	1	3	2	1	0
RAF-563	52	61	9	1	3	1	2	0
RAF-563	52	477	425	0	2	1	0	0
RAF-563	53	477	424	0	3	4	0	0
RAF-563	53	54	1	1	3	1	1	0
RAF-564	53	79	26	1	3	5	0	0
RAF-564	53	76	23	1	3	1	1	0
RAF-564	53	84	31	1	3	1	2	0
RAF-564	54	477	423	0	4	4	0	0
RAF-564	56	216	160	1	3	4	1	0
RAF-564	56	72	16	1	3	1	2	1
RAF-564	58	73	15	1	3	1	2	0
RAF-564	58	59	1	1	4	1	2	0
RAF-564	59	60	1	1	3	1	1	0
RAF-564	59	60	1	1	4	4	1	0
RAF-565	60	477	417	0	3	1	0	0
RAF-565	60	62	2	1	4	4	1	0
RAF-565	60	62	2	1	4	4	1	0
RAF-565	60	63	3	1	4	4	1	0
RAF-565	61	62	1	1	3	4	1	0
RAF-565	61	62	1	1	3	4	1	0
RAF-565	63	477	414	0	3	4	0	0
RAF-565	64	73	9	1	3	1	2	1
RAF-565	65	73	8	1	3	5	1	0
RAF-565	65	248	183	1	3	5	1	1
RAF-566	65	248	183	1	3	5	1	0
RAF-566	65	239	174	1	3	2	1	0
RAF-566	65	66	1	1	3	1	1	0
RAF-566	66	72	6	1	3	1	0	0
RAF-566	67	70	3	1	3	1	0	1
RAF-566	71	72	1	1	3	2	2	0
RAF-566	71	73	2	1	3	1	0	0
RAF-566	71	73	2	1	2	1	1	0
RAF-566	73	74	1	1	3	5	2	1
RAF-567	77	80	3	1	3	1	1	0
RAF-567	77	86	9	1	3	1	2	0
RAF-567	78	79	1	1	3	1	1	0
RAF-567	78	79	1	1	3	1	1	0
RAF-567	78	477	399	0	2	1	0	1
RAF-567	81	82	1	1	3	5	1	0
RAF-567	84	85	1	1	3	4	2	0
RAF-567	85	86	1	1	3	1	1	0
RAF-567	85	87	2	1	3	4	1	0
RAF-568	85	86	1	1	3	2	1	1
RAF-568	85	86	1	1	3	1	3	0
RAF-568	86	477	391	0	3	1	1	0
RAF-568	86	199	113	1	3	1	2	0
RAF-568	87	436	349	1	3	4	0	0
RAF-568	88	168	80	1	3	4	1	0
RAF-568	91	92	1	1	4	1	0	0
RAF-568	92	254	162	1	3	1	1	0
RAF-568	93	94	1	1	2	1	1	0
RAF-568	93	214	121	1	3	1	2	2
RAF-569	93	201	108	1	1	1	1	0
RAF-569	94	477	383	0	4	4	1	0
RAF-569	95	96	1	1	3	1	1	0
RAF-569	98	210	112	1	3	1	0	3
RAF-569	99	115	16	1	3	1	2	0
RAF-569	100	168	68	1	3	1	1	0
RAF-569	100	168	68	1	3	1	1	0
RAF-569	101	102	1	1	3	1	1	0
RAF-569	101	102	1	1	4	5	1	1
RAF-569	101	132	31	1	4	1	2	0
RAF-570	102	103	1	1	3	4	1	0
RAF-570	102	177	75	1	3	1	1	0
RAF-570	105	477	372	0	3	1	0	0
RAF-570	106	322	216	1	2	1	1	0
RAF-570	107	272	165	1	3	1	1	0
RAF-570	107	185	78	1	3	1	1	2
RAF-570	112	126	14	1	3	4	1	0
RAF-570	113	260	147	1	3	3	1	0
RAF-570	115	168	53	1	4	1	0	0
RAF-570	115	477	362	0	4	1	2	0
RAF-571	118	122	4	1	3	5	2	0
RAF-571	118	163	45	1	4	4	0	1
RAF-571	118	162	44	1	4	4	0	1
RAF-571	118	122	4	1	3	5	1	0
RAF-571	118	169	51	1	3	5	1	0
RAF-571	118	122	4	1	3	5	1	0
RAF-571	118	122	4	1	3	5	1	0
RAF-571	118	122	4	1	3	5	2	0
RAF-571	118	123	5	1	3	5	2	0
RAF-571	118	126	8	1	3	5	2	0
RAF-572	118	168	50	1	3	5	1	0
RAF-572	118	144	26	1	3	5	1	0
RAF-572	118	160	42	1	3	5	1	2
RAF-572	118	144	26	1	3	5	1	0
RAF-572	118	185	67	1	3	2	0	1
RAF-572	118	185	67	1	3	2	0	1
RAF-572	119	168	49	1	3	5	1	1
RAF-572	119	477	358	0	3	1	0	1
RAF-572	120	165	45	1	3	5	1	1
RAF-572	121	144	23	1	3	1	1	1
RAF-573	121	477	356	0	2	1	0	0
RAF-573	122	340	218	1	1	1	0	0
RAF-573	126	150	24	1	3	5	1	1
RAF-573	126	142	16	1	3	5	1	0
RAF-573	126	143	17	1	3	5	1	0
RAF-573	126	150	24	1	3	5	1	1
RAF-573	126	149	23	1	3	5	1	0
RAF-573	126	156	30	1	3	5	1	0
RAF-573	126	143	17	1	3	5	1	0
RAF-574	126	132	6	1	3	1	0	0
RAF-574	127	477	350	0	3	4	1	0
RAF-574	128	133	5	1	4	4	2	0
RAF-574	128	156	28	1	3	5	0	0
RAF-574	129	132	3	1	3	5	1	0
RAF-574	129	131	2	1	3	5	1	0
RAF-574	129	477	348	0	3	5	0	0
RAF-574	130	161	31	1	4	4	1	0
RAF-574	130	131	1	1	3	1	1	0
RAF-574	130	131	1	1	1	1	1	0
RAF-575	130	131	1	1	3	1	1	0
RAF-575	130	477	347	0	3	1	0	0
RAF-575	132	155	23	1	3	4	1	0
RAF-575	133	143	10	1	3	1	2	0
RAF-575	134	135	1	1	3	4	1	0
RAF-575	135	477	342	0	3	4	0	0
RAF-575	135	477	342	0	3	3	0	0
RAF-575	136	477	341	0	3	2	1	3
RAF-575	136	137	1	1	3	5	1	0
RAF-575	137	167	30	1	3	4	2	0
RAF-576	137	138	1	1	3	1	1	0
RAF-576	137	141	4	1	4	2	1	0
RAF-576	140	477	337	0	4	1	0	0
RAF-576	140	144	4	1	4	4	1	0
RAF-576	141	186	45	1	3	3	1	4
RAF-576	141	143	2	1	3	1	1	0
RAF-576	142	150	8	1	3	5	1	0
RAF-576	142	477	335	0	3	1	0	0
RAF-576	143	145	2	1	3	1	1	1
RAF-576	143	477	334	0	3	1	0	0
RAF-577	144	477	333	0	3	5	1	0
RAF-577	144	145	1	1	3	5	1	0
RAF-577	150	477	327	0	3	4	2	1
RAF-577	151	165	14	1	3	1	0	0
RAF-577	155	477	322	0	3	4	1	0
RAF-577	155	477	322	0	3	4	1	0
RAF-577	155	336	181	1	3	4	0	3
RAF-577	156	477	321	0	3	4	1	0
RAF-577	156	157	1	1	3	4	1	0
RAF-577	157	158	1	1	3	5	1	0
RAF-578	158	477	319	0	3	1	0	0
RAF-578	159	209	50	1	3	1	2	0
RAF-578	159	246	87	1	3	4	1	0
RAF-578	161	477	316	0	4	1	0	0
RAF-578	161	162	1	1	3	4	1	0
RAF-578	163	185	22	1	3	4	1	0
RAF-578	163	168	5	1	3	4	2	0
RAF-578	168	477	309	0	3	4	0	0
RAF-578	169	327	158	1	3	2	2	0
RAF-579	169	328	159	1	4	1	1	0
RAF-579	170	172	2	1	3	1	1	0
RAF-579	171	248	77	1	3	4	1	0
RAF-579	176	247	71	1	3	4	1	0
RAF-579	177	477	300	0	3	5	0	0
RAF-579	177	181	4	1	3	5	0	0
RAF-579	178	185	7	1	3	4	2	0
RAF-579	178	477	299	0	3	4	0	0
RAF-579	179	214	35	1	3	1	2	0
RAF-579	182	249	67	1	3	4	1	0
RAF-580	183	184	1	1	3	5	1	0
RAF-580	183	248	65	1	3	4	1	0
RAF-580	183	249	66	1	3	2	1	0
RAF-580	183	477	294	0	2	5	0	0
RAF-580	183	185	2	1	3	4	1	0
RAF-580	185	186	1	1	3	4	1	0
RAF-580	185	306	121	1	3	5	1	1
RAF-580	185	186	1	1	3	5	1	1
RAF-580	190	228	38	1	3	1	0	0
RAF-580	190	192	2	1	3	1	1	0
RAF-581	191	214	23	1	3	1	0	0
RAF-581	191	223	32	1	2	1	0	0
RAF-581	192	193	1	1	3	5	1	0
RAF-581	192	193	1	1	3	5	1	0
RAF-581	192	196	4	1	3	5	0	1
RAF-581	192	193	1	1	3	5	1	0
RAF-581	192	196	4	1	3	5	1	1
RAF-581	192	199	7	1	3	5	4	0
RAF-581	192	201	9	1	3	5	1	0
RAF-581	192	477	285	0	3	5	1	0
RAF-582	192	477	285	0	3	5	1	0
RAF-582	192	199	7	1	3	5	1	0
RAF-582	192	200	8	1	3	5	1	0
RAF-582	192	477	285	0	3	5	1	0
RAF-582	192	200	8	1	3	5	1	0
RAF-582	192	477	285	0	3	5	1	0
RAF-582	192	200	8	1	3	5	1	0
RAF-582	192	199	7	1	3	5	1	0
RAF-582	192	223	31	1	3	5	0	0
RAF-582	192	213	21	1	3	5	2	0
RAF-583	192	199	7	1	3	5	1	0
RAF-583	192	197	5	1	3	5	1	0
RAF-583	192	197	5	1	3	5	1	0
RAF-583	192	197	5	1	3	5	1	0
RAF-583	192	201	9	1	3	5	1	0
RAF-583	192	197	5	1	3	5	1	0
RAF-583	192	196	4	1	3	5	1	0
RAF-583	192	195	3	1	3	5	1	0
RAF-583	196	201	5	1	3	5	1	0
RAF-583	196	201	5	1	3	4	1	0
RAF-584	196	210	14	1	3	1	1	0
RAF-584	197	199	2	1	3	5	1	0
RAF-584	197	258	61	1	3	1	1	0
RAF-584	198	228	30	1	3	1	0	0
RAF-584	198	477	279	0	3	5	1	0
RAF-584	199	337	138	1	3	5	1	0
RAF-584	199	201	2	1	3	5	1	0
RAF-584	203	204	1	1	3	4	1	0
RAF-584	203	258	55	1	3	1	0	1
RAF-584	203	204	1	1	4	5	1	0
RAF-585	205	210	5	1	3	1	1	0
RAF-585	210	212	2	1	4	1	2	0
RAF-585	210	477	267	0	3	4	0	0
RAF-585	210	477	267	0	3	2	0	1
RAF-585	211	382	171	1	3	1	2	0
RAF-585	212	214	2	1	3	5	1	0
RAF-585	216	217	1	1	4	5	1	0
RAF-585	216	217	1	1	3	5	1	0
RAF-585	216	217	1	1	3	5	1	0
RAF-586	218	220	2	1	3	5	1	0
RAF-586	218	223	5	1	3	5	1	0
RAF-586	219	227	8	1	3	1	1	0
RAF-586	220	221	1	1	3	5	1	0
RAF-586	222	249	27	1	3	4	1	0
RAF-586	223	224	1	1	3	5	1	0
RAF-586	223	224	1	1	3	5	1	0
RAF-586	225	227	2	1	3	2	1	0
RAF-586	226	227	1	1	3	4	1	0
RAF-586	227	228	1	1	3	5	1	0
RAF-587	227	228	1	1	3	2	1	0
RAF-587	227	228	1	1	3	2	1	0
RAF-587	227	228	1	1	3	2	1	0
RAF-587	227	401	174	1	3	2	1	0
RAF-587	229	406	177	1	3	5	0	0
RAF-587	230	406	176	1	3	5	0	0
RAF-587	231	385	154	1	4	3	0	0
RAF-587	231	305	74	1	5	1	1	0
RAF-587	234	477	243	0	3	1	0	0
RAF-587	236	239	3	1	4	1	1	0
RAF-588	237	477	240	0	4	2	1	0
RAF-588	238	477	239	0	3	1	0	0
RAF-588	241	242	1	1	3	3	1	0
RAF-588	242	336	94	1	4	1	0	0
RAF-588	245	248	3	1	3	5	1	1
RAF-588	246	247	1	1	3	5	1	0
RAF-588	246	247	1	1	3	1	3	0
RAF-588	246	253	7	1	3	1	2	1
RAF-588	247	249	2	1	3	4	1	0
RAF-588	247	248	1	1	3	3	1	0
RAF-589	247	248	1	1	3	1	1	0
RAF-589	247	248	1	1	3	1	1	0
RAF-589	247	248	1	1	3	4	1	0
RAF-589	247	346	99	1	4	3	1	1
RAF-589	248	249	1	1	3	4	1	0
RAF-589	249	477	228	0	3	1	0	0
RAF-589	249	250	1	1	3	1	0	1
RAF-589	249	250	1	1	3	1	1	0
RAF-589	251	337	86	1	5	5	1	1
RAF-589	251	281	30	1	5	5	2	2
RAF-590	251	345	94	1	5	5	1	1
RAF-590	251	362	111	1	3	3	1	1
RAF-590	251	252	1	1	3	1	1	0
RAF-590	251	477	226	0	3	3	0	0
RAF-590	252	282	30	1	5	5	1	0
RAF-590	252	436	184	1	4	5	1	0
RAF-590	253	274	21	1	3	4	2	0
RAF-590	253	269	16	1	4	1	0	0
RAF-590	254	255	1	1	3	1	1	1
RAF-590	254	345	91	1	3	1	1	1
RAF-591	255	477	222	0	3	4	1	0
RAF-591	255	262	7	1	3	1	2	0
RAF-591	255	256	1	1	3	1	1	0
RAF-591	255	348	93	1	3	3	1	0
RAF-591	255	477	222	0	3	4	2	0
RAF-591	256	257	1	1	3	4	1	0
RAF-591	258	293	35	1	3	1	2	1
RAF-591	259	263	4	1	3	1	1	0
RAF-591	259	477	218	0	3	1	0	0
RAF-591	259	309	50	1	3	4	1	1
RAF-592	260	477	217	0	3	4	0	0
RAF-592	260	477	217	0	3	5	0	0
RAF-592	260	477	217	0	3	4	1	0
RAF-592	266	477	211	0	3	4	2	0
RAF-592	266	438	172	1	3	5	1	0
RAF-592	267	389	122	1	3	5	0	0
RAF-592	268	322	54	1	3	5	1	1
RAF-592	269	270	1	1	3	1	0	0
RAF-592	269	270	1	1	3	5	1	0
RAF-593	269	339	70	1	3	1	0	0
RAF-593	269	322	53	1	2	1	1	0
RAF-593	270	314	44	1	3	1	2	1
RAF-593	271	272	1	1	3	5	1	0
RAF-593	273	337	64	1	3	5	1	0
RAF-593	273	310	37	1	3	5	1	0
RAF-593	273	274	1	1	3	5	4	0
RAF-593	273	274	1	1	3	4	1	0
RAF-593	273	477	204	0	3	4	0	0
RAF-593	273	329	56	1	4	1	2	1
RAF-594	274	275	1	1	3	4	1	1
RAF-594	274	275	1	1	3	5	1	0
RAF-594	274	341	67	1	3	5	1	0
RAF-594	274	341	67	1	3	5	1	0
RAF-594	274	342	68	1	3	5	0	1
RAF-594	274	275	1	1	3	5	1	0
RAF-594	274	277	3	1	3	5	2	0
RAF-594	274	275	1	1	3	5	1	0
RAF-594	274	275	1	1	3	5	1	0
RAF-594	274	477	203	0	3	5	1	0
RAF-595	274	275	1	1	3	5	1	0
RAF-595	274	477	203	0	3	5	1	0
RAF-595	274	275	1	1	3	5	1	0
RAF-595	274	275	1	1	3	5	1	0
RAF-595	274	275	1	1	3	5	1	0
RAF-595	274	275	1	1	3	5	1	0
RAF-595	274	281	7	1	3	5	1	0
RAF-595	274	407	133	1	3	5	1	0
RAF-595	274	275	1	1	3	5	1	0
RAF-595	274	275	1	1	3	5	1	0
RAF-596	274	277	3	1	3	5	4	0
RAF-596	275	324	49	1	3	5	1	2
RAF-596	275	348	73	1	3	1	1	1
RAF-596	275	277	2	1	3	5	1	0
RAF-596	275	277	2	1	3	5	1	0
RAF-596	275	277	2	1	3	5	1	0
RAF-596	275	277	2	1	3	5	1	0
RAF-596	275	277	2	1	3	5	1	0
RAF-596	275	277	2	1	3	5	1	0
RAF-596	277	477	200	0	3	4	1	2
RAF-597	278	477	199	0	3	4	2	0
RAF-597	279	477	198	0	3	2	0	0
RAF-597	281	282	1	1	4	4	1	0
RAF-597	282	283	1	1	3	1	0	0
RAF-597	284	285	1	1	3	1	0	0
RAF-597	284	285	1	1	4	1	0	0
RAF-597	286	308	22	1	3	4	1	0
RAF-597	289	290	1	1	3	5	0	0
RAF-597	289	379	90	1	3	1	1	0
RAF-597	289	290	1	1	3	4	1	0
RAF-598	289	290	1	1	3	1	2	1
RAF-598	290	293	3	1	3	4	1	0
RAF-598	290	291	1	1	3	4	1	0
RAF-598	290	297	7	1	3	1	1	0
RAF-598	293	477	184	0	3	4	2	0
RAF-598	294	295	1	1	3	3	1	0
RAF-598	295	477	182	0	3	4	2	0
RAF-598	297	298	1	1	3	3	1	0
RAF-598	297	298	1	1	3	4	1	0
RAF-598	297	305	8	1	3	1	1	0
RAF-599	298	299	1	1	3	1	2	3
RAF-599	301	302	1	1	3	4	1	0
RAF-599	301	302	1	1	3	4	1	0
RAF-599	301	328	27	1	3	1	0	0
RAF-599	302	303	1	1	3	4	2	1
RAF-599	303	304	1	1	3	4	1	0
RAF-599	304	389	85	1	3	1	0	1
RAF-599	305	339	34	1	3	1	1	0
RAF-599	306	308	2	1	3	1	1	0
RAF-599	308	477	169	0	3	1	2	0
RAF-600	308	477	169	0	3	2	1	0
RAF-600	308	309	1	1	3	2	1	0
RAF-600	308	337	29	1	3	2	1	0
RAF-600	308	348	40	1	1	1	1	1
RAF-600	309	342	33	1	3	1	1	0
RAF-600	310	372	62	1	2	1	1	1
RAF-600	310	339	29	1	3	1	0	0
RAF-600	311	477	166	0	3	1	0	0
RAF-600	313	477	164	0	3	2	0	0
RAF-600	315	391	76	1	3	4	1	0
RAF-601	316	477	161	0	4	1	0	0
RAF-601	317	338	21	1	3	3	1	0
RAF-601	318	477	159	0	4	2	0	0
RAF-601	322	415	93	1	3	1	2	0
RAF-601	322	323	1	1	3	4	1	0
RAF-601	323	337	14	1	4	5	1	1
RAF-601	323	324	1	1	3	1	1	0
RAF-601	325	477	152	0	3	2	0	0
RAF-601	325	326	1	1	3	3	1	0
RAF-601	325	326	1	1	3	1	0	0
RAF-602	325	327	2	1	3	1	1	0
RAF-602	329	338	9	1	3	1	1	0
RAF-602	332	337	5	1	3	4	1	0
RAF-602	333	334	1	1	3	3	1	0
RAF-602	336	337	1	1	3	1	2	1
RAF-602	336	337	1	1	4	1	1	0
RAF-602	337	338	1	1	3	5	1	0
RAF-602	337	338	1	1	3	5	1	0
RAF-603	337	338	1	1	3	5	1	0
RAF-603	337	338	1	1	3	5	1	0
RAF-603	337	340	3	1	3	5	1	0
RAF-603	337	338	1	1	3	1	1	0
RAF-603	339	340	1	1	3	5	1	0
RAF-603	339	341	2	1	3	5	1	0
RAF-603	339	343	4	1	3	2	1	0
RAF-603	340	370	30	1	3	1	1	0
RAF-603	340	477	137	0	3	4	0	0
RAF-603	340	416	76	1	3	1	2	0
RAF-604	341	344	3	1	1	1	1	1
RAF-604	341	342	1	1	3	1	1	1
RAF-604	342	343	1	1	3	5	1	1
RAF-604	343	344	1	1	3	1	1	1
RAF-604	344	347	3	1	3	5	1	1
RAF-604	344	348	4	1	3	5	1	1
RAF-604	345	351	6	1	3	1	1	0
RAF-604	346	347	1	1	3	1	1	1
RAF-604	348	477	129	0	3	1	0	0
RAF-605	350	351	1	1	3	1	1	0
RAF-605	350	377	27	1	3	4	2	0
RAF-605	351	361	10	1	3	1	1	0
RAF-605	351	352	1	1	3	4	1	0
RAF-605	351	352	1	1	3	4	1	0
RAF-605	352	354	2	1	3	4	1	0
RAF-605	354	385	31	1	3	1	1	0
RAF-605	356	383	27	1	3	1	2	0
RAF-605	358	359	1	1	4	5	0	0
RAF-606	358	392	34	1	4	5	1	2
RAF-606	358	477	119	0	4	5	2	0
RAF-606	359	360	1	1	3	4	1	0
RAF-606	359	371	12	1	3	4	1	0
RAF-606	359	477	118	0	3	5	1	0
RAF-606	359	389	30	1	3	1	1	1
RAF-606	363	477	114	0	2	1	0	0
OX-115	1	2	1	1	3	1	0	0
OX-115	3	42	39	1	4	4	1	1
OX-116	3	127	124	1	4	1	1	2
OX-116	4	8	4	1	3	4	1	0
OX-116	4	414	410	1	4	4	1	1
OX-116	4	78	74	1	3	2	1	0
OX-116	7	157	150	1	3	1	1	0
OX-116	8	319	311	1	2	1	1	1
OX-116	11	142	131	1	3	1	1	0
OX-116	21	50	29	1	3	1	1	0
OX-116	22	23	1	1	3	1	2	0
OX-116	32	33	1	1	3	1	1	0
OX-117	32	477	445	0	4	5	0	0
OX-117	36	37	1	1	3	1	1	0
OX-117	36	37	1	1	3	1	1	0
OX-117	36	477	441	0	4	1	0	0
OX-117	36	37	1	1	3	1	2	2
OX-117	36	37	1	1	5	1	1	0
OX-117	37	51	14	1	4	1	1	0
OX-117	37	51	14	1	5	1	1	1
OX-117	39	128	89	1	4	5	1	0
OX-117	42	63	21	1	3	1	1	0
OX-118	42	477	435	0	3	1	0	0
OX-118	42	52	10	1	3	1	1	0
OX-118	43	98	55	1	3	1	1	0
OX-118	43	477	434	0	2	1	1	0
OX-118	44	58	14	1	3	1	1	0
OX-118	44	477	433	0	3	1	0	0
OX-118	44	50	6	1	3	1	1	0
OX-118	45	100	55	1	3	1	1	4
OX-118	49	50	1	1	3	1	1	0
OX-118	52	310	258	1	3	2	1	1
OX-119	52	66	14	1	3	5	1	0
OX-119	52	417	365	1	3	1	1	1
OX-119	52	56	4	1	3	5	1	0
OX-119	52	311	259	1	3	1	1	0
OX-119	54	55	1	1	3	1	1	0
OX-119	56	64	8	1	5	4	1	0
OX-119	57	58	1	1	3	1	1	0
OX-119	58	60	2	1	3	1	1	0
OX-119	59	60	1	1	3	1	1	0
OX-119	60	61	1	1	3	1	1	0
OX-120	64	65	1	1	5	4	1	0
OX-120	66	67	1	1	4	4	1	0
OX-120	67	127	60	1	3	1	1	0
OX-120	67	70	3	1	3	1	1	0
OX-120	68	477	409	0	3	1	1	0
OX-120	70	477	407	0	3	1	0	0
OX-120	71	88	17	1	3	1	1	1
OX-120	71	323	252	1	3	1	1	4
OX-120	73	74	1	1	3	1	1	0
OX-120	73	183	110	1	4	4	1	1
OX-121	73	78	5	1	3	1	0	1
OX-121	74	75	1	1	3	1	1	1
OX-121	76	95	19	1	3	1	1	1
OX-121	76	313	237	1	3	1	0	3
OX-121	77	91	14	1	2	1	1	0
OX-121	77	87	10	1	3	1	1	0
OX-121	77	78	1	1	3	1	1	0
OX-121	77	78	1	1	3	1	1	0
OX-121	77	294	217	1	3	1	1	0
OX-121	78	79	1	1	3	1	1	0
OX-122	78	95	17	1	3	1	1	0
OX-122	79	287	208	1	3	1	1	4
OX-122	79	227	148	1	4	1	1	0
OX-122	80	81	1	1	3	1	1	0
OX-122	80	81	1	1	3	1	0	0
OX-122	80	310	230	1	3	2	0	1
OX-122	81	133	52	1	3	1	1	0
OX-122	81	133	52	1	3	1	1	0
OX-122	85	86	1	1	3	1	1	0
OX-122	86	87	1	1	3	1	1	0
OX-123	86	88	2	1	3	1	1	1
OX-123	87	88	1	1	3	1	1	0
OX-123	91	92	1	1	3	1	0	0
OX-123	91	92	1	1	3	1	1	0
OX-123	91	477	386	0	3	1	0	2
OX-123	91	477	386	0	3	1	0	1
OX-123	93	128	35	1	3	1	1	2
OX-123	93	477	384	0	4	4	1	1
OX-123	93	94	1	1	3	1	1	0
OX-123	94	95	1	1	1	1	1	1
OX-124	94	95	1	1	3	1	1	1
OX-124	94	183	89	1	3	1	1	1
OX-124	94	95	1	1	3	1	1	2
OX-124	96	97	1	1	3	1	1	0
OX-124	99	130	31	1	3	1	1	2
OX-124	100	311	211	1	3	1	0	1
OX-124	105	106	1	1	3	1	1	0
OX-124	105	204	99	1	3	1	1	1
OX-124	106	107	1	1	3	1	1	0
OX-124	106	120	14	1	2	1	0	1
OX-125	106	108	2	1	2	1	0	0
OX-125	106	107	1	1	3	1	1	0
OX-125	107	109	2	1	1	1	1	1
OX-125	107	109	2	1	3	1	1	0
OX-125	107	108	1	1	3	1	1	1
OX-125	107	477	370	0	3	1	0	0
OX-125	107	108	1	1	3	1	1	0
OX-125	108	114	6	1	3	1	1	0
OX-125	108	109	1	1	3	1	1	0
OX-125	108	109	1	1	2	1	1	0
OX-126	108	109	1	1	3	1	1	0
OX-126	108	109	1	1	1	1	1	2
OX-126	108	120	12	1	3	1	0	1
OX-126	108	109	1	1	3	1	1	0
OX-126	109	120	11	1	2	1	0	0
OX-126	109	110	1	1	3	1	1	0
OX-126	109	130	21	1	4	1	1	2
OX-126	112	113	1	1	2	1	1	0
OX-126	112	113	1	1	2	1	1	0
OX-126	112	113	1	1	3	1	1	1
OX-127	112	312	200	1	3	1	0	3
OX-127	113	114	1	1	1	1	1	0
OX-127	113	114	1	1	3	1	1	0
OX-127	113	127	14	1	3	2	1	0
OX-127	113	130	17	1	3	1	1	1
OX-127	113	128	15	1	3	1	1	0
OX-127	113	114	1	1	3	1	1	0
OX-127	113	116	3	1	3	1	1	1
OX-127	114	115	1	1	3	1	1	0
OX-127	114	115	1	1	3	1	1	0
OX-128	114	171	57	1	2	1	1	0
OX-128	115	116	1	1	3	1	1	0
OX-128	115	116	1	1	2	1	1	0
OX-128	116	117	1	1	3	1	1	0
OX-128	118	263	145	1	3	4	0	2
OX-128	118	388	270	1	3	2	1	1
OX-128	120	313	193	1	3	4	0	1
OX-128	120	122	2	1	2	1	1	0
OX-128	121	122	1	1	3	1	1	0
OX-128	121	122	1	1	2	1	1	0
OX-129	122	141	19	1	3	1	1	1
OX-129	122	274	152	1	4	4	1	0
OX-129	122	123	1	1	3	1	1	0
OX-129	122	126	4	1	3	1	1	0
OX-129	123	124	1	1	3	1	1	0
OX-129	123	127	4	1	3	4	1	0
OX-129	123	124	1	1	3	1	1	0
OX-129	124	125	1	1	3	1	1	0
OX-129	126	127	1	1	2	1	1	0
OX-129	126	477	351	0	2	1	1	0
OX-130	126	127	1	1	3	1	1	0
OX-130	127	128	1	1	3	1	1	1
OX-130	127	477	350	0	3	1	0	0
OX-130	127	477	350	0	3	1	0	0
OX-130	127	477	350	0	3	1	0	0
OX-130	128	129	1	1	3	1	1	1
OX-130	128	129	1	1	3	1	1	1
OX-130	130	477	347	0	3	2	0	0
OX-130	133	134	1	1	3	1	1	0
OX-130	133	134	1	1	3	1	1	0
OX-131	133	135	2	1	3	1	1	0
OX-131	134	135	1	1	2	1	1	0
OX-131	134	135	1	1	3	1	1	0
OX-131	135	136	1	1	3	1	1	0
OX-131	135	136	1	1	3	1	1	0
OX-131	135	191	56	1	3	1	1	0
OX-131	135	313	178	1	4	4	0	2
OX-131	136	137	1	1	3	1	1	0
OX-131	136	137	1	1	3	1	1	0
OX-131	136	137	1	1	3	1	1	0
OX-132	136	140	4	1	3	1	1	0
OX-132	136	318	182	1	3	1	0	1
OX-132	136	137	1	1	3	1	1	0
OX-132	137	138	1	1	3	1	1	0
OX-132	137	138	1	1	3	1	1	0
OX-132	140	141	1	1	3	1	1	0
OX-132	140	141	1	1	3	1	1	2
OX-132	140	141	1	1	3	1	1	0
OX-132	140	141	1	1	3	1	1	0
OX-132	141	142	1	1	3	1	1	0
OX-133	142	143	1	1	3	1	0	0
OX-133	142	143	1	1	2	1	2	0
OX-133	142	143	1	1	2	2	1	0
OX-133	143	144	1	1	3	1	1	0
OX-133	143	477	334	0	3	1	1	0
OX-133	144	145	1	1	3	1	1	0
OX-133	145	146	1	1	3	1	1	0
OX-133	150	176	26	1	3	1	1	0
OX-133	151	152	1	1	3	1	1	0
OX-133	154	477	323	0	3	1	1	4
OX-134	154	155	1	1	3	1	1	2
OX-134	154	156	2	1	3	1	1	0
OX-134	156	157	1	1	3	1	1	0
OX-134	156	310	154	1	4	2	1	0
OX-134	157	158	1	1	3	1	1	0
OX-134	157	165	8	1	3	3	1	0
OX-134	158	161	3	1	3	1	1	0
OX-134	158	159	1	1	3	1	1	0
OX-134	158	159	1	1	3	1	1	0
OX-134	158	171	13	1	3	1	1	0
OX-135	159	160	1	1	3	1	1	0
OX-135	161	267	106	1	1	1	0	2
OX-135	161	162	1	1	3	1	1	0
OX-135	161	164	3	1	4	1	1	0
OX-135	162	171	9	1	4	1	1	2
OX-135	163	477	314	0	3	1	1	0
OX-135	163	171	8	1	3	1	1	0
OX-135	164	165	1	1	3	1	1	0
OX-135	165	171	6	1	3	2	1	1
OX-135	169	269	100	1	3	4	1	0
OX-136	170	171	1	1	2	1	1	0
OX-136	171	477	306	0	3	1	0	0
OX-136	171	183	12	1	3	4	1	0
OX-136	172	173	1	1	3	1	1	0
OX-136	174	340	166	1	3	4	1	1
OX-136	175	179	4	1	3	1	1	0
OX-136	175	176	1	1	3	1	1	0
OX-136	176	179	3	1	3	1	1	0
OX-136	178	179	1	1	1	1	1	1
OX-136	178	179	1	1	3	1	1	0
OX-137	179	180	1	1	4	1	1	0
OX-137	181	182	1	1	3	1	1	0
OX-137	182	183	1	1	3	1	1	0
OX-137	183	184	1	1	3	1	1	0
OX-137	183	184	1	1	3	1	1	0
OX-137	183	184	1	1	3	1	1	0
OX-137	184	311	127	1	3	1	0	1
OX-137	185	186	1	1	3	1	1	0
OX-137	186	187	1	1	3	1	1	0
OX-137	189	190	1	1	3	1	1	0
OX-138	190	477	287	0	3	4	1	0
OX-138	190	191	1	1	3	1	1	0
OX-138	190	477	287	0	3	1	0	0
OX-138	190	191	1	1	3	1	1	0
OX-138	191	477	286	0	3	4	0	0
OX-138	191	192	1	1	3	5	1	0
OX-138	191	193	2	1	3	4	1	0
OX-138	193	194	1	1	3	4	1	0
OX-138	193	194	1	1	3	3	0	0
OX-138	197	477	280	0	3	2	0	0
OX-139	199	200	1	1	3	4	1	0
OX-139	199	200	1	1	3	1	1	0
OX-139	199	200	1	1	3	4	1	0
OX-139	200	201	1	1	3	4	1	0
OX-139	200	201	1	1	3	1	1	0
OX-139	200	201	1	1	3	1	1	0
OX-139	203	204	1	1	3	1	1	0
OX-139	204	205	1	1	3	1	1	0
OX-139	204	205	1	1	3	1	1	0
OX-139	205	206	1	1	3	1	1	0
OX-140	205	312	107	1	3	1	0	1
OX-140	205	206	1	1	3	4	1	0
OX-140	207	208	1	1	5	3	1	0
OX-140	210	319	109	1	3	1	1	1
OX-140	210	211	1	1	3	1	0	0
OX-140	210	310	100	1	3	1	1	1
OX-140	210	211	1	1	4	1	0	0
OX-140	211	308	97	1	3	3	1	0
OX-140	211	308	97	1	3	3	1	0
OX-140	211	477	266	0	4	4	0	0
OX-141	211	477	266	0	3	4	1	0
OX-141	212	213	1	1	3	4	1	0
OX-141	212	217	5	1	3	1	1	0
OX-141	213	477	264	0	4	1	0	2
OX-141	213	477	264	0	4	1	1	1
OX-141	213	214	1	1	3	1	1	0
OX-141	213	239	26	1	3	1	1	0
OX-141	213	239	26	1	3	1	1	0
OX-141	214	423	209	1	3	4	1	0
OX-141	219	220	1	1	3	1	1	0
OX-142	221	224	3	1	3	1	1	0
OX-142	226	303	77	1	3	2	1	2
OX-142	227	228	1	1	3	1	1	0
OX-142	228	477	249	0	3	1	1	0
OX-142	238	239	1	1	3	1	1	0
OX-142	238	477	239	0	3	1	1	2
OX-142	238	383	145	1	3	1	1	1
OX-142	238	477	239	0	3	1	0	2
OX-142	239	283	44	1	3	1	1	0
OX-143	241	277	36	1	3	1	1	0
OX-143	242	302	60	1	3	1	0	1
OX-143	246	477	231	0	3	1	1	0
OX-143	246	295	49	1	4	1	1	2
OX-143	247	260	13	1	2	1	1	0
OX-143	248	249	1	1	3	5	1	0
OX-143	248	269	21	1	4	1	1	0
OX-143	252	477	225	0	3	1	0	1
OX-143	256	477	221	0	3	2	0	0
OX-143	261	477	216	0	3	4	1	2
OX-144	261	269	8	1	3	4	1	0
OX-144	263	267	4	1	3	4	1	2
OX-144	263	267	4	1	3	4	1	3
OX-144	265	269	4	1	3	4	1	1
OX-144	265	266	1	1	3	4	1	0
OX-144	265	266	1	1	3	1	1	0
OX-144	266	308	42	1	3	1	0	0
OX-144	267	281	14	1	3	1	0	3
OX-144	267	274	7	1	3	4	1	1
OX-144	267	269	2	1	3	5	1	0
OX-145	267	269	2	1	3	5	1	0
OX-145	267	268	1	1	3	5	1	0
OX-145	267	268	1	1	3	5	1	0
OX-145	267	268	1	1	3	5	1	0
OX-145	267	268	1	1	3	5	1	0
OX-145	267	269	2	1	3	5	1	0
OX-145	268	274	6	1	3	5	1	1
OX-145	268	269	1	1	3	5	1	0
OX-145	268	319	51	1	1	4	1	4
OX-145	268	269	1	1	3	1	1	3
OX-146	268	269	1	1	4	4	1	0
OX-146	268	269	1	1	3	4	1	2
OX-146	268	477	209	0	1	4	1	2
OX-146	269	274	5	1	3	5	1	4
OX-146	269	270	1	1	4	4	1	1
OX-146	269	270	1	1	4	4	1	1
OX-146	269	270	1	1	4	4	1	1
OX-146	269	270	1	1	4	4	1	1
OX-146	269	270	1	1	4	4	1	1
OX-146	269	319	50	1	4	4	0	2
OX-147	270	271	1	1	3	5	1	0
OX-147	270	271	1	1	4	5	1	0
OX-147	270	271	1	1	3	5	1	0
OX-147	270	271	1	1	3	5	1	1
OX-147	270	274	4	1	3	4	1	2
OX-147	270	271	1	1	4	4	1	0
OX-147	270	271	1	1	3	5	0	1
OX-147	270	271	1	1	3	4	1	0
OX-147	270	271	1	1	4	4	1	1
OX-147	271	273	2	1	3	4	1	0
OX-148	274	275	1	1	3	5	1	1
OX-148	274	275	1	1	3	5	1	0
OX-148	274	275	1	1	4	5	1	0
OX-148	274	277	3	1	4	4	0	2
OX-148	274	276	2	1	3	4	1	4
OX-148	274	275	1	1	3	5	1	0
OX-148	274	275	1	1	3	5	1	0
OX-148	274	275	1	1	3	5	1	0
OX-148	274	275	1	1	3	5	1	1
OX-148	274	275	1	1	3	5	1	0
OX-149	274	275	1	1	3	5	1	0
OX-149	274	275	1	1	3	5	1	1
OX-149	274	275	1	1	3	5	1	0
OX-149	274	275	1	1	3	5	1	0
OX-149	274	275	1	1	3	5	1	0
OX-149	274	275	1	1	3	5	1	0
OX-149	274	275	1	1	3	5	1	0
OX-149	274	275	1	1	3	5	1	0
OX-149	274	275	1	1	3	5	1	0
OX-149	274	275	1	1	3	5	1	0
OX-150	274	275	1	1	3	5	1	0
OX-150	274	276	2	1	3	4	1	1
OX-150	274	477	203	0	3	4	0	3
OX-150	275	276	1	1	3	5	1	0
OX-150	275	276	1	1	3	5	1	0
OX-150	275	276	1	1	3	1	1	1
OX-150	276	277	1	1	3	5	1	0
OX-150	276	277	1	1	3	5	1	0
OX-150	276	277	1	1	3	5	1	0
OX-150	276	277	1	1	3	5	1	2
OX-151	276	277	1	1	3	5	1	0
OX-151	276	277	1	1	3	4	1	0
OX-151	276	277	1	1	3	4	1	0
OX-151	276	277	1	1	3	5	1	2
OX-151	276	277	1	1	3	5	1	0
OX-151	276	277	1	1	3	5	1	1
OX-151	277	319	42	1	1	4	1	4
OX-151	277	477	200	0	3	4	1	1
OX-151	280	281	1	1	3	4	1	2
OX-151	281	291	10	1	5	1	2	0
OX-152	281	291	10	1	4	1	1	0
OX-152	282	283	1	1	3	4	1	2
OX-152	283	284	1	1	3	4	1	0
OX-152	284	285	1	1	3	1	1	0
OX-152	287	305	18	1	3	3	1	4
OX-152	287	288	1	1	3	3	1	4
OX-152	288	294	6	1	3	1	1	1
OX-152	288	346	58	1	4	5	1	4
OX-152	289	290	1	1	4	4	1	0
OX-152	290	291	1	1	1	1	1	1
OX-153	291	302	11	1	2	4	1	4
OX-153	291	302	11	1	3	5	1	4
OX-153	291	295	4	1	3	5	1	2
OX-153	291	302	11	1	3	5	1	2
OX-153	291	294	3	1	4	5	1	1
OX-153	291	302	11	1	4	5	1	1
OX-153	294	295	1	1	5	3	1	0
OX-153	294	295	1	1	4	4	1	0
OX-153	295	296	1	1	4	4	1	0
OX-153	296	297	1	1	5	3	1	0
OX-154	296	304	8	1	4	4	1	0
OX-154	299	301	2	1	3	1	1	0
OX-154	302	303	1	1	3	3	1	0
OX-154	302	310	8	1	1	3	1	2
OX-154	302	303	1	1	3	4	1	0
OX-154	303	308	5	1	3	4	1	0
OX-154	303	306	3	1	4	4	1	0
OX-154	304	305	1	1	3	4	1	0
OX-154	304	305	1	1	4	5	1	0
OX-154	304	310	6	1	3	2	1	2
OX-155	305	316	11	1	3	2	1	1
OX-155	305	310	5	1	1	3	0	2
OX-155	305	311	6	1	4	1	1	1
OX-155	308	309	1	1	3	4	1	1
OX-155	308	309	1	1	3	4	1	0
OX-155	309	310	1	1	3	4	1	0
OX-155	309	310	1	1	3	1	1	0
OX-155	309	310	1	1	3	1	1	1
OX-155	309	311	2	1	3	1	1	0
OX-155	310	388	78	1	3	4	1	2
OX-156	310	399	89	1	4	3	1	1
OX-156	310	424	114	1	3	4	1	1
OX-156	311	339	28	1	3	4	1	2
OX-156	311	312	1	1	5	5	1	0
OX-156	311	312	1	1	4	5	1	0
OX-156	311	312	1	1	5	5	1	0
OX-156	311	312	1	1	5	5	1	0
OX-156	311	312	1	1	5	5	1	0
OX-156	311	345	34	1	3	5	1	1
OX-156	311	312	1	1	4	5	1	0
OX-157	311	312	1	1	4	5	1	0
OX-157	311	312	1	1	3	5	1	0
OX-157	311	312	1	1	4	5	1	0
OX-157	311	312	1	1	5	5	1	0
OX-157	311	312	1	1	3	5	1	0
OX-157	311	312	1	1	5	5	1	0
OX-157	311	312	1	1	5	4	1	0
OX-157	312	317	5	1	2	1	1	0
OX-157	312	313	1	1	4	5	1	0
OX-157	312	313	1	1	4	5	0	1
OX-158	312	313	1	1	4	5	1	0
OX-158	312	323	11	1	3	5	1	4
OX-158	312	313	1	1	3	5	0	2
OX-158	312	313	1	1	4	5	0	2
OX-158	312	477	165	0	4	5	1	1
OX-158	312	477	165	0	4	5	1	0
OX-158	312	477	165	0	4	1	1	2
OX-158	312	313	1	1	4	5	1	2
OX-158	312	477	165	0	4	5	1	2
OX-158	312	477	165	0	3	1	1	2
OX-159	312	477	165	0	3	5	1	1
OX-159	312	477	165	0	3	4	1	4
OX-159	312	477	165	0	4	5	0	0
OX-159	312	477	165	0	3	5	1	0
OX-159	313	314	1	1	3	5	1	0
OX-159	315	477	162	0	3	4	1	2
OX-159	315	316	1	1	3	1	1	0
OX-159	315	477	162	0	3	2	0	0
OX-159	315	316	1	1	4	5	1	0
OX-159	315	337	22	1	4	5	1	3
OX-160	315	316	1	1	4	5	1	0
OX-160	316	399	83	1	4	3	1	1
OX-160	317	318	1	1	3	1	1	0
OX-160	318	319	1	1	3	4	1	0
OX-160	318	319	1	1	3	2	1	1
OX-160	318	319	1	1	4	4	1	0
OX-160	319	477	158	0	3	5	0	0
OX-160	319	320	1	1	5	5	1	0
OX-160	319	477	158	0	1	4	1	0
OX-160	319	477	158	0	1	4	1	1
OX-161	319	477	158	0	3	4	0	0
OX-161	319	323	4	1	3	5	1	0
OX-161	319	322	3	1	1	1	1	3
OX-161	319	323	4	1	3	5	1	0
OX-161	322	477	155	0	3	4	1	1
OX-161	322	343	21	1	3	4	1	1
OX-161	323	324	1	1	1	1	1	1
OX-161	323	477	154	0	3	4	0	0
OX-161	324	340	16	1	3	4	1	1
OX-161	324	329	5	1	3	1	1	0
OX-162	324	325	1	1	3	1	0	0
OX-162	324	329	5	1	3	4	1	0
OX-162	326	327	1	1	3	3	1	0
OX-162	327	339	12	1	3	2	1	0
OX-162	329	330	1	1	3	4	1	0
OX-162	329	330	1	1	4	4	1	0
OX-162	329	330	1	1	5	4	1	0
OX-162	329	330	1	1	5	5	1	0
OX-162	329	336	7	1	3	4	1	3
OX-162	329	330	1	1	3	1	0	0
OX-163	329	330	1	1	3	4	1	1
OX-163	330	331	1	1	4	5	1	0
OX-163	330	331	1	1	5	5	1	0
OX-163	330	331	1	1	3	5	1	0
OX-163	330	331	1	1	4	5	1	0
OX-163	330	331	1	1	5	5	1	0
OX-163	330	331	1	1	5	5	1	0
OX-163	330	331	1	1	4	3	1	0
OX-163	331	345	14	1	3	4	1	2
OX-163	331	332	1	1	1	1	1	1
OX-164	331	339	8	1	3	4	1	2
OX-164	331	477	146	0	3	2	1	1
OX-164	332	333	1	1	3	1	0	0
OX-164	332	340	8	1	3	4	0	2
OX-164	332	477	145	0	3	1	1	1
OX-164	332	333	1	1	1	1	1	4
OX-164	332	333	1	1	4	4	1	1
OX-164	336	351	15	1	3	1	1	4
OX-164	336	345	9	1	3	1	0	4
OX-164	336	337	1	1	3	4	1	1
OX-165	337	338	1	1	3	1	1	3
OX-165	337	338	1	1	1	1	1	2
OX-165	338	477	139	0	3	4	1	2
OX-165	338	477	139	0	3	4	1	3
OX-165	338	477	139	0	3	1	1	0
OX-165	339	362	23	1	3	4	1	2
OX-165	339	340	1	1	5	5	1	0
OX-165	339	340	1	1	5	5	1	0
OX-165	339	340	1	1	5	5	1	0
OX-165	339	340	1	1	5	5	1	0
OX-166	339	340	1	1	4	4	1	1
OX-166	339	406	67	1	4	4	1	2
OX-166	339	340	1	1	5	1	1	0
OX-166	340	351	11	1	4	4	1	0
OX-166	341	342	1	1	4	4	1	0
OX-166	343	346	3	1	3	4	1	1
OX-166	343	344	1	1	3	5	1	0
OX-166	343	344	1	1	3	5	1	0
OX-166	343	344	1	1	3	5	1	0
OX-166	344	345	1	1	3	5	1	0
OX-167	344	387	43	1	3	5	1	0
OX-167	345	346	1	1	4	1	1	0
OX-167	345	346	1	1	3	4	1	0
OX-167	345	346	1	1	5	5	1	0
OX-167	345	477	132	0	3	4	1	1
OX-167	345	477	132	0	3	4	1	3
OX-167	346	347	1	1	3	5	1	0
OX-167	346	347	1	1	3	4	1	0
OX-167	350	351	1	1	3	4	1	0
OX-167	350	364	14	1	3	2	1	2
OX-168	350	351	1	1	3	1	1	0
OX-168	351	352	1	1	5	5	1	0
OX-168	351	352	1	1	5	5	1	0
OX-168	351	352	1	1	4	1	1	0
OX-168	351	352	1	1	4	1	1	0
OX-168	351	352	1	1	5	4	1	0
OX-168	351	352	1	1	3	1	1	0
OX-168	351	429	78	1	3	4	1	4
OX-168	351	352	1	1	3	1	1	1
OX-168	352	353	1	1	3	3	1	1
OX-169	352	353	1	1	3	5	1	0
OX-169	352	353	1	1	3	5	1	0
OX-169	352	353	1	1	3	5	1	0
OX-169	352	353	1	1	3	5	1	0
OX-169	352	477	125	0	3	2	0	0
OX-169	353	354	1	1	3	5	1	0
OX-169	353	354	1	1	4	5	1	0
OX-169	353	354	1	1	4	5	1	0
OX-169	353	354	1	1	4	4	1	1
OX-169	353	354	1	1	3	5	1	0
OX-170	353	354	1	1	4	5	1	0
OX-170	353	354	1	1	4	5	1	0
OX-170	353	354	1	1	4	4	1	0
OX-170	353	354	1	1	5	4	1	0
OX-170	353	477	124	0	3	4	1	0
OX-170	353	354	1	1	3	4	1	3
OX-170	353	477	124	0	3	4	1	1
OX-170	353	354	1	1	3	4	1	1
OX-170	354	355	1	1	4	4	1	2
OX-170	354	409	55	1	3	4	1	0
OX-171	354	372	18	1	3	4	1	0
OX-171	359	386	27	1	3	4	1	0
OX-171	360	361	1	1	5	5	1	0
OX-171	360	361	1	1	5	5	1	0
OX-171	360	361	1	1	5	5	1	0
OX-171	360	361	1	1	4	5	0	0
OX-171	360	362	2	1	3	5	1	0
OX-171	360	362	2	1	4	4	1	0
OX-171	362	477	115	0	3	1	1	3
DU-225	3	11	8	1	2	1	3	0
DU-225	8	477	469	0	3	2	0	0
DU-225	8	18	10	1	3	1	1	0
DU-225	8	18	10	1	3	4	1	0
DU-225	9	477	468	0	3	1	0	0
DU-225	10	11	1	1	3	4	1	0
DU-225	10	477	467	0	3	4	0	0
DU-225	11	477	466	0	3	5	0	0
DU-225	11	73	62	1	1	1	2	0
DU-226	11	172	161	1	3	1	1	1
DU-226	15	18	3	1	3	4	1	1
DU-226	15	25	10	1	3	1	1	1
DU-226	16	477	461	0	3	4	0	0
DU-226	17	66	49	1	2	4	1	0
DU-226	17	25	8	1	3	4	1	2
DU-226	17	477	460	0	4	4	0	0
DU-226	17	25	8	1	3	4	1	2
DU-226	18	477	459	0	3	4	0	0
DU-226	23	477	454	0	3	1	0	0
DU-227	23	24	1	1	4	4	1	1
DU-227	23	101	78	1	3	4	1	0
DU-227	25	28	3	1	3	1	1	0
DU-227	28	308	280	1	3	2	0	0
DU-227	29	42	13	1	3	1	1	0
DU-227	29	52	23	1	3	1	1	1
DU-227	29	30	1	1	3	3	0	0
DU-227	30	477	447	0	3	4	0	0
DU-227	30	477	447	0	3	4	0	1
DU-227	31	36	5	1	3	2	1	0
DU-228	31	477	446	0	2	1	0	1
DU-228	31	43	12	1	2	4	1	1
DU-228	31	477	446	0	3	4	0	1
DU-228	31	477	446	0	4	4	0	1
DU-228	32	477	445	0	3	4	0	1
DU-228	35	477	442	0	2	2	0	0
DU-228	36	477	441	0	3	4	0	0
DU-228	38	152	114	1	3	2	1	1
DU-228	38	477	439	0	3	4	0	1
DU-228	38	351	313	1	3	4	1	0
DU-229	38	143	105	1	3	2	1	2
DU-229	38	52	14	1	3	4	1	1
DU-229	38	39	1	1	2	1	1	0
DU-229	38	276	238	1	3	1	1	2
DU-229	39	40	1	1	4	1	1	0
DU-229	43	71	28	1	3	1	1	0
DU-229	43	44	1	1	3	1	1	0
DU-229	44	73	29	1	3	4	1	1
DU-229	45	477	432	0	3	4	0	0
DU-229	45	477	432	0	4	4	0	0
DU-230	45	48	3	1	3	1	0	0
DU-230	45	477	432	0	3	3	0	1
DU-230	46	477	431	0	2	1	0	1
DU-230	46	74	28	1	4	4	1	0
DU-230	46	47	1	1	3	4	1	1
DU-230	46	80	34	1	3	1	1	1
DU-230	46	374	328	1	3	4	1	0
DU-230	46	477	431	0	3	4	0	0
DU-230	46	477	431	0	3	4	0	0
DU-230	46	73	27	1	3	1	1	0
DU-231	46	101	55	1	3	1	1	0
DU-231	46	477	431	0	3	4	0	1
DU-231	47	193	146	1	3	1	1	0
DU-231	50	477	427	0	3	1	0	0
DU-231	50	168	118	1	3	4	1	0
DU-231	50	477	427	0	3	1	0	0
DU-231	50	477	427	0	3	4	0	0
DU-231	50	477	427	0	3	1	0	1
DU-231	51	477	426	0	3	1	0	2
DU-231	51	60	9	1	3	1	1	1
DU-232	51	71	20	1	4	1	1	1
DU-232	51	477	426	0	3	4	0	0
DU-232	52	71	19	1	2	1	2	0
DU-232	52	477	425	0	3	1	0	1
DU-232	52	281	229	1	3	4	1	0
DU-232	53	58	5	1	1	1	1	0
DU-232	53	477	424	0	3	2	0	2
DU-232	53	477	424	0	3	2	0	3
DU-232	58	59	1	1	1	1	1	0
DU-232	60	61	1	1	3	1	1	0
DU-233	63	71	8	1	3	1	1	0
DU-233	64	71	7	1	3	4	2	0
DU-233	66	477	411	0	4	1	0	0
DU-233	66	289	223	1	3	5	1	1
DU-233	67	71	4	1	3	1	1	1
DU-233	67	217	150	1	3	1	1	0
DU-233	68	71	3	1	3	1	1	0
DU-233	71	477	406	0	3	5	0	0
DU-233	71	72	1	1	2	1	1	0
DU-233	71	87	16	1	3	1	1	1
DU-234	71	72	1	1	2	1	1	0
DU-234	71	73	2	1	1	1	1	0
DU-234	71	73	2	1	2	1	4	0
DU-234	71	477	406	0	4	1	0	0
DU-234	71	477	406	0	4	4	0	0
DU-234	71	130	59	1	3	4	1	0
DU-234	72	477	405	0	3	4	0	0
DU-234	73	477	404	0	3	4	0	0
DU-234	73	477	404	0	3	4	0	0
DU-235	73	214	141	1	3	1	1	0
DU-235	73	119	46	1	3	4	1	0
DU-235	73	477	404	0	3	4	0	1
DU-235	73	477	404	0	3	4	0	1
DU-235	73	477	404	0	3	1	0	0
DU-235	74	477	403	0	3	1	0	0
DU-235	74	477	403	0	3	4	0	0
DU-235	78	477	399	0	3	2	0	0
DU-235	78	79	1	1	3	4	1	0
DU-235	78	142	64	1	3	4	1	1
DU-236	78	477	399	0	3	1	0	0
DU-236	78	91	13	1	3	1	1	0
DU-236	78	477	399	0	3	2	0	0
DU-236	78	477	399	0	3	4	0	0
DU-236	79	87	8	1	3	1	1	0
DU-236	79	113	34	1	3	1	1	1
DU-236	80	477	397	0	3	4	0	0
DU-236	80	81	1	1	3	1	2	0
DU-236	80	119	39	1	3	4	1	0
DU-236	80	477	397	0	3	1	0	0
DU-237	80	477	397	0	3	4	0	0
DU-237	81	119	38	1	3	4	1	1
DU-237	82	477	395	0	3	4	0	1
DU-237	82	477	395	0	4	1	0	0
DU-237	83	84	1	1	4	4	1	0
DU-237	83	477	394	0	3	1	0	0
DU-237	83	477	394	0	3	1	0	0
DU-237	84	85	1	1	1	1	2	0
DU-237	85	312	227	1	3	4	1	0
DU-237	85	86	1	1	1	1	2	0
DU-238	85	477	392	0	3	4	0	0
DU-238	85	477	392	0	3	4	0	0
DU-238	85	337	252	1	3	4	1	0
DU-238	85	477	392	0	3	4	0	0
DU-238	85	91	6	1	3	1	1	0
DU-238	86	87	1	1	3	1	1	1
DU-238	86	374	288	1	3	4	1	0
DU-238	86	353	267	1	2	1	1	1
DU-238	86	106	20	1	3	1	1	0
DU-238	86	477	391	0	3	1	0	0
DU-239	86	477	391	0	2	1	0	0
DU-239	86	88	2	1	3	1	1	0
DU-239	86	477	391	0	3	1	0	0
DU-239	86	91	5	1	3	1	1	0
DU-239	88	106	18	1	3	1	1	0
DU-239	88	477	389	0	3	1	0	1
DU-239	91	477	386	0	3	2	0	2
DU-239	93	477	384	0	3	1	0	0
DU-239	93	477	384	0	4	2	0	0
DU-239	94	160	66	1	3	2	1	0
DU-240	94	477	383	0	3	4	0	0
DU-240	94	211	117	1	3	1	1	1
DU-240	96	311	215	1	3	1	1	0
DU-240	98	128	30	1	3	4	1	1
DU-240	99	477	378	0	3	4	0	0
DU-240	99	477	378	0	3	4	0	0
DU-240	102	103	1	1	3	1	1	0
DU-240	102	103	1	1	3	1	1	0
DU-240	102	130	28	1	4	1	1	0
DU-240	105	477	372	0	3	4	0	1
DU-241	106	477	371	0	3	4	0	1
DU-241	106	428	322	1	3	4	1	2
DU-241	108	109	1	1	3	1	2	0
DU-241	108	477	369	0	4	4	0	0
DU-241	112	113	1	1	3	1	1	0
DU-241	113	351	238	1	3	1	1	2
DU-241	114	115	1	1	2	1	4	0
DU-241	114	477	363	0	3	4	0	0
DU-241	116	477	361	0	3	2	0	1
DU-241	116	288	172	1	3	4	1	0
DU-242	116	192	76	1	3	4	1	0
DU-242	116	477	361	0	3	4	0	1
DU-242	116	122	6	1	2	4	1	0
DU-242	119	477	358	0	3	1	0	0
DU-242	119	477	358	0	3	4	0	0
DU-242	120	477	357	0	3	5	0	0
DU-242	120	147	27	1	3	1	1	0
DU-242	123	142	19	1	3	1	1	2
DU-242	123	126	3	1	1	1	1	0
DU-242	126	127	1	1	3	4	1	0
DU-243	126	477	351	0	3	5	0	0
DU-243	126	477	351	0	3	1	0	0
DU-243	127	477	350	0	3	1	0	0
DU-243	127	477	350	0	3	1	0	0
DU-243	127	477	350	0	3	4	0	0
DU-243	128	477	349	0	3	4	0	0
DU-243	131	477	346	0	4	4	0	0
DU-243	134	260	126	1	3	4	1	1
DU-243	134	169	35	1	3	1	0	0
DU-243	134	477	343	0	3	1	0	2
DU-244	134	477	343	0	3	4	0	0
DU-244	134	186	52	1	3	4	1	0
DU-244	134	477	343	0	3	4	0	1
DU-244	135	140	5	1	3	1	1	0
DU-244	136	477	341	0	3	1	0	0
DU-244	136	477	341	0	3	1	0	0
DU-244	136	477	341	0	3	1	0	0
DU-244	140	197	57	1	3	1	2	0
DU-244	140	477	337	0	3	3	0	0
DU-244	140	464	324	1	3	3	1	0
DU-245	141	477	336	0	3	4	0	0
DU-245	141	143	2	1	3	1	0	0
DU-245	141	477	336	0	3	4	0	0
DU-245	143	477	334	0	3	1	0	0
DU-245	143	477	334	0	2	1	0	0
DU-245	143	477	334	0	3	1	0	0
DU-245	144	392	248	1	3	1	1	0
DU-245	148	477	329	0	3	4	0	0
DU-245	148	477	329	0	3	4	0	0
DU-245	149	213	64	1	3	1	1	0
DU-246	149	217	68	1	3	1	1	0
DU-246	152	477	325	0	3	4	0	0
DU-246	154	477	323	0	3	1	0	1
DU-246	154	284	130	1	2	1	1	0
DU-246	155	156	1	1	4	1	1	1
DU-246	155	172	17	1	3	1	1	0
DU-246	157	477	320	0	2	1	0	0
DU-246	157	477	320	0	3	4	0	0
DU-246	158	477	319	0	3	4	0	0
DU-246	161	246	85	1	3	4	1	1
DU-247	161	162	1	1	3	4	1	0
DU-247	161	177	16	1	1	1	1	0
DU-247	162	477	315	0	3	1	0	1
DU-247	162	164	2	1	2	1	1	1
DU-247	163	169	6	1	3	1	1	0
DU-247	163	477	314	0	3	4	0	0
DU-247	164	165	1	1	3	1	1	0
DU-247	164	428	264	1	3	4	1	0
DU-247	168	170	2	1	3	1	2	0
DU-247	169	170	1	1	3	1	1	0
DU-248	169	477	308	0	3	5	0	0
DU-248	169	477	308	0	3	4	0	0
DU-248	170	477	307	0	3	4	0	0
DU-248	171	477	306	0	3	2	0	0
DU-248	171	477	306	0	3	4	0	0
DU-248	175	477	302	0	3	4	0	0
DU-248	176	477	301	0	3	4	0	0
DU-248	178	367	189	1	2	1	1	1
DU-248	178	477	299	0	3	5	0	0
DU-248	179	247	68	1	3	4	1	0
DU-249	182	477	295	0	3	4	0	2
DU-249	185	205	20	1	3	5	1	0
DU-249	185	197	12	1	3	1	1	0
DU-249	186	187	1	1	2	1	0	0
DU-249	190	477	287	0	3	4	0	0
DU-249	191	213	22	1	3	1	1	0
DU-249	191	477	286	0	3	1	0	0
DU-249	191	477	286	0	3	4	0	0
DU-249	191	477	286	0	3	4	0	0
DU-249	191	477	286	0	4	5	0	0
DU-250	191	477	286	0	3	1	0	0
DU-250	192	477	285	0	3	1	0	0
DU-250	196	477	281	0	3	2	0	0
DU-250	196	197	1	1	3	2	0	0
DU-250	196	477	281	0	4	4	0	2
DU-250	196	477	281	0	3	4	0	2
DU-250	196	477	281	0	3	4	0	2
DU-250	197	210	13	1	3	1	1	0
DU-250	199	411	212	1	3	1	1	0
DU-250	199	204	5	1	3	1	1	0
DU-251	204	205	1	1	4	4	1	0
DU-251	205	210	5	1	4	1	1	0
DU-251	205	228	23	1	3	1	1	1
DU-251	205	477	272	0	3	4	0	0
DU-251	206	477	271	0	3	2	0	0
DU-251	206	477	271	0	3	4	0	2
DU-251	206	477	271	0	3	5	0	0
DU-251	207	311	104	1	3	1	1	0
DU-251	207	477	270	0	3	4	0	0
DU-251	208	477	269	0	3	2	0	0
DU-252	210	211	1	1	3	3	0	0
DU-252	210	256	46	1	3	5	1	0
DU-252	210	477	267	0	3	4	0	0
DU-252	212	477	265	0	2	1	0	0
DU-252	212	477	265	0	3	1	0	0
DU-252	213	218	5	1	3	1	1	0
DU-252	218	477	259	0	3	4	0	1
DU-252	218	374	156	1	3	4	1	0
DU-252	218	219	1	1	3	1	1	0
DU-252	219	247	28	1	3	4	1	0
DU-253	219	477	258	0	4	4	0	0
DU-253	219	249	30	1	3	1	1	0
DU-253	220	221	1	1	3	2	0	0
DU-253	220	477	257	0	3	5	0	0
DU-253	220	477	257	0	3	1	0	0
DU-253	220	477	257	0	3	1	0	0
DU-253	220	477	257	0	3	1	0	0
DU-253	221	477	256	0	3	1	0	0
DU-253	221	226	5	1	3	3	1	0
DU-253	224	268	44	1	4	4	1	0
DU-254	225	226	1	1	3	1	3	0
DU-254	227	477	250	0	3	5	0	0
DU-254	227	477	250	0	3	5	0	0
DU-254	227	477	250	0	3	5	0	0
DU-254	228	477	249	0	4	3	0	0
DU-254	228	477	249	0	2	1	0	0
DU-254	231	477	246	0	4	1	0	0
DU-254	232	477	245	0	3	4	0	0
DU-254	233	477	244	0	3	4	0	0
DU-254	234	477	243	0	2	4	0	0
DU-255	235	477	242	0	3	1	0	0
DU-255	236	325	89	1	4	1	1	0
DU-255	236	477	241	0	3	1	0	0
DU-255	236	477	241	0	4	1	0	0
DU-255	236	477	241	0	4	1	0	0
DU-255	236	239	3	1	3	1	1	0
DU-255	236	477	241	0	4	1	0	1
DU-255	238	395	157	1	4	1	1	0
DU-255	239	477	238	0	4	1	0	0
DU-255	239	260	21	1	3	1	1	0
DU-256	240	241	1	1	3	1	1	0
DU-256	240	477	237	0	3	1	0	1
DU-256	241	477	236	0	4	4	0	0
DU-256	241	281	40	1	3	4	1	1
DU-256	241	477	236	0	4	1	0	0
DU-256	242	243	1	1	3	5	1	0
DU-256	245	253	8	1	3	4	1	0
DU-256	246	247	1	1	3	4	1	0
DU-256	247	477	230	0	4	4	0	0
DU-256	247	477	230	0	3	1	0	0
DU-257	247	477	230	0	3	4	0	0
DU-257	248	374	126	1	3	4	1	0
DU-257	248	477	229	0	3	4	0	0
DU-257	249	477	228	0	3	2	0	0
DU-257	249	477	228	0	3	4	0	0
DU-257	254	367	113	1	3	1	1	1
DU-257	254	438	184	1	3	1	1	0
DU-257	254	477	223	0	3	4	0	0
DU-257	256	257	1	1	3	4	1	0
DU-257	257	477	220	0	2	1	0	1
DU-258	259	261	2	1	3	1	1	1
DU-258	259	477	218	0	3	2	1	0
DU-258	259	260	1	1	3	1	1	0
DU-258	260	311	51	1	3	1	1	0
DU-258	260	316	56	1	3	1	1	1
DU-258	261	477	216	0	3	2	0	0
DU-258	261	477	216	0	3	4	0	1
DU-258	264	477	213	0	4	2	0	0
DU-258	266	367	101	1	3	1	1	0
DU-258	267	477	210	0	3	1	0	0
DU-259	268	477	209	0	3	5	0	0
DU-259	268	477	209	0	3	1	0	0
DU-259	273	477	204	0	3	1	0	0
DU-259	273	477	204	0	3	1	0	0
DU-259	273	477	204	0	3	1	0	0
DU-259	274	477	203	0	4	1	0	0
DU-259	274	477	203	0	3	4	0	0
DU-259	276	477	201	0	3	5	0	0
DU-259	277	281	4	1	3	1	1	0
DU-259	277	316	39	1	3	1	1	0
DU-260	277	477	200	0	4	4	0	0
DU-260	280	281	1	1	3	1	1	0
DU-260	281	283	2	1	3	1	1	1
DU-260	282	283	1	1	3	2	0	0
DU-260	282	477	195	0	3	2	0	1
DU-260	283	477	194	0	3	4	0	0
DU-260	283	316	33	1	3	2	1	0
DU-260	287	329	42	1	3	4	1	0
DU-260	289	329	40	1	3	1	1	0
DU-260	289	477	188	0	3	4	0	0
DU-261	290	477	187	0	3	1	0	0
DU-261	296	477	181	0	3	1	0	0
DU-261	296	477	181	0	3	3	0	1
DU-261	296	477	181	0	3	3	0	2
DU-261	296	477	181	0	3	3	0	0
DU-261	298	477	179	0	3	4	1	2
DU-261	301	477	176	0	4	1	0	0
DU-261	304	477	173	0	3	4	0	0
DU-261	304	477	173	0	3	4	0	0
DU-261	309	477	168	0	3	4	0	0
DU-262	309	315	6	1	3	1	1	0
DU-262	309	477	168	0	3	1	0	0
DU-262	311	477	166	0	2	1	0	3
DU-262	318	477	159	0	4	1	0	0
DU-262	319	477	158	0	4	1	0	0
DU-262	320	477	157	0	2	1	0	0
DU-262	324	477	153	0	2	1	0	0
DU-262	325	477	152	0	3	4	0	0
DU-262	325	477	152	0	3	4	0	0
DU-262	325	477	152	0	3	1	0	0
DU-263	326	477	151	0	3	1	0	0
DU-263	336	337	1	1	3	1	1	0
DU-263	337	477	140	0	3	2	0	1
DU-263	338	477	139	0	3	4	0	0
DU-263	340	477	137	0	3	1	0	0
DU-263	343	477	134	0	3	1	0	0
DU-263	345	381	36	1	3	4	1	1
DU-263	345	477	132	0	4	4	0	0
DU-263	346	347	1	1	3	4	1	0
DU-263	346	347	1	1	3	1	1	0
DU-264	346	381	35	1	3	2	1	0
DU-264	350	477	127	0	3	1	0	0
DU-264	350	477	127	0	3	4	0	0
DU-264	350	477	127	0	3	4	0	0
DU-264	351	477	126	0	3	4	0	1
DU-264	351	430	79	1	3	2	1	1
DU-264	352	477	125	0	3	1	1	0
DU-264	356	357	1	1	3	1	1	0
DU-264	360	408	48	1	3	1	0	1
DU-264	360	477	117	0	3	1	0	0
DU-265	361	362	1	1	3	1	1	0
LIN-314	0	1	1	1	4	1	1	0
LIN-314	1	26	25	1	4	4	1	0
LIN-314	1	39	38	1	3	4	1	0
LIN-314	2	213	211	1	4	4	1	1
LIN-314	2	3	1	1	4	4	0	0
LIN-314	2	477	475	0	3	1	0	0
LIN-314	2	165	163	1	3	1	1	0
LIN-315	2	26	24	1	3	4	1	0
LIN-315	4	5	1	1	4	4	1	0
LIN-315	4	24	20	1	3	1	0	0
LIN-315	6	13	7	1	3	5	1	0
LIN-315	6	13	7	1	3	5	1	0
LIN-315	6	13	7	1	3	5	1	0
LIN-315	7	149	142	1	3	1	0	1
LIN-315	7	26	19	1	3	4	1	0
LIN-315	8	26	18	1	3	4	1	0
LIN-315	9	15	6	1	4	4	1	0
LIN-316	10	149	139	1	3	3	0	0
LIN-316	10	177	167	1	3	4	0	0
LIN-316	11	15	4	1	5	4	1	0
LIN-316	11	23	12	1	3	1	0	0
LIN-316	14	26	12	1	4	1	1	0
LIN-316	15	16	1	1	3	1	1	0
LIN-316	15	477	462	0	3	1	1	0
LIN-316	15	26	11	1	3	1	1	0
LIN-316	16	196	180	1	3	1	1	1
LIN-316	16	477	461	0	3	4	0	0
LIN-317	16	17	1	1	3	1	0	0
LIN-317	16	24	8	1	3	4	0	1
LIN-317	16	26	10	1	3	1	1	0
LIN-317	16	26	10	1	4	1	1	0
LIN-317	16	71	55	1	4	4	1	0
LIN-317	16	26	10	1	3	1	1	1
LIN-317	16	17	1	1	3	1	0	1
LIN-317	16	23	7	1	3	1	1	1
LIN-317	17	23	6	1	4	1	1	0
LIN-317	17	23	6	1	3	1	0	1
LIN-318	17	175	158	1	3	1	1	1
LIN-318	18	23	5	1	4	4	1	0
LIN-318	18	23	5	1	4	4	1	0
LIN-318	18	23	5	1	3	1	1	0
LIN-318	18	23	5	1	4	1	1	0
LIN-318	18	477	459	0	3	4	0	0
LIN-318	18	199	181	1	3	4	1	0
LIN-318	20	245	225	1	3	1	1	0
LIN-318	21	79	58	1	3	5	0	0
LIN-318	21	35	14	1	3	3	1	0
LIN-319	22	23	1	1	3	1	1	0
LIN-319	22	23	1	1	4	3	1	0
LIN-319	22	23	1	1	3	2	0	0
LIN-319	23	24	1	1	4	4	1	0
LIN-319	23	34	11	1	3	4	1	0
LIN-319	24	62	38	1	3	3	1	0
LIN-319	24	25	1	1	4	4	1	0
LIN-319	24	477	453	0	3	1	1	0
LIN-319	25	26	1	1	4	3	1	0
LIN-319	25	36	11	1	4	1	1	0
LIN-320	25	26	1	1	3	3	1	0
LIN-320	25	256	231	1	2	1	0	0
LIN-320	25	28	3	1	3	5	1	0
LIN-320	25	256	231	1	4	5	1	1
LIN-320	25	29	4	1	3	1	1	0
LIN-320	27	34	7	1	3	1	1	2
LIN-320	27	477	450	0	3	1	0	0
LIN-320	28	29	1	1	3	3	1	0
LIN-320	28	477	449	0	3	2	0	0
LIN-320	28	29	1	1	4	4	1	0
LIN-321	28	29	1	1	4	1	1	0
LIN-321	28	34	6	1	3	1	1	0
LIN-321	29	477	448	0	4	2	0	0
LIN-321	29	31	2	1	3	1	1	0
LIN-321	29	37	8	1	4	4	1	0
LIN-321	30	35	5	1	4	4	1	2
LIN-321	30	31	1	1	4	1	1	0
LIN-321	30	477	447	0	4	1	0	0
LIN-321	30	477	447	0	3	1	0	0
LIN-321	31	35	4	1	4	1	1	1
LIN-322	31	71	40	1	3	4	1	0
LIN-322	31	161	130	1	3	2	1	0
LIN-322	31	36	5	1	3	1	1	0
LIN-322	31	40	9	1	3	1	1	0
LIN-322	32	42	10	1	3	1	1	0
LIN-322	32	34	2	1	3	1	0	0
LIN-322	32	36	4	1	3	1	1	0
LIN-322	32	38	6	1	4	1	1	0
LIN-322	32	35	3	1	3	1	1	2
LIN-322	33	175	142	1	3	5	0	0
LIN-323	33	175	142	1	3	4	0	1
LIN-323	33	477	444	0	3	4	0	0
LIN-323	33	293	260	1	3	3	1	0
LIN-323	34	71	37	1	4	4	1	0
LIN-323	34	71	37	1	4	4	1	0
LIN-323	35	36	1	1	3	5	1	0
LIN-323	35	60	25	1	3	1	1	0
LIN-323	35	477	442	0	3	4	0	0
LIN-323	35	477	442	0	3	5	0	0
LIN-323	35	39	4	1	4	4	1	0
LIN-324	35	149	114	1	3	5	1	0
LIN-324	35	36	1	1	4	1	1	1
LIN-324	36	39	3	1	4	1	1	0
LIN-324	36	38	2	1	5	4	1	0
LIN-324	37	477	440	0	3	4	0	1
LIN-324	37	38	1	1	4	4	1	0
LIN-324	37	71	34	1	3	4	1	0
LIN-324	38	39	1	1	3	1	1	0
LIN-324	38	71	33	1	3	4	1	0
LIN-324	38	477	439	0	3	1	1	0
LIN-325	39	256	217	1	4	4	1	0
LIN-325	41	71	30	1	4	4	1	0
LIN-325	42	43	1	1	4	1	1	0
LIN-325	42	477	435	0	3	1	1	0
LIN-325	45	477	432	0	2	1	0	0
LIN-325	46	206	160	1	1	1	2	0
LIN-325	46	262	216	1	3	1	0	1
LIN-325	46	77	31	1	4	1	1	0
LIN-325	46	256	210	1	4	1	1	0
LIN-325	46	206	160	1	3	4	1	0
LIN-326	47	256	209	1	1	1	1	0
LIN-326	49	175	126	1	2	1	0	0
LIN-326	53	450	397	1	3	3	1	0
LIN-326	53	54	1	1	3	1	1	1
LIN-326	54	66	12	1	3	1	1	1
LIN-326	54	59	5	1	3	4	1	0
LIN-326	54	71	17	1	3	4	1	0
LIN-326	57	71	14	1	3	4	1	0
LIN-326	57	58	1	1	3	1	1	0
LIN-326	59	81	22	1	3	1	1	0
LIN-327	59	80	21	1	2	5	1	0
LIN-327	60	71	11	1	4	4	1	0
LIN-327	61	284	223	1	4	4	1	1
LIN-327	62	63	1	1	3	1	0	0
LIN-327	62	477	415	0	3	1	0	0
LIN-327	63	71	8	1	5	4	1	0
LIN-327	63	76	13	1	3	1	1	0
LIN-327	65	93	28	1	3	1	1	0
LIN-327	65	79	14	1	3	4	1	0
LIN-327	66	76	10	1	4	4	1	0
LIN-328	67	71	4	1	4	1	1	0
LIN-328	67	76	9	1	2	1	1	0
LIN-328	67	477	410	0	3	1	0	0
LIN-328	67	161	94	1	3	2	1	0
LIN-328	67	76	9	1	3	4	1	0
LIN-328	67	175	108	1	3	1	0	1
LIN-328	70	256	186	1	3	1	0	0
LIN-328	70	71	1	1	3	1	1	4
LIN-328	70	82	12	1	3	1	1	0
LIN-328	71	161	90	1	4	4	1	0
LIN-329	71	337	266	1	4	3	1	0
LIN-329	71	360	289	1	1	1	1	0
LIN-329	74	81	7	1	4	1	1	0
LIN-329	74	85	11	1	3	1	1	0
LIN-329	76	127	51	1	3	4	1	0
LIN-329	76	150	74	1	4	1	1	0
LIN-329	77	165	88	1	3	1	1	1
LIN-329	78	477	399	0	3	1	0	0
LIN-329	78	79	1	1	1	1	1	0
LIN-329	78	477	399	0	3	1	1	0
LIN-330	78	79	1	1	3	4	1	0
LIN-330	78	79	1	1	3	4	1	0
LIN-330	79	80	1	1	3	4	0	0
LIN-330	79	175	96	1	3	1	0	1
LIN-330	79	477	398	0	3	5	0	0
LIN-330	79	90	11	1	4	4	0	0
LIN-330	79	80	1	1	3	1	1	0
LIN-330	79	477	398	0	3	3	0	0
LIN-330	79	477	398	0	3	4	0	0
LIN-330	79	123	44	1	3	1	0	0
LIN-331	80	477	397	0	3	4	1	0
LIN-331	81	93	12	1	3	1	1	0
LIN-331	81	477	396	0	3	1	0	1
LIN-331	82	175	93	1	3	5	0	0
LIN-331	84	85	1	1	3	4	1	0
LIN-331	84	93	9	1	3	2	1	0
LIN-331	84	85	1	1	3	1	0	1
LIN-331	84	235	151	1	3	3	1	0
LIN-331	85	256	171	1	3	1	0	0
LIN-331	85	477	392	0	1	1	0	0
LIN-332	85	86	1	1	4	4	1	0
LIN-332	85	170	85	1	3	4	1	0
LIN-332	85	477	392	0	3	1	0	1
LIN-332	86	91	5	1	4	4	0	0
LIN-332	86	93	7	1	3	1	1	0
LIN-332	88	123	35	1	3	1	1	1
LIN-332	88	352	264	1	3	4	1	1
LIN-332	88	98	10	1	3	3	1	0
LIN-332	90	160	70	1	3	4	1	0
LIN-332	91	175	84	1	3	1	0	0
LIN-333	97	100	3	1	4	4	0	1
LIN-333	97	160	63	1	4	4	1	1
LIN-333	98	477	379	0	2	5	0	0
LIN-333	98	477	379	0	3	1	0	0
LIN-333	98	477	379	0	3	3	0	0
LIN-333	99	477	378	0	3	4	1	0
LIN-333	99	149	50	1	4	1	2	0
LIN-333	102	177	75	1	3	4	1	0
LIN-333	104	477	373	0	4	4	0	0
LIN-333	104	148	44	1	5	4	0	0
LIN-334	105	177	72	1	4	4	1	0
LIN-334	106	477	371	0	3	4	0	0
LIN-334	107	108	1	1	3	1	0	0
LIN-334	108	112	4	1	3	2	1	0
LIN-334	108	109	1	1	4	1	0	0
LIN-334	112	146	34	1	3	4	2	0
LIN-334	112	123	11	1	3	1	0	0
LIN-334	114	240	126	1	3	1	1	0
LIN-334	114	149	35	1	3	1	2	0
LIN-334	114	170	56	1	3	1	0	0
LIN-335	115	477	362	0	3	2	0	0
LIN-335	115	175	60	1	3	3	0	1
LIN-335	116	160	44	1	3	1	2	2
LIN-335	116	198	82	1	4	4	0	0
LIN-335	117	146	29	1	3	4	1	0
LIN-335	117	213	96	1	3	4	1	1
LIN-335	119	268	149	1	4	4	0	0
LIN-335	121	206	85	1	4	1	0	0
LIN-335	121	165	44	1	3	2	1	2
LIN-335	121	165	44	1	3	5	1	4
LIN-336	121	175	54	1	3	5	1	0
LIN-336	121	477	356	0	3	5	1	0
LIN-336	121	165	44	1	3	5	1	0
LIN-336	121	146	25	1	4	1	2	0
LIN-336	122	165	43	1	3	5	1	0
LIN-336	122	352	230	1	3	5	1	1
LIN-336	122	151	29	1	4	2	1	0
LIN-336	123	143	20	1	4	1	1	1
LIN-336	123	139	16	1	3	1	1	1
LIN-336	126	137	11	1	3	4	1	0
LIN-337	126	188	62	1	3	4	1	1
LIN-337	127	477	350	0	3	1	1	0
LIN-337	128	151	23	1	3	3	2	1
LIN-337	129	165	36	1	3	5	1	1
LIN-337	129	165	36	1	3	5	1	0
LIN-337	129	165	36	1	3	5	1	0
LIN-337	129	165	36	1	3	5	1	0
LIN-337	129	165	36	1	3	5	1	0
LIN-337	130	161	31	1	3	2	1	0
LIN-337	132	219	87	1	3	1	1	0
LIN-338	134	146	12	1	4	4	1	0
LIN-338	135	177	42	1	4	1	0	1
LIN-338	135	213	78	1	4	1	1	0
LIN-338	136	144	8	1	3	4	0	0
LIN-338	142	182	40	1	4	4	1	0
LIN-338	144	219	75	1	3	1	1	0
LIN-338	144	165	21	1	4	4	1	0
LIN-338	144	477	333	0	3	4	0	0
LIN-338	147	165	18	1	2	1	2	3
LIN-338	147	477	330	0	3	1	1	0
LIN-339	147	188	41	1	3	1	1	0
LIN-339	147	188	41	1	3	1	2	0
LIN-339	148	477	329	0	3	1	0	1
LIN-339	149	175	26	1	3	4	0	0
LIN-339	150	477	327	0	3	3	0	0
LIN-339	151	191	40	1	3	1	0	0
LIN-339	154	155	1	1	4	1	1	0
LIN-339	155	477	322	0	3	1	0	0
LIN-339	155	161	6	1	3	1	1	0
LIN-339	155	185	30	1	3	1	1	0
LIN-340	156	169	13	1	3	1	2	0
LIN-340	156	160	4	1	3	1	2	0
LIN-340	158	165	7	1	3	4	0	0
LIN-340	162	188	26	1	3	1	2	0
LIN-340	162	169	7	1	3	1	2	1
LIN-340	162	477	315	0	3	1	0	0
LIN-340	163	347	184	1	3	1	1	0
LIN-340	163	256	93	1	3	1	0	0
LIN-340	163	175	12	1	3	3	0	0
LIN-340	163	477	314	0	3	1	0	0
LIN-341	164	256	92	1	2	1	0	0
LIN-341	165	477	312	0	4	4	1	0
LIN-341	166	175	9	1	3	1	0	0
LIN-341	168	175	7	1	3	1	0	1
LIN-341	168	206	38	1	3	4	1	0
LIN-341	169	170	1	1	3	3	2	0
LIN-341	169	347	178	1	1	1	1	0
LIN-341	169	477	308	0	3	4	1	0
LIN-341	169	235	66	1	3	4	1	0
LIN-341	169	235	66	1	3	4	1	0
LIN-342	170	477	307	0	2	1	0	0
LIN-342	170	173	3	1	3	4	2	1
LIN-342	170	171	1	1	4	4	1	0
LIN-342	171	188	17	1	3	4	1	0
LIN-342	173	231	58	1	3	4	2	1
LIN-342	175	188	13	1	3	3	1	0
LIN-342	175	477	302	0	4	1	0	0
LIN-342	176	185	9	1	3	4	1	0
LIN-342	176	186	10	1	2	1	2	0
LIN-342	176	477	301	0	3	4	0	0
LIN-343	177	360	183	1	3	4	1	0
LIN-343	177	477	300	0	3	4	1	0
LIN-343	177	477	300	0	3	4	0	1
LIN-343	179	477	298	0	3	5	0	0
LIN-343	179	225	46	1	3	4	1	2
LIN-343	181	477	296	0	3	4	0	0
LIN-343	182	240	58	1	3	3	1	0
LIN-343	183	256	73	1	3	4	0	0
LIN-343	183	196	13	1	3	1	2	3
LIN-343	183	261	78	1	4	1	2	0
LIN-344	184	185	1	1	3	1	2	0
LIN-344	186	254	68	1	3	4	1	0
LIN-344	186	235	49	1	3	4	1	0
LIN-344	186	477	291	0	3	4	0	0
LIN-344	189	190	1	1	3	4	0	0
LIN-344	192	310	118	1	4	4	1	0
LIN-344	192	231	39	1	3	1	1	0
LIN-344	192	477	285	0	3	4	0	0
LIN-344	193	477	284	0	3	1	0	0
LIN-344	193	235	42	1	3	4	1	0
LIN-345	193	477	284	0	4	4	0	0
LIN-345	194	199	5	1	4	1	2	0
LIN-345	195	213	18	1	3	4	1	0
LIN-345	195	213	18	1	3	4	1	1
LIN-345	196	245	49	1	3	4	1	0
LIN-345	197	477	280	0	3	4	0	0
LIN-345	197	240	43	1	3	1	2	0
LIN-345	197	206	9	1	3	4	1	0
LIN-345	198	240	42	1	3	1	1	0
LIN-345	198	206	8	1	3	1	0	0
LIN-346	199	240	41	1	3	1	1	1
LIN-346	200	213	13	1	2	1	2	0
LIN-346	203	213	10	1	3	1	1	0
LIN-346	203	218	15	1	4	4	2	0
LIN-346	203	213	10	1	4	4	1	0
LIN-346	204	205	1	1	3	1	0	0
LIN-346	204	205	1	1	2	4	0	0
LIN-346	205	206	1	1	3	1	0	0
LIN-346	205	206	1	1	3	1	0	1
LIN-346	205	206	1	1	3	1	0	0
LIN-347	206	234	28	1	3	4	1	0
LIN-347	207	219	12	1	3	4	1	1
LIN-347	207	240	33	1	4	4	1	1
LIN-347	207	477	270	0	3	1	0	0
LIN-347	210	450	240	1	3	1	1	0
LIN-347	210	213	3	1	3	4	1	0
LIN-347	211	219	8	1	3	1	2	1
LIN-347	212	239	27	1	3	1	1	0
LIN-347	212	213	1	1	3	4	1	0
LIN-347	212	217	5	1	3	4	1	0
LIN-348	213	239	26	1	3	4	1	0
LIN-348	214	218	4	1	4	4	1	0
LIN-348	214	245	31	1	4	1	1	0
LIN-348	214	217	3	1	4	1	1	0
LIN-348	215	477	262	0	4	3	0	0
LIN-348	217	219	2	1	4	4	1	0
LIN-348	218	231	13	1	4	1	0	0
LIN-348	221	477	256	0	3	4	1	0
LIN-348	221	245	24	1	3	2	1	0
LIN-348	221	231	10	1	3	4	1	1
LIN-349	221	231	10	1	3	4	1	1
LIN-349	221	245	24	1	3	4	1	1
LIN-349	223	231	8	1	5	1	2	0
LIN-349	224	477	253	0	3	1	0	0
LIN-349	224	417	193	1	3	1	1	0
LIN-349	224	477	253	0	3	1	0	0
LIN-349	225	284	59	1	4	4	1	0
LIN-349	225	263	38	1	4	4	1	0
LIN-349	225	235	10	1	4	4	0	0
LIN-349	225	284	59	1	3	4	1	1
LIN-350	226	231	5	1	3	1	2	0
LIN-350	227	477	250	0	3	5	0	0
LIN-350	228	477	249	0	3	1	0	0
LIN-350	231	239	8	1	3	4	2	1
LIN-350	232	251	19	1	3	3	1	0
LIN-350	232	233	1	1	4	1	2	0
LIN-350	233	239	6	1	3	1	1	0
LIN-350	233	234	1	1	4	4	2	0
LIN-350	234	235	1	1	3	1	1	0
LIN-350	234	240	6	1	3	4	1	0
LIN-351	234	238	4	1	4	4	1	0
LIN-351	235	477	242	0	4	1	1	0
LIN-351	235	477	242	0	3	4	1	0
LIN-351	235	371	136	1	3	3	1	0
LIN-351	235	477	242	0	4	2	0	0
LIN-351	237	263	26	1	3	1	1	1
LIN-351	237	239	2	1	4	1	1	0
LIN-351	239	254	15	1	3	1	1	0
LIN-351	239	242	3	1	3	1	1	0
LIN-351	239	477	238	0	4	4	0	1
LIN-352	240	293	53	1	3	4	1	1
LIN-352	242	259	17	1	4	4	1	0
LIN-352	242	245	3	1	4	1	1	0
LIN-352	242	477	235	0	3	4	0	0
LIN-352	244	253	9	1	3	1	0	0
LIN-352	245	254	9	1	4	1	1	0
LIN-352	245	301	56	1	4	4	1	0
LIN-352	246	301	55	1	4	1	1	0
LIN-352	246	301	55	1	4	4	1	0
LIN-352	246	253	7	1	3	1	1	0
LIN-353	246	253	7	1	3	1	0	0
LIN-353	246	269	23	1	3	1	1	0
LIN-353	246	477	231	0	3	1	0	0
LIN-353	246	253	7	1	3	1	1	0
LIN-353	246	253	7	1	3	1	1	0
LIN-353	246	247	1	1	3	1	1	0
LIN-353	246	252	6	1	4	1	1	0
LIN-353	247	417	170	1	3	1	1	0
LIN-353	247	253	6	1	4	1	1	0
LIN-353	247	253	6	1	3	4	1	0
LIN-354	247	358	111	1	3	4	1	0
LIN-354	247	477	230	0	3	1	0	0
LIN-354	248	256	8	1	4	1	0	0
LIN-354	248	261	13	1	4	1	1	0
LIN-354	249	352	103	1	3	4	1	0
LIN-354	252	477	225	0	3	4	0	0
LIN-354	252	266	14	1	3	1	2	0
LIN-354	252	254	2	1	1	1	1	0
LIN-354	252	253	1	1	3	1	0	0
LIN-354	252	253	1	1	3	1	0	0
LIN-355	253	254	1	1	4	1	1	0
LIN-355	253	254	1	1	4	1	1	0
LIN-355	253	332	79	1	3	2	1	0
LIN-355	253	254	1	1	3	1	2	0
LIN-355	253	256	3	1	3	1	1	0
LIN-355	253	477	224	0	3	1	0	0
LIN-355	253	302	49	1	4	1	1	0
LIN-355	253	254	1	1	4	1	1	0
LIN-355	254	260	6	1	3	5	1	0
LIN-355	255	358	103	1	3	3	1	0
LIN-356	256	310	54	1	3	3	1	0
LIN-356	256	477	221	0	3	3	0	0
LIN-356	259	301	42	1	3	1	2	2
LIN-356	259	477	218	0	3	4	0	0
LIN-356	259	260	1	1	3	1	1	0
LIN-356	259	267	8	1	4	1	1	1
LIN-356	259	477	218	0	3	1	0	0
LIN-356	260	267	7	1	4	1	1	0
LIN-356	261	262	1	1	4	1	0	1
LIN-356	261	477	216	0	3	1	0	0
LIN-357	261	371	110	1	3	4	1	0
LIN-357	261	450	189	1	3	4	1	0
LIN-357	261	477	216	0	3	3	0	0
LIN-357	262	477	215	0	3	3	0	0
LIN-357	263	270	7	1	4	1	1	0
LIN-357	263	266	3	1	4	1	1	0
LIN-357	265	267	2	1	4	1	1	0
LIN-357	265	477	212	0	4	4	0	0
LIN-357	265	310	45	1	3	1	1	0
LIN-357	265	295	30	1	4	1	1	0
LIN-358	265	269	4	1	3	1	1	0
LIN-358	265	272	7	1	4	1	1	0
LIN-358	265	269	4	1	4	1	2	0
LIN-358	265	295	30	1	4	1	0	0
LIN-358	265	477	212	0	4	1	0	0
LIN-358	265	295	30	1	4	1	0	0
LIN-358	265	269	4	1	3	1	1	0
LIN-358	266	269	3	1	4	1	0	0
LIN-358	266	272	6	1	4	1	1	0
LIN-358	266	272	6	1	3	1	1	0
LIN-359	266	272	6	1	3	1	1	0
LIN-359	267	477	210	0	3	1	0	0
LIN-359	267	268	1	1	5	4	1	0
LIN-359	267	477	210	0	4	4	0	0
LIN-359	267	280	13	1	3	1	1	0
LIN-359	267	268	1	1	4	1	1	0
LIN-359	268	280	12	1	3	1	0	0
LIN-359	268	366	98	1	3	4	1	0
LIN-359	268	477	209	0	3	3	0	0
LIN-359	269	301	32	1	3	4	1	0
LIN-360	269	270	1	1	3	4	1	0
LIN-360	270	477	207	0	3	1	0	0
LIN-360	270	347	77	1	3	4	1	0
LIN-360	271	284	13	1	4	1	1	0
LIN-360	271	295	24	1	1	1	1	0
LIN-360	271	477	206	0	3	4	0	0
LIN-360	272	477	205	0	3	1	0	0
LIN-360	273	350	77	1	3	1	1	0
LIN-360	274	477	203	0	4	3	0	0
LIN-360	274	477	203	0	4	1	0	0
LIN-361	275	477	202	0	4	3	0	0
LIN-361	276	304	28	1	3	4	2	0
LIN-361	278	477	199	0	3	2	0	0
LIN-361	280	297	17	1	3	1	2	1
LIN-361	280	477	197	0	3	1	0	0
LIN-361	280	284	4	1	3	1	0	0
LIN-361	280	284	4	1	3	1	1	0
LIN-361	281	342	61	1	3	4	1	0
LIN-361	281	477	196	0	3	4	0	0
LIN-361	282	310	28	1	3	1	1	0
LIN-362	284	296	12	1	3	1	1	0
LIN-362	284	477	193	0	3	2	0	0
LIN-362	284	477	193	0	3	5	0	0
LIN-362	284	477	193	0	3	5	0	0
LIN-362	284	477	193	0	3	5	0	0
LIN-362	284	477	193	0	3	5	0	0
LIN-362	284	477	193	0	3	5	0	0
LIN-362	284	285	1	1	3	1	0	0
LIN-362	285	360	75	1	3	4	1	0
LIN-362	286	301	15	1	3	1	1	1
LIN-363	286	287	1	1	4	4	1	0
LIN-363	286	323	37	1	4	4	1	0
LIN-363	287	289	2	1	4	4	1	0
LIN-363	288	296	8	1	3	1	1	0
LIN-363	289	304	15	1	3	1	2	0
LIN-363	290	301	11	1	3	1	2	0
LIN-363	290	330	40	1	3	1	1	0
LIN-363	291	301	10	1	3	1	0	2
LIN-363	291	477	186	0	4	5	0	0
LIN-363	291	294	3	1	3	1	0	0
LIN-364	292	305	13	1	4	4	1	0
LIN-364	294	477	183	0	3	3	0	0
LIN-364	294	295	1	1	3	3	1	0
LIN-364	295	359	64	1	2	1	1	0
LIN-364	295	304	9	1	3	1	1	2
LIN-364	296	297	1	1	4	1	2	0
LIN-364	296	302	6	1	3	4	2	0
LIN-364	296	297	1	1	3	1	2	1
LIN-364	297	347	50	1	4	1	0	0
LIN-364	298	303	5	1	3	1	1	0
LIN-365	298	477	179	0	3	4	0	0
LIN-365	300	301	1	1	3	1	1	0
LIN-365	302	477	175	0	3	4	0	0
LIN-365	302	305	3	1	3	1	1	0
LIN-365	303	461	158	1	3	2	1	0
LIN-365	303	357	54	1	3	4	1	0
LIN-365	303	318	15	1	3	4	1	0
LIN-365	304	477	173	0	3	1	0	0
LIN-365	304	360	56	1	3	1	0	2
LIN-365	304	477	173	0	4	4	1	0
LIN-366	304	305	1	1	3	1	0	0
LIN-366	304	477	173	0	3	1	0	0
LIN-366	304	310	6	1	4	1	1	0
LIN-366	305	310	5	1	4	1	1	0
LIN-366	305	477	172	0	3	4	0	0
LIN-366	305	331	26	1	3	1	1	0
LIN-366	308	325	17	1	3	1	1	1
LIN-366	308	315	7	1	3	1	0	0
LIN-366	309	477	168	0	3	1	0	0
LIN-366	309	329	20	1	5	4	1	0
LIN-367	309	310	1	1	5	4	1	0
LIN-367	310	336	26	1	4	4	1	0
LIN-367	311	315	4	1	2	1	1	0
LIN-367	311	477	166	0	4	5	0	0
LIN-367	311	477	166	0	3	1	0	0
LIN-367	311	323	12	1	3	1	0	0
LIN-367	312	319	7	1	3	4	1	0
LIN-367	312	477	165	0	3	1	0	0
LIN-367	312	329	17	1	3	1	1	0
LIN-367	314	477	163	0	3	2	0	0
LIN-368	315	347	32	1	3	1	1	0
LIN-368	315	477	162	0	3	1	0	0
LIN-368	316	477	161	0	3	1	0	0
LIN-368	316	323	7	1	3	1	1	0
LIN-368	316	329	13	1	3	1	1	0
LIN-368	316	477	161	0	3	1	0	0
LIN-368	316	477	161	0	3	4	0	0
LIN-368	316	419	103	1	3	4	0	1
LIN-368	317	323	6	1	3	1	0	0
LIN-368	317	329	12	1	3	1	1	0
LIN-369	319	461	142	1	3	5	1	0
LIN-369	319	461	142	1	3	5	1	0
LIN-369	319	461	142	1	3	5	1	0
LIN-369	321	330	9	1	3	1	1	2
LIN-369	322	477	155	0	3	2	0	0
LIN-369	323	345	22	1	4	1	1	0
LIN-369	323	329	6	1	3	1	0	1
LIN-369	323	347	24	1	4	1	1	0
LIN-369	323	477	154	0	4	4	1	0
LIN-369	326	354	28	1	3	1	1	1
LIN-370	326	347	21	1	3	4	1	2
LIN-370	328	477	149	0	3	5	0	0
LIN-370	329	343	14	1	3	3	0	0
LIN-370	329	417	88	1	3	1	1	0
LIN-370	329	330	1	1	3	4	1	0
LIN-370	331	336	5	1	2	1	1	1
LIN-370	331	359	28	1	4	1	0	0
LIN-370	331	359	28	1	4	4	1	0
LIN-370	332	477	145	0	3	1	0	0
LIN-370	337	357	20	1	2	1	0	0
LIN-371	338	354	16	1	3	1	1	0
LIN-371	339	461	122	1	4	4	0	0
LIN-371	340	341	1	1	1	1	1	0
LIN-371	340	477	137	0	3	1	0	0
LIN-371	343	422	79	1	3	1	1	0
LIN-371	343	347	4	1	3	1	1	0
LIN-371	344	427	83	1	4	4	1	0
LIN-371	345	346	1	1	3	1	0	0
LIN-371	346	347	1	1	3	1	1	0
LIN-371	346	347	1	1	3	1	0	0
LIN-372	348	350	2	1	3	4	1	0
LIN-372	349	350	1	1	4	1	1	0
LIN-372	349	371	22	1	3	1	1	1
LIN-372	350	360	10	1	3	4	0	0
LIN-372	350	357	7	1	3	1	1	0
LIN-372	351	402	51	1	3	3	1	0
LIN-372	351	359	8	1	3	5	0	0
LIN-372	352	424	72	1	3	1	1	1
LIN-372	352	477	125	0	3	1	0	0
LIN-372	352	359	7	1	4	4	1	0
LIN-373	352	359	7	1	4	1	0	0
LIN-373	353	359	6	1	2	1	1	0
LIN-373	353	359	6	1	1	1	0	0
LIN-373	353	477	124	0	1	1	0	0
LIN-373	353	356	3	1	3	1	1	0
LIN-373	354	358	4	1	4	1	0	0
LIN-373	355	477	122	0	3	1	0	0
LIN-373	356	359	3	1	3	4	1	0
LIN-373	357	380	23	1	3	1	1	0
LIN-373	358	477	119	0	3	4	0	0
LIN-374	358	372	14	1	1	1	1	0
LIN-374	358	477	119	0	4	1	0	0
LIN-374	359	362	3	1	2	1	0	0
LIN-374	360	428	68	1	3	1	0	0
LIN-374	360	461	101	1	4	4	1	0
LIN-374	361	362	1	1	3	5	1	0
LIN-374	361	477	116	0	3	1	0	0
LIN-374	361	362	1	1	3	5	1	0
LIN-374	361	366	5	1	3	1	1	0
LIN-374	363	366	3	1	3	4	1	0
NG-137	2	184	182	1	3	2	0	0
NG-137	3	4	1	1	5	1	1	0
NG-137	19	20	1	1	4	4	1	0
NG-137	19	477	458	0	5	4	0	0
NG-137	27	46	19	1	3	1	0	0
NG-137	38	39	1	1	3	5	0	1
NG-138	52	183	131	1	4	1	1	0
NG-138	55	477	422	0	3	1	0	0
NG-138	60	230	170	1	3	2	0	0
NG-138	60	477	417	0	3	1	0	0
NG-138	66	81	15	1	3	1	1	0
NG-138	68	69	1	1	4	1	1	0
NG-138	71	477	406	0	4	1	0	0
NG-138	74	477	403	0	4	4	0	0
NG-138	82	83	1	1	5	5	0	0
NG-138	97	477	380	0	3	3	0	1
NG-139	100	141	41	1	4	4	1	0
NG-139	101	107	6	1	4	1	1	0
NG-139	108	158	50	1	3	2	1	0
NG-139	109	110	1	1	3	4	1	0
NG-139	111	112	1	1	3	4	1	0
NG-139	128	129	1	1	3	1	1	1
NG-139	129	130	1	1	3	1	1	1
NG-139	135	137	2	1	3	1	1	2
NG-139	161	162	1	1	3	1	0	0
NG-140	173	477	304	0	4	4	0	0
NG-140	186	207	21	1	4	1	1	0
NG-140	187	227	40	1	4	2	1	0
NG-140	189	477	288	0	4	5	0	0
NG-140	192	194	2	1	4	4	0	0
NG-140	207	208	1	1	4	4	1	0
NG-140	212	477	265	0	3	1	0	0
NG-140	217	477	260	0	4	3	0	0
NG-140	219	225	6	1	4	4	1	0
NG-140	220	477	257	0	3	1	0	0
NG-141	226	477	251	0	4	4	0	0
NG-141	226	231	5	1	3	2	1	0
NG-141	226	477	251	0	3	2	0	0
NG-141	233	477	244	0	3	4	1	0
NG-141	233	477	244	0	3	1	1	0
NG-141	234	235	1	1	3	3	1	0
NG-141	234	246	12	1	3	3	1	0
NG-141	239	246	7	1	3	4	1	0
NG-141	248	477	229	0	3	1	0	0
NG-141	248	261	13	1	2	1	1	1
NG-142	255	477	222	0	3	1	0	0
NG-142	263	477	214	0	4	4	0	1
NG-142	297	298	1	1	3	2	1	0
NG-142	316	477	161	0	4	4	0	0
NG-142	318	477	159	0	4	3	0	0
NG-142	321	477	156	0	3	1	0	0
NG-142	343	477	134	0	5	1	0	0
NG-142	344	345	1	1	3	2	1	0
NG-142	357	358	1	1	4	3	0	0
NG-142	362	477	115	0	3	1	0	0
GAL-35	11	143	132	1	3	5	0	1
GAL-36	22	264	242	1	3	5	0	2
GAL-36	22	49	27	1	3	5	0	0
GAL-36	25	83	58	1	3	5	0	1
GAL-36	29	143	114	1	3	5	0	0
GAL-36	29	143	114	1	3	5	0	0
GAL-36	32	219	187	1	3	5	0	1
GAL-36	36	143	107	1	3	5	0	0
GAL-36	40	79	39	1	3	5	0	0
GAL-36	42	43	1	1	3	5	0	0
GAL-36	42	219	177	1	3	5	0	0
GAL-37	64	219	155	1	3	5	0	0
GAL-37	64	143	79	1	3	5	0	0
GAL-37	66	219	153	1	3	5	0	0
GAL-37	71	143	72	1	3	5	0	0
GAL-37	71	85	14	1	3	5	0	0
GAL-37	75	143	68	1	3	5	0	0
GAL-37	78	143	65	1	3	3	0	0
GAL-37	81	219	138	1	3	5	0	0
GAL-37	82	92	10	1	3	5	0	0
GAL-37	92	93	1	1	3	5	0	0
GAL-38	94	95	1	1	3	5	0	0
GAL-38	129	130	1	1	3	5	0	0
GAL-38	140	142	2	1	3	5	0	0
GAL-38	141	477	336	0	3	3	0	0
GAL-38	141	154	13	1	3	5	0	0
GAL-38	142	219	77	1	3	5	0	1
GAL-38	142	176	34	1	3	5	0	1
GAL-38	142	214	72	1	3	5	0	2
GAL-38	144	219	75	1	3	5	0	0
GAL-38	144	159	15	1	3	5	0	2
GAL-39	154	477	323	0	3	5	0	0
GAL-39	183	219	36	1	3	5	0	0
GAL-39	185	209	24	1	3	5	0	0
GAL-39	192	405	213	1	3	5	0	1
GAL-39	194	214	20	1	3	5	0	0
GAL-39	198	202	4	1	3	5	0	0
GAL-39	200	465	265	1	3	3	0	1
GAL-39	212	214	2	1	3	5	0	0
GAL-39	220	221	1	1	3	5	0	0
GAL-39	221	266	45	1	3	5	0	0
GAL-40	227	231	4	1	3	5	0	0
GAL-40	231	265	34	1	3	5	0	0
GAL-40	233	433	200	1	3	5	0	0
GAL-40	235	264	29	1	3	5	0	0
GAL-40	238	239	1	1	3	5	0	0
GAL-40	238	239	1	1	3	5	0	0
GAL-40	247	264	17	1	3	5	0	0
GAL-40	259	264	5	1	3	5	0	0
GAL-40	266	268	2	1	3	5	0	0
GAL-40	267	268	1	1	3	3	0	0
GAL-41	267	433	166	1	3	3	0	1
GAL-41	267	416	149	1	3	3	0	1
GAL-41	267	477	210	0	3	3	0	1
GAL-41	267	477	210	0	3	3	0	1
GAL-41	267	477	210	0	3	3	0	1
GAL-41	267	477	210	0	3	3	0	1
GAL-41	268	477	209	0	3	3	0	1
GAL-41	268	269	1	1	3	5	0	0
GAL-41	273	280	7	1	3	5	0	0
GAL-41	280	286	6	1	3	5	0	0
GAL-42	281	323	42	1	3	5	0	1
GAL-42	290	298	8	1	3	5	0	0
GAL-42	291	477	186	0	3	3	0	0
GAL-42	291	292	1	1	3	5	0	0
GAL-42	322	327	5	1	3	5	0	0
GAL-42	331	341	10	1	3	5	0	0
GAL-42	339	435	96	1	3	5	0	0
GAL-42	345	405	60	1	3	5	0	0
NS-149	1	477	476	0	3	1	1	0
NS-149	1	477	476	0	3	1	1	0
NS-150	2	22	20	1	3	1	1	1
NS-150	7	8	1	1	3	1	1	0
NS-150	31	177	146	1	3	1	1	0
NS-150	36	477	441	0	5	1	1	0
NS-150	37	477	440	0	3	2	0	0
NS-150	42	477	435	0	3	1	0	0
NS-150	71	94	23	1	3	4	1	0
NS-150	86	87	1	1	3	1	0	0
NS-150	98	200	102	1	3	3	1	0
NS-150	100	137	37	1	3	4	1	0
NS-151	109	110	1	1	3	1	1	0
NS-151	137	477	340	0	3	1	0	0
NS-151	137	138	1	1	3	3	1	0
NS-151	140	141	1	1	3	1	1	0
NS-151	142	143	1	1	3	4	1	0
NS-151	144	145	1	1	3	1	1	0
NS-151	144	145	1	1	3	1	1	0
NS-151	151	154	3	1	3	1	0	0
NS-151	154	155	1	1	3	1	0	0
NS-151	161	162	1	1	3	3	1	0
NS-152	162	163	1	1	3	3	1	0
NS-152	163	177	14	1	3	3	1	0
NS-152	183	477	294	0	3	1	1	0
NS-152	192	193	1	1	3	3	1	0
NS-152	198	477	279	0	3	4	0	0
NS-152	219	227	8	1	3	3	1	0
NS-152	219	220	1	1	3	4	1	0
NS-152	220	221	1	1	3	1	1	0
NS-152	226	477	251	0	3	2	0	0
NS-152	227	248	21	1	3	3	1	1
NS-153	227	477	250	0	3	3	0	0
NS-153	227	310	83	1	3	4	0	1
NS-153	233	477	244	0	3	1	0	1
NS-153	238	262	24	1	3	4	1	2
NS-153	249	252	3	1	3	4	1	0
NS-153	252	477	225	0	3	4	0	0
NS-153	252	477	225	0	3	4	0	0
NS-153	263	477	214	0	3	4	1	1
NS-153	344	393	49	1	3	4	1	0
BCLOUD-100	171	477	306	0	2	1	0	1
BCLOUD-100	182	477	295	0	3	1	0	0
BCLOUD-100	182	477	295	0	5	4	0	0
BCLOUD-100	183	477	294	0	3	1	0	1
BCLOUD-100	183	477	294	0	5	4	0	0
BCLOUD-100	211	477	266	0	4	4	0	0
BCLOUD-100	224	477	253	0	3	4	0	0
BCLOUD-100	231	477	246	0	3	1	0	0
BCLOUD-100	235	477	242	0	2	1	0	0
BCLOUD-100	235	477	242	0	3	1	0	0
BCLOUD-101	238	477	239	0	3	1	0	0
BCLOUD-101	246	477	231	0	3	1	0	0
BCLOUD-101	254	477	223	0	4	4	0	0
BCLOUD-101	263	264	1	1	3	4	0	1
BCLOUD-101	266	477	211	0	4	4	0	0
BCLOUD-101	267	477	210	0	3	1	0	0
BCLOUD-101	269	477	208	0	4	4	0	0
BCLOUD-101	269	477	208	0	4	1	0	0
BCLOUD-101	270	477	207	0	3	4	0	0
BCLOUD-101	284	477	193	0	4	1	1	0
BCLOUD-102	295	477	182	0	5	2	0	0
BCLOUD-102	296	477	181	0	3	4	0	0
BCLOUD-102	313	477	164	0	4	4	0	0
BCLOUD-102	316	477	161	0	3	2	0	0
BCLOUD-102	325	477	152	0	3	2	0	0
BCLOUD-102	325	477	152	0	3	4	0	0
BCLOUD-102	330	477	147	0	5	4	0	0
BCLOUD-102	332	477	145	0	4	1	0	0
BCLOUD-102	333	477	144	0	3	3	0	0
BCLOUD-102	338	477	139	0	3	1	0	0
BCLOUD-103	347	477	130	0	3	2	0	0
BCLOUD-103	352	477	125	0	4	4	0	0
BCLOUD-97	2	477	475	0	3	1	0	0
BCLOUD-97	7	477	470	0	3	1	0	0
BCLOUD-97	17	22	5	1	3	1	0	0
BCLOUD-97	22	24	2	1	4	4	0	0
BCLOUD-97	24	25	1	1	1	1	0	0
BCLOUD-97	25	28	3	1	4	2	0	0
BCLOUD-97	26	477	451	0	4	1	0	0
BCLOUD-97	26	477	451	0	3	1	0	0
BCLOUD-98	30	477	447	0	1	1	0	0
BCLOUD-98	35	477	442	0	3	1	0	0
BCLOUD-98	35	477	442	0	3	1	0	0
BCLOUD-98	49	51	2	1	4	5	0	0
BCLOUD-98	64	477	413	0	3	5	0	0
BCLOUD-98	71	477	406	0	4	4	0	0
BCLOUD-98	74	88	14	1	3	4	0	0
BCLOUD-98	74	477	403	0	3	2	0	1
BCLOUD-98	74	477	403	0	3	1	0	0
BCLOUD-98	77	477	400	0	4	1	0	0
BCLOUD-99	85	86	1	1	3	1	0	0
BCLOUD-99	87	105	18	1	4	1	0	0
BCLOUD-99	98	477	379	0	4	4	0	0
BCLOUD-99	106	477	371	0	3	1	0	0
BCLOUD-99	108	477	369	0	3	1	0	0
BCLOUD-99	119	477	358	0	3	1	0	0
BCLOUD-99	142	477	335	0	4	4	0	0
BCLOUD-99	143	477	334	0	3	1	0	0
BCLOUD-99	143	477	334	0	3	4	0	0
BCLOUD-99	165	477	312	0	3	1	0	0
VY-43	1	477	476	0	3	1	0	0
VY-43	10	134	124	1	3	1	0	0
VY-43	14	477	463	0	5	1	0	0
VY-43	14	477	463	0	3	1	0	0
VY-43	15	39	24	1	3	3	1	0
VY-43	22	477	455	0	4	1	0	0
VY-43	25	477	452	0	3	1	0	0
VY-43	29	477	448	0	3	4	0	0
VY-43	34	477	443	0	3	1	0	0
VY-43	35	477	442	0	3	1	0	0
VY-44	35	36	1	1	3	3	0	1
VY-44	35	36	1	1	3	1	0	0
VY-44	36	44	8	1	4	1	0	0
VY-44	36	37	1	1	4	4	0	1
VY-44	50	477	427	0	3	4	0	0
VY-44	58	59	1	1	3	4	0	1
VY-44	63	70	7	1	3	4	1	0
VY-44	63	477	414	0	3	1	0	0
VY-44	65	66	1	1	5	4	1	0
VY-44	65	477	412	0	3	4	0	0
VY-45	72	224	152	1	3	4	0	0
VY-45	72	477	405	0	3	1	0	0
VY-45	74	140	66	1	3	4	1	0
VY-45	79	477	398	0	3	1	0	0
VY-45	85	91	6	1	4	5	0	0
VY-45	93	100	7	1	3	1	2	0
VY-45	101	477	376	0	4	1	0	0
VY-45	105	107	2	1	3	1	2	0
VY-45	107	108	1	1	3	1	1	0
VY-45	108	477	369	0	3	1	0	0
VY-46	113	115	2	1	5	4	1	0
VY-46	113	121	8	1	3	5	0	0
VY-46	117	121	4	1	5	5	0	0
VY-46	119	477	358	0	5	5	0	0
VY-46	119	477	358	0	3	1	0	0
VY-46	120	477	357	0	4	5	0	0
VY-46	121	122	1	1	3	1	2	0
VY-46	129	130	1	1	3	4	0	0
VY-46	129	142	13	1	4	2	1	0
VY-46	130	477	347	0	3	1	0	0
VY-47	134	477	343	0	3	1	0	0
VY-47	137	477	340	0	3	4	0	1
VY-47	142	144	2	1	4	4	2	0
VY-47	147	148	1	1	4	4	1	0
VY-47	149	477	328	0	3	1	0	0
VY-47	149	150	1	1	3	4	1	0
VY-47	156	157	1	1	3	5	0	0
VY-47	161	162	1	1	4	4	1	0
VY-47	164	477	313	0	3	1	0	0
VY-47	171	352	181	1	3	4	1	0
VY-48	184	185	1	1	3	5	0	0
VY-48	186	367	181	1	3	2	0	0
VY-48	186	477	291	0	3	5	0	0
VY-48	193	477	284	0	3	1	0	0
VY-48	196	477	281	0	3	1	1	0
VY-48	199	477	278	0	3	5	0	0
VY-48	199	205	6	1	3	5	0	0
VY-48	210	477	267	0	2	1	0	0
VY-48	211	477	266	0	3	4	0	0
VY-48	220	457	237	1	3	2	1	0
VY-49	224	225	1	1	3	5	0	0
VY-49	224	252	28	1	3	5	1	0
VY-49	224	252	28	1	3	5	1	0
VY-49	224	252	28	1	3	5	1	0
VY-49	224	266	42	1	3	5	1	0
VY-49	224	297	73	1	3	5	1	0
VY-49	224	477	253	0	3	1	0	0
VY-49	227	477	250	0	3	5	0	0
VY-49	228	233	5	1	3	1	2	0
VY-49	233	234	1	1	2	4	0	0
VY-50	237	277	40	1	3	5	1	0
VY-50	238	239	1	1	3	1	0	0
VY-50	239	333	94	1	3	5	1	0
VY-50	239	332	93	1	3	5	1	0
VY-50	239	477	238	0	3	1	0	0
VY-50	240	477	237	0	3	1	0	0
VY-50	245	477	232	0	3	5	0	0
VY-50	252	477	225	0	3	1	0	0
VY-50	253	406	153	1	3	4	1	1
VY-50	255	279	24	1	3	1	0	0
VY-51	256	262	6	1	3	3	1	0
VY-51	256	269	13	1	3	3	1	0
VY-51	256	269	13	1	3	3	1	0
VY-51	256	450	194	1	3	1	1	0
VY-51	259	277	18	1	3	1	0	0
VY-51	259	477	218	0	3	1	0	0
VY-51	262	277	15	1	3	5	0	0
VY-51	263	450	187	1	4	1	1	0
VY-51	268	310	42	1	3	3	1	1
VY-51	268	477	209	0	3	1	0	0
VY-52	269	273	4	1	4	4	1	0
VY-52	274	477	203	0	3	3	0	0
VY-52	277	477	200	0	3	1	0	0
VY-52	277	278	1	1	3	3	0	1
VY-52	281	282	1	1	3	2	0	1
VY-52	281	308	27	1	4	1	1	0
VY-52	281	285	4	1	3	4	1	0
VY-52	284	477	193	0	3	1	0	0
VY-52	288	477	189	0	3	1	0	0
VY-52	288	289	1	1	5	5	1	0
VY-53	294	477	183	0	5	4	0	0
VY-53	297	298	1	1	3	1	1	0
VY-53	308	477	169	0	3	1	0	0
VY-53	316	336	20	1	3	1	1	0
VY-53	322	324	2	1	3	1	0	0
VY-53	325	329	4	1	3	1	1	0
VY-53	325	477	152	0	2	4	1	0
VY-53	330	331	1	1	3	1	1	0
VY-53	330	367	37	1	3	5	1	0
VY-53	337	338	1	1	3	5	1	0
VY-54	338	346	8	1	3	1	0	0
VY-54	344	477	133	0	2	1	0	0
VY-54	346	477	131	0	3	1	0	0
VY-54	348	352	4	1	3	5	1	0
VY-54	354	477	123	0	4	4	0	0
VY-54	354	477	123	0	3	1	0	0
G4J2-216	1	58	57	1	3	1	0	0
G4J2-216	1	58	57	1	3	5	1	0
G4J2-217	1	477	476	0	3	4	0	1
G4J2-217	2	98	96	1	3	1	1	0
G4J2-217	2	477	475	0	3	2	0	1
G4J2-217	2	477	475	0	3	5	0	0
G4J2-217	2	477	475	0	4	1	0	0
G4J2-217	3	5	2	1	4	5	1	0
G4J2-217	3	4	1	1	3	5	0	1
G4J2-217	3	8	5	1	3	4	1	0
G4J2-217	3	477	474	0	4	4	0	0
G4J2-217	9	10	1	1	3	2	1	2
G4J2-218	10	11	1	1	3	2	1	2
G4J2-218	10	11	1	1	3	2	1	2
G4J2-218	10	23	13	1	3	1	1	0
G4J2-218	10	11	1	1	3	4	0	1
G4J2-218	11	12	1	1	3	4	1	0
G4J2-218	12	13	1	1	3	2	1	1
G4J2-218	12	59	47	1	3	2	2	3
G4J2-218	12	59	47	1	3	2	1	3
G4J2-218	12	27	15	1	3	2	1	2
G4J2-218	14	15	1	1	3	5	0	0
G4J2-219	15	19	4	1	3	2	1	0
G4J2-219	16	18	2	1	3	3	1	3
G4J2-219	16	477	461	0	3	4	0	0
G4J2-219	16	17	1	1	3	3	1	0
G4J2-219	16	17	1	1	3	3	1	2
G4J2-219	16	24	8	1	4	1	1	1
G4J2-219	16	477	461	0	3	1	0	0
G4J2-219	16	17	1	1	4	1	0	0
G4J2-219	17	18	1	1	3	4	1	0
G4J2-219	18	59	41	1	3	3	1	3
G4J2-220	18	19	1	1	3	4	1	0
G4J2-220	18	217	199	1	3	1	2	0
G4J2-220	19	23	4	1	3	1	1	1
G4J2-220	20	21	1	1	3	2	1	0
G4J2-220	20	21	1	1	3	4	1	0
G4J2-220	20	27	7	1	3	4	1	1
G4J2-220	20	21	1	1	3	2	1	0
G4J2-220	20	21	1	1	3	4	1	0
G4J2-220	21	22	1	1	3	4	1	1
G4J2-221	21	22	1	1	3	1	1	0
G4J2-221	22	477	455	0	1	1	0	0
G4J2-221	22	23	1	1	3	4	1	2
G4J2-221	22	23	1	1	3	4	1	1
G4J2-221	22	23	1	1	3	4	1	1
G4J2-221	23	24	1	1	4	3	1	0
G4J2-221	23	477	454	0	4	1	0	0
G4J2-221	23	477	454	0	3	1	0	0
G4J2-221	23	477	454	0	5	1	0	0
G4J2-221	23	24	1	1	3	1	1	1
G4J2-222	24	477	453	0	3	1	0	0
G4J2-222	24	25	1	1	3	1	1	1
G4J2-222	25	477	452	0	4	4	0	0
G4J2-222	25	26	1	1	3	1	0	0
G4J2-222	26	30	4	1	3	3	1	0
G4J2-222	26	30	4	1	3	3	1	0
G4J2-222	26	477	451	0	3	5	0	1
G4J2-222	26	27	1	1	3	4	1	1
G4J2-222	26	27	1	1	3	4	1	0
G4J2-222	26	27	1	1	3	4	1	0
G4J2-223	27	28	1	1	3	4	1	0
G4J2-223	27	28	1	1	3	4	1	0
G4J2-223	28	29	1	1	3	4	1	0
G4J2-223	28	29	1	1	3	4	0	1
G4J2-223	28	477	449	0	3	5	1	1
G4J2-223	28	477	449	0	4	4	1	0
G4J2-223	29	30	1	1	3	3	1	0
G4J2-223	29	50	21	1	3	4	1	1
G4J2-223	29	477	448	0	4	1	1	0
G4J2-223	35	36	1	1	3	1	1	0
G4J2-224	35	477	442	0	2	4	0	0
G4J2-224	36	62	26	1	1	1	0	1
G4J2-224	36	477	441	0	3	1	0	0
G4J2-224	39	40	1	1	3	1	2	0
G4J2-224	40	41	1	1	3	1	1	0
G4J2-224	41	42	1	1	3	2	2	0
G4J2-224	43	477	434	0	3	1	0	0
G4J2-224	43	477	434	0	2	1	1	0
G4J2-224	44	477	433	0	4	4	0	0
G4J2-224	44	55	11	1	1	1	1	1
G4J2-225	44	46	2	1	4	4	2	0
G4J2-225	44	477	433	0	3	1	0	0
G4J2-225	46	57	11	1	3	1	1	1
G4J2-225	46	56	10	1	3	4	1	0
G4J2-225	47	49	2	1	3	1	1	0
G4J2-225	47	48	1	1	3	1	1	0
G4J2-225	49	477	428	0	3	1	0	0
G4J2-225	50	51	1	1	3	5	1	0
G4J2-225	50	51	1	1	3	4	1	0
G4J2-225	50	51	1	1	3	4	2	0
G4J2-226	50	51	1	1	3	4	2	0
G4J2-226	50	51	1	1	3	5	1	0
G4J2-226	50	51	1	1	3	5	1	0
G4J2-226	50	51	1	1	3	5	0	0
G4J2-226	50	51	1	1	3	4	2	0
G4J2-226	51	395	344	1	3	1	1	0
G4J2-226	52	477	425	0	2	1	0	0
G4J2-226	53	76	23	1	4	4	2	0
G4J2-226	53	112	59	1	3	1	1	0
G4J2-227	55	56	1	1	4	1	2	0
G4J2-227	55	56	1	1	3	1	0	0
G4J2-227	56	477	421	0	4	1	0	0
G4J2-227	57	58	1	1	3	5	1	0
G4J2-227	57	59	2	1	3	4	2	1
G4J2-227	58	477	419	0	3	4	0	0
G4J2-227	58	59	1	1	3	1	2	0
G4J2-227	59	477	418	0	4	4	0	0
G4J2-227	59	477	418	0	4	4	0	0
G4J2-227	59	60	1	1	3	1	2	1
G4J2-228	60	477	417	0	3	2	0	0
G4J2-228	71	72	1	1	1	1	0	0
G4J2-228	73	477	404	0	3	5	0	0
G4J2-228	78	79	1	1	3	1	2	0
G4J2-228	79	477	398	0	3	1	0	0
G4J2-228	84	477	393	0	4	1	0	2
G4J2-228	85	86	1	1	3	1	0	0
G4J2-228	85	477	392	0	3	5	0	0
G4J2-228	85	477	392	0	4	5	0	0
G4J2-228	85	96	11	1	3	1	1	0
G4J2-229	87	88	1	1	3	5	1	0
G4J2-229	87	88	1	1	3	3	1	1
G4J2-229	87	91	4	1	3	5	1	0
G4J2-229	87	88	1	1	3	5	1	0
G4J2-229	87	90	3	1	3	5	1	0
G4J2-229	87	91	4	1	3	5	1	0
G4J2-229	87	88	1	1	3	5	1	0
G4J2-229	88	477	389	0	3	1	0	0
G4J2-229	88	89	1	1	3	5	1	0
G4J2-229	88	99	11	1	3	1	1	1
G4J2-230	88	89	1	1	3	4	2	0
G4J2-230	91	120	29	1	3	1	2	0
G4J2-230	91	92	1	1	3	4	2	0
G4J2-230	91	92	1	1	3	5	1	0
G4J2-230	93	94	1	1	3	1	2	0
G4J2-230	93	186	93	1	3	1	1	0
G4J2-230	93	94	1	1	3	3	1	0
G4J2-230	94	96	2	1	3	1	0	1
G4J2-230	94	95	1	1	3	1	0	1
G4J2-230	94	95	1	1	3	3	1	0
G4J2-231	97	477	380	0	2	1	0	0
G4J2-231	97	98	1	1	3	4	2	0
G4J2-231	97	183	86	1	3	1	2	1
G4J2-231	98	99	1	1	3	4	2	0
G4J2-231	99	477	378	0	3	1	0	0
G4J2-231	101	477	376	0	3	1	0	0
G4J2-231	102	202	100	1	3	1	0	0
G4J2-231	103	104	1	1	3	1	0	0
G4J2-231	105	106	1	1	3	1	1	0
G4J2-231	105	106	1	1	3	1	0	0
G4J2-232	106	107	1	1	3	1	1	0
G4J2-232	108	109	1	1	3	1	1	0
G4J2-232	109	112	3	1	3	1	1	0
G4J2-232	113	477	364	0	4	1	0	0
G4J2-232	113	477	364	0	3	1	0	1
G4J2-232	114	477	363	0	3	1	0	0
G4J2-232	114	477	363	0	4	4	0	0
G4J2-232	115	422	307	1	3	1	2	0
G4J2-232	115	116	1	1	3	4	2	0
G4J2-232	119	477	358	0	3	1	0	0
G4J2-233	120	477	357	0	3	1	0	0
G4J2-233	121	122	1	1	4	1	2	0
G4J2-233	122	477	355	0	4	4	0	0
G4J2-233	122	123	1	1	3	1	2	0
G4J2-233	123	124	1	1	3	4	2	0
G4J2-233	125	268	143	1	3	5	0	0
G4J2-233	126	127	1	1	5	1	2	0
G4J2-233	127	477	350	0	3	1	0	0
G4J2-233	131	146	15	1	2	1	0	0
G4J2-233	132	158	26	1	3	2	0	0
G4J2-234	134	477	343	0	3	4	0	0
G4J2-234	142	183	41	1	3	1	2	1
G4J2-234	144	477	333	0	3	1	1	0
G4J2-234	145	182	37	1	3	1	1	0
G4J2-234	147	477	330	0	5	4	0	0
G4J2-234	149	150	1	1	3	1	0	1
G4J2-234	150	477	327	0	3	1	0	0
G4J2-234	153	154	1	1	3	2	2	0
G4J2-234	157	217	60	1	3	1	2	0
G4J2-234	158	477	319	0	3	1	0	0
G4J2-235	158	477	319	0	3	4	0	0
G4J2-235	162	163	1	1	5	4	2	0
G4J2-235	162	163	1	1	3	4	2	0
G4J2-235	165	477	312	0	5	1	0	0
G4J2-235	168	477	309	0	2	1	0	0
G4J2-235	172	173	1	1	3	1	2	0
G4J2-235	175	477	302	0	3	2	0	0
G4J2-235	176	177	1	1	3	4	2	0
G4J2-235	176	177	1	1	3	4	2	0
G4J2-235	177	477	300	0	3	4	0	0
G4J2-236	178	477	299	0	3	4	0	0
G4J2-236	178	477	299	0	3	1	0	0
G4J2-236	178	180	2	1	3	4	2	0
G4J2-236	178	477	299	0	3	4	2	0
G4J2-236	182	183	1	1	3	4	2	0
G4J2-236	183	214	31	1	3	1	2	0
G4J2-236	183	477	294	0	3	1	0	0
G4J2-236	185	477	292	0	3	5	0	0
G4J2-236	185	190	5	1	3	1	2	0
G4J2-236	185	477	292	0	3	1	0	0
G4J2-237	185	477	292	0	3	2	0	0
G4J2-237	185	477	292	0	3	4	0	0
G4J2-237	190	477	287	0	3	4	0	0
G4J2-237	191	192	1	1	3	1	2	0
G4J2-237	194	195	1	1	3	4	2	0
G4J2-237	196	477	281	0	2	1	0	0
G4J2-237	196	197	1	1	3	4	2	0
G4J2-237	198	199	1	1	1	1	2	0
G4J2-237	198	477	279	0	3	5	0	0
G4J2-237	199	477	278	0	3	5	0	0
G4J2-238	199	200	1	1	3	4	1	0
G4J2-238	199	477	278	0	3	5	0	0
G4J2-238	199	200	1	1	3	4	2	0
G4J2-238	199	200	1	1	3	4	1	0
G4J2-238	199	200	1	1	3	4	2	0
G4J2-238	199	200	1	1	3	4	2	0
G4J2-238	200	201	1	1	3	4	1	0
G4J2-238	200	201	1	1	3	4	1	0
G4J2-238	201	202	1	1	2	1	2	0
G4J2-238	202	203	1	1	3	1	1	0
G4J2-239	202	203	1	1	3	1	1	0
G4J2-239	203	477	274	0	3	3	0	0
G4J2-239	204	205	1	1	4	1	0	0
G4J2-239	205	398	193	1	4	1	0	0
G4J2-239	206	477	271	0	4	1	0	0
G4J2-239	209	477	268	0	4	4	0	0
G4J2-239	211	477	266	0	3	1	0	0
G4J2-239	212	213	1	1	3	1	2	0
G4J2-239	212	213	1	1	3	3	0	0
G4J2-239	218	477	259	0	3	3	0	0
G4J2-240	218	477	259	0	3	2	0	0
G4J2-240	218	477	259	0	3	4	0	0
G4J2-240	219	220	1	1	3	1	0	0
G4J2-240	220	477	257	0	4	4	0	0
G4J2-240	220	477	257	0	3	5	0	0
G4J2-240	221	309	88	1	4	4	2	0
G4J2-240	225	477	252	0	4	4	0	0
G4J2-240	225	477	252	0	3	5	0	0
G4J2-240	225	226	1	1	3	3	0	0
G4J2-240	225	477	252	0	3	5	0	0
G4J2-241	226	477	251	0	2	2	0	0
G4J2-241	226	227	1	1	3	5	0	1
G4J2-241	227	477	250	0	3	1	0	0
G4J2-241	227	288	61	1	3	1	2	0
G4J2-241	228	477	249	0	3	4	0	0
G4J2-241	228	477	249	0	3	1	0	0
G4J2-241	232	477	245	0	3	1	0	0
G4J2-241	233	264	31	1	4	1	1	0
G4J2-241	234	235	1	1	3	1	2	1
G4J2-241	235	477	242	0	4	2	0	0
G4J2-242	235	264	29	1	4	4	1	0
G4J2-242	235	265	30	1	3	1	1	1
G4J2-242	239	240	1	1	3	1	2	0
G4J2-242	239	477	238	0	3	1	0	0
G4J2-242	239	477	238	0	3	2	0	0
G4J2-242	241	477	236	0	3	1	0	0
G4J2-242	241	242	1	1	3	5	0	0
G4J2-242	241	477	236	0	4	2	0	0
G4J2-242	245	307	62	1	3	4	1	0
G4J2-242	246	265	19	1	3	1	1	0
G4J2-243	246	477	231	0	3	4	0	0
G4J2-243	246	264	18	1	5	4	1	0
G4J2-243	246	306	60	1	4	4	1	0
G4J2-243	246	477	231	0	3	2	0	0
G4J2-243	248	477	229	0	4	4	0	0
G4J2-243	248	477	229	0	3	1	0	0
G4J2-243	249	266	17	1	3	4	0	0
G4J2-243	249	477	228	0	4	1	0	0
G4J2-243	250	477	227	0	2	4	0	1
G4J2-243	252	477	225	0	3	1	0	0
G4J2-244	252	265	13	1	4	4	1	0
G4J2-244	253	254	1	1	3	1	2	0
G4J2-244	254	264	10	1	4	4	1	0
G4J2-244	254	272	18	1	3	4	1	1
G4J2-244	254	255	1	1	3	1	2	0
G4J2-244	255	477	222	0	3	4	0	0
G4J2-244	257	258	1	1	3	2	1	0
G4J2-244	257	258	1	1	3	4	2	0
G4J2-244	258	477	219	0	4	4	0	0
G4J2-244	260	477	217	0	3	1	0	0
G4J2-245	264	267	3	1	1	1	1	1
G4J2-245	265	266	1	1	4	4	1	0
G4J2-245	266	327	61	1	3	1	1	0
G4J2-245	268	270	2	1	4	4	0	0
G4J2-245	268	477	209	0	4	1	0	0
G4J2-245	269	477	208	0	3	2	0	0
G4J2-245	269	292	23	1	3	1	2	0
G4J2-245	269	477	208	0	4	1	0	0
G4J2-245	269	477	208	0	3	1	0	0
G4J2-246	270	271	1	1	4	4	1	1
G4J2-246	270	477	207	0	4	4	1	0
G4J2-246	273	477	204	0	3	1	0	0
G4J2-246	274	477	203	0	3	1	0	0
G4J2-246	275	477	202	0	3	2	0	0
G4J2-246	280	477	197	0	4	1	0	0
G4J2-246	282	288	6	1	3	1	2	0
G4J2-246	282	283	1	1	3	1	1	0
G4J2-246	282	283	1	1	3	4	2	0
G4J2-246	282	283	1	1	3	4	2	0
G4J2-247	282	283	1	1	3	4	2	0
G4J2-247	282	283	1	1	3	4	2	0
G4J2-247	282	283	1	1	3	4	2	0
G4J2-247	282	283	1	1	3	4	1	0
G4J2-247	283	477	194	0	3	2	0	0
G4J2-247	283	477	194	0	3	4	0	0
G4J2-247	285	294	9	1	3	1	2	0
G4J2-247	287	288	1	1	3	1	0	0
G4J2-247	287	288	1	1	4	1	0	0
G4J2-247	290	477	187	0	4	5	0	0
G4J2-248	290	477	187	0	4	1	0	0
G4J2-248	291	292	1	1	3	1	2	0
G4J2-248	293	294	1	1	3	1	2	0
G4J2-248	294	477	183	0	3	1	0	0
G4J2-248	294	477	183	0	4	4	0	0
G4J2-248	294	356	62	1	3	1	1	0
G4J2-248	298	477	179	0	4	4	0	0
G4J2-248	298	477	179	0	3	1	0	0
G4J2-248	298	477	179	0	3	1	0	0
G4J2-248	298	299	1	1	3	4	2	0
G4J2-249	301	477	176	0	3	4	0	0
G4J2-249	301	305	4	1	3	2	2	0
G4J2-249	301	302	1	1	3	4	1	0
G4J2-249	301	477	176	0	3	4	1	0
G4J2-249	303	477	174	0	4	1	0	0
G4J2-249	305	477	172	0	4	4	0	0
G4J2-249	308	309	1	1	3	4	2	0
G4J2-249	308	309	1	1	3	1	2	0
G4J2-249	308	477	169	0	3	4	1	0
G4J2-249	308	309	1	1	3	1	2	0
G4J2-250	309	398	89	1	4	5	1	0
G4J2-250	309	477	168	0	3	1	0	0
G4J2-250	311	317	6	1	3	1	0	0
G4J2-250	315	316	1	1	3	4	2	0
G4J2-250	316	477	161	0	3	5	0	0
G4J2-250	316	477	161	0	3	4	2	0
G4J2-250	317	477	160	0	3	1	0	0
G4J2-250	317	477	160	0	3	4	0	0
G4J2-250	318	319	1	1	3	1	2	0
G4J2-250	319	477	158	0	3	1	2	0
G4J2-251	319	320	1	1	4	1	0	1
G4J2-251	320	477	157	0	4	4	0	0
G4J2-251	322	477	155	0	1	1	0	0
G4J2-251	324	477	153	0	3	1	0	0
G4J2-251	327	328	1	1	3	1	1	0
G4J2-251	327	328	1	1	3	5	1	0
G4J2-251	330	477	147	0	3	1	0	0
G4J2-251	338	477	139	0	4	1	0	0
G4J2-251	340	477	137	0	3	2	0	0
G4J2-251	345	477	132	0	3	5	0	0
G4J2-252	345	477	132	0	3	4	0	0
G4J2-252	347	348	1	1	3	5	1	0
G4J2-252	350	366	16	1	4	1	2	1
G4J2-252	352	477	125	0	3	2	0	0
G4J2-252	354	477	123	0	3	1	0	0
G4J2-252	354	477	123	0	4	2	0	0
G4J2-252	354	477	123	0	4	4	0	0
G4J2-252	360	363	3	1	3	1	2	0
G4NET-58	14	477	463	0	3	1	0	0
G4NET-58	25	477	452	0	3	1	0	0
G4NET-58	34	477	443	0	4	4	0	0
G4NET-59	51	477	426	0	2	1	0	0
G4NET-59	78	79	1	1	2	1	1	1
G4NET-59	94	101	7	1	3	2	2	0
G4NET-59	120	477	357	0	3	1	0	0
G4NET-59	121	477	356	0	1	1	1	0
G4NET-59	130	131	1	1	2	3	0	0
G4NET-59	132	477	345	0	3	1	0	0
G4NET-59	132	477	345	0	3	1	0	0
G4NET-59	132	133	1	1	4	1	0	0
G4NET-59	147	477	330	0	1	1	0	0
G4NET-60	172	477	305	0	3	1	0	0
G4NET-60	172	477	305	0	3	1	0	0
G4NET-60	179	477	298	0	4	1	0	0
G4NET-60	193	477	284	0	3	1	0	0
G4NET-60	195	477	282	0	3	1	0	0
G4NET-60	197	477	280	0	3	1	0	0
G4NET-60	199	477	278	0	3	1	0	0
G4NET-60	205	206	1	1	4	1	1	0
G4NET-60	210	477	267	0	4	1	0	0
G4NET-60	226	477	251	0	5	4	1	0
G4NET-61	231	232	1	1	3	1	0	1
G4NET-61	261	477	216	0	2	1	0	3
G4NET-61	261	265	4	1	3	1	0	1
G4NET-61	285	477	192	0	4	2	1	1
G4NET-61	290	294	4	1	3	1	1	1
G4NET-61	310	477	167	0	5	5	0	0
G4NET-61	333	477	144	0	3	1	0	0
G4NET-61	336	337	1	1	4	1	1	0
G4NET-61	344	345	1	1	3	1	0	0
G4NET-61	344	477	133	0	4	1	1	0
G4NET-62	346	477	131	0	4	5	0	0
G4NET-62	349	351	2	1	3	1	1	0
G4NET-62	359	387	28	1	3	3	1	0
G4PHP-23	7	477	470	0	3	1	0	0
G4PHP-24	25	477	452	0	3	1	0	0
G4PHP-24	246	477	231	0	5	1	0	0
G4PHP-24	324	477	153	0	2	1	0	0
G4PHP-24	354	477	123	0	3	4	0	0
GCXX-49	10	477	467	0	3	4	0	0
GCXX-49	10	477	467	0	3	4	0	0
GCXX-49	10	477	467	0	4	4	0	0
GCXX-49	25	26	1	1	3	1	0	0
GCXX-49	31	477	446	0	3	1	0	0
GCXX-49	31	477	446	0	3	1	0	0
GCXX-50	228	307	79	1	4	4	1	0
GCXX-50	339	420	81	1	1	1	1	0
GCXX-50	346	347	1	1	5	5	1	0
CENE-811	1	4	3	1	3	4	1	0
CENE-811	1	477	476	0	3	4	0	0
CENE-811	1	7	6	1	4	3	2	0
CENE-811	3	4	1	1	3	3	1	0
CENE-811	3	4	1	1	3	1	2	0
CENE-811	4	477	473	0	3	1	0	0
CENE-811	4	8	4	1	4	3	1	0
CENE-812	4	10	6	1	5	1	2	0
CENE-812	5	52	47	1	4	1	1	2
CENE-812	5	84	79	1	3	4	1	1
CENE-812	6	7	1	1	4	1	0	0
CENE-812	6	21	15	1	3	1	2	0
CENE-812	7	84	77	1	3	4	2	2
CENE-812	8	62	54	1	3	2	2	0
CENE-812	10	42	32	1	4	4	2	0
CENE-812	10	11	1	1	3	1	0	0
CENE-812	2	15	13	1	4	4	2	0
CENE-813	14	18	4	1	3	1	2	0
CENE-813	14	15	1	1	3	1	3	1
CENE-813	18	477	459	0	3	1	0	0
CENE-813	21	22	1	1	3	1	3	0
CENE-813	21	45	24	1	4	1	1	0
CENE-813	22	45	23	1	4	4	1	1
CENE-813	23	24	1	1	3	1	3	0
CENE-813	23	477	454	0	3	1	0	1
CENE-813	24	442	418	1	4	4	2	0
CENE-813	24	25	1	1	4	4	3	1
CENE-814	27	30	3	1	3	1	3	0
CENE-814	29	477	448	0	4	1	0	0
CENE-814	30	122	92	1	4	4	1	0
CENE-814	30	477	447	0	4	3	0	0
CENE-814	30	144	114	1	4	3	1	0
CENE-814	30	32	2	1	4	4	1	1
CENE-814	30	477	447	0	4	1	0	1
CENE-814	31	477	446	0	3	1	0	1
CENE-814	31	477	446	0	3	4	0	1
CENE-814	31	35	4	1	4	4	1	1
CENE-815	31	477	446	0	4	3	2	0
CENE-815	32	35	3	1	5	4	0	0
CENE-815	32	43	11	1	5	4	2	1
CENE-815	32	51	19	1	3	1	1	0
CENE-815	34	477	443	0	3	3	0	2
CENE-815	34	95	61	1	3	3	2	2
CENE-815	35	38	3	1	3	3	2	1
CENE-815	35	40	5	1	3	1	3	0
CENE-815	35	477	442	0	3	4	0	0
CENE-815	35	477	442	0	3	4	0	0
CENE-816	35	477	442	0	3	4	0	0
CENE-816	35	38	3	1	3	4	1	0
CENE-816	36	477	441	0	3	4	1	0
CENE-816	37	39	2	1	4	1	2	0
CENE-816	38	163	125	1	3	1	2	0
CENE-816	38	157	119	1	3	1	2	0
CENE-816	38	442	404	1	4	3	2	0
CENE-816	39	43	4	1	4	3	2	1
CENE-816	40	41	1	1	3	3	2	0
CENE-816	41	42	1	1	3	3	2	0
CENE-817	41	42	1	1	3	4	2	0
CENE-817	42	43	1	1	3	5	3	0
CENE-817	43	477	434	0	4	4	0	0
CENE-817	43	44	1	1	3	1	3	0
CENE-817	44	45	1	1	3	1	2	0
CENE-817	44	85	41	1	2	1	2	0
CENE-817	45	69	24	1	4	1	2	1
CENE-817	49	477	428	0	3	1	0	0
CENE-817	49	477	428	0	3	4	0	0
CENE-817	49	50	1	1	3	1	0	0
CENE-818	50	107	57	1	5	4	0	0
CENE-818	50	477	427	0	3	1	0	0
CENE-818	51	52	1	1	3	1	1	0
CENE-818	53	477	424	0	3	1	0	1
CENE-818	54	477	423	0	3	4	0	1
CENE-818	55	477	422	0	4	1	0	0
CENE-818	56	147	91	1	4	1	2	2
CENE-818	57	58	1	1	3	1	3	0
CENE-818	59	60	1	1	3	1	2	1
CENE-818	59	60	1	1	4	1	0	0
CENE-819	62	63	1	1	3	4	2	0
CENE-819	62	63	1	1	3	1	2	0
CENE-819	62	85	23	1	3	1	2	0
CENE-819	63	477	414	0	4	3	0	1
CENE-819	64	477	413	0	3	4	0	0
CENE-819	66	92	26	1	3	2	1	0
CENE-819	66	78	12	1	4	4	2	0
CENE-819	69	72	3	1	3	4	0	0
CENE-819	70	71	1	1	3	1	0	0
CENE-820	70	72	2	1	3	4	0	0
CENE-820	70	126	56	1	3	5	0	0
CENE-820	70	83	13	1	3	2	1	0
CENE-820	71	74	3	1	4	5	0	0
CENE-820	72	219	147	1	4	4	1	0
CENE-820	72	143	71	1	3	4	2	0
CENE-820	72	76	4	1	4	3	2	0
CENE-820	73	350	277	1	3	4	0	0
CENE-820	73	74	1	1	3	1	3	0
CENE-820	73	477	404	0	4	4	0	0
CENE-821	73	77	4	1	3	5	0	1
CENE-821	74	75	1	1	3	1	3	0
CENE-821	74	76	2	1	3	4	2	0
CENE-821	75	477	402	0	4	4	0	0
CENE-821	76	77	1	1	3	4	3	0
CENE-821	77	78	1	1	3	4	2	0
CENE-821	78	418	340	1	3	4	1	0
CENE-821	78	79	1	1	3	4	0	0
CENE-821	78	477	399	0	4	4	0	0
CENE-821	80	81	1	1	3	4	2	0
CENE-822	81	84	3	1	3	1	3	0
CENE-822	84	144	60	1	4	1	1	1
CENE-822	84	477	393	0	3	1	0	0
CENE-822	84	85	1	1	3	1	2	0
CENE-822	84	85	1	1	3	3	1	0
CENE-822	84	477	393	0	3	4	0	0
CENE-822	85	96	11	1	3	3	1	0
CENE-822	85	88	3	1	1	1	3	1
CENE-822	86	87	1	1	5	1	1	0
CENE-822	86	100	14	1	3	2	1	1
CENE-823	86	87	1	1	3	4	2	0
CENE-823	86	102	16	1	3	2	2	1
CENE-823	87	89	2	1	3	4	2	0
CENE-823	90	93	3	1	3	4	2	0
CENE-823	92	93	1	1	4	1	3	0
CENE-823	93	183	90	1	3	1	0	0
CENE-823	93	94	1	1	4	1	3	0
CENE-823	93	98	5	1	3	4	2	0
CENE-823	93	95	2	1	4	1	1	0
CENE-823	94	95	1	1	3	1	3	0
CENE-824	94	477	383	0	3	5	0	0
CENE-824	95	477	382	0	3	4	0	1
CENE-824	95	98	3	1	3	4	2	0
CENE-824	95	97	2	1	3	1	2	0
CENE-824	95	117	22	1	3	1	2	0
CENE-824	97	101	4	1	3	1	3	0
CENE-824	98	100	2	1	3	4	2	0
CENE-824	99	100	1	1	4	1	2	0
CENE-824	99	102	3	1	4	5	2	0
CENE-824	101	129	28	1	3	4	1	0
CENE-825	101	477	376	0	3	4	0	0
CENE-825	102	103	1	1	3	1	3	0
CENE-825	102	103	1	1	3	1	0	0
CENE-825	104	105	1	1	3	1	0	0
CENE-825	105	112	7	1	3	1	1	0
CENE-825	105	477	372	0	3	4	0	0
CENE-825	106	107	1	1	3	1	2	0
CENE-825	106	107	1	1	3	1	3	0
CENE-825	108	109	1	1	3	1	3	0
CENE-825	108	157	49	1	3	4	2	0
CENE-826	108	112	4	1	3	4	2	0
CENE-826	109	126	17	1	5	1	1	0
CENE-826	106	228	122	1	4	1	0	0
CENE-826	111	197	86	1	3	4	2	1
CENE-826	111	229	118	1	3	4	0	3
CENE-826	111	117	6	1	3	4	2	0
CENE-826	112	113	1	1	3	1	3	0
CENE-826	112	127	15	1	3	3	1	0
CENE-826	112	113	1	1	3	4	0	0
CENE-826	112	113	1	1	3	4	2	0
CENE-827	112	182	70	1	3	4	2	0
CENE-827	113	114	1	1	3	4	2	0
CENE-827	113	114	1	1	3	4	2	0
CENE-827	113	168	55	1	3	2	1	0
CENE-827	114	477	363	0	3	1	0	0
CENE-827	114	115	1	1	3	1	2	0
CENE-827	114	115	1	1	3	1	3	0
CENE-827	114	477	363	0	4	4	0	0
CENE-827	115	162	47	1	4	1	2	1
CENE-827	115	135	20	1	4	4	1	0
CENE-828	115	117	2	1	3	1	3	0
CENE-828	115	148	33	1	3	1	3	0
CENE-828	116	119	3	1	3	4	2	0
CENE-828	117	119	2	1	5	4	1	1
CENE-828	119	477	358	0	4	4	0	1
CENE-828	120	477	357	0	3	4	0	1
CENE-828	120	241	121	1	3	4	1	3
CENE-828	120	136	16	1	3	1	2	0
CENE-828	120	477	357	0	3	1	0	0
CENE-828	121	122	1	1	3	4	2	0
CENE-829	121	122	1	1	3	1	2	0
CENE-829	121	177	56	1	3	1	2	0
CENE-829	122	410	288	1	3	1	4	1
CENE-829	122	123	1	1	3	1	2	0
CENE-829	122	318	196	1	4	1	0	0
CENE-829	123	124	1	1	4	4	2	0
CENE-829	123	130	7	1	4	4	2	0
CENE-829	125	126	1	1	3	4	2	0
CENE-829	126	128	2	1	3	4	2	0
CENE-829	127	156	29	1	4	4	2	0
CENE-830	128	149	21	1	3	2	1	0
CENE-830	128	129	1	1	5	3	1	0
CENE-830	128	130	2	1	4	4	0	1
CENE-830	128	130	2	1	4	4	2	1
CENE-830	128	477	349	0	3	2	0	1
CENE-830	129	203	74	1	3	2	1	0
CENE-830	130	135	5	1	4	4	0	1
CENE-830	130	477	347	0	3	3	0	0
CENE-830	130	163	33	1	4	4	2	0
CENE-831	134	135	1	1	3	4	2	1
CENE-831	134	477	343	0	4	4	0	0
CENE-831	134	144	10	1	4	4	1	0
CENE-831	135	319	184	1	4	4	1	0
CENE-831	135	319	184	1	3	4	1	0
CENE-831	135	350	215	1	4	4	2	0
CENE-831	135	136	1	1	3	4	2	1
CENE-831	135	136	1	1	3	1	2	0
CENE-831	135	136	1	1	3	1	0	0
CENE-831	135	477	342	0	4	4	0	0
CENE-832	137	138	1	1	3	1	0	0
CENE-832	137	477	340	0	4	4	0	0
CENE-832	137	477	340	0	4	4	0	0
CENE-832	137	144	7	1	3	2	0	2
CENE-832	139	140	1	1	3	1	0	0
CENE-832	141	142	1	1	4	1	2	0
CENE-832	120	477	357	0	3	4	0	2
CENE-832	141	477	336	0	3	2	0	0
CENE-832	141	142	1	1	3	1	0	0
CENE-832	142	477	335	0	4	1	0	0
CENE-833	143	157	14	1	3	4	2	0
CENE-833	143	477	334	0	3	2	0	0
CENE-833	144	155	11	1	3	2	1	2
CENE-833	144	145	1	1	5	3	1	1
CENE-833	145	147	2	1	3	1	2	0
CENE-833	146	154	8	1	4	4	0	0
CENE-833	147	260	113	1	4	4	0	1
CENE-833	148	149	1	1	3	1	3	0
CENE-833	148	150	2	1	3	4	2	0
CENE-833	148	149	1	1	3	1	3	0
CENE-834	150	246	96	1	4	4	1	1
CENE-834	150	154	4	1	3	4	2	0
CENE-834	150	477	327	0	3	2	2	0
CENE-834	151	253	102	1	3	1	1	1
CENE-834	151	164	13	1	3	1	1	0
CENE-834	153	196	43	1	4	4	2	0
CENE-834	154	156	2	1	4	4	2	0
CENE-834	154	477	323	0	3	4	0	1
CENE-834	155	477	322	0	3	3	0	0
CENE-834	156	477	321	0	3	2	0	0
CENE-835	158	159	1	1	4	5	4	0
CENE-835	158	159	1	1	4	5	0	1
CENE-835	161	261	100	1	4	4	1	0
CENE-835	161	477	316	0	3	4	0	0
CENE-835	162	477	315	0	4	4	0	0
CENE-835	163	164	1	1	3	1	0	0
CENE-835	163	177	14	1	3	2	2	0
CENE-835	164	165	1	1	3	1	2	1
CENE-835	165	166	1	1	1	1	3	0
CENE-835	165	477	312	0	4	2	0	0
CENE-836	167	168	1	1	3	2	1	0
CENE-836	168	477	309	0	4	5	0	0
CENE-836	168	477	309	0	4	4	0	0
CENE-836	169	170	1	1	3	1	3	0
CENE-836	169	477	308	0	3	4	0	0
CENE-836	170	171	1	1	3	1	3	0
CENE-836	171	172	1	1	3	4	2	0
CENE-836	172	177	5	1	3	4	2	0
CENE-836	174	477	303	0	3	2	0	0
CENE-836	175	477	302	0	3	3	0	1
CENE-837	175	179	4	1	3	1	2	1
CENE-837	176	182	6	1	3	1	1	0
CENE-837	177	477	300	0	3	1	0	1
CENE-837	177	179	2	1	3	2	2	0
CENE-837	177	344	167	1	3	4	0	3
CENE-837	179	477	298	0	5	3	0	0
CENE-837	182	183	1	1	3	3	1	0
CENE-837	182	477	295	0	3	2	0	0
CENE-837	182	185	3	1	3	4	2	0
CENE-837	182	185	3	1	3	4	2	0
CENE-838	183	184	1	1	4	1	1	0
CENE-838	183	185	2	1	3	1	3	0
CENE-838	184	190	6	1	4	4	1	0
CENE-838	184	189	5	1	4	4	2	0
CENE-838	184	185	1	1	3	1	3	0
CENE-838	185	189	4	1	4	1	2	0
CENE-838	185	477	292	0	4	4	0	0
CENE-838	185	196	11	1	3	4	2	0
CENE-838	186	187	1	1	3	2	2	0
CENE-838	186	189	3	1	3	1	0	0
CENE-839	189	190	1	1	3	2	1	0
CENE-839	189	190	1	1	4	5	2	0
CENE-839	189	190	1	1	4	5	2	0
CENE-839	189	190	1	1	4	1	2	0
CENE-839	189	190	1	1	4	4	2	0
CENE-839	192	193	1	1	3	2	1	0
CENE-839	192	304	112	1	3	2	0	0
CENE-839	193	194	1	1	3	4	2	0
CENE-839	196	197	1	1	4	4	2	0
CENE-839	196	319	123	1	3	5	0	0
CENE-840	196	198	2	1	3	4	2	0
CENE-840	196	477	281	0	3	2	0	0
CENE-840	196	200	4	1	3	5	2	0
CENE-840	196	477	281	0	4	4	0	0
CENE-840	197	202	5	1	3	2	1	0
CENE-840	197	207	10	1	3	3	1	1
CENE-840	197	392	195	1	4	4	0	2
CENE-840	197	198	1	1	4	4	1	0
CENE-840	197	200	3	1	5	4	1	0
CENE-840	198	477	279	0	3	1	0	0
CENE-841	198	207	9	1	4	1	2	0
CENE-841	198	199	1	1	4	3	1	0
CENE-841	198	203	5	1	4	3	1	0
CENE-841	199	204	5	1	4	1	2	0
CENE-841	199	214	15	1	4	4	1	0
CENE-841	200	477	277	0	5	4	0	0
CENE-841	200	477	277	0	4	2	0	0
CENE-841	200	213	13	1	3	1	0	0
CENE-841	200	477	277	0	3	2	0	0
CENE-842	200	203	3	1	4	3	2	0
CENE-842	203	261	58	1	4	4	0	0
CENE-842	203	245	42	1	3	2	1	0
CENE-842	203	207	4	1	4	3	2	0
CENE-842	204	477	273	0	4	1	0	0
CENE-842	204	205	1	1	3	4	2	0
CENE-842	204	477	273	0	3	4	0	0
CENE-842	205	206	1	1	3	1	1	1
CENE-842	206	207	1	1	4	4	2	0
CENE-842	206	207	1	1	4	1	2	0
CENE-843	206	319	113	1	4	5	1	0
CENE-843	206	319	113	1	4	5	1	0
CENE-843	207	241	34	1	4	4	2	1
CENE-843	207	229	22	1	5	4	0	0
CENE-843	207	225	18	1	4	4	0	1
CENE-843	208	213	5	1	3	2	0	0
CENE-843	210	219	9	1	3	1	0	0
CENE-843	211	212	1	1	3	1	2	0
CENE-843	211	392	181	1	4	4	1	2
CENE-843	211	219	8	1	4	4	1	0
CENE-844	211	477	266	0	3	2	0	0
CENE-844	212	213	1	1	4	1	2	0
CENE-844	213	218	5	1	4	5	2	0
CENE-844	214	215	1	1	4	5	0	0
CENE-844	214	217	3	1	3	1	3	0
CENE-844	214	217	3	1	3	1	3	0
CENE-844	214	224	10	1	4	4	1	0
CENE-844	217	219	2	1	3	2	0	0
CENE-844	218	225	7	1	4	3	1	0
CENE-844	218	225	7	1	4	4	2	0
CENE-845	220	477	257	0	3	4	0	0
CENE-845	220	222	2	1	3	1	3	0
CENE-845	220	477	257	0	3	4	0	0
CENE-845	221	222	1	1	4	4	2	1
CENE-845	224	477	253	0	3	1	0	0
CENE-845	225	226	1	1	4	4	2	0
CENE-845	227	228	1	1	3	3	2	0
CENE-845	228	229	1	1	3	1	3	0
CENE-845	230	235	5	1	3	1	2	0
CENE-845	231	253	22	1	3	1	2	0
CENE-846	231	241	10	1	3	4	2	0
CENE-846	232	234	2	1	4	4	1	0
CENE-846	233	298	65	1	5	4	2	1
CENE-846	234	319	85	1	4	4	2	0
CENE-846	234	319	85	1	4	4	1	0
CENE-846	234	241	7	1	4	3	1	0
CENE-846	238	239	1	1	2	3	2	0
CENE-846	238	239	1	1	4	5	1	1
CENE-846	239	240	1	1	4	5	1	1
CENE-846	240	242	2	1	5	4	1	0
CENE-847	240	319	79	1	4	3	1	0
CENE-847	240	241	1	1	3	2	1	0
CENE-847	240	245	5	1	4	1	3	0
CENE-847	241	477	236	0	4	1	0	0
CENE-847	242	392	150	1	3	5	1	4
CENE-847	242	246	4	1	3	3	1	0
CENE-847	244	247	3	1	3	4	2	0
CENE-847	245	450	205	1	3	2	1	0
CENE-847	245	283	38	1	4	1	0	0
CENE-847	245	276	31	1	3	5	2	0
CENE-848	245	477	232	0	4	1	0	0
CENE-848	245	248	3	1	4	3	1	3
CENE-848	246	261	15	1	4	2	1	0
CENE-848	246	249	3	1	3	2	1	0
CENE-848	246	261	15	1	4	4	2	1
CENE-848	247	248	1	1	5	3	1	0
CENE-848	247	477	230	0	4	4	0	0
CENE-848	247	477	230	0	4	4	0	0
CENE-848	248	477	229	0	4	3	0	1
CENE-848	248	477	229	0	3	4	0	0
CENE-849	249	336	87	1	3	2	0	0
CENE-849	249	250	1	1	5	1	2	0
CENE-849	108	477	369	0	3	1	0	1
CENE-849	249	268	19	1	3	3	3	2
CENE-849	251	477	226	0	3	1	0	0
CENE-849	253	477	224	0	3	1	0	0
CENE-849	254	290	36	1	3	2	2	0
CENE-849	256	322	66	1	3	2	1	1
CENE-849	256	262	6	1	3	2	1	0
CENE-849	256	477	221	0	3	3	0	0
CENE-850	256	257	1	1	3	5	2	0
CENE-850	259	261	2	1	3	4	0	0
CENE-850	259	260	1	1	3	1	2	0
CENE-850	259	260	1	1	3	4	2	0
CENE-850	259	260	1	1	3	4	2	0
CENE-850	259	267	8	1	4	4	1	0
CENE-850	259	261	2	1	3	1	0	1
CENE-850	260	290	30	1	4	4	1	0
CENE-850	260	319	59	1	4	2	2	0
CENE-850	261	337	76	1	3	3	1	0
CENE-851	261	477	216	0	4	4	0	0
CENE-851	261	264	3	1	4	4	1	0
CENE-851	263	265	2	1	3	1	3	0
CENE-851	266	273	7	1	3	4	1	1
CENE-851	266	267	1	1	3	1	0	1
CENE-851	267	477	210	0	4	3	0	1
CENE-851	270	477	207	0	3	3	0	0
CENE-851	271	477	206	0	3	1	0	0
CENE-851	272	334	62	1	4	5	0	0
CENE-851	273	477	204	0	4	4	0	0
CENE-852	274	277	3	1	5	1	1	0
CENE-852	275	477	202	0	3	2	0	0
CENE-852	276	287	11	1	2	1	2	0
CENE-852	276	286	10	1	4	1	2	0
CENE-852	276	298	22	1	3	1	2	0
CENE-852	277	477	200	0	3	4	0	0
CENE-852	277	283	6	1	4	4	0	1
CENE-852	277	372	95	1	4	4	3	4
CENE-852	283	287	4	1	3	1	1	0
CENE-852	283	331	48	1	4	4	2	0
CENE-853	283	477	194	0	4	3	0	0
CENE-853	287	291	4	1	3	1	2	2
CENE-853	288	477	189	0	3	1	0	0
CENE-853	288	290	2	1	3	4	2	0
CENE-853	289	305	16	1	1	1	2	0
CENE-853	289	290	1	1	3	4	1	0
CENE-853	290	477	187	0	3	1	0	0
CENE-853	290	312	22	1	4	1	2	0
CENE-853	294	477	183	0	3	2	0	0
CENE-853	294	408	114	1	4	4	1	0
CENE-854	295	305	10	1	3	1	3	0
CENE-854	296	344	48	1	4	4	2	4
CENE-854	296	477	181	0	4	4	0	0
CENE-854	296	477	181	0	4	2	0	0
CENE-854	296	477	181	0	4	4	0	0
CENE-854	297	477	180	0	3	5	0	4
CENE-854	297	344	47	1	3	5	2	2
CENE-854	297	477	180	0	3	5	0	2
CENE-854	298	336	38	1	4	4	2	0
CENE-854	301	305	4	1	1	1	2	0
CENE-855	302	305	3	1	1	1	2	0
CENE-855	303	348	45	1	3	4	0	0
CENE-855	303	319	16	1	4	2	1	0
CENE-855	304	477	173	0	3	2	0	0
CENE-855	304	307	3	1	1	2	0	0
CENE-855	304	307	3	1	1	2	0	0
CENE-855	305	312	7	1	1	1	2	0
CENE-855	305	309	4	1	3	1	0	1
CENE-855	306	310	4	1	3	4	2	0
CENE-855	308	310	2	1	1	1	2	0
CENE-856	311	317	6	1	4	1	1	0
CENE-856	312	477	165	0	3	1	0	0
CENE-856	314	330	16	1	3	4	2	0
CENE-856	315	333	18	1	4	4	1	1
CENE-856	316	337	21	1	3	3	1	0
CENE-856	316	477	161	0	4	4	0	0
CENE-856	321	477	156	0	4	4	0	1
CENE-856	322	477	155	0	3	1	0	0
CENE-856	323	324	1	1	5	1	1	0
CENE-856	323	324	1	1	3	4	2	0
CENE-857	324	326	2	1	3	1	2	0
CENE-857	324	325	1	1	3	4	2	0
CENE-857	324	477	153	0	3	1	0	0
CENE-857	326	331	5	1	4	4	2	0
CENE-857	328	477	149	0	3	1	0	0
CENE-857	330	333	3	1	3	4	2	1
CENE-857	331	477	146	0	4	4	0	0
CENE-857	331	477	146	0	3	4	0	0
CENE-857	332	333	1	1	3	4	0	0
CENE-857	332	333	1	1	3	4	2	0
CENE-858	333	334	1	1	4	3	0	0
CENE-858	333	351	18	1	3	2	2	0
CENE-858	333	477	144	0	3	3	0	0
CENE-858	335	337	2	1	3	4	0	0
CENE-858	336	337	1	1	4	4	0	0
CENE-858	336	424	88	1	4	4	1	1
CENE-858	336	337	1	1	3	3	2	0
CENE-858	336	344	8	1	3	1	1	0
CENE-858	337	338	1	1	5	4	2	1
CENE-858	337	338	1	1	3	1	1	0
CENE-859	337	338	1	1	3	4	2	0
CENE-859	338	340	2	1	4	4	1	0
CENE-859	338	340	2	1	1	1	2	0
CENE-859	338	339	1	1	3	4	2	0
CENE-859	339	340	1	1	1	1	1	0
CENE-859	339	340	1	1	3	1	3	0
CENE-859	342	477	135	0	3	1	0	0
CENE-859	342	343	1	1	3	3	1	0
CENE-859	342	343	1	1	3	4	2	0
CENE-859	343	344	1	1	3	4	2	0
CENE-860	344	354	10	1	4	4	2	0
CENE-860	344	368	24	1	3	4	2	0
CENE-860	344	345	1	1	3	4	2	0
CENE-860	345	349	4	1	3	1	2	0
CENE-860	345	351	6	1	5	4	2	1
CENE-860	345	346	1	1	4	4	2	0
CENE-860	345	477	132	0	3	4	0	0
CENE-860	345	346	1	1	3	3	1	0
CENE-860	345	346	1	1	3	4	2	0
CENE-860	346	347	1	1	3	4	2	0
CENE-861	347	350	3	1	4	5	0	1
CENE-861	347	348	1	1	4	3	1	0
CENE-861	350	365	15	1	3	3	1	0
CENE-861	351	477	126	0	4	4	0	0
CENE-861	352	477	125	0	3	1	0	0
CENE-861	353	477	124	0	4	4	0	0
CENE-861	353	477	124	0	3	4	0	1
CENE-861	353	477	124	0	3	1	0	1
CENE-861	354	477	123	0	4	4	0	0
CENE-861	354	464	110	1	4	4	0	0
CENE-862	354	477	123	0	3	4	2	0
CENE-862	354	477	123	0	4	4	0	0
CENE-862	354	371	17	1	3	3	1	0
CENE-862	360	378	18	1	3	4	3	0
CENE-862	360	361	1	1	4	1	1	0
CENE-862	360	361	1	1	4	1	1	0
CENE-862	301	477	176	0	3	5	0	1
CENENET-59	1	477	476	0	3	1	0	0
CENENET-59	30	477	447	0	4	4	0	0
CENENET-60	100	385	285	1	4	1	0	0
CENENET-60	125	388	263	1	3	3	0	0
CENENET-60	164	477	313	0	1	1	1	0
CENENET-60	197	477	280	0	3	4	0	0
CENENET-60	242	477	235	0	4	5	0	0
CENENET-60	340	385	45	1	3	1	0	0
CY-32	31	127	96	1	3	1	0	0
CY-32	38	39	1	1	4	1	2	0
CY-32	50	51	1	1	5	1	0	0
CY-32	73	477	404	0	4	5	0	0
CR-4	40	41	1	1	4	5	1	0
CR-4	80	81	1	1	4	5	1	0
CR-4	107	108	1	1	1	1	1	0
CR-4	132	153	21	1	1	5	1	0
CR-4	153	154	1	1	4	5	1	0
CR-4	189	190	1	1	1	3	1	0
CR-4	201	202	1	1	4	5	1	0
DLIB-119	7	477	470	0	3	1	0	0
DLIB-119	11	16	5	1	3	1	1	0
DLIB-119	11	12	1	1	3	1	1	0
DLIB-119	22	477	455	0	4	4	0	0
DLIB-120	23	106	83	1	3	2	1	1
DLIB-120	25	72	47	1	3	1	1	0
DLIB-120	29	72	43	1	4	4	1	0
DLIB-120	32	477	445	0	4	4	0	0
DLIB-120	39	198	159	1	3	1	1	0
DLIB-120	43	163	120	1	3	2	1	1
DLIB-120	45	106	61	1	3	2	1	0
DLIB-120	51	72	21	1	4	1	1	0
DLIB-120	51	52	1	1	4	1	1	0
DLIB-120	51	52	1	1	4	1	1	0
DLIB-121	58	182	124	1	3	2	1	0
DLIB-121	58	80	22	1	4	1	1	0
DLIB-121	66	85	19	1	3	1	1	0
DLIB-121	66	477	411	0	3	4	0	0
DLIB-121	67	91	24	1	4	4	1	0
DLIB-121	72	78	6	1	4	1	1	0
DLIB-121	78	79	1	1	3	4	1	0
DLIB-121	79	81	2	1	3	1	1	0
DLIB-121	79	81	2	1	3	1	1	0
DLIB-121	80	84	4	1	4	1	1	0
DLIB-122	80	102	22	1	3	2	1	0
DLIB-122	81	477	396	0	3	4	0	0
DLIB-122	81	98	17	1	3	2	1	0
DLIB-122	92	99	7	1	3	1	1	0
DLIB-122	94	102	8	1	3	4	1	0
DLIB-122	95	102	7	1	3	1	1	0
DLIB-122	98	102	4	1	4	4	1	0
DLIB-122	98	102	4	1	4	4	1	0
DLIB-122	100	102	2	1	4	1	1	0
DLIB-122	101	197	96	1	4	1	1	0
DLIB-123	120	184	64	1	3	1	0	1
DLIB-123	120	477	357	0	4	1	0	0
DLIB-123	120	179	59	1	4	3	1	0
DLIB-123	120	141	21	1	3	1	1	0
DLIB-123	120	137	17	1	3	1	1	1
DLIB-123	122	222	100	1	4	3	1	0
DLIB-123	122	141	19	1	3	1	1	0
DLIB-123	141	182	41	1	3	1	1	0
DLIB-123	141	182	41	1	3	1	1	0
DLIB-123	142	212	70	1	3	2	1	0
DLIB-124	142	212	70	1	3	2	1	0
DLIB-124	142	192	50	1	3	2	1	0
DLIB-124	148	192	44	1	3	4	1	0
DLIB-124	149	182	33	1	4	1	1	0
DLIB-124	158	477	319	0	3	1	0	0
DLIB-124	158	477	319	0	3	4	0	0
DLIB-124	163	192	29	1	3	2	1	1
DLIB-124	169	477	308	0	3	4	0	0
DLIB-124	176	477	301	0	3	1	0	0
DLIB-124	182	212	30	1	3	2	1	0
DLIB-125	183	212	29	1	4	1	1	0
DLIB-125	183	196	13	1	4	1	1	0
DLIB-125	191	196	5	1	3	4	1	0
DLIB-125	193	197	4	1	3	1	1	0
DLIB-125	196	205	9	1	3	1	1	0
DLIB-125	197	477	280	0	4	1	1	0
DLIB-125	198	275	77	1	3	2	1	0
DLIB-125	204	477	273	0	3	1	1	0
DLIB-125	205	212	7	1	3	1	1	0
DLIB-125	207	477	270	0	3	1	1	0
DLIB-126	210	229	19	1	4	4	1	0
DLIB-126	212	477	265	0	3	4	0	0
DLIB-126	217	228	11	1	4	1	1	0
DLIB-126	218	477	259	0	4	1	0	0
DLIB-126	218	229	11	1	4	4	1	0
DLIB-126	218	477	259	0	3	2	1	0
DLIB-126	218	477	259	0	3	2	1	0
DLIB-126	218	477	259	0	3	2	1	0
DLIB-126	218	436	218	1	3	2	1	0
DLIB-126	218	477	259	0	4	3	1	0
DLIB-127	219	228	9	1	4	1	1	0
DLIB-127	224	477	253	0	4	1	1	0
DLIB-127	240	275	35	1	4	1	1	0
DLIB-127	241	275	34	1	4	2	1	0
DLIB-127	257	259	2	1	3	1	1	0
DLIB-127	261	477	216	0	4	1	0	0
DLIB-127	266	287	21	1	4	1	1	0
DLIB-127	269	477	208	0	3	5	0	0
DLIB-127	273	287	14	1	3	1	1	0
DLIB-127	273	275	2	1	4	1	1	0
DLIB-128	275	477	202	0	4	4	1	0
DLIB-128	298	340	42	1	4	4	1	0
DLIB-128	302	477	175	0	3	1	0	0
DLIB-128	314	347	33	1	3	4	1	0
DLIB-128	320	416	96	1	4	1	1	0
DLIB-128	337	477	140	0	3	4	1	0
DLIB-128	337	338	1	1	3	1	1	0
DLIB-128	344	351	7	1	4	1	1	0
DLIB-128	344	477	133	0	4	4	1	0
DLIB-128	350	351	1	1	3	1	0	0
DLIB-129	353	417	64	1	3	2	1	0
HOUT-202	38	477	439	0	4	1	0	0
HOUT-203	57	477	420	0	4	2	0	0
HOUT-203	154	477	323	0	3	5	0	0
HOUT-203	154	155	1	1	3	4	1	0
HOUT-203	154	179	25	1	3	1	1	0
HOUT-203	154	177	23	1	3	4	1	0
HOUT-203	154	477	323	0	3	1	1	0
HOUT-203	154	156	2	1	3	4	1	0
HOUT-203	154	155	1	1	3	1	1	0
HOUT-203	154	170	16	1	3	1	1	0
HOUT-203	154	169	15	1	3	1	1	0
HOUT-204	154	170	16	1	3	1	1	0
HOUT-204	154	168	14	1	3	1	1	0
HOUT-204	154	177	23	1	3	1	1	0
HOUT-204	154	177	23	1	3	1	1	0
HOUT-204	154	477	323	0	3	1	1	0
HOUT-204	154	177	23	1	3	1	1	0
HOUT-204	156	477	321	0	5	1	1	0
HOUT-204	168	169	1	1	3	4	0	0
HOUT-204	177	477	300	0	4	5	1	0
HOUT-204	179	477	298	0	5	4	0	0
HOUT-205	179	477	298	0	3	5	1	0
HOUT-205	198	477	279	0	4	1	4	0
HOUT-205	199	477	278	0	5	1	0	0
HOUT-205	210	477	267	0	3	2	0	0
HOUT-205	219	477	258	0	4	4	1	0
HOUT-205	288	477	189	0	3	2	0	0
ILBOX-32	21	28	7	1	3	3	0	0
ILBOX-32	73	74	1	1	3	1	0	0
ILBOX-32	78	81	3	1	3	1	0	0
ILBOX-32	92	95	3	1	3	4	0	0
ILBOX-32	92	95	3	1	3	4	0	0
ILBOX-32	105	477	372	0	3	1	2	0
ILBOX-32	107	108	1	1	3	1	0	0
ILBOX-33	107	108	1	1	3	1	0	0
ILBOX-33	115	127	12	1	3	2	0	0
ILBOX-33	121	129	8	1	3	2	0	0
ILBOX-33	128	129	1	1	3	2	0	0
ILBOX-33	128	129	1	1	3	2	0	0
ILBOX-33	141	142	1	1	3	4	0	0
ILBOX-33	142	143	1	1	3	4	0	0
ILBOX-33	143	144	1	1	3	4	0	0
ILBOX-33	144	150	6	1	3	4	0	0
ILBOX-33	144	147	3	1	3	4	0	0
ILBOX-34	150	151	1	1	3	4	0	0
ILBOX-34	162	164	2	1	3	4	1	0
ILBOX-34	185	186	1	1	3	4	0	0
ILBOX-34	194	197	3	1	3	1	0	0
ILBOX-34	196	477	281	0	3	1	0	0
ILBOX-34	196	477	281	0	3	1	0	0
ILBOX-34	197	477	280	0	3	1	0	0
ILBOX-34	198	477	279	0	3	1	0	0
ILBOX-34	200	477	277	0	3	4	0	0
ILBOX-34	227	232	5	1	3	1	1	0
ILBOX-35	315	477	162	0	3	1	0	0
ILBOX-35	323	332	9	1	3	2	1	0
ILBOX-35	323	331	8	1	3	2	1	0
ILBOX-35	324	477	153	0	3	2	0	0
ILBOX-35	333	337	4	1	3	4	1	0
ILBOX-35	337	477	140	0	3	4	1	0
ILBOX-35	339	354	15	1	3	1	1	0
ILBOX-35	344	345	1	1	3	4	1	0
ILBOX-35	344	347	3	1	3	4	1	0
ILBOX-35	344	354	10	1	3	2	1	0
ILBOX-36	344	346	2	1	3	2	1	0
ILBOX-36	344	477	133	0	3	2	0	0
ILBOX-36	344	352	8	1	3	2	1	0
ILBOX-36	344	477	133	0	3	2	0	0
ILBOX-36	344	351	7	1	3	2	0	0
ILBOX-36	351	352	1	1	3	2	1	0
ILBOX-36	354	373	19	1	3	2	1	0
ILBOX-36	357	379	22	1	3	4	1	0
ILBOX-36	358	375	17	1	3	4	1	0
ILBOX-36	360	386	26	1	3	4	1	0
ILET-16	56	57	1	1	3	4	0	0
ILET-16	81	477	396	0	4	4	1	0
NT-8	304	307	3	1	3	2	0	0
NTRUN-20	36	477	441	0	3	1	0	0
NTRUN-20	103	104	1	1	4	3	1	0
NTRUN-21	103	104	1	1	4	5	1	0
NTRUN-21	103	104	1	1	1	3	1	0
NTRUN-21	103	201	98	1	4	5	1	0
NTRUN-21	103	104	1	1	4	5	1	0
NTRUN-21	145	477	332	0	3	5	1	0
NTRUN-21	201	202	1	1	4	5	1	0
PREDUCE-703	10	15	5	1	3	5	1	0
PREDUCE-703	10	31	21	1	2	1	2	3
PREDUCE-703	11	14	3	1	3	5	1	0
PREDUCE-703	14	281	267	1	4	1	1	0
PREDUCE-703	14	101	87	1	4	1	1	1
PREDUCE-703	14	477	463	0	4	1	0	0
PREDUCE-703	15	29	14	1	3	1	0	0
PREDUCE-703	15	477	462	0	3	5	0	1
PREDUCE-704	16	477	461	0	3	1	0	0
PREDUCE-704	23	25	2	1	3	1	3	1
PREDUCE-704	23	115	92	1	3	1	4	0
PREDUCE-704	24	25	1	1	3	1	0	0
PREDUCE-704	27	477	450	0	4	1	1	0
PREDUCE-704	28	477	449	0	3	1	0	0
PREDUCE-704	32	477	445	0	3	4	0	0
PREDUCE-704	32	73	41	1	3	4	1	2
PREDUCE-704	35	42	7	1	3	4	4	0
PREDUCE-704	36	37	1	1	3	1	0	3
PREDUCE-705	40	477	437	0	4	4	0	0
PREDUCE-705	42	477	435	0	5	1	0	0
PREDUCE-705	43	45	2	1	3	1	4	0
PREDUCE-705	44	46	2	1	3	1	4	1
PREDUCE-705	45	477	432	0	4	4	0	0
PREDUCE-705	47	49	2	1	1	1	0	1
PREDUCE-705	50	477	427	0	3	1	0	1
PREDUCE-705	50	477	427	0	4	4	0	0
PREDUCE-705	52	53	1	1	3	4	0	1
PREDUCE-705	56	59	3	1	2	1	2	1
PREDUCE-706	56	59	3	1	4	4	1	2
PREDUCE-706	46	57	11	1	3	4	2	1
PREDUCE-706	58	100	42	1	3	1	4	0
PREDUCE-706	64	168	104	1	4	4	1	0
PREDUCE-706	70	72	2	1	3	1	2	0
PREDUCE-706	70	477	407	0	3	4	0	2
PREDUCE-706	73	77	4	1	3	5	2	1
PREDUCE-706	74	477	403	0	4	1	0	0
PREDUCE-706	80	477	397	0	3	1	0	0
PREDUCE-706	86	101	15	1	3	4	1	4
PREDUCE-707	87	477	390	0	4	4	0	1
PREDUCE-707	87	477	390	0	3	3	0	0
PREDUCE-707	93	116	23	1	3	1	2	0
PREDUCE-707	98	121	23	1	3	1	4	0
PREDUCE-707	98	477	379	0	3	1	1	0
PREDUCE-707	99	477	378	0	3	4	0	0
PREDUCE-707	99	477	378	0	4	1	0	0
PREDUCE-707	100	102	2	1	2	1	2	1
PREDUCE-707	101	477	376	0	3	1	0	0
PREDUCE-707	101	477	376	0	3	1	0	0
PREDUCE-708	106	107	1	1	3	4	0	1
PREDUCE-708	106	421	315	1	3	4	0	1
PREDUCE-708	107	477	370	0	3	1	0	0
PREDUCE-708	107	477	370	0	3	1	0	0
PREDUCE-708	108	477	369	0	3	1	0	0
PREDUCE-708	111	477	366	0	4	1	0	0
PREDUCE-708	109	120	11	1	3	4	2	1
PREDUCE-708	114	477	363	0	4	1	0	0
PREDUCE-708	116	477	361	0	4	1	0	0
PREDUCE-708	116	477	361	0	4	1	0	0
PREDUCE-709	119	444	325	1	4	5	1	2
PREDUCE-709	120	444	324	1	4	5	1	3
PREDUCE-709	120	444	324	1	3	4	1	4
PREDUCE-709	122	125	3	1	4	4	1	0
PREDUCE-709	127	136	9	1	3	1	1	0
PREDUCE-709	87	129	42	1	4	1	1	0
PREDUCE-709	130	131	1	1	3	1	0	0
PREDUCE-709	137	152	15	1	3	1	2	1
PREDUCE-709	144	150	6	1	3	4	1	1
PREDUCE-709	150	444	294	1	2	1	0	1
PREDUCE-710	150	477	327	0	2	4	0	1
PREDUCE-710	150	162	12	1	2	1	3	2
PREDUCE-710	151	153	2	1	4	5	4	1
PREDUCE-710	152	155	3	1	4	1	4	2
PREDUCE-710	153	154	1	1	4	1	0	2
PREDUCE-710	154	155	1	1	4	5	3	1
PREDUCE-710	157	477	320	0	3	1	0	0
PREDUCE-710	158	162	4	1	4	1	4	1
PREDUCE-710	161	477	316	0	3	4	0	1
PREDUCE-711	161	477	316	0	3	4	0	0
PREDUCE-711	163	164	1	1	4	1	2	1
PREDUCE-711	168	414	246	1	4	4	0	0
PREDUCE-711	170	171	1	1	4	4	1	0
PREDUCE-711	172	173	1	1	3	1	1	0
PREDUCE-711	65	477	412	0	4	4	0	0
PREDUCE-711	179	477	298	0	3	1	0	0
PREDUCE-711	183	477	294	0	3	1	0	0
PREDUCE-711	183	199	16	1	1	1	2	2
PREDUCE-711	185	477	292	0	4	1	0	0
PREDUCE-712	185	477	292	0	3	2	0	0
PREDUCE-712	190	477	287	0	3	2	0	0
PREDUCE-712	192	477	285	0	3	1	0	0
PREDUCE-712	194	226	32	1	3	1	0	0
PREDUCE-712	196	477	281	0	5	1	0	0
PREDUCE-712	203	266	63	1	3	1	2	1
PREDUCE-712	206	477	271	0	3	1	0	0
PREDUCE-712	214	477	263	0	3	2	0	0
PREDUCE-712	222	477	255	0	3	1	0	0
PREDUCE-712	225	477	252	0	3	1	0	0
PREDUCE-713	231	281	50	1	4	1	1	0
PREDUCE-713	239	248	9	1	3	1	4	1
PREDUCE-713	240	288	48	1	3	1	3	0
PREDUCE-713	241	255	14	1	3	1	4	2
PREDUCE-713	247	477	230	0	4	1	0	0
PREDUCE-713	252	253	1	1	4	1	1	0
PREDUCE-713	252	253	1	1	4	1	1	0
PREDUCE-713	252	260	8	1	4	1	4	2
PREDUCE-713	252	260	8	1	4	1	4	0
PREDUCE-713	253	477	224	0	4	1	0	0
PREDUCE-714	255	256	1	1	4	4	1	1
PREDUCE-714	261	477	216	0	3	3	0	1
PREDUCE-714	262	263	1	1	2	4	0	2
PREDUCE-714	262	477	215	0	4	4	0	0
PREDUCE-714	267	477	210	0	3	1	0	0
PREDUCE-714	269	477	208	0	3	1	0	0
PREDUCE-714	270	477	207	0	4	4	0	0
PREDUCE-714	270	477	207	0	5	4	0	0
PREDUCE-714	277	310	33	1	3	4	1	0
PREDUCE-714	283	284	1	1	4	4	1	1
PREDUCE-715	284	288	4	1	3	4	1	0
PREDUCE-715	287	296	9	1	3	1	3	1
PREDUCE-715	287	330	43	1	3	4	0	0
PREDUCE-715	288	477	189	0	3	1	0	0
PREDUCE-715	289	304	15	1	4	4	0	2
PREDUCE-715	294	477	183	0	3	1	0	1
PREDUCE-715	303	310	7	1	3	1	4	0
PREDUCE-715	305	477	172	0	3	4	0	0
PREDUCE-715	315	316	1	1	3	1	3	1
PREDUCE-715	323	339	16	1	3	1	3	1
PREDUCE-716	324	477	153	0	3	1	0	0
PREDUCE-716	328	330	2	1	2	1	3	1
PREDUCE-716	329	477	148	0	4	2	0	0
PREDUCE-716	329	331	2	1	3	4	4	1
PREDUCE-716	331	333	2	1	3	1	4	1
PREDUCE-716	331	353	22	1	3	4	1	0
PREDUCE-716	331	477	146	0	3	1	0	0
PREDUCE-716	334	477	143	0	4	2	0	0
PREDUCE-716	336	477	141	0	3	2	0	1
PREDUCE-717	343	346	3	1	4	1	3	1
PREDUCE-717	344	477	133	0	4	4	0	0
PREDUCE-717	344	477	133	0	2	1	0	1
PREDUCE-717	353	477	124	0	3	2	0	0
PREDUCE-717	362	366	4	1	3	1	4	0
PREDUCE-719	70	477	407	0	3	4	0	0
RCHETYPES-5	48	54	6	1	3	3	1	1
RCHETYPES-5	48	49	1	1	3	3	1	0
RCHETYPES-5	49	55	6	1	3	3	1	1
RCHETYPES-5	49	55	6	1	3	3	1	0
RCHETYPES-5	49	477	428	0	3	3	0	0
RCHETYPES-5	49	50	1	1	3	3	1	0
RCHETYPES-5	50	51	1	1	3	3	1	1
RCHETYPES-5	55	56	1	1	3	2	1	0
RCHETYPES-6	79	82	3	1	3	3	1	1
RCHETYPES-6	285	477	192	0	4	4	0	0
RCHETYPES-6	303	304	1	1	3	1	1	0
RCHETYPES-6	341	342	1	1	3	5	1	1
RCHETYPES-6	341	342	1	1	3	3	1	1
RCHETYPES-6	342	343	1	1	3	4	1	0
RMOTTA-67	122	162	40	1	3	1	1	1
RMOTTA-67	283	477	194	0	2	1	0	0
SFRES-1	86	371	285	1	4	2	0	0
SFRES-2	200	477	277	0	3	3	0	1
SFRES-2	212	477	265	0	3	1	0	0
SFRES-2	318	477	159	0	3	1	0	0
SSEMBLY-87	16	477	461	0	3	4	0	0
SSEMBLY-87	28	382	354	1	4	1	1	4
SSEMBLY-87	40	41	1	1	4	5	1	0
SSEMBLY-87	49	477	428	0	3	4	0	0
SSEMBLY-87	55	56	1	1	3	1	0	0
SSEMBLY-87	65	477	412	0	4	1	0	0
SSEMBLY-88	78	477	399	0	3	2	0	0
SSEMBLY-88	81	477	396	0	4	4	0	0
SSEMBLY-88	96	137	41	1	4	5	1	0
SSEMBLY-88	100	477	377	0	3	1	0	0
SSEMBLY-88	125	137	12	1	2	5	1	0
SSEMBLY-88	129	130	1	1	3	3	1	1
SSEMBLY-88	134	477	343	0	4	4	0	0
SSEMBLY-88	137	140	3	1	3	1	0	0
SSEMBLY-88	142	382	240	1	3	4	0	3
SSEMBLY-88	152	411	259	1	3	1	0	0
SSEMBLY-89	153	360	207	1	4	5	1	0
SSEMBLY-89	184	477	293	0	3	1	0	0
SSEMBLY-89	201	360	159	1	4	5	1	0
SSEMBLY-89	214	215	1	1	5	1	1	0
SSEMBLY-89	240	477	237	0	4	1	0	0
SSEMBLY-89	263	477	214	0	3	2	0	0
SSEMBLY-89	294	477	183	0	4	2	0	0
SSEMBLY-89	331	477	146	0	3	1	0	0
SSEMBLY-89	340	341	1	1	3	3	1	0
SSEMBLY-89	355	356	1	1	3	3	1	0
SSEMBLY-90	356	360	4	1	3	5	1	3
SSEMBLY-90	361	362	1	1	1	3	1	0
SSEMBLY-90	361	362	1	1	3	3	1	0
TH-143	20	21	1	1	3	1	1	0
TH-144	20	24	4	1	3	3	0	1
TH-144	22	477	455	0	4	4	0	0
TH-144	23	25	2	1	3	1	1	0
TH-144	23	477	454	0	3	3	1	1
TH-144	28	477	449	0	3	1	1	0
TH-144	30	58	28	1	3	5	1	0
TH-144	30	477	447	0	3	5	0	0
TH-144	32	33	1	1	3	1	1	0
TH-144	32	477	445	0	5	5	0	0
TH-144	34	37	3	1	3	1	1	0
TH-145	41	45	4	1	3	1	1	0
TH-145	43	477	434	0	3	1	0	0
TH-145	47	477	430	0	3	4	0	2
TH-145	59	477	418	0	2	1	0	0
TH-145	88	89	1	1	3	1	0	0
TH-145	89	477	388	0	4	1	0	0
TH-145	95	477	382	0	4	4	0	0
TH-145	116	477	361	0	2	1	0	0
TH-145	120	382	262	1	4	1	0	1
TH-145	120	477	357	0	4	4	1	0
TH-146	121	382	261	1	4	1	1	1
TH-146	134	477	343	0	3	4	0	0
TH-146	161	477	316	0	2	1	0	2
TH-146	162	163	1	1	3	1	1	0
TH-146	162	477	315	0	3	2	0	0
TH-146	221	477	256	0	4	4	0	0
TH-146	238	477	239	0	3	1	0	0
TH-146	239	477	238	0	3	4	1	0
TH-146	250	477	227	0	5	3	1	1
TH-146	256	477	221	0	4	3	1	0
TH-147	274	477	203	0	3	1	0	0
TH-147	283	290	7	1	3	1	0	0
TH-147	345	477	132	0	3	1	0	0
HANGELOG-14	60	477	417	0	3	1	0	0
HANGELOG-14	98	99	1	1	4	5	0	0
HANGELOG-14	98	99	1	1	4	5	1	0
HANGELOG-14	201	243	42	1	4	5	1	0
HANGES-38	23	477	454	0	4	1	0	0
HANGES-38	107	188	81	1	1	5	1	0
HANGES-38	108	243	135	1	1	5	0	1
HANGES-38	128	477	349	0	4	5	0	0
HANGES-38	136	477	341	0	3	1	0	0
HANGES-39	188	189	1	1	1	3	1	0
HANGES-39	195	477	282	0	1	4	1	0
HANGES-39	201	202	1	1	4	5	1	1
HANGES-39	213	477	264	0	3	1	0	0
HANGES-39	232	477	245	0	3	1	0	0
HANGES-39	248	249	1	1	3	4	0	0
HECKSTYLE-34	5	96	91	1	5	1	1	0
HECKSTYLE-34	20	21	1	1	3	1	0	0
HECKSTYLE-34	96	97	1	1	4	5	1	0
HECKSTYLE-35	96	97	1	1	4	4	1	0
HECKSTYLE-35	123	477	354	0	3	1	0	0
HECKSTYLE-35	139	477	338	0	3	3	0	0
HECKSTYLE-35	141	477	336	0	3	4	0	1
HECKSTYLE-35	161	339	178	1	3	1	0	1
HECKSTYLE-35	177	477	300	0	4	4	0	0
HECKSTYLE-35	180	477	297	0	3	4	0	0
HECKSTYLE-35	193	353	160	1	3	4	0	0
HECKSTYLE-35	201	477	276	0	3	3	0	0
HECKSTYLE-35	201	202	1	1	4	5	1	0
HECKSTYLE-36	201	202	1	1	4	5	1	0
HECKSTYLE-36	201	477	276	0	2	3	1	0
HECKSTYLE-36	226	477	251	0	4	2	0	0
HECKSTYLE-36	305	477	172	0	4	4	0	0
HECKSTYLE-36	339	477	138	0	4	1	0	0
LEAN-8	40	41	1	1	4	5	1	0
LEAN-8	96	97	1	1	4	3	1	0
LEAN-8	96	97	1	1	4	3	1	0
LEAN-8	96	97	1	1	4	5	1	0
LEAN-8	101	411	310	1	3	1	0	0
LEAN-8	201	202	1	1	4	5	1	0
OMPILER-32	16	477	461	0	3	2	0	1
OMPILER-32	26	157	131	1	3	1	1	0
OMPILER-32	36	218	182	1	4	4	1	0
OMPILER-32	41	188	147	1	3	4	1	1
OMPILER-32	43	44	1	1	4	5	1	0
OMPILER-32	44	45	1	1	4	1	0	1
OMPILER-32	54	55	1	1	4	5	0	0
OMPILER-32	56	477	421	0	3	1	0	0
OMPILER-32	72	73	1	1	2	1	0	0
OMPILER-32	73	74	1	1	3	1	0	0
OMPILER-33	73	477	404	0	3	4	0	0
OMPILER-33	78	79	1	1	3	5	0	0
OMPILER-33	78	154	76	1	3	1	1	1
OMPILER-33	83	477	394	0	3	1	0	0
OMPILER-33	93	95	2	1	4	4	0	0
OMPILER-33	97	195	98	1	3	4	1	1
OMPILER-33	101	137	36	1	3	3	1	0
OMPILER-33	101	102	1	1	3	1	0	0
OMPILER-33	103	187	84	1	1	1	1	0
OMPILER-33	105	477	372	0	3	4	0	0
OMPILER-34	130	477	347	0	3	1	0	1
OMPILER-34	131	152	21	1	4	4	1	1
OMPILER-34	134	153	19	1	1	1	1	2
OMPILER-34	141	154	13	1	3	1	1	1
OMPILER-34	155	157	2	1	4	3	1	0
OMPILER-34	24	477	453	0	3	1	0	0
OMPILER-34	178	477	299	0	3	1	0	0
OMPILER-34	184	477	293	0	3	1	0	0
OMPILER-34	195	241	46	1	3	1	0	0
OMPILER-34	197	218	21	1	3	1	1	0
OMPILER-35	203	204	1	1	4	3	1	0
OMPILER-35	205	206	1	1	4	5	1	0
OMPILER-35	205	206	1	1	4	5	1	0
OMPILER-35	205	206	1	1	4	5	1	0
OMPILER-35	208	477	269	0	3	1	0	0
OMPILER-35	210	277	67	1	3	1	0	2
OMPILER-35	210	213	3	1	3	1	0	1
OMPILER-35	224	246	22	1	3	1	0	0
OMPILER-35	226	227	1	1	3	1	0	0
OMPILER-35	241	477	236	0	3	1	0	0
OMPILER-36	247	277	30	1	3	1	1	1
OMPILER-36	248	249	1	1	3	1	0	0
OMPILER-36	261	262	1	1	5	4	0	0
OMPILER-36	282	477	195	0	3	4	0	0
OMPILER-36	315	477	162	0	2	1	0	0
OMPILER-36	325	477	152	0	4	4	0	1
OMPILER-36	338	446	108	1	3	4	1	0
OMPILER-36	341	477	136	0	3	4	0	0
OMPILER-36	349	477	128	0	3	1	0	2
OMPILER-36	359	477	118	0	3	1	0	0
EP-59	9	477	468	0	3	1	1	0
EP-59	16	477	461	0	3	4	0	0
EP-59	23	477	454	0	3	1	0	0
EP-59	39	40	1	1	3	1	0	2
EP-59	43	44	1	1	4	5	1	0
EP-60	58	477	419	0	4	4	0	0
EP-60	78	477	399	0	4	2	0	0
EP-60	81	477	396	0	3	4	0	0
EP-60	82	87	5	1	1	1	1	3
EP-60	91	92	1	1	4	4	1	0
EP-60	99	100	1	1	2	1	0	0
EP-60	103	138	35	1	3	1	1	2
EP-60	113	477	364	0	3	4	0	0
EP-60	115	477	362	0	3	1	0	1
EP-61	126	128	2	1	2	5	1	0
EP-61	132	138	6	1	1	5	1	1
EP-61	134	368	234	1	3	1	1	1
EP-61	138	139	1	1	4	5	1	0
EP-61	141	440	299	1	3	1	0	0
EP-61	147	477	330	0	4	4	0	0
EP-61	160	477	317	0	3	5	0	0
EP-61	161	477	316	0	3	2	1	0
EP-61	162	477	315	0	3	1	0	0
EP-62	163	440	277	1	3	1	0	0
EP-62	194	477	283	0	3	2	0	0
EP-62	196	477	281	0	3	1	0	2
EP-62	199	440	241	1	3	4	0	0
EP-62	202	203	1	1	4	5	1	0
EP-62	220	440	220	1	4	5	1	1
EP-62	242	477	235	0	3	5	0	0
EP-62	247	250	3	1	1	1	0	0
EP-62	264	332	68	1	3	2	1	0
EP-62	273	477	204	0	3	1	0	0
EP-63	283	477	194	0	3	1	0	1
EP-63	303	477	174	0	3	2	0	0
EP-63	324	325	1	1	3	1	0	0
EP-63	333	477	144	0	3	1	0	0
EP-63	341	342	1	1	4	5	1	0
EP-63	342	419	77	1	4	5	1	0
EP-63	342	343	1	1	4	5	1	0
EP-63	348	349	1	1	4	5	1	0
EPLOY-22	12	13	1	1	4	5	1	0
EPLOY-22	30	32	2	1	2	1	0	0
EPLOY-23	40	41	1	1	4	5	1	0
EPLOY-23	62	237	175	1	1	4	1	2
EPLOY-23	65	66	1	1	4	4	1	0
EPLOY-23	65	68	3	1	4	4	1	0
EPLOY-23	100	101	1	1	3	1	0	1
EPLOY-23	100	103	3	1	4	5	1	0
EPLOY-23	175	477	302	0	3	1	0	0
EPLOY-23	202	203	1	1	4	5	1	0
EPLOY-23	202	203	1	1	4	5	1	0
EPLOY-23	204	205	1	1	4	3	1	0
EPLOY-24	220	230	10	1	4	4	1	0
EPLOY-24	236	237	1	1	4	4	0	0
EPLOY-24	265	266	1	1	4	3	1	0
EPLOY-24	265	440	175	1	4	3	1	0
EPLOY-24	273	434	161	1	2	1	1	2
EPLOY-24	277	434	157	1	5	3	1	0
EPLOY-24	277	477	200	0	3	1	0	1
EPLOY-24	312	434	122	1	5	1	1	1
EPLOY-24	360	434	74	1	4	5	1	0
OAP-5	43	44	1	1	4	5	1	0
OAP-5	100	173	73	1	4	1	1	0
OAP-5	173	188	15	1	4	4	1	0
OAP-5	188	189	1	1	1	5	1	0
OAP-5	188	189	1	1	4	5	1	0
OAP-5	188	189	1	1	2	3	1	0
OAP-5	188	189	1	1	4	5	1	0
OAP-5	202	203	1	1	4	5	1	0
OAP-5	283	334	51	1	4	5	1	0
OCCK-3	43	44	1	1	4	5	1	0
AR-25	9	62	53	1	2	4	1	0
AR-25	43	55	12	1	4	5	1	0
AR-25	62	63	1	1	4	5	1	0
AR-25	62	63	1	1	4	5	1	0
AR-25	65	66	1	1	1	4	1	0
AR-25	66	67	1	1	5	3	1	0
AR-26	66	67	1	1	2	4	1	0
AR-26	66	67	1	1	2	4	1	0
AR-26	66	67	1	1	5	4	1	0
AR-26	66	67	1	1	5	4	1	0
AR-26	87	477	390	0	3	2	0	0
AR-26	96	97	1	1	4	4	1	0
AR-26	96	97	1	1	4	4	1	0
AR-26	113	477	364	0	3	1	0	0
AR-26	125	126	1	1	2	5	1	0
AR-26	200	477	277	0	4	2	0	0
AR-27	203	230	27	1	4	5	1	0
AR-27	246	312	66	1	3	5	1	0
AR-27	311	477	166	0	3	1	0	0
ECROWAVE-10	57	58	1	1	5	1	1	0
ECROWAVE-10	58	59	1	1	3	3	1	0
ECROWAVE-10	58	59	1	1	3	3	1	0
ECROWAVE-10	68	69	1	1	3	3	1	0
ECROWAVE-10	68	100	32	1	3	3	1	1
ECROWAVE-10	71	100	29	1	3	1	1	0
ECROWAVE-10	78	79	1	1	3	3	1	0
ECROWAVE-10	79	80	1	1	3	2	1	0
ECROWAVE-10	84	85	1	1	4	1	1	0
ECROWAVE-10	87	88	1	1	4	1	1	0
ECROWAVE-11	98	100	2	1	3	2	1	0
ECROWAVE-11	106	107	1	1	3	1	1	0
ECROWAVE-11	106	119	13	1	3	4	1	0
ECROWAVE-11	106	119	13	1	3	1	1	1
ECROWAVE-11	116	117	1	1	3	4	1	0
ECROWAVE-11	141	142	1	1	3	2	1	0
ECROWAVE-11	155	156	1	1	3	1	1	0
ECROWAVE-11	169	170	1	1	3	3	1	0
ECROWAVE-11	171	172	1	1	3	1	0	0
ECROWAVE-11	172	173	1	1	3	3	1	0
ECROWAVE-12	172	173	1	1	3	3	1	0
ECROWAVE-12	176	177	1	1	3	1	1	0
ECROWAVE-12	181	182	1	1	3	3	1	0
ECROWAVE-12	185	186	1	1	3	1	1	0
ECROWAVE-12	186	187	1	1	3	3	1	0
ECROWAVE-12	186	187	1	1	3	3	1	0
ECROWAVE-12	186	187	1	1	3	3	1	0
ECROWAVE-12	194	195	1	1	3	4	1	0
ECROWAVE-12	199	200	1	1	1	1	1	0
ECROWAVE-12	199	200	1	1	3	1	1	0
ECROWAVE-13	204	262	58	1	3	1	1	0
ECROWAVE-13	209	232	23	1	3	1	0	0
ECROWAVE-13	209	232	23	1	3	4	0	0
ECROWAVE-13	223	224	1	1	3	3	1	0
ECROWAVE-13	229	230	1	1	3	3	1	0
ECROWAVE-13	229	230	1	1	3	3	1	0
ECROWAVE-13	235	236	1	1	3	4	1	0
ECROWAVE-13	236	237	1	1	5	2	0	0
ECROWAVE-13	245	252	7	1	3	3	1	0
ECROWAVE-13	245	252	7	1	3	3	1	0
ECROWAVE-14	246	247	1	1	3	4	1	0
ECROWAVE-14	246	262	16	1	3	4	1	0
ECROWAVE-14	261	262	1	1	3	1	1	0
ECROWAVE-14	262	263	1	1	3	1	1	0
ECROWAVE-14	262	263	1	1	3	1	1	0
ECROWAVE-14	263	264	1	1	3	3	1	0
ECROWAVE-14	263	264	1	1	3	3	1	0
ECROWAVE-14	263	264	1	1	3	3	1	0
ECROWAVE-14	263	264	1	1	3	3	1	0
ECROWAVE-14	263	264	1	1	3	3	1	0
ECROWAVE-15	263	264	1	1	3	3	1	0
ECROWAVE-15	273	274	1	1	3	4	1	0
ECROWAVE-15	273	274	1	1	3	4	1	0
ECROWAVE-15	278	279	1	1	3	4	1	0
ECROWAVE-15	278	324	46	1	3	4	1	0
ECROWAVE-15	284	477	193	0	4	4	0	0
ECROWAVE-15	298	477	179	0	3	1	0	0
ECROWAVE-15	301	302	1	1	3	3	1	0
ECROWAVE-15	305	306	1	1	3	3	1	0
ECROWAVE-15	305	306	1	1	4	3	1	0
ECROWAVE-16	308	309	1	1	3	3	1	0
ECROWAVE-16	324	343	19	1	3	1	1	0
ECROWAVE-16	339	340	1	1	3	4	1	0
ECROWAVE-16	339	340	1	1	3	4	1	0
ECROWAVE-16	339	340	1	1	3	4	1	0
ECROWAVE-16	339	340	1	1	3	1	1	0
ECROWAVE-16	343	430	87	1	3	1	1	0
ECROWAVE-16	345	346	1	1	3	1	1	0
ECROWAVE-16	353	354	1	1	3	4	1	0
ECROWAVE-8	2	3	1	1	3	4	1	0
ECROWAVE-9	4	5	1	1	3	1	1	0
ECROWAVE-9	5	344	339	1	2	1	1	0
ECROWAVE-9	22	23	1	1	4	3	1	0
ECROWAVE-9	24	25	1	1	3	1	1	0
ECROWAVE-9	24	25	1	1	3	1	1	0
ECROWAVE-9	36	37	1	1	3	1	1	0
ECROWAVE-9	36	56	20	1	3	1	1	0
ECROWAVE-9	42	43	1	1	3	3	1	0
ECROWAVE-9	46	56	10	1	3	3	1	0
ECROWAVE-9	56	57	1	1	3	1	1	0
JB-11	43	44	1	1	4	5	1	0
JB-12	100	102	2	1	4	5	1	0
JB-12	102	103	1	1	4	5	1	0
JB-12	201	202	1	1	4	5	1	0
JB-12	206	207	1	1	4	5	1	0
JB-12	206	207	1	1	4	5	1	0
JB-12	206	207	1	1	4	5	1	0
NFORCER-29	0	5	5	1	2	4	2	0
NFORCER-29	5	6	1	1	2	4	2	1
NFORCER-29	6	7	1	1	4	4	2	0
NFORCER-29	11	477	466	0	4	4	1	0
NFORCER-29	22	42	20	1	4	5	0	1
NFORCER-29	26	27	1	1	5	3	2	0
NFORCER-29	40	41	1	1	4	5	2	1
NFORCER-29	63	477	414	0	2	1	0	3
NFORCER-29	74	161	87	1	1	4	0	1
NFORCER-30	87	419	332	1	3	1	0	1
NFORCER-30	105	477	372	0	3	1	0	0
NFORCER-30	106	477	371	0	3	1	0	1
NFORCER-30	128	161	33	1	1	5	2	0
NFORCER-30	137	477	340	0	4	4	0	3
NFORCER-30	138	167	29	1	4	4	1	0
NFORCER-30	167	419	252	1	2	1	1	3
NFORCER-30	167	477	310	0	4	3	1	0
NFORCER-30	171	477	306	0	3	1	0	1
NFORCER-30	191	194	3	1	3	5	0	0
NFORCER-31	196	477	281	0	3	1	0	0
NFORCER-31	196	477	281	0	2	1	0	0
NFORCER-31	218	279	61	1	4	5	1	0
NFORCER-31	221	477	256	0	4	4	0	0
NFORCER-31	231	398	167	1	3	1	1	0
NFORCER-31	239	278	39	1	3	4	1	0
NFORCER-31	240	477	237	0	3	1	0	0
NFORCER-31	245	278	33	1	3	1	1	0
NFORCER-31	261	417	156	1	3	1	0	2
NFORCER-31	269	417	148	1	3	1	1	0
NFORCER-32	277	278	1	1	3	1	1	0
NFORCER-32	277	419	142	1	3	1	1	2
NFORCER-32	332	344	12	1	3	1	1	0
NFORCER-32	344	477	133	0	5	1	1	0
NFORCER-32	344	390	46	1	5	4	1	0
SOS-836	1	477	476	0	3	4	0	2
SOS-836	1	2	1	1	1	1	1	0
SOS-837	1	477	476	0	3	1	0	0
SOS-837	1	477	476	0	3	5	0	3
SOS-837	2	477	475	0	3	3	0	0
SOS-837	2	38	36	1	3	3	1	0
SOS-837	2	477	475	0	3	5	0	4
SOS-837	2	10	8	1	1	3	1	1
SOS-837	2	3	1	1	1	1	1	0
SOS-837	2	3	1	1	3	1	1	0
SOS-837	2	38	36	1	3	1	0	0
SOS-837	2	477	475	0	2	3	0	0
SOS-838	2	375	373	1	2	4	1	1
SOS-838	2	3	1	1	3	3	0	0
SOS-838	2	72	70	1	3	3	1	0
SOS-838	2	151	149	1	3	3	1	0
SOS-838	2	477	475	0	3	3	0	0
SOS-838	2	58	56	1	3	3	0	1
SOS-838	2	477	475	0	3	1	0	2
SOS-838	2	477	475	0	3	3	0	0
SOS-838	2	78	76	1	3	3	1	0
SOS-838	3	22	19	1	3	4	1	0
SOS-839	3	11	8	1	3	4	1	0
SOS-839	3	12	9	1	1	1	1	2
SOS-839	3	477	474	0	3	1	0	0
SOS-839	3	10	7	1	1	1	1	1
SOS-839	3	4	1	1	1	3	1	0
SOS-839	3	214	211	1	1	3	1	2
SOS-839	3	477	474	0	3	5	0	1
SOS-839	3	477	474	0	3	5	0	1
SOS-839	3	477	474	0	3	1	0	0
SOS-839	4	301	297	1	3	1	0	0
SOS-840	4	477	473	0	2	4	0	3
SOS-840	4	477	473	0	3	1	0	0
SOS-840	4	121	117	1	3	4	1	4
SOS-840	4	382	378	1	2	4	1	3
SOS-840	4	10	6	1	4	1	1	0
SOS-840	4	477	473	0	3	1	0	0
SOS-840	4	406	402	1	3	3	0	1
SOS-840	4	19	15	1	3	3	1	0
SOS-840	4	19	15	1	3	3	1	0
SOS-840	5	31	26	1	3	3	1	0
SOS-841	5	11	6	1	1	1	1	1
SOS-841	7	43	36	1	2	1	3	2
SOS-841	7	8	1	1	3	1	0	2
SOS-841	7	18	11	1	3	1	2	1
SOS-841	7	14	7	1	3	1	0	0
SOS-841	7	38	31	1	3	3	1	0
SOS-841	7	106	99	1	1	1	2	1
SOS-841	8	9	1	1	3	1	1	0
SOS-841	8	197	189	1	2	4	4	1
SOS-841	8	10	2	1	1	1	1	0
SOS-842	8	19	11	1	3	3	1	1
SOS-842	9	15	6	1	4	4	1	0
SOS-842	9	12	3	1	1	1	1	0
SOS-842	9	477	468	0	3	4	0	1
SOS-842	9	49	40	1	3	3	1	1
SOS-842	9	277	268	1	3	1	0	1
SOS-842	9	38	29	1	3	4	1	0
SOS-842	9	38	29	1	3	4	1	0
SOS-842	9	477	468	0	3	1	0	0
SOS-842	9	246	237	1	3	1	1	0
SOS-843	9	57	48	1	3	1	0	0
SOS-843	9	477	468	0	3	4	0	0
SOS-843	10	477	467	0	3	5	0	0
SOS-843	10	477	467	0	3	3	0	0
SOS-843	10	72	62	1	3	4	1	0
SOS-843	10	477	467	0	3	1	0	0
SOS-843	10	477	467	0	3	4	0	0
SOS-843	10	477	467	0	3	1	0	0
SOS-843	10	477	467	0	3	1	0	0
SOS-843	10	477	467	0	4	4	0	0
SOS-844	11	15	4	1	3	1	1	0
SOS-844	11	477	466	0	3	3	0	0
SOS-844	11	54	43	1	3	3	1	0
SOS-844	11	15	4	1	1	1	1	1
SOS-844	13	16	3	1	3	1	2	1
SOS-844	14	17	3	1	3	3	1	0
SOS-844	14	16	2	1	3	1	2	0
SOS-844	15	24	9	1	3	1	1	0
SOS-844	15	477	462	0	3	1	0	0
SOS-844	15	477	462	0	3	4	0	1
SOS-845	16	477	461	0	3	1	0	0
SOS-845	16	477	461	0	3	1	0	0
SOS-845	16	477	461	0	3	1	0	0
SOS-845	16	23	7	1	3	1	1	0
SOS-845	16	58	42	1	3	4	1	0
SOS-845	16	17	1	1	3	4	1	1
SOS-845	16	477	461	0	3	4	0	0
SOS-845	17	477	460	0	4	1	0	1
SOS-845	17	477	460	0	3	1	0	0
SOS-845	17	477	460	0	3	1	0	1
SOS-846	17	18	1	1	3	1	1	1
SOS-846	17	18	1	1	3	1	1	0
SOS-846	18	23	5	1	3	3	1	0
SOS-846	18	50	32	1	3	1	1	1
SOS-846	18	477	459	0	3	1	0	0
SOS-846	18	23	5	1	3	1	0	0
SOS-846	18	477	459	0	3	4	0	0
SOS-846	18	464	446	1	2	1	2	1
SOS-846	18	44	26	1	2	1	2	0
SOS-846	19	22	3	1	2	1	1	1
SOS-847	19	344	325	1	3	1	1	1
SOS-847	21	32	11	1	4	4	1	1
SOS-847	21	477	456	0	3	1	0	0
SOS-847	21	190	169	1	3	3	1	1
SOS-847	21	38	17	1	3	1	1	0
SOS-847	21	477	456	0	3	4	0	0
SOS-847	21	477	456	0	3	4	0	0
SOS-847	22	25	3	1	3	1	1	0
SOS-847	22	477	455	0	3	1	0	1
SOS-847	22	477	455	0	3	1	0	0
SOS-848	22	23	1	1	3	1	3	0
SOS-848	23	29	6	1	1	1	1	0
SOS-848	23	24	1	1	3	1	1	1
SOS-848	23	29	6	1	1	1	1	1
SOS-848	23	24	1	1	1	1	1	0
SOS-848	23	65	42	1	3	1	1	0
SOS-848	24	477	453	0	3	3	0	0
SOS-848	24	417	393	1	3	3	0	1
SOS-848	24	44	20	1	3	4	3	2
SOS-848	24	100	76	1	3	1	1	1
SOS-849	24	42	18	1	3	1	1	0
SOS-849	24	477	453	0	3	1	0	0
SOS-849	24	119	95	1	1	3	1	1
SOS-849	25	477	452	0	5	4	0	0
SOS-849	25	477	452	0	3	3	0	0
SOS-849	25	477	452	0	4	1	0	1
SOS-849	25	71	46	1	2	1	1	1
SOS-849	25	56	31	1	3	3	0	2
SOS-849	25	142	117	1	2	1	1	1
SOS-850	25	477	452	0	3	5	0	0
SOS-850	25	477	452	0	3	3	0	0
SOS-850	27	477	450	0	3	1	0	0
SOS-850	28	477	449	0	3	3	0	0
SOS-850	28	477	449	0	4	1	0	0
SOS-850	28	477	449	0	4	4	0	0
SOS-850	29	99	70	1	5	4	1	0
SOS-850	29	477	448	0	3	1	0	0
SOS-850	29	30	1	1	3	1	1	0
SOS-850	29	477	448	0	3	1	0	1
SOS-851	29	39	10	1	3	1	2	0
SOS-851	29	477	448	0	3	4	0	1
SOS-851	29	51	22	1	3	1	1	0
SOS-851	30	36	6	1	4	1	1	0
SOS-851	30	31	1	1	1	1	1	0
SOS-851	30	477	447	0	3	1	0	0
SOS-851	30	477	447	0	4	4	0	1
SOS-851	30	477	447	0	4	4	0	0
SOS-851	30	477	447	0	3	1	0	1
SOS-851	30	39	9	1	3	1	1	0
SOS-852	30	477	447	0	4	5	0	0
SOS-852	31	144	113	1	3	1	0	0
SOS-852	31	477	446	0	3	1	0	0
SOS-852	31	39	8	1	3	1	0	0
SOS-852	31	477	446	0	3	1	0	1
SOS-852	31	477	446	0	3	4	0	0
SOS-852	31	477	446	0	3	4	0	0
SOS-852	31	32	1	1	3	3	1	0
SOS-852	31	438	407	1	3	3	1	2
SOS-852	31	477	446	0	3	5	0	0
SOS-853	31	85	54	1	2	1	1	0
SOS-853	31	477	446	0	3	1	0	2
SOS-853	31	477	446	0	3	1	0	0
SOS-853	31	477	446	0	3	3	0	0
SOS-853	32	85	53	1	4	3	1	0
SOS-853	32	477	445	0	5	3	0	0
SOS-853	32	70	38	1	3	1	2	2
SOS-853	32	477	445	0	3	1	0	0
SOS-853	32	477	445	0	3	4	0	0
SOS-853	32	33	1	1	3	3	1	0
SOS-854	32	477	445	0	3	1	0	1
SOS-854	33	477	444	0	3	1	0	1
SOS-854	35	477	442	0	3	1	0	0
SOS-854	35	477	442	0	3	1	0	0
SOS-854	35	477	442	0	3	1	0	0
SOS-854	35	260	225	1	3	1	4	2
SOS-854	35	37	2	1	3	1	1	0
SOS-854	36	302	266	1	3	1	1	0
SOS-854	36	38	2	1	3	1	1	0
SOS-854	36	477	441	0	3	1	0	0
SOS-855	37	80	43	1	3	1	3	2
SOS-855	37	66	29	1	3	3	1	1
SOS-855	38	39	1	1	2	1	3	0
SOS-855	38	207	169	1	3	3	0	0
SOS-855	38	477	439	0	3	3	0	0
SOS-855	38	477	439	0	3	5	0	0
SOS-855	38	77	39	1	4	4	1	0
SOS-855	39	477	438	0	3	1	0	0
SOS-855	39	477	438	0	3	5	0	2
SOS-855	39	477	438	0	4	4	0	0
SOS-856	39	477	438	0	3	3	0	0
SOS-856	39	477	438	0	3	3	0	3
SOS-856	39	477	438	0	3	1	0	0
SOS-856	39	40	1	1	3	1	1	2
SOS-856	39	224	185	1	3	5	1	0
SOS-856	40	44	4	1	3	1	2	2
SOS-856	40	477	437	0	3	1	0	0
SOS-856	40	193	153	1	3	1	1	0
SOS-856	42	248	206	1	1	1	4	1
SOS-856	42	50	8	1	3	3	3	0
SOS-857	43	477	434	0	4	1	0	0
SOS-857	43	477	434	0	3	1	0	0
SOS-857	43	477	434	0	3	5	0	0
SOS-857	43	54	11	1	3	4	3	1
SOS-857	43	61	18	1	3	4	3	2
SOS-857	43	54	11	1	3	4	3	3
SOS-857	43	59	16	1	3	4	3	1
SOS-857	43	44	1	1	3	1	2	0
SOS-857	43	477	434	0	3	1	0	0
SOS-857	43	477	434	0	4	1	0	0
SOS-858	43	477	434	0	3	4	0	0
SOS-858	43	477	434	0	3	4	0	0
SOS-858	44	477	433	0	3	4	0	3
SOS-858	44	477	433	0	4	1	0	0
SOS-858	45	477	432	0	3	4	0	1
SOS-858	45	109	64	1	1	1	1	2
SOS-858	45	59	14	1	4	1	1	1
SOS-858	45	477	432	0	3	4	0	2
SOS-858	45	477	432	0	3	5	0	0
SOS-858	45	477	432	0	3	1	0	0
SOS-859	46	477	431	0	3	1	0	1
SOS-859	46	54	8	1	3	4	1	0
SOS-859	47	477	430	0	3	1	0	0
SOS-859	49	477	428	0	3	4	0	0
SOS-859	49	120	71	1	1	1	2	3
SOS-859	49	477	428	0	4	1	0	0
SOS-859	50	477	427	0	3	4	0	0
SOS-859	50	477	427	0	3	3	0	0
SOS-859	50	53	3	1	3	1	2	0
SOS-859	50	66	16	1	3	4	1	0
SOS-860	52	477	425	0	3	4	0	0
SOS-860	52	54	2	1	1	1	2	1
SOS-860	52	56	4	1	1	1	1	2
SOS-860	53	79	26	1	3	1	0	1
SOS-860	53	57	4	1	3	1	3	0
SOS-860	53	61	8	1	3	1	3	0
SOS-860	54	55	1	1	3	1	0	0
SOS-860	54	59	5	1	4	4	1	0
SOS-860	54	477	423	0	2	1	0	0
SOS-860	55	72	17	1	4	4	1	0
SOS-861	56	57	1	1	3	1	1	0
SOS-861	56	95	39	1	3	1	1	0
SOS-861	56	477	421	0	3	5	0	0
SOS-861	56	219	163	1	3	1	1	1
SOS-861	56	112	56	1	3	1	0	3
SOS-861	57	477	420	0	3	4	0	1
SOS-861	57	477	420	0	3	4	0	0
SOS-861	57	95	38	1	3	1	2	2
SOS-861	57	120	63	1	3	1	1	0
SOS-861	57	60	3	1	3	1	2	0
SOS-862	58	281	223	1	3	1	3	1
SOS-862	58	477	419	0	3	4	0	2
SOS-862	58	477	419	0	3	4	0	0
SOS-862	58	331	273	1	1	1	0	1
SOS-862	59	95	36	1	1	1	2	2
SOS-862	59	477	418	0	3	4	0	0
SOS-862	60	182	122	1	3	1	4	4
SOS-862	60	477	417	0	3	4	0	1
SOS-862	60	477	417	0	3	4	0	0
SOS-862	60	61	1	1	3	3	0	0
SOS-863	60	127	67	1	3	1	1	0
SOS-863	60	63	3	1	2	1	2	1
SOS-863	60	477	417	0	3	3	0	1
SOS-863	61	477	416	0	3	3	0	1
SOS-863	62	477	415	0	3	3	0	0
SOS-863	63	77	14	1	3	1	0	2
SOS-863	63	477	414	0	3	4	0	1
SOS-863	63	477	414	0	4	4	0	0
SOS-863	63	477	414	0	3	4	0	1
SOS-863	63	477	414	0	3	4	0	1
SOS-864	64	71	7	1	3	4	1	1
SOS-864	64	74	10	1	3	1	2	0
SOS-864	64	65	1	1	3	1	1	0
SOS-864	64	65	1	1	3	1	1	0
SOS-864	64	65	1	1	3	1	1	0
SOS-864	65	477	412	0	3	5	0	0
SOS-864	65	68	3	1	3	1	2	0
SOS-864	66	84	18	1	3	1	1	0
SOS-864	66	477	411	0	4	4	0	0
SOS-864	67	123	56	1	1	5	1	2
SOS-865	67	102	35	1	1	3	1	0
SOS-865	67	74	7	1	3	1	3	0
SOS-865	67	477	410	0	3	3	0	0
SOS-865	67	102	35	1	1	3	1	0
SOS-865	67	74	7	1	2	1	1	0
SOS-865	67	477	410	0	3	1	0	0
SOS-865	67	72	5	1	3	4	1	0
SOS-865	67	73	6	1	3	3	1	0
SOS-865	67	77	10	1	3	4	1	1
SOS-865	67	77	10	1	4	1	1	0
SOS-866	68	477	409	0	3	1	0	0
SOS-866	69	477	408	0	3	1	0	0
SOS-866	70	477	407	0	3	1	0	1
SOS-866	70	477	407	0	3	4	0	0
SOS-866	70	71	1	1	3	1	1	0
SOS-866	70	477	407	0	3	4	0	0
SOS-866	71	477	406	0	3	1	0	0
SOS-866	71	477	406	0	4	4	0	0
SOS-866	71	178	107	1	3	5	1	4
SOS-867	71	142	71	1	3	3	1	2
SOS-867	71	178	107	1	3	3	1	0
SOS-867	71	178	107	1	3	3	1	0
SOS-867	72	121	49	1	3	3	1	2
SOS-867	72	142	70	1	3	3	1	0
SOS-867	72	121	49	1	3	3	1	4
SOS-867	72	121	49	1	3	3	1	3
SOS-867	73	74	1	1	3	1	0	0
SOS-867	73	79	6	1	3	3	1	1
SOS-867	73	477	404	0	2	1	0	1
SOS-868	74	163	89	1	3	4	1	0
SOS-868	74	142	68	1	3	3	1	1
SOS-868	74	121	47	1	3	3	0	4
SOS-868	75	121	46	1	1	3	1	1
SOS-868	75	121	46	1	1	3	1	1
SOS-868	75	121	46	1	1	3	1	1
SOS-868	77	192	115	1	3	1	1	1
SOS-868	77	127	50	1	3	1	1	1
SOS-868	77	477	400	0	3	1	0	1
SOS-868	77	477	400	0	3	4	0	1
SOS-869	77	477	400	0	4	1	0	0
SOS-869	77	78	1	1	4	1	1	0
SOS-869	77	121	44	1	1	3	1	1
SOS-869	77	267	190	1	3	3	0	1
SOS-869	77	477	400	0	3	1	0	1
SOS-869	77	477	400	0	3	4	0	0
SOS-869	77	477	400	0	3	4	0	0
SOS-869	77	79	2	1	3	3	1	0
SOS-869	77	110	33	1	1	3	1	1
SOS-869	78	477	399	0	4	1	0	0
SOS-870	78	477	399	0	3	5	0	0
SOS-870	78	477	399	0	3	1	0	0
SOS-870	79	87	8	1	3	4	1	1
SOS-870	79	333	254	1	1	1	0	2
SOS-870	79	477	398	0	3	1	0	0
SOS-870	79	218	139	1	3	5	1	0
SOS-870	79	100	21	1	3	3	1	0
SOS-870	79	477	398	0	3	1	0	0
SOS-870	79	477	398	0	3	1	0	0
SOS-870	79	477	398	0	3	1	0	0
SOS-871	79	100	21	1	3	3	1	0
SOS-871	79	84	5	1	3	1	1	0
SOS-871	79	144	65	1	3	3	1	0
SOS-871	79	144	65	1	3	3	1	0
SOS-871	79	144	65	1	3	3	1	0
SOS-871	79	277	198	1	4	4	0	2
SOS-871	79	477	398	0	3	1	0	1
SOS-871	80	102	22	1	1	3	1	0
SOS-871	80	477	397	0	3	4	0	0
SOS-871	80	87	7	1	3	1	1	0
SOS-872	80	477	397	0	3	1	0	0
SOS-872	80	477	397	0	3	1	0	0
SOS-872	80	477	397	0	3	1	0	0
SOS-872	80	477	397	0	3	1	0	2
SOS-872	80	110	30	1	1	1	1	2
SOS-872	80	122	42	1	3	4	1	0
SOS-872	81	477	396	0	3	1	0	0
SOS-872	81	477	396	0	3	1	0	0
SOS-872	81	86	5	1	3	4	1	0
SOS-872	81	477	396	0	3	1	0	2
SOS-873	84	477	393	0	3	1	0	0
SOS-873	85	477	392	0	3	1	0	1
SOS-873	85	218	133	1	3	3	1	4
SOS-873	85	86	1	1	3	1	1	1
SOS-873	85	144	59	1	3	3	1	0
SOS-873	85	121	36	1	3	3	1	2
SOS-873	85	144	59	1	3	3	1	0
SOS-873	85	144	59	1	3	3	1	0
SOS-873	85	134	49	1	3	3	0	0
SOS-873	85	134	49	1	3	3	0	0
SOS-874	85	144	59	1	3	5	1	0
SOS-874	85	95	10	1	3	1	2	0
SOS-874	85	87	2	1	1	1	2	1
SOS-874	86	477	391	0	3	5	0	0
SOS-874	86	87	1	1	3	1	0	1
SOS-874	86	477	391	0	3	4	0	0
SOS-874	86	99	13	1	4	4	0	0
SOS-874	86	123	37	1	1	3	1	0
SOS-874	86	123	37	1	1	3	1	0
SOS-874	87	88	1	1	4	1	1	1
SOS-875	88	123	35	1	2	1	1	0
SOS-875	89	477	388	0	3	5	0	0
SOS-875	89	477	388	0	3	4	0	1
SOS-875	89	477	388	0	3	4	0	0
SOS-875	90	99	9	1	3	1	0	1
SOS-875	91	477	386	0	3	4	0	0
SOS-875	92	477	385	0	3	1	0	0
SOS-875	92	477	385	0	3	3	0	1
SOS-875	93	477	384	0	3	5	0	0
SOS-875	93	477	384	0	4	3	0	0
SOS-876	93	477	384	0	3	3	0	1
SOS-876	94	101	7	1	3	1	1	1
SOS-876	95	477	382	0	3	1	0	0
SOS-876	95	477	382	0	3	4	0	0
SOS-876	95	477	382	0	3	3	0	1
SOS-876	96	477	381	0	3	3	0	1
SOS-876	98	477	379	0	4	4	0	0
SOS-876	98	477	379	0	3	5	0	0
SOS-876	98	477	379	0	3	4	0	1
SOS-876	99	477	378	0	2	1	0	0
SOS-877	99	246	147	1	3	3	1	2
SOS-877	99	477	378	0	3	4	0	0
SOS-877	99	106	7	1	3	4	1	0
SOS-877	100	477	377	0	3	1	0	1
SOS-877	100	128	28	1	3	3	1	1
SOS-877	100	477	377	0	3	4	0	0
SOS-877	100	477	377	0	3	3	0	1
SOS-877	101	102	1	1	1	3	1	0
SOS-877	101	477	376	0	4	1	0	1
SOS-877	101	340	239	1	4	4	0	0
SOS-878	101	477	376	0	4	4	0	0
SOS-878	101	112	11	1	3	1	1	0
SOS-878	101	374	273	1	2	1	1	0
SOS-878	101	380	279	1	2	1	1	0
SOS-878	101	127	26	1	1	1	1	0
SOS-878	102	477	375	0	3	5	0	0
SOS-878	102	130	28	1	3	1	4	0
SOS-878	103	107	4	1	1	1	2	0
SOS-878	103	137	34	1	4	4	1	0
SOS-878	103	477	374	0	3	4	0	0
SOS-879	105	477	372	0	4	4	0	0
SOS-879	105	477	372	0	3	4	0	0
SOS-879	105	144	39	1	3	4	1	2
SOS-879	106	123	17	1	3	4	1	0
SOS-879	106	157	51	1	1	3	1	0
SOS-879	106	458	352	1	3	3	0	0
SOS-879	106	477	371	0	4	1	0	0
SOS-879	106	346	240	1	3	1	1	0
SOS-879	106	128	22	1	2	4	1	0
SOS-879	106	128	22	1	3	3	0	0
SOS-880	107	477	370	0	3	3	0	0
SOS-880	107	108	1	1	3	4	1	0
SOS-880	107	477	370	0	3	4	0	1
SOS-880	107	477	370	0	2	1	0	1
SOS-880	108	109	1	1	3	1	1	0
SOS-880	108	477	369	0	3	1	0	0
SOS-880	108	477	369	0	3	3	0	1
SOS-880	108	477	369	0	3	1	0	1
SOS-880	108	477	369	0	3	1	0	1
SOS-880	109	415	306	1	3	3	0	0
SOS-881	109	423	314	1	3	3	1	1
SOS-881	109	477	368	0	3	3	0	0
SOS-881	109	477	368	0	3	3	0	0
SOS-881	109	423	314	1	3	3	1	0
SOS-881	109	226	117	1	3	3	1	0
SOS-881	109	477	368	0	3	1	0	0
SOS-881	109	477	368	0	3	4	0	0
SOS-881	110	477	367	0	3	3	0	0
SOS-881	112	113	1	1	3	1	1	1
SOS-881	112	113	1	1	4	3	1	0
SOS-882	112	477	365	0	3	1	0	0
SOS-882	112	126	14	1	3	3	0	0
SOS-882	112	477	365	0	4	1	0	0
SOS-882	112	477	365	0	3	5	0	0
SOS-882	112	477	365	0	3	1	0	0
SOS-882	113	193	80	1	3	3	1	0
SOS-882	113	477	364	0	3	3	0	2
SOS-882	113	477	364	0	3	3	0	2
SOS-882	113	477	364	0	3	1	0	2
SOS-882	113	144	31	1	3	4	1	0
SOS-883	113	162	49	1	1	1	4	2
SOS-883	113	477	364	0	3	1	0	0
SOS-883	113	477	364	0	3	1	0	0
SOS-883	113	121	8	1	3	3	1	0
SOS-883	114	116	2	1	1	1	2	1
SOS-883	114	400	286	1	4	1	1	0
SOS-883	114	136	22	1	3	1	1	0
SOS-883	114	151	37	1	3	3	1	0
SOS-883	114	189	75	1	3	1	1	1
SOS-883	114	477	363	0	3	1	0	1
SOS-884	114	477	363	0	2	1	0	1
SOS-884	115	352	237	1	3	1	0	0
SOS-884	115	213	98	1	2	5	1	1
SOS-884	115	212	97	1	3	3	1	0
SOS-884	115	212	97	1	3	3	1	0
SOS-884	115	212	97	1	3	3	1	0
SOS-884	115	212	97	1	3	3	1	1
SOS-884	115	212	97	1	3	3	1	1
SOS-884	115	212	97	1	3	3	1	0
SOS-884	115	212	97	1	3	3	1	0
SOS-885	115	477	362	0	3	1	0	2
SOS-885	115	116	1	1	3	4	1	1
SOS-885	116	477	361	0	3	1	0	2
SOS-885	116	417	301	1	3	4	0	0
SOS-885	119	246	127	1	4	1	0	1
SOS-885	119	477	358	0	3	1	0	0
SOS-885	120	477	357	0	3	1	0	0
SOS-885	120	135	15	1	3	1	1	0
SOS-885	120	477	357	0	4	1	0	0
SOS-885	121	477	356	0	4	3	0	0
SOS-886	121	477	356	0	4	3	0	0
SOS-886	121	477	356	0	3	3	0	1
SOS-886	121	477	356	0	4	3	0	0
SOS-886	121	477	356	0	4	3	0	0
SOS-886	121	477	356	0	3	3	0	0
SOS-886	121	122	1	1	3	1	1	0
SOS-886	121	122	1	1	4	1	1	0
SOS-886	121	477	356	0	3	1	0	0
SOS-886	121	122	1	1	3	1	1	0
SOS-886	121	477	356	0	4	4	0	0
SOS-887	121	123	2	1	1	1	1	0
SOS-887	121	171	50	1	3	1	4	0
SOS-887	122	234	112	1	3	1	1	0
SOS-887	122	198	76	1	3	1	1	0
SOS-887	122	123	1	1	3	1	1	0
SOS-887	122	165	43	1	3	1	1	2
SOS-887	122	126	4	1	3	1	3	1
SOS-887	122	477	355	0	3	1	0	1
SOS-887	123	477	354	0	3	5	0	0
SOS-887	123	477	354	0	3	1	0	1
SOS-888	123	429	306	1	3	4	3	0
SOS-888	123	126	3	1	3	1	3	1
SOS-888	123	477	354	0	3	5	0	0
SOS-888	123	144	21	1	3	3	0	0
SOS-888	123	130	7	1	3	1	1	0
SOS-888	126	127	1	1	3	4	3	0
SOS-888	126	477	351	0	3	1	0	0
SOS-888	126	411	285	1	3	1	4	2
SOS-888	126	477	351	0	3	4	0	2
SOS-888	126	477	351	0	3	4	0	1
SOS-889	126	477	351	0	3	4	0	0
SOS-889	127	477	350	0	3	1	0	0
SOS-889	127	128	1	1	3	1	1	0
SOS-889	127	477	350	0	3	1	0	0
SOS-889	127	144	17	1	3	3	0	0
SOS-889	127	477	350	0	3	1	0	1
SOS-889	128	477	349	0	3	1	0	0
SOS-889	128	134	6	1	3	1	1	0
SOS-889	128	477	349	0	3	3	0	0
SOS-889	129	477	348	0	3	3	0	0
SOS-890	129	477	348	0	3	4	0	0
SOS-890	129	477	348	0	3	4	0	0
SOS-890	129	477	348	0	3	1	0	0
SOS-890	129	196	67	1	3	3	1	0
SOS-890	130	134	4	1	1	1	3	0
SOS-890	130	477	347	0	3	1	0	0
SOS-890	130	131	1	1	3	1	3	0
SOS-890	130	294	164	1	3	1	4	4
SOS-890	130	140	10	1	3	4	1	1
SOS-890	130	477	347	0	3	3	0	0
SOS-891	133	141	8	1	3	3	0	0
SOS-891	133	212	79	1	3	4	1	0
SOS-891	133	183	50	1	3	3	1	1
SOS-891	133	175	42	1	3	1	1	2
SOS-891	133	477	344	0	3	5	0	2
SOS-891	133	192	59	1	4	1	0	1
SOS-891	134	212	78	1	3	5	1	0
SOS-891	134	175	41	1	3	1	4	2
SOS-891	134	477	343	0	3	4	0	0
SOS-891	135	212	77	1	3	4	1	1
SOS-892	135	136	1	1	3	4	1	0
SOS-892	135	245	110	1	3	1	4	1
SOS-892	135	477	342	0	3	5	0	1
SOS-892	135	477	342	0	3	3	0	0
SOS-892	135	158	23	1	3	4	1	0
SOS-892	135	477	342	0	3	4	0	1
SOS-892	135	253	118	1	3	1	1	0
SOS-892	135	477	342	0	3	1	0	0
SOS-892	135	415	280	1	2	4	0	0
SOS-892	136	477	341	0	3	4	0	0
SOS-893	136	477	341	0	3	1	0	0
SOS-893	136	140	4	1	3	3	1	0
SOS-893	136	141	5	1	3	1	1	0
SOS-893	137	477	340	0	4	4	0	0
SOS-893	137	149	12	1	3	3	4	0
SOS-893	137	171	34	1	3	1	4	4
SOS-893	138	171	33	1	3	3	4	2
SOS-893	138	477	339	0	3	3	0	0
SOS-893	138	477	339	0	3	4	0	1
SOS-893	138	477	339	0	3	5	0	2
SOS-894	138	212	74	1	3	3	1	0
SOS-894	138	477	339	0	3	3	0	0
SOS-894	141	154	13	1	3	3	4	0
SOS-894	141	151	10	1	3	3	1	0
SOS-894	142	477	335	0	3	3	0	0
SOS-894	142	150	8	1	2	1	4	2
SOS-894	142	477	335	0	2	1	0	1
SOS-894	143	151	8	1	3	4	3	0
SOS-894	143	477	334	0	4	4	0	0
SOS-894	143	477	334	0	3	1	0	2
SOS-895	143	408	265	1	4	1	0	0
SOS-895	143	477	334	0	3	1	0	0
SOS-895	143	144	1	1	3	1	4	1
SOS-895	144	477	333	0	3	1	0	0
SOS-895	144	145	1	1	3	1	1	0
SOS-895	144	196	52	1	3	4	1	0
SOS-895	144	477	333	0	3	1	0	0
SOS-895	144	253	109	1	3	3	1	0
SOS-895	145	149	4	1	3	1	1	1
SOS-895	146	477	331	0	4	4	0	0
SOS-896	147	477	330	0	3	1	0	0
SOS-896	147	148	1	1	4	3	1	0
SOS-896	147	477	330	0	3	1	0	0
SOS-896	147	148	1	1	3	1	4	0
SOS-896	149	477	328	0	3	4	0	1
SOS-896	149	477	328	0	3	3	0	0
SOS-896	149	477	328	0	3	1	0	1
SOS-896	149	477	328	0	3	3	0	0
SOS-896	149	477	328	0	3	1	0	1
SOS-896	150	477	327	0	3	1	0	0
SOS-897	150	151	1	1	1	1	1	0
SOS-897	150	151	1	1	3	3	0	1
SOS-897	150	459	309	1	1	1	0	1
SOS-897	151	477	326	0	3	5	0	0
SOS-897	154	477	323	0	4	4	0	0
SOS-897	154	323	169	1	3	3	1	0
SOS-897	154	477	323	0	3	1	0	1
SOS-897	155	156	1	1	5	1	1	0
SOS-897	155	274	119	1	3	1	4	0
SOS-897	155	162	7	1	3	1	1	0
SOS-898	155	158	3	1	3	1	4	0
SOS-898	156	477	321	0	3	1	0	1
SOS-898	156	477	321	0	4	4	0	0
SOS-898	156	477	321	0	3	1	0	0
SOS-898	156	477	321	0	3	5	0	2
SOS-898	157	164	7	1	3	1	1	0
SOS-898	162	171	9	1	3	4	4	0
SOS-898	162	190	28	1	1	1	4	1
SOS-898	163	477	314	0	4	5	0	2
SOS-898	163	180	17	1	4	4	1	0
SOS-899	164	211	47	1	1	3	1	0
SOS-899	164	182	18	1	3	3	0	0
SOS-899	164	477	313	0	3	3	0	0
SOS-899	164	477	313	0	3	1	0	1
SOS-899	164	477	313	0	4	4	0	2
SOS-899	164	193	29	1	3	3	1	2
SOS-899	164	477	313	0	3	1	0	0
SOS-899	165	218	53	1	3	3	1	1
SOS-899	165	176	11	1	1	4	1	0
SOS-899	165	279	114	1	3	4	1	0
SOS-900	165	232	67	1	3	1	1	1
SOS-900	165	477	312	0	4	3	0	0
SOS-900	165	166	1	1	4	3	2	0
SOS-900	165	477	312	0	3	3	0	4
SOS-900	166	477	311	0	3	3	0	3
SOS-900	168	477	309	0	3	1	0	0
SOS-900	168	477	309	0	2	1	0	1
SOS-900	169	204	35	1	4	1	1	0
SOS-900	169	171	2	1	1	1	1	0
SOS-900	169	417	248	1	3	3	1	0
SOS-901	170	193	23	1	1	1	1	0
SOS-901	170	477	307	0	4	1	0	0
SOS-901	170	477	307	0	3	1	0	0
SOS-901	170	203	33	1	3	5	1	0
SOS-901	170	177	7	1	3	1	1	0
SOS-901	171	193	22	1	3	4	1	0
SOS-901	171	477	306	0	3	3	0	0
SOS-901	171	346	175	1	4	3	0	0
SOS-901	171	477	306	0	4	1	0	0
SOS-901	172	477	305	0	3	4	0	0
SOS-902	172	211	39	1	3	5	1	0
SOS-902	172	477	305	0	4	3	0	1
SOS-902	172	336	164	1	1	1	1	1
SOS-902	173	477	304	0	3	3	0	0
SOS-902	173	184	11	1	1	1	2	2
SOS-902	174	176	2	1	1	1	2	0
SOS-902	175	477	302	0	3	4	0	0
SOS-902	175	177	2	1	3	1	1	0
SOS-902	176	477	301	0	3	4	0	1
SOS-902	176	392	216	1	3	5	1	1
SOS-903	176	477	301	0	3	3	0	0
SOS-903	177	477	300	0	3	1	0	0
SOS-903	178	392	214	1	3	3	1	0
SOS-903	178	392	214	1	3	3	1	0
SOS-903	178	392	214	1	3	3	1	0
SOS-903	178	392	214	1	3	3	1	0
SOS-903	178	392	214	1	3	5	1	0
SOS-903	178	179	1	1	3	1	1	0
SOS-903	178	179	1	1	2	1	1	0
SOS-903	179	182	3	1	3	1	1	0
SOS-904	180	477	297	0	4	3	0	1
SOS-904	180	477	297	0	3	3	0	3
SOS-904	180	477	297	0	4	4	0	1
SOS-904	180	183	3	1	3	3	1	1
SOS-904	182	477	295	0	3	1	0	1
SOS-904	182	477	295	0	3	1	0	0
SOS-904	182	477	295	0	4	4	0	0
SOS-904	182	477	295	0	3	1	0	0
SOS-904	182	477	295	0	3	4	0	0
SOS-904	183	184	1	1	4	1	4	1
SOS-905	183	477	294	0	3	1	0	0
SOS-905	184	197	13	1	4	1	1	1
SOS-905	185	477	292	0	3	1	0	0
SOS-905	186	477	291	0	2	1	0	0
SOS-905	186	477	291	0	3	1	0	1
SOS-905	186	197	11	1	3	4	1	0
SOS-905	188	277	89	1	4	1	1	0
SOS-905	188	195	7	1	3	1	0	0
SOS-905	189	190	1	1	4	1	0	0
SOS-905	189	477	288	0	3	3	0	0
SOS-906	190	207	17	1	3	1	1	1
SOS-906	190	193	3	1	3	3	1	1
SOS-906	190	191	1	1	3	4	1	0
SOS-906	190	205	15	1	3	3	1	0
SOS-906	191	477	286	0	3	1	0	0
SOS-907	191	200	9	1	3	3	1	0
SOS-907	191	477	286	0	2	3	0	0
SOS-907	192	477	285	0	3	3	0	3
SOS-907	193	194	1	1	3	1	1	0
SOS-907	193	245	52	1	4	1	1	0
SOS-907	193	194	1	1	3	1	1	0
SOS-907	196	477	281	0	3	1	0	0
SOS-907	196	477	281	0	3	1	0	0
SOS-907	196	477	281	0	3	1	0	0
SOS-907	196	298	102	1	3	1	1	0
SOS-908	196	477	281	0	3	1	0	0
SOS-908	197	231	34	1	3	4	1	1
SOS-908	197	477	280	0	3	3	0	0
SOS-908	197	477	280	0	3	1	0	2
SOS-908	197	477	280	0	3	3	0	1
SOS-908	198	477	279	0	3	1	0	0
SOS-908	198	207	9	1	3	4	1	0
SOS-908	198	477	279	0	3	5	0	0
SOS-908	198	199	1	1	3	4	3	0
SOS-908	198	429	231	1	3	1	1	1
SOS-909	198	477	279	0	3	1	0	0
SOS-909	198	477	279	0	3	1	0	0
SOS-909	199	205	6	1	3	4	1	3
SOS-909	199	477	278	0	4	3	0	0
SOS-909	199	205	6	1	3	1	1	0
SOS-909	199	477	278	0	3	4	0	0
SOS-909	199	477	278	0	3	4	0	0
SOS-909	199	477	278	0	3	1	0	0
SOS-909	199	477	278	0	4	4	0	0
SOS-909	200	338	138	1	3	3	1	0
SOS-910	200	477	277	0	3	1	0	0
SOS-910	200	477	277	0	3	5	0	0
SOS-910	200	477	277	0	4	3	0	0
SOS-910	200	477	277	0	3	4	0	0
SOS-910	200	206	6	1	3	4	1	0
SOS-910	203	392	189	1	3	3	1	0
SOS-910	203	392	189	1	3	3	1	0
SOS-910	203	477	274	0	3	1	0	0
SOS-910	204	477	273	0	3	1	0	0
SOS-910	204	477	273	0	3	1	0	0
SOS-911	204	218	14	1	3	4	1	0
SOS-911	204	477	273	0	4	1	0	0
SOS-911	205	246	41	1	3	1	1	0
SOS-911	205	477	272	0	3	4	0	2
SOS-911	206	207	1	1	3	1	1	2
SOS-911	207	210	3	1	3	1	1	2
SOS-911	207	231	24	1	2	1	3	0
SOS-911	207	477	270	0	3	3	0	1
SOS-911	207	208	1	1	3	3	0	0
SOS-911	210	477	267	0	3	3	0	0
SOS-912	210	281	71	1	3	4	0	0
SOS-912	211	477	266	0	3	3	0	0
SOS-912	211	222	11	1	1	4	1	2
SOS-912	211	477	266	0	2	4	0	0
SOS-912	211	380	169	1	3	1	1	0
SOS-912	212	214	2	1	3	1	4	0
SOS-912	212	477	265	0	3	4	0	0
SOS-912	213	218	5	1	3	1	4	0
SOS-912	213	477	264	0	3	5	0	0
SOS-912	213	214	1	1	3	4	1	0
SOS-913	213	389	176	1	3	1	1	1
SOS-913	214	260	46	1	1	1	4	1
SOS-913	214	477	263	0	3	4	0	0
SOS-913	214	236	22	1	3	4	1	0
SOS-913	214	218	4	1	3	1	0	0
SOS-913	214	477	263	0	3	1	0	0
SOS-913	214	477	263	0	3	1	0	0
SOS-913	217	218	1	1	1	1	1	0
SOS-913	217	477	260	0	4	1	0	0
SOS-913	218	477	259	0	3	4	0	4
SOS-914	218	477	259	0	3	4	0	0
SOS-914	219	477	258	0	3	4	0	0
SOS-914	220	226	6	1	3	1	3	0
SOS-914	220	410	190	1	3	1	1	0
SOS-914	220	226	6	1	1	1	4	3
SOS-914	220	226	6	1	1	1	4	3
SOS-914	220	227	7	1	1	1	4	3
SOS-914	221	227	6	1	1	1	4	3
SOS-914	221	222	1	1	3	3	1	0
SOS-914	221	222	1	1	1	1	1	0
SOS-915	221	222	1	1	3	1	0	1
SOS-915	221	255	34	1	2	1	4	3
SOS-915	221	311	90	1	3	1	2	2
SOS-915	225	226	1	1	1	1	0	0
SOS-915	225	231	6	1	3	1	1	0
SOS-915	226	477	251	0	4	4	0	0
SOS-915	226	228	2	1	3	1	1	0
SOS-915	227	373	146	1	1	1	0	0
SOS-915	227	248	21	1	3	4	1	2
SOS-915	227	477	250	0	3	3	0	2
SOS-916	227	228	1	1	3	1	1	0
SOS-916	227	477	250	0	3	1	0	0
SOS-916	228	240	12	1	3	1	0	1
SOS-916	228	229	1	1	3	1	1	0
SOS-916	228	311	83	1	3	1	2	2
SOS-916	228	477	249	0	3	1	0	0
SOS-916	228	234	6	1	3	4	0	1
SOS-916	228	277	49	1	3	4	0	2
SOS-916	231	246	15	1	3	1	1	0
SOS-916	232	233	1	1	2	1	0	1
SOS-917	232	233	1	1	3	1	4	0
SOS-917	232	233	1	1	1	1	1	0
SOS-917	232	289	57	1	3	1	1	0
SOS-917	232	477	245	0	3	4	0	0
SOS-917	232	477	245	0	3	1	0	0
SOS-917	232	477	245	0	3	1	0	1
SOS-917	233	294	61	1	3	5	0	0
SOS-917	233	235	2	1	1	1	1	1
SOS-917	233	477	244	0	4	4	0	0
SOS-917	234	245	11	1	4	1	1	0
SOS-918	234	477	243	0	2	1	0	1
SOS-918	234	477	243	0	3	5	0	0
SOS-918	235	477	242	0	3	4	0	2
SOS-918	235	477	242	0	4	1	0	0
SOS-918	238	477	239	0	3	4	0	0
SOS-918	238	239	1	1	3	1	1	0
SOS-918	238	242	4	1	4	1	1	0
SOS-918	239	256	17	1	3	1	1	0
SOS-918	239	477	238	0	3	3	0	2
SOS-918	240	477	237	0	3	4	0	3
SOS-919	240	241	1	1	3	1	1	0
SOS-919	240	477	237	0	3	1	0	1
SOS-919	240	241	1	1	3	1	0	0
SOS-919	241	242	1	1	1	1	2	0
SOS-919	241	248	7	1	3	4	1	1
SOS-919	241	477	236	0	3	4	0	0
SOS-919	241	243	2	1	1	1	4	0
SOS-919	242	477	235	0	3	4	0	0
SOS-919	242	477	235	0	3	1	0	1
SOS-919	242	477	235	0	4	1	0	1
SOS-920	242	477	235	0	4	1	0	0
SOS-920	242	395	153	1	2	5	0	1
SOS-920	244	477	233	0	4	4	0	0
SOS-920	244	477	233	0	4	1	0	0
SOS-920	245	248	3	1	3	1	0	0
SOS-920	245	477	232	0	3	1	0	0
SOS-920	246	477	231	0	3	4	0	0
SOS-920	246	247	1	1	3	1	0	0
SOS-920	246	477	231	0	3	1	0	0
SOS-920	247	477	230	0	3	4	0	1
SOS-921	247	394	147	1	3	1	4	0
SOS-921	248	458	210	1	3	5	1	0
SOS-921	248	254	6	1	3	1	1	1
SOS-921	248	249	1	1	3	4	1	0
SOS-921	249	263	14	1	3	1	1	0
SOS-921	249	477	228	0	3	1	0	3
SOS-921	249	477	228	0	3	1	0	1
SOS-921	249	302	53	1	3	1	1	0
SOS-921	249	477	228	0	3	1	0	0
SOS-921	249	477	228	0	3	1	0	0
SOS-922	249	477	228	0	3	4	0	0
SOS-922	250	299	49	1	3	1	0	2
SOS-922	251	276	25	1	4	1	1	0
SOS-922	252	388	136	1	2	4	1	2
SOS-922	252	374	122	1	3	4	1	0
SOS-922	252	255	3	1	3	1	1	1
SOS-922	252	477	225	0	4	4	0	1
SOS-922	254	477	223	0	3	1	0	0
SOS-922	254	264	10	1	1	1	2	1
SOS-922	255	256	1	1	4	3	1	0
SOS-923	255	477	222	0	3	1	0	0
SOS-923	255	272	17	1	3	1	4	0
SOS-923	256	257	1	1	1	1	1	0
SOS-923	256	477	221	0	4	1	0	0
SOS-923	257	477	220	0	3	4	0	1
SOS-923	257	477	220	0	3	4	0	2
SOS-923	257	477	220	0	3	4	0	2
SOS-923	257	477	220	0	3	4	0	1
SOS-923	258	268	10	1	3	1	0	1
SOS-923	259	269	10	1	2	4	2	0
SOS-924	259	260	1	1	3	1	1	0
SOS-924	260	477	217	0	4	4	0	0
SOS-924	260	477	217	0	3	1	0	0
SOS-924	260	477	217	0	3	4	0	0
SOS-924	261	477	216	0	3	1	0	0
SOS-924	261	477	216	0	3	1	0	0
SOS-924	262	477	215	0	3	1	0	0
SOS-924	263	477	214	0	4	1	0	0
SOS-924	263	477	214	0	4	5	0	0
SOS-924	263	269	6	1	2	4	2	1
SOS-925	263	477	214	0	3	4	0	0
SOS-925	263	477	214	0	3	4	0	0
SOS-925	265	477	212	0	3	4	0	0
SOS-925	266	282	16	1	2	1	1	0
SOS-925	267	477	210	0	2	4	0	3
SOS-925	267	269	2	1	3	4	2	1
SOS-925	267	268	1	1	3	1	0	1
SOS-925	267	477	210	0	3	1	0	0
SOS-925	268	347	79	1	2	4	1	3
SOS-925	268	477	209	0	3	1	0	0
SOS-926	268	477	209	0	3	1	0	0
SOS-926	268	477	209	0	3	1	0	0
SOS-926	268	477	209	0	3	1	0	1
SOS-926	268	477	209	0	3	1	0	0
SOS-926	268	477	209	0	3	1	0	0
SOS-926	268	276	8	1	3	3	1	1
SOS-926	268	344	76	1	4	1	2	1
SOS-926	268	269	1	1	3	1	3	1
SOS-926	268	290	22	1	3	1	0	2
SOS-926	268	477	209	0	3	1	0	0
SOS-927	269	280	11	1	4	3	1	0
SOS-927	269	477	208	0	3	1	0	0
SOS-927	269	457	188	1	3	1	0	0
SOS-927	269	477	208	0	3	1	0	0
SOS-927	269	277	8	1	3	1	3	0
SOS-927	269	332	63	1	1	4	2	1
SOS-927	270	477	207	0	3	1	0	0
SOS-927	270	477	207	0	3	1	0	0
SOS-927	270	344	74	1	3	3	1	1
SOS-927	270	284	14	1	1	1	4	2
SOS-928	273	477	204	0	3	4	0	0
SOS-928	273	303	30	1	1	1	2	1
SOS-928	273	477	204	0	3	1	0	2
SOS-928	274	289	15	1	1	1	4	2
SOS-928	274	477	203	0	4	5	0	0
SOS-928	274	477	203	0	3	1	0	0
SOS-928	274	477	203	0	3	1	0	0
SOS-928	274	477	203	0	4	1	0	0
SOS-928	274	477	203	0	3	4	0	0
SOS-928	275	477	202	0	4	5	0	0
SOS-929	276	281	5	1	3	1	0	0
SOS-929	276	477	201	0	3	1	0	0
SOS-929	276	449	173	1	3	4	1	0
SOS-929	276	338	62	1	3	1	2	1
SOS-929	276	477	201	0	3	5	0	0
SOS-929	277	280	3	1	3	1	2	0
SOS-929	277	458	181	1	4	3	0	0
SOS-929	277	477	200	0	3	4	0	1
SOS-929	279	477	198	0	3	5	0	2
SOS-929	280	477	197	0	3	1	0	1
SOS-930	280	287	7	1	3	1	1	0
SOS-930	280	297	17	1	3	4	1	0
SOS-930	281	291	10	1	3	1	1	0
SOS-930	281	477	196	0	3	4	0	1
SOS-930	281	282	1	1	3	1	1	0
SOS-930	282	300	18	1	2	4	4	1
SOS-930	282	477	195	0	2	1	0	0
SOS-930	283	477	194	0	3	4	0	1
SOS-930	283	284	1	1	2	1	4	1
SOS-930	283	477	194	0	3	1	0	2
SOS-931	283	477	194	0	3	4	0	2
SOS-931	283	477	194	0	3	5	0	0
SOS-931	284	324	40	1	3	1	0	1
SOS-931	284	477	193	0	3	5	0	0
SOS-931	284	417	133	1	3	4	0	1
SOS-931	287	407	120	1	4	4	1	0
SOS-931	287	310	23	1	3	1	1	0
SOS-931	287	323	36	1	1	1	4	0
SOS-931	287	449	162	1	3	3	1	3
SOS-931	287	338	51	1	3	1	1	1
SOS-932	288	303	15	1	3	1	0	3
SOS-932	288	347	59	1	2	4	2	0
SOS-932	288	477	189	0	3	1	0	0
SOS-932	288	477	189	0	3	1	0	0
SOS-932	288	373	85	1	3	1	4	1
SOS-932	288	291	3	1	3	4	1	0
SOS-932	289	477	188	0	3	1	0	0
SOS-932	289	290	1	1	3	1	0	0
SOS-932	289	477	188	0	3	1	0	0
SOS-932	289	477	188	0	3	1	0	0
SOS-933	289	477	188	0	3	1	0	0
SOS-933	289	392	103	1	3	1	1	0
SOS-933	290	311	21	1	3	1	3	0
SOS-933	290	325	35	1	3	3	1	0
SOS-933	291	302	11	1	2	1	4	2
SOS-933	291	477	186	0	3	1	0	0
SOS-933	291	477	186	0	3	4	0	0
SOS-933	291	477	186	0	3	1	0	0
SOS-933	293	477	184	0	3	4	0	2
SOS-933	293	477	184	0	3	1	0	2
SOS-934	293	297	4	1	3	4	3	1
SOS-934	294	329	35	1	3	3	0	0
SOS-934	294	329	35	1	3	3	0	0
SOS-934	294	458	164	1	3	3	0	0
SOS-934	294	458	164	1	3	3	0	0
SOS-934	294	477	183	0	4	4	0	0
SOS-934	294	477	183	0	4	5	0	0
SOS-934	294	477	183	0	3	4	0	0
SOS-934	294	477	183	0	3	1	0	0
SOS-934	295	477	182	0	4	4	0	0
SOS-935	296	303	7	1	3	1	1	0
SOS-935	296	477	181	0	4	4	0	0
SOS-935	296	477	181	0	2	1	0	3
SOS-935	296	477	181	0	4	1	0	0
SOS-935	296	301	5	1	4	1	1	0
SOS-935	297	477	180	0	2	1	0	0
SOS-935	297	394	97	1	3	3	1	0
SOS-935	297	302	5	1	3	1	1	0
SOS-935	298	317	19	1	3	1	1	0
SOS-935	299	477	178	0	3	1	0	0
SOS-936	300	346	46	1	2	3	1	0
SOS-936	301	477	176	0	3	1	0	0
SOS-936	301	303	2	1	3	1	4	1
SOS-936	302	329	27	1	3	3	0	0
SOS-936	302	477	175	0	3	1	0	0
SOS-936	303	477	174	0	2	1	0	0
SOS-936	304	305	1	1	3	1	1	0
SOS-936	304	305	1	1	3	1	1	0
SOS-936	305	477	172	0	3	1	0	0
SOS-936	305	477	172	0	3	4	0	0
SOS-937	308	322	14	1	3	1	1	0
SOS-937	310	477	167	0	3	1	0	0
SOS-937	311	477	166	0	3	5	0	0
SOS-937	311	477	166	0	3	3	0	2
SOS-937	311	477	166	0	3	3	0	3
SOS-937	311	477	166	0	3	3	0	4
SOS-937	311	477	166	0	3	3	0	1
SOS-937	311	477	166	0	3	3	0	2
SOS-937	311	477	166	0	3	3	0	1
SOS-937	311	477	166	0	3	3	0	2
SOS-938	311	477	166	0	3	3	0	1
SOS-938	311	477	166	0	3	5	0	0
SOS-938	312	313	1	1	3	1	1	0
SOS-938	314	477	163	0	3	4	0	0
SOS-938	316	375	59	1	3	4	1	0
SOS-938	316	477	161	0	3	1	0	0
SOS-938	317	392	75	1	3	3	0	0
SOS-938	317	477	160	0	2	4	0	2
SOS-938	317	477	160	0	2	4	0	0
SOS-938	318	477	159	0	3	1	0	0
SOS-939	318	319	1	1	3	1	1	0
SOS-939	318	477	159	0	3	1	0	0
SOS-939	318	392	74	1	3	3	1	0
SOS-939	319	477	158	0	2	1	0	0
SOS-939	319	477	158	0	3	1	0	1
SOS-939	319	477	158	0	3	1	0	1
SOS-939	319	322	3	1	3	3	1	0
SOS-939	321	327	6	1	3	1	1	0
SOS-939	321	327	6	1	3	1	1	0
SOS-939	322	329	7	1	3	3	1	0
SOS-940	322	409	87	1	3	4	0	0
SOS-940	322	477	155	0	3	1	0	0
SOS-940	322	477	155	0	3	4	0	0
SOS-940	322	477	155	0	4	4	0	0
SOS-940	323	477	154	0	4	4	0	2
SOS-940	323	477	154	0	4	4	0	0
SOS-940	323	328	5	1	4	4	1	0
SOS-940	323	350	27	1	3	1	0	1
SOS-940	323	380	57	1	3	1	0	2
SOS-940	323	392	69	1	3	3	1	0
SOS-941	323	477	154	0	3	1	0	0
SOS-941	324	334	10	1	3	1	4	0
SOS-941	325	477	152	0	4	3	0	0
SOS-941	325	477	152	0	3	1	0	0
SOS-941	328	477	149	0	4	4	0	0
SOS-941	328	477	149	0	4	4	0	0
SOS-941	329	330	1	1	1	1	1	0
SOS-941	329	330	1	1	3	1	3	0
SOS-941	329	331	2	1	1	1	4	1
SOS-942	331	477	146	0	4	4	0	0
SOS-942	331	477	146	0	3	1	0	0
SOS-942	332	477	145	0	3	1	0	0
SOS-942	332	333	1	1	3	1	0	1
SOS-942	332	477	145	0	3	1	0	0
SOS-942	332	380	48	1	3	1	0	1
SOS-942	332	477	145	0	2	1	0	0
SOS-942	332	477	145	0	3	5	0	0
SOS-942	332	477	145	0	3	3	0	0
SOS-942	333	477	144	0	3	1	0	0
SOS-943	333	336	3	1	3	1	0	4
SOS-943	333	334	1	1	3	1	0	1
SOS-943	333	336	3	1	3	1	0	1
SOS-943	334	388	54	1	3	1	0	1
SOS-943	334	401	67	1	3	1	1	0
SOS-943	334	477	143	0	3	1	0	0
SOS-943	334	477	143	0	3	1	0	0
SOS-943	335	338	3	1	3	1	0	1
SOS-943	335	338	3	1	3	1	0	1
SOS-943	335	477	142	0	3	1	0	0
SOS-944	335	351	16	1	3	1	0	1
SOS-944	335	338	3	1	3	1	0	1
SOS-944	335	477	142	0	3	1	0	0
SOS-944	335	336	1	1	3	1	0	1
SOS-944	335	477	142	0	3	1	0	0
SOS-944	335	477	142	0	3	1	0	0
SOS-944	335	336	1	1	3	1	0	1
SOS-944	336	477	141	0	4	1	0	0
SOS-944	336	437	101	1	3	1	0	2
SOS-944	336	477	141	0	4	4	0	0
SOS-945	337	477	140	0	3	1	0	0
SOS-945	337	409	72	1	3	1	0	0
SOS-945	337	477	140	0	3	5	0	0
SOS-945	338	477	139	0	3	1	0	0
SOS-945	338	410	72	1	5	3	0	0
SOS-945	338	477	139	0	3	3	0	2
SOS-945	338	477	139	0	3	3	0	0
SOS-945	338	477	139	0	3	1	0	0
SOS-945	338	477	139	0	3	1	0	2
SOS-945	339	351	12	1	3	1	1	0
SOS-946	340	477	137	0	3	1	0	3
SOS-946	340	477	137	0	3	1	0	0
SOS-946	340	344	4	1	1	1	1	1
SOS-946	342	477	135	0	3	1	0	1
SOS-946	342	477	135	0	3	1	0	1
SOS-946	344	477	133	0	3	1	0	0
SOS-946	344	477	133	0	3	1	0	0
SOS-946	344	477	133	0	3	1	0	1
SOS-946	344	477	133	0	3	1	0	0
SOS-946	344	353	9	1	3	1	1	1
SOS-947	344	477	133	0	3	1	0	0
SOS-947	344	394	50	1	3	3	1	0
SOS-947	344	394	50	1	3	3	1	2
SOS-947	344	408	64	1	3	3	1	1
SOS-947	345	351	6	1	1	1	2	0
SOS-947	346	477	131	0	3	1	0	0
SOS-947	346	477	131	0	3	1	0	0
SOS-947	346	400	54	1	3	3	1	1
SOS-947	347	477	130	0	3	1	0	1
SOS-947	347	351	4	1	3	1	2	0
SOS-948	347	353	6	1	1	1	4	0
SOS-948	350	477	127	0	3	1	0	0
SOS-948	350	477	127	0	3	1	0	1
SOS-948	350	477	127	0	3	1	0	3
SOS-948	350	477	127	0	3	1	0	1
SOS-948	351	477	126	0	3	3	0	0
SOS-948	351	352	1	1	3	4	2	1
SOS-948	351	477	126	0	3	3	0	0
SOS-948	351	477	126	0	3	3	0	0
SOS-948	351	477	126	0	4	1	0	0
SOS-949	351	477	126	0	3	1	0	1
SOS-949	351	477	126	0	3	5	0	0
SOS-949	351	352	1	1	3	1	4	1
SOS-949	352	477	125	0	3	4	0	0
SOS-949	352	477	125	0	3	4	0	1
SOS-949	353	373	20	1	3	1	1	0
SOS-949	353	477	124	0	3	1	0	0
SOS-949	354	477	123	0	3	4	0	0
SOS-949	354	477	123	0	3	4	0	0
SOS-949	354	477	123	0	3	4	0	0
SOS-950	354	477	123	0	2	1	0	0
SOS-950	360	375	15	1	2	1	4	2
SOS-950	361	373	12	1	2	1	4	2
TAMODEL-117	1	19	18	1	3	1	2	0
TAMODEL-117	25	26	1	1	3	2	1	0
TAMODEL-118	63	477	414	0	3	3	0	0
TAMODEL-118	109	477	368	0	3	1	0	0
TAMODEL-118	112	477	365	0	3	1	0	0
TAMODEL-118	133	134	1	1	3	2	1	1
TAMODEL-118	143	171	28	1	4	4	1	0
TAMODEL-118	156	157	1	1	3	2	1	0
TAMODEL-118	157	477	320	0	4	1	0	0
TAMODEL-118	169	477	308	0	4	4	0	0
TAMODEL-118	171	172	1	1	3	2	1	0
TAMODEL-118	173	477	304	0	3	3	0	0
TAMODEL-119	179	477	298	0	3	1	0	0
TAMODEL-119	228	477	249	0	3	1	0	0
TAMODEL-119	236	237	1	1	3	4	0	0
TAMODEL-119	237	243	6	1	3	3	1	0
TAMODEL-119	239	243	4	1	4	1	1	0
TAMODEL-119	245	477	232	0	3	1	0	0
TAMODEL-119	247	477	230	0	3	1	0	0
TAMODEL-119	256	257	1	1	3	3	1	0
TAMODEL-119	259	477	218	0	3	4	0	0
TAMODEL-119	275	477	202	0	3	4	0	0
TAMODEL-120	281	282	1	1	5	2	0	0
TAMODEL-120	301	477	176	0	4	3	0	0
TAMODEL-120	313	315	2	1	2	1	0	0
TAMODEL-120	315	477	162	0	1	1	0	0
TAMODEL-120	316	477	161	0	2	1	0	0
TAMODEL-120	326	337	11	1	3	4	1	0
TAMODEL-120	331	332	1	1	3	1	1	0
TAMODEL-120	352	432	80	1	3	1	1	0
TRON-138	1	141	140	1	3	1	1	0
TRON-138	2	49	47	1	3	1	1	1
TRON-138	2	477	475	0	4	4	0	0
TRON-138	2	3	1	1	3	1	1	1
TRON-138	4	29	25	1	3	1	1	0
TRON-139	4	10	6	1	4	1	1	0
TRON-139	5	29	24	1	5	4	1	0
TRON-139	8	141	133	1	4	1	1	0
TRON-139	8	9	1	1	3	1	1	1
TRON-139	9	141	132	1	3	1	1	0
TRON-139	10	141	131	1	4	1	1	0
TRON-139	10	128	118	1	5	1	1	0
TRON-139	10	73	63	1	3	2	1	0
TRON-139	11	141	130	1	4	1	1	0
TRON-139	11	29	18	1	3	1	0	0
TRON-140	11	23	12	1	3	1	1	0
TRON-140	11	477	466	0	3	4	0	1
TRON-140	11	477	466	0	3	4	0	2
TRON-140	11	477	466	0	3	4	0	2
TRON-140	11	477	466	0	3	4	0	2
TRON-140	12	477	465	0	3	2	0	0
TRON-140	16	477	461	0	4	4	0	0
TRON-140	16	67	51	1	5	1	0	0
TRON-140	16	477	461	0	3	1	0	0
TRON-140	17	477	460	0	3	4	0	1
TRON-141	17	26	9	1	3	1	1	0
TRON-141	17	128	111	1	4	1	1	0
TRON-141	18	477	459	0	3	1	0	0
TRON-141	18	32	14	1	3	4	1	0
TRON-141	21	477	456	0	3	1	0	0
TRON-141	21	22	1	1	3	1	0	0
TRON-141	22	121	99	1	3	1	1	0
TRON-141	22	23	1	1	3	3	1	0
TRON-141	23	149	126	1	3	5	0	1
TRON-141	23	149	126	1	3	5	1	0
TRON-142	23	149	126	1	3	5	0	0
TRON-142	23	149	126	1	3	5	1	0
TRON-142	23	477	454	0	3	5	0	0
TRON-142	23	170	147	1	3	5	1	0
TRON-142	23	149	126	1	3	5	1	0
TRON-142	23	477	454	0	3	5	0	0
TRON-142	23	141	118	1	3	1	1	0
TRON-142	23	29	6	1	3	4	1	0
TRON-142	23	24	1	1	3	1	1	0
TRON-142	23	141	118	1	3	1	1	0
TRON-143	24	141	117	1	3	4	1	0
TRON-143	27	29	2	1	4	4	1	0
TRON-143	28	32	4	1	3	1	1	0
TRON-143	28	477	449	0	3	4	0	0
TRON-143	29	477	448	0	4	4	1	0
TRON-143	29	32	3	1	3	1	1	0
TRON-143	30	32	2	1	3	5	1	0
TRON-143	30	32	2	1	3	2	0	0
TRON-143	30	32	2	1	3	5	1	0
TRON-143	31	141	110	1	5	4	1	0
TRON-144	31	477	446	0	3	5	0	0
TRON-144	31	149	118	1	3	5	1	1
TRON-144	32	141	109	1	3	1	1	0
TRON-144	32	35	3	1	3	1	1	1
TRON-144	35	38	3	1	3	1	1	1
TRON-144	35	106	71	1	3	4	1	1
TRON-144	35	36	1	1	3	1	1	0
TRON-144	36	79	43	1	3	1	1	0
TRON-144	37	246	209	1	3	4	1	0
TRON-144	37	98	61	1	3	4	1	1
TRON-145	38	64	26	1	3	1	1	0
TRON-145	38	41	3	1	3	1	1	0
TRON-145	39	79	40	1	3	4	1	0
TRON-145	39	361	322	1	3	2	0	0
TRON-145	39	477	438	0	3	4	0	0
TRON-145	39	141	102	1	3	1	1	0
TRON-145	42	477	435	0	3	1	0	1
TRON-145	46	128	82	1	3	1	1	0
TRON-145	46	477	431	0	4	1	0	0
TRON-145	52	477	425	0	4	4	0	0
TRON-146	52	141	89	1	3	2	1	0
TRON-146	53	141	88	1	4	1	1	0
TRON-146	53	94	41	1	3	5	1	0
TRON-146	57	141	84	1	3	4	1	0
TRON-146	58	170	112	1	3	5	1	0
TRON-146	59	98	39	1	3	1	1	0
TRON-146	60	86	26	1	3	1	0	0
TRON-146	60	141	81	1	3	4	1	0
TRON-146	63	67	4	1	4	4	1	0
TRON-146	64	98	34	1	3	4	1	0
TRON-147	64	141	77	1	3	1	1	0
TRON-147	64	141	77	1	3	4	1	0
TRON-147	64	477	413	0	4	4	0	0
TRON-147	64	477	413	0	4	4	0	0
TRON-147	64	477	413	0	4	4	0	0
TRON-147	64	477	413	0	4	4	0	0
TRON-147	65	344	279	1	3	4	1	0
TRON-147	65	477	412	0	4	4	0	0
TRON-147	65	477	412	0	4	4	0	0
TRON-147	65	477	412	0	4	4	0	0
TRON-148	65	477	412	0	4	4	0	0
TRON-148	65	477	412	0	4	4	0	0
TRON-148	65	149	84	1	3	5	1	0
TRON-148	66	141	75	1	3	2	1	0
TRON-148	67	477	410	0	3	1	0	0
TRON-148	67	141	74	1	3	4	1	0
TRON-148	70	71	1	1	3	1	0	1
TRON-148	70	79	9	1	3	4	1	0
TRON-148	70	141	71	1	3	4	1	1
TRON-148	71	247	176	1	3	4	1	0
TRON-149	72	141	69	1	3	4	1	0
TRON-149	73	78	5	1	3	1	1	0
TRON-149	73	477	404	0	3	4	0	0
TRON-149	74	79	5	1	3	4	1	0
TRON-149	74	107	33	1	3	1	1	0
TRON-149	74	477	403	0	3	1	0	0
TRON-149	77	477	400	0	4	4	0	0
TRON-149	77	141	64	1	3	1	1	0
TRON-149	77	78	1	1	4	1	0	0
TRON-149	79	107	28	1	3	4	1	0
TRON-150	80	98	18	1	4	4	1	0
TRON-150	81	141	60	1	3	1	1	0
TRON-150	85	141	56	1	4	4	1	0
TRON-150	86	247	161	1	3	1	1	0
TRON-150	86	141	55	1	3	1	1	0
TRON-150	91	98	7	1	3	1	1	0
TRON-150	92	477	385	0	4	1	0	0
TRON-150	93	102	9	1	5	4	0	0
TRON-150	93	273	180	1	4	1	1	0
TRON-150	93	477	384	0	4	4	1	0
TRON-151	94	100	6	1	3	1	1	1
TRON-151	94	131	37	1	3	1	1	0
TRON-151	94	107	13	1	4	4	0	1
TRON-151	95	477	382	0	4	4	0	0
TRON-151	95	477	382	0	3	2	0	0
TRON-151	98	141	43	1	3	1	1	0
TRON-151	99	101	2	1	3	2	1	0
TRON-151	99	477	378	0	3	1	0	0
TRON-151	99	102	3	1	3	1	1	0
TRON-151	99	102	3	1	2	1	1	0
TRON-152	100	141	41	1	3	4	1	0
TRON-152	100	141	41	1	3	1	1	0
TRON-152	101	141	40	1	5	1	1	0
TRON-152	101	477	376	0	5	3	0	1
TRON-152	102	477	375	0	3	2	0	0
TRON-152	105	477	372	0	3	1	0	0
TRON-152	105	247	142	1	3	1	1	0
TRON-152	105	106	1	1	3	3	1	0
TRON-152	106	107	1	1	3	1	1	1
TRON-152	107	131	24	1	4	1	1	1
TRON-153	107	141	34	1	4	1	1	0
TRON-153	108	191	83	1	3	1	0	0
TRON-153	109	150	41	1	5	4	1	0
TRON-153	109	191	82	1	4	4	1	0
TRON-153	110	477	367	0	3	1	0	0
TRON-153	111	477	366	0	3	1	0	0
TRON-153	112	477	365	0	3	1	0	0
TRON-153	112	113	1	1	3	1	0	0
TRON-153	113	477	364	0	3	4	0	0
TRON-153	113	141	28	1	3	2	1	0
TRON-154	115	122	7	1	3	5	1	0
TRON-154	116	141	25	1	4	1	1	0
TRON-154	116	477	361	0	3	4	0	0
TRON-154	116	131	15	1	3	1	1	0
TRON-154	121	150	29	1	3	1	1	0
TRON-154	121	141	20	1	3	4	1	0
TRON-154	122	477	355	0	3	1	0	0
TRON-154	122	155	33	1	3	5	1	0
TRON-154	122	141	19	1	3	4	1	0
TRON-154	127	130	3	1	3	5	1	0
TRON-155	130	477	347	0	3	3	0	0
TRON-155	130	141	11	1	3	1	1	1
TRON-155	131	134	3	1	3	4	1	0
TRON-155	131	191	60	1	3	1	1	1
TRON-155	133	246	113	1	3	2	1	0
TRON-155	133	219	86	1	3	5	1	0
TRON-155	133	196	63	1	3	5	0	1
TRON-155	133	220	87	1	3	5	0	1
TRON-156	133	219	86	1	3	5	1	0
TRON-156	133	477	344	0	3	4	0	0
TRON-156	133	219	86	1	3	5	1	0
TRON-156	133	298	165	1	3	5	0	0
TRON-156	134	141	7	1	3	1	1	0
TRON-156	134	142	8	1	3	1	1	0
TRON-156	135	142	7	1	3	1	1	0
TRON-156	137	149	12	1	3	5	1	0
TRON-156	140	247	107	1	3	4	1	0
TRON-156	141	149	8	1	3	4	1	0
TRON-157	141	477	336	0	3	1	0	0
TRON-157	141	247	106	1	3	4	1	0
TRON-157	141	191	50	1	3	4	1	0
TRON-157	141	191	50	1	3	4	1	0
TRON-157	142	143	1	1	3	1	1	0
TRON-157	142	143	1	1	3	1	1	0
TRON-157	142	143	1	1	3	1	1	0
TRON-157	143	149	6	1	3	5	1	0
TRON-157	144	477	333	0	4	1	0	0
TRON-157	144	247	103	1	3	4	1	0
TRON-158	144	146	2	1	3	4	1	0
TRON-158	147	477	330	0	4	1	0	0
TRON-158	148	477	329	0	3	1	0	0
TRON-158	148	477	329	0	3	1	0	0
TRON-158	148	191	43	1	3	1	1	0
TRON-158	149	170	21	1	3	5	1	0
TRON-158	149	150	1	1	3	1	1	0
TRON-158	149	170	21	1	3	5	1	0
TRON-158	149	185	36	1	2	4	1	0
TRON-158	150	170	20	1	3	5	1	0
TRON-159	150	151	1	1	3	1	0	1
TRON-159	150	477	327	0	4	4	0	0
TRON-159	150	191	41	1	3	1	1	0
TRON-159	150	247	97	1	3	1	1	0
TRON-159	150	156	6	1	3	1	1	0
TRON-159	151	477	326	0	3	1	0	0
TRON-159	151	477	326	0	4	4	0	0
TRON-159	153	477	324	0	4	4	0	0
TRON-159	154	191	37	1	3	1	1	0
TRON-159	154	191	37	1	3	4	1	0
TRON-160	154	171	17	1	3	5	0	1
TRON-160	154	247	93	1	3	4	1	0
TRON-160	155	477	322	0	3	5	0	0
TRON-160	155	156	1	1	3	1	1	0
TRON-160	156	247	91	1	4	1	1	0
TRON-160	156	170	14	1	3	1	0	0
TRON-160	156	201	45	1	4	4	1	0
TRON-160	157	247	90	1	3	3	1	0
TRON-160	157	247	90	1	3	1	1	2
TRON-160	157	191	34	1	3	5	1	0
TRON-161	157	477	320	0	3	3	0	0
TRON-161	158	247	89	1	3	3	1	0
TRON-161	158	247	89	1	3	3	1	0
TRON-161	161	246	85	1	3	1	1	0
TRON-161	161	198	37	1	3	5	1	0
TRON-161	162	477	315	0	5	4	0	0
TRON-161	162	247	85	1	3	1	1	0
TRON-161	164	247	83	1	3	1	1	1
TRON-161	166	477	311	0	3	4	0	0
TRON-161	166	247	81	1	3	4	1	0
TRON-162	167	196	29	1	3	1	1	0
TRON-162	168	246	78	1	3	1	1	0
TRON-162	168	191	23	1	3	4	1	2
TRON-162	169	477	308	0	3	1	0	0
TRON-162	169	247	78	1	3	4	1	0
TRON-162	169	170	1	1	3	5	1	0
TRON-162	170	247	77	1	3	1	1	0
TRON-162	170	247	77	1	3	1	1	0
TRON-162	170	171	1	1	3	4	0	0
TRON-162	170	247	77	1	3	5	1	0
TRON-163	170	247	77	1	3	1	1	0
TRON-163	171	247	76	1	3	1	1	0
TRON-163	171	477	306	0	3	5	0	0
TRON-163	171	172	1	1	4	1	1	0
TRON-163	172	247	75	1	3	1	1	0
TRON-163	172	247	75	1	3	1	1	0
TRON-163	175	247	72	1	3	1	1	0
TRON-163	175	247	72	1	3	1	1	0
TRON-163	176	219	43	1	3	5	1	0
TRON-163	176	477	301	0	4	4	0	0
TRON-164	176	477	301	0	3	4	0	0
TRON-164	177	191	14	1	3	5	1	2
TRON-164	177	247	70	1	3	4	1	0
TRON-164	177	247	70	1	3	4	1	0
TRON-164	177	247	70	1	3	4	1	0
TRON-164	177	247	70	1	3	1	1	0
TRON-164	178	191	13	1	3	4	1	0
TRON-164	178	247	69	1	4	1	1	0
TRON-164	182	477	295	0	3	4	0	0
TRON-164	182	191	9	1	3	1	1	0
TRON-165	183	246	63	1	4	4	1	0
TRON-165	183	246	63	1	3	1	1	0
TRON-165	183	191	8	1	4	4	1	0
TRON-165	183	477	294	0	3	4	0	0
TRON-165	183	477	294	0	3	1	0	0
TRON-165	186	199	13	1	3	4	1	0
TRON-165	187	191	4	1	3	4	1	0
TRON-165	190	247	57	1	3	1	1	0
TRON-165	190	226	36	1	4	4	1	0
TRON-165	190	199	9	1	5	4	1	0
TRON-166	190	247	57	1	3	1	1	0
TRON-166	190	219	29	1	3	5	1	0
TRON-166	191	220	29	1	3	5	1	0
TRON-166	192	477	285	0	3	4	0	0
TRON-166	192	477	285	0	3	5	0	0
TRON-166	192	477	285	0	3	5	0	0
TRON-166	192	477	285	0	3	5	0	0
TRON-166	192	477	285	0	3	5	0	0
TRON-166	192	477	285	0	3	5	0	0
TRON-166	192	477	285	0	3	5	0	0
TRON-167	193	247	54	1	5	1	1	0
TRON-167	196	219	23	1	3	5	1	0
TRON-167	196	247	51	1	3	1	1	0
TRON-167	196	247	51	1	3	1	1	0
TRON-167	196	219	23	1	3	5	1	0
TRON-167	197	220	23	1	3	5	1	0
TRON-167	197	220	23	1	3	5	1	0
TRON-167	198	352	154	1	3	1	0	0
TRON-167	198	477	279	0	3	4	0	1
TRON-167	198	477	279	0	3	4	0	1
TRON-168	198	477	279	0	3	4	0	0
TRON-168	198	344	146	1	3	4	1	0
TRON-168	198	477	279	0	3	4	0	0
TRON-168	198	220	22	1	3	5	1	0
TRON-168	198	247	49	1	3	4	1	0
TRON-168	198	219	21	1	3	5	1	0
TRON-168	199	200	1	1	3	5	1	0
TRON-168	200	246	46	1	3	1	1	0
TRON-168	203	477	274	0	4	5	0	0
TRON-168	203	477	274	0	3	5	0	0
TRON-169	204	205	1	1	3	5	1	0
TRON-169	204	219	15	1	3	5	1	0
TRON-169	205	477	272	0	4	1	0	0
TRON-169	205	219	14	1	3	5	1	0
TRON-169	205	226	21	1	5	1	1	0
TRON-169	205	277	72	1	3	1	1	0
TRON-169	206	226	20	1	3	5	0	1
TRON-169	206	477	271	0	5	4	0	0
TRON-169	207	477	270	0	4	4	0	0
TRON-169	207	273	66	1	3	4	1	0
TRON-170	207	219	12	1	3	5	1	0
TRON-170	211	219	8	1	4	1	1	0
TRON-170	211	221	10	1	3	5	1	0
TRON-170	211	226	15	1	4	5	1	0
TRON-170	211	246	35	1	3	5	1	0
TRON-170	211	246	35	1	3	5	1	0
TRON-170	211	246	35	1	3	5	1	0
TRON-170	211	246	35	1	3	5	1	0
TRON-170	211	246	35	1	3	5	1	0
TRON-170	212	344	132	1	3	1	1	1
TRON-171	212	477	265	0	3	1	0	0
TRON-171	212	219	7	1	3	5	1	0
TRON-171	212	221	9	1	3	5	1	0
TRON-171	212	246	34	1	3	5	1	0
TRON-171	212	246	34	1	3	5	1	0
TRON-171	212	259	47	1	3	5	1	0
TRON-171	212	221	9	1	3	5	0	0
TRON-171	212	213	1	1	3	1	0	1
TRON-172	214	219	5	1	3	5	1	0
TRON-172	214	219	5	1	3	5	1	0
TRON-172	214	221	7	1	3	5	1	0
TRON-172	217	221	4	1	3	5	1	0
TRON-172	217	247	30	1	3	1	1	0
TRON-172	217	224	7	1	3	5	1	0
TRON-172	217	218	1	1	3	5	1	0
TRON-172	218	226	8	1	3	1	1	0
TRON-172	218	220	2	1	3	5	1	0
TRON-172	218	477	259	0	3	4	0	0
TRON-173	219	220	1	1	3	4	1	0
TRON-173	219	221	2	1	3	5	1	0
TRON-173	221	226	5	1	3	5	1	0
TRON-173	221	224	3	1	3	5	1	0
TRON-173	221	224	3	1	3	5	1	0
TRON-173	221	225	4	1	3	5	1	0
TRON-173	224	246	22	1	3	5	1	0
TRON-173	224	226	2	1	3	5	1	0
TRON-173	226	227	1	1	3	5	1	1
TRON-173	227	228	1	1	3	5	1	0
TRON-174	231	344	113	1	3	4	1	0
TRON-174	232	246	14	1	3	5	1	0
TRON-174	234	477	243	0	4	4	0	0
TRON-174	234	247	13	1	5	5	1	0
TRON-174	234	477	243	0	3	5	0	0
TRON-174	234	477	243	0	4	5	0	0
TRON-174	234	477	243	0	1	5	0	0
TRON-174	234	477	243	0	4	5	0	0
TRON-174	234	296	62	1	3	1	1	0
TRON-174	235	318	83	1	3	4	1	0
TRON-175	235	273	38	1	3	5	1	0
TRON-175	238	246	8	1	3	1	1	0
TRON-175	238	247	9	1	4	1	1	0
TRON-175	238	477	239	0	3	4	0	0
TRON-175	239	477	238	0	3	5	0	0
TRON-175	239	477	238	0	3	5	0	0
TRON-175	239	477	238	0	3	5	0	0
TRON-175	239	246	7	1	3	1	1	1
TRON-175	240	344	104	1	3	4	1	0
TRON-175	242	344	102	1	3	4	1	0
TRON-176	242	261	19	1	3	4	1	0
TRON-176	242	282	40	1	4	4	1	0
TRON-176	242	477	235	0	3	4	0	0
TRON-176	246	273	27	1	3	1	0	0
TRON-176	246	247	1	1	3	4	1	0
TRON-176	246	273	27	1	3	5	0	0
TRON-176	247	477	230	0	3	1	0	0
TRON-176	247	477	230	0	3	4	0	0
TRON-176	248	477	229	0	4	4	0	0
TRON-176	248	283	35	1	3	4	1	0
TRON-177	248	261	13	1	3	5	1	0
TRON-177	249	344	95	1	3	4	1	0
TRON-177	249	261	12	1	3	5	1	0
TRON-177	250	305	55	1	3	4	1	0
TRON-177	253	305	52	1	3	4	1	0
TRON-177	254	305	51	1	4	4	1	0
TRON-177	254	283	29	1	3	4	1	0
TRON-177	254	260	6	1	3	1	1	0
TRON-177	255	436	181	1	3	1	1	0
TRON-177	255	477	222	0	4	5	0	0
TRON-178	255	283	28	1	3	1	1	0
TRON-178	259	261	2	1	3	5	1	0
TRON-178	260	273	13	1	3	4	1	0
TRON-178	260	477	217	0	3	1	0	0
TRON-178	261	268	7	1	3	4	1	0
TRON-178	261	477	216	0	3	4	0	0
TRON-178	262	344	82	1	3	1	1	0
TRON-178	262	273	11	1	3	5	1	0
TRON-178	262	477	215	0	3	4	0	0
TRON-178	262	477	215	0	3	4	0	0
TRON-179	263	344	81	1	4	4	1	0
TRON-179	266	305	39	1	3	1	1	0
TRON-179	267	305	38	1	3	4	1	0
TRON-179	268	477	209	0	3	1	0	0
TRON-179	268	273	5	1	3	4	1	0
TRON-179	269	350	81	1	4	2	0	0
TRON-179	269	477	208	0	4	4	0	0
TRON-179	269	406	137	1	3	4	0	0
TRON-179	270	276	6	1	3	3	1	0
TRON-179	270	283	13	1	3	1	1	0
TRON-180	272	285	13	1	5	3	1	0
TRON-180	274	319	45	1	3	5	1	0
TRON-180	275	477	202	0	3	1	0	0
TRON-180	275	305	30	1	3	4	1	0
TRON-180	275	276	1	1	3	3	1	0
TRON-180	275	344	69	1	3	4	1	0
TRON-180	276	281	5	1	3	4	1	0
TRON-180	277	344	67	1	3	1	1	0
TRON-180	277	344	67	1	3	4	1	0
TRON-180	277	305	28	1	3	1	1	0
TRON-181	278	343	65	1	3	1	1	0
TRON-181	280	344	64	1	3	1	1	0
TRON-181	280	281	1	1	3	1	1	0
TRON-181	280	305	25	1	3	1	1	0
TRON-181	281	477	196	0	3	1	0	1
TRON-181	282	352	70	1	3	4	0	1
TRON-181	282	344	62	1	3	4	1	0
TRON-181	282	477	195	0	3	3	0	0
TRON-181	282	324	42	1	4	3	1	0
TRON-181	282	285	3	1	3	3	0	0
TRON-182	283	287	4	1	3	5	1	0
TRON-182	283	324	41	1	3	3	1	0
TRON-182	283	477	194	0	3	3	0	0
TRON-182	285	286	1	1	3	4	0	0
TRON-182	285	324	39	1	5	3	1	0
TRON-182	285	324	39	1	4	3	1	0
TRON-182	285	324	39	1	4	3	1	0
TRON-182	287	324	37	1	5	3	1	0
TRON-182	287	344	57	1	3	1	1	0
TRON-183	289	318	29	1	4	1	1	0
TRON-183	291	305	14	1	3	1	1	0
TRON-183	291	477	186	0	3	1	0	0
TRON-183	291	294	3	1	3	1	1	0
TRON-183	291	322	31	1	3	4	1	1
TRON-183	291	322	31	1	3	5	0	0
TRON-183	291	311	20	1	3	5	0	0
TRON-183	291	310	19	1	3	5	0	0
TRON-183	291	310	19	1	3	5	0	0
TRON-183	292	305	13	1	3	1	1	0
TRON-184	295	477	182	0	3	2	0	0
TRON-184	296	477	181	0	3	4	0	1
TRON-184	296	477	181	0	3	4	0	1
TRON-184	296	477	181	0	3	1	0	0
TRON-184	297	344	47	1	3	2	1	0
TRON-184	297	340	43	1	3	5	1	0
TRON-184	298	353	55	1	3	2	0	0
TRON-184	298	324	26	1	3	4	1	0
TRON-184	301	477	176	0	3	4	0	0
TRON-184	301	344	43	1	3	4	0	0
TRON-185	302	344	42	1	3	2	1	0
TRON-185	305	477	172	0	3	1	0	0
TRON-185	305	310	5	1	3	4	0	1
TRON-185	305	310	5	1	3	4	1	1
TRON-185	305	477	172	0	4	3	0	1
TRON-185	307	308	1	1	3	4	1	0
TRON-185	308	477	169	0	3	2	0	0
TRON-185	308	340	32	1	3	1	1	0
TRON-185	309	311	2	1	3	4	1	0
TRON-185	309	477	168	0	3	5	0	0
TRON-186	310	477	167	0	3	4	0	3
TRON-186	311	312	1	1	3	1	1	0
TRON-186	311	322	11	1	1	1	0	0
TRON-186	311	477	166	0	3	2	0	0
TRON-186	311	312	1	1	3	1	1	0
TRON-186	312	324	12	1	3	3	1	0
TRON-186	312	330	18	1	3	3	1	0
TRON-186	316	340	24	1	3	1	1	0
TRON-186	316	324	8	1	4	3	1	0
TRON-186	316	337	21	1	3	1	1	0
TRON-187	317	344	27	1	3	1	1	0
TRON-187	317	332	15	1	3	1	0	0
TRON-187	317	344	27	1	3	4	1	0
TRON-187	318	344	26	1	3	1	1	0
TRON-187	318	329	11	1	3	2	1	0
TRON-187	318	344	26	1	3	4	1	0
TRON-187	319	477	158	0	3	1	0	0
TRON-187	319	344	25	1	3	4	1	0
TRON-187	319	477	158	0	3	2	0	0
TRON-187	319	352	33	1	3	5	0	0
TRON-188	320	329	9	1	3	4	1	0
TRON-188	321	477	156	0	4	3	0	0
TRON-188	321	477	156	0	3	5	0	0
TRON-188	321	477	156	0	3	1	0	0
TRON-188	321	322	1	1	3	1	0	0
TRON-188	322	324	2	1	4	3	1	0
TRON-188	322	477	155	0	4	1	0	0
TRON-188	322	329	7	1	3	4	1	0
TRON-188	323	332	9	1	3	1	1	1
TRON-188	323	337	14	1	3	4	1	0
TRON-189	323	324	1	1	3	1	1	0
TRON-189	324	477	153	0	3	1	0	0
TRON-189	324	350	26	1	3	4	0	0
TRON-189	327	361	34	1	3	5	0	0
TRON-189	329	477	148	0	3	4	0	0
TRON-189	329	477	148	0	3	2	0	0
TRON-189	330	477	147	0	3	4	0	1
TRON-189	330	477	147	0	3	4	0	1
TRON-189	331	477	146	0	3	4	0	1
TRON-189	331	477	146	0	3	5	0	0
TRON-190	331	477	146	0	3	5	0	0
TRON-190	331	477	146	0	3	5	0	0
TRON-190	331	477	146	0	3	5	0	0
TRON-190	331	477	146	0	3	5	0	0
TRON-190	331	477	146	0	3	5	0	0
TRON-190	331	477	146	0	3	5	0	0
TRON-190	331	477	146	0	3	5	0	0
TRON-190	331	477	146	0	3	5	0	1
TRON-190	331	477	146	0	3	5	0	0
TRON-190	331	344	13	1	3	4	1	0
TRON-191	331	419	88	1	3	1	0	0
TRON-191	331	401	70	1	3	2	0	0
TRON-191	332	477	145	0	3	4	0	0
TRON-191	332	344	12	1	1	1	1	0
TRON-191	332	477	145	0	4	4	0	0
TRON-191	333	477	144	0	3	1	0	0
TRON-191	333	414	81	1	3	4	0	0
TRON-191	336	477	141	0	3	1	0	0
TRON-191	336	477	141	0	3	1	0	0
TRON-191	337	477	140	0	3	1	0	0
TRON-192	337	339	2	1	3	1	0	1
TRON-192	338	477	139	0	3	1	0	0
TRON-192	338	344	6	1	3	1	1	1
TRON-192	338	477	139	0	4	1	0	0
TRON-192	339	477	138	0	3	1	0	0
TRON-192	339	351	12	1	3	4	0	0
TRON-192	339	477	138	0	3	1	0	0
TRON-192	339	340	1	1	3	1	0	0
TRON-192	340	344	4	1	3	3	1	0
TRON-192	343	477	134	0	3	3	0	0
TRON-193	343	385	42	1	3	1	0	0
TRON-193	343	344	1	1	3	3	1	0
TRON-193	343	351	8	1	3	4	0	0
TRON-193	344	388	44	1	3	1	0	0
TRON-193	344	353	9	1	3	4	0	0
TRON-193	345	477	132	0	3	1	0	0
TRON-193	347	385	38	1	3	1	0	0
TRON-193	347	477	130	0	3	3	0	0
TRON-193	350	351	1	1	4	4	0	0
TRON-193	350	477	127	0	3	3	0	0
TRON-194	351	434	83	1	3	1	0	0
TRON-194	351	477	126	0	4	1	0	1
TRON-194	351	477	126	0	3	1	0	0
TRON-194	352	477	125	0	4	4	0	0
TRON-194	352	477	125	0	3	1	0	1
TRON-194	352	477	125	0	3	2	0	0
TRON-194	352	477	125	0	3	1	0	0
TRON-194	352	477	125	0	3	1	0	0
TRON-194	352	477	125	0	3	1	0	0
TRON-194	352	477	125	0	4	4	0	0
TRON-195	353	354	1	1	3	1	0	2
TRON-195	353	354	1	1	3	4	0	2
TRON-195	354	477	123	0	3	3	0	2
TRON-195	354	414	60	1	3	1	1	1
TRON-195	354	436	82	1	4	1	1	0
TRON-195	359	360	1	1	3	1	0	0
TRON-195	359	380	21	1	3	1	0	0
TRON-195	360	361	1	1	3	1	0	0
TRON-195	361	385	24	1	3	1	0	0
TRON-195	361	477	116	0	3	1	0	0
PG-6	43	44	1	1	4	5	1	0
PG-6	89	280	191	1	4	5	1	0
PG-6	89	477	388	0	5	5	1	0
PG-6	133	477	344	0	3	1	0	0
PG-6	276	477	201	0	3	1	0	0
PG-6	280	448	168	1	4	5	1	0
PG-6	305	306	1	1	3	1	0	0
LAGRO-1	156	477	321	0	1	3	0	0
LAGRO-2	156	477	321	0	3	3	0	0
LAGRO-2	156	477	321	0	3	3	0	0
LAGRO-2	312	477	165	0	5	4	0	0
ME4J-26	4	477	473	0	3	1	0	0
ME4J-26	4	477	473	0	3	1	0	0
ME4J-26	15	18	3	1	3	1	2	0
ME4J-26	67	71	4	1	3	2	0	0
ME4J-26	67	71	4	1	3	2	0	0
ME4J-27	81	141	60	1	4	4	0	0
ME4J-27	86	106	20	1	3	2	0	0
ME4J-27	98	106	8	1	3	4	0	0
ME4J-27	113	116	3	1	3	1	0	0
ME4J-27	126	127	1	1	3	2	0	0
ME4J-27	135	477	342	0	3	1	0	0
ME4J-27	136	137	1	1	4	1	0	1
ME4J-27	136	477	341	0	5	1	0	0
ME4J-27	136	477	341	0	4	1	0	0
ME4J-27	141	142	1	1	5	4	0	0
ME4J-28	141	477	336	0	5	4	0	0
ME4J-28	182	477	295	0	3	1	0	0
ME4J-28	192	477	285	0	3	1	0	0
NDEXER-10	76	77	1	1	3	3	1	1
NDEXER-11	171	172	1	1	4	4	1	0
NDEXER-11	171	172	1	1	1	5	1	0
NDEXER-11	206	207	1	1	4	5	1	0
NDEXER-11	309	310	1	1	3	3	1	0
NIFI-42	11	477	466	0	3	2	0	0
NIFI-42	15	25	10	1	3	1	0	0
NIFI-42	15	22	7	1	3	3	0	0
NIFI-42	16	17	1	1	4	4	1	0
NIFI-42	17	18	1	1	1	1	1	0
NIFI-42	20	24	4	1	3	1	0	1
NIFI-43	23	143	120	1	3	3	1	0
NIFI-43	23	32	9	1	1	1	1	0
NIFI-43	25	32	7	1	5	3	1	0
NIFI-43	26	477	451	0	3	4	0	0
NIFI-43	27	38	11	1	3	4	1	0
NIFI-43	27	32	5	1	1	1	1	0
NIFI-43	28	477	449	0	3	4	0	1
NIFI-43	28	477	449	0	3	3	0	0
NIFI-43	37	477	440	0	3	4	0	0
NIFI-43	39	477	438	0	3	4	0	0
NIFI-44	57	154	97	1	3	3	0	0
NIFI-44	58	175	117	1	3	4	1	0
NIFI-44	67	477	410	0	3	4	0	0
NIFI-44	70	477	407	0	3	4	0	1
NIFI-44	74	80	6	1	3	2	0	1
NIFI-44	77	477	400	0	3	1	0	0
NIFI-44	77	477	400	0	3	4	0	0
NIFI-44	80	81	1	1	4	4	0	0
NIFI-44	81	91	10	1	3	2	0	0
NIFI-44	85	91	6	1	3	4	1	0
NIFI-45	105	176	71	1	3	1	1	0
NIFI-45	108	112	4	1	3	3	1	0
NIFI-45	108	129	21	1	3	3	1	0
NIFI-45	126	129	3	1	3	4	1	0
NIFI-45	126	143	17	1	3	4	0	1
NIFI-45	130	141	11	1	3	3	1	0
NIFI-45	133	142	9	1	1	1	1	1
NIFI-45	134	143	9	1	1	1	1	0
NIFI-45	149	203	54	1	3	3	0	0
NIFI-45	173	176	3	1	1	3	1	0
NIFI-46	178	179	1	1	1	3	1	0
NIFI-46	183	203	20	1	4	4	1	0
NIFI-46	183	203	20	1	4	1	0	0
NIFI-46	188	189	1	1	3	1	0	0
NIFI-46	193	477	284	0	4	1	0	0
NIFI-46	205	206	1	1	4	1	0	0
NIFI-46	206	477	271	0	3	5	0	0
NIFI-46	207	218	11	1	3	2	1	0
NIFI-46	212	218	6	1	3	4	1	0
NIFI-47	227	228	1	1	3	2	1	0
NIFI-47	277	280	3	1	3	3	1	0
NIFI-47	277	284	7	1	3	1	1	0
NIFI-47	280	301	21	1	4	4	1	2
NIFI-47	283	477	194	0	3	4	0	0
NIFI-47	287	288	1	1	4	4	0	0
NIFI-47	287	477	190	0	3	4	0	2
NIFI-47	287	304	17	1	3	4	1	1
NIFI-47	289	477	188	0	3	1	0	1
NIFI-47	294	295	1	1	3	4	0	1
NIFI-48	298	304	6	1	4	4	0	0
NIFI-48	333	477	144	0	3	3	1	0
NIFI-48	333	345	12	1	2	1	1	0
NIFI-48	337	338	1	1	5	4	1	0
NIFI-48	340	343	3	1	5	4	1	0
NIFI-48	340	477	137	0	3	5	0	0
NIFI-48	340	477	137	0	3	5	0	0
NIFI-48	343	477	134	0	3	5	0	0
NIFI-48	343	477	134	0	3	5	0	0
NIFI-48	343	477	134	0	3	5	0	0
NIFI-49	344	477	133	0	3	4	0	0
NIFI-49	344	477	133	0	3	4	0	0
NIFI-49	346	477	131	0	4	4	0	0
NIFICPP-36	4	477	473	0	3	1	0	0
NIFICPP-36	4	5	1	1	3	1	1	0
NIFICPP-36	7	9	2	1	3	1	1	0
NIFICPP-36	8	9	1	1	4	4	1	0
NIFICPP-36	8	9	1	1	1	5	1	0
NIFICPP-36	9	19	10	1	3	4	1	0
NIFICPP-36	9	23	14	1	3	4	1	0
NIFICPP-36	9	18	9	1	3	4	0	0
NIFICPP-36	9	127	118	1	3	4	1	0
NIFICPP-36	9	137	128	1	3	4	1	0
NIFICPP-37	9	114	105	1	3	4	0	0
NIFICPP-37	11	12	1	1	4	5	1	0
NIFICPP-37	12	15	3	1	3	1	1	0
NIFICPP-37	12	18	6	1	2	1	1	0
NIFICPP-37	15	18	3	1	3	4	1	0
NIFICPP-37	15	477	462	0	3	4	0	0
NIFICPP-37	16	21	5	1	3	1	0	0
NIFICPP-37	21	22	1	1	1	4	1	0
NIFICPP-37	21	22	1	1	2	4	1	0
NIFICPP-37	22	26	4	1	3	3	1	0
NIFICPP-38	22	23	1	1	4	4	1	0
NIFICPP-38	23	477	454	0	3	3	0	0
NIFICPP-38	24	45	21	1	3	4	1	0
NIFICPP-38	24	42	18	1	3	4	1	0
NIFICPP-38	24	29	5	1	3	1	1	0
NIFICPP-38	24	56	32	1	3	4	1	0
NIFICPP-38	29	477	448	0	3	4	0	0
NIFICPP-38	30	35	5	1	4	4	1	0
NIFICPP-38	30	35	5	1	3	1	1	0
NIFICPP-38	30	35	5	1	3	1	1	0
NIFICPP-39	30	35	5	1	3	1	1	0
NIFICPP-39	30	35	5	1	3	1	1	0
NIFICPP-39	31	127	96	1	4	4	1	0
NIFICPP-39	35	42	7	1	4	4	1	0
NIFICPP-39	36	127	91	1	3	4	1	0
NIFICPP-39	37	123	86	1	3	4	1	0
NIFICPP-39	39	42	3	1	1	4	1	0
NIFICPP-39	39	77	38	1	3	4	1	1
NIFICPP-39	39	477	438	0	3	4	0	1
NIFICPP-39	43	44	1	1	4	1	0	0
NIFICPP-40	43	46	3	1	3	4	1	0
NIFICPP-40	44	77	33	1	3	4	1	1
NIFICPP-40	44	77	33	1	3	5	1	0
NIFICPP-40	45	137	92	1	4	4	1	0
NIFICPP-40	45	441	396	1	4	4	1	0
NIFICPP-40	45	72	27	1	4	4	1	0
NIFICPP-40	46	51	5	1	3	4	1	0
NIFICPP-40	50	52	2	1	3	4	1	0
NIFICPP-40	50	51	1	1	3	5	1	0
NIFICPP-40	50	51	1	1	4	4	1	0
NIFICPP-41	51	142	91	1	3	4	1	0
NIFICPP-41	52	58	6	1	3	1	1	0
NIFICPP-41	52	477	425	0	3	4	0	1
NIFICPP-41	56	65	9	1	3	5	1	0
NIFICPP-41	56	77	21	1	3	4	1	1
NIFICPP-41	56	65	9	1	3	5	1	0
NIFICPP-41	56	65	9	1	3	4	1	0
NIFICPP-41	57	123	66	1	1	1	1	0
NIFICPP-41	64	123	59	1	3	1	1	0
NIFICPP-41	66	269	203	1	3	1	1	0
NIFICPP-42	66	477	411	0	3	4	0	0
NIFICPP-42	66	67	1	1	3	4	0	0
NIFICPP-42	67	77	10	1	3	4	1	1
NIFICPP-42	70	134	64	1	3	4	1	4
NIFICPP-42	70	72	2	1	3	4	1	0
NIFICPP-42	70	71	1	1	3	4	1	0
NIFICPP-42	72	477	405	0	3	4	0	0
NIFICPP-42	73	213	140	1	3	4	1	1
NIFICPP-42	73	79	6	1	3	4	1	1
NIFICPP-42	73	477	404	0	3	4	0	0
NIFICPP-43	74	77	3	1	3	1	1	0
NIFICPP-43	74	477	403	0	3	1	0	0
NIFICPP-43	74	127	53	1	3	1	1	0
NIFICPP-43	76	79	3	1	3	4	1	1
NIFICPP-43	76	79	3	1	3	4	1	1
NIFICPP-43	77	477	400	0	3	4	0	0
NIFICPP-43	77	81	4	1	3	4	1	0
NIFICPP-43	78	477	399	0	3	4	0	0
NIFICPP-43	78	268	190	1	3	4	1	0
NIFICPP-43	78	80	2	1	3	4	1	0
NIFICPP-44	79	93	14	1	3	4	1	0
NIFICPP-44	79	477	398	0	3	4	0	0
NIFICPP-44	80	477	397	0	3	4	0	0
NIFICPP-44	80	109	29	1	3	4	1	0
NIFICPP-44	81	477	396	0	3	4	0	0
NIFICPP-44	81	98	17	1	3	4	1	1
NIFICPP-44	81	107	26	1	3	4	1	2
NIFICPP-44	88	477	389	0	3	1	0	0
NIFICPP-44	93	98	5	1	3	4	1	0
NIFICPP-44	98	100	2	1	3	4	1	0
NIFICPP-45	100	477	377	0	3	4	0	0
NIFICPP-45	101	114	13	1	3	5	1	0
NIFICPP-45	101	477	376	0	3	5	0	0
NIFICPP-45	101	107	6	1	3	4	1	0
NIFICPP-45	102	105	3	1	1	1	1	0
NIFICPP-45	105	107	2	1	3	4	1	1
NIFICPP-45	105	135	30	1	3	1	1	0
NIFICPP-45	106	144	38	1	4	4	1	0
NIFICPP-45	106	477	371	0	4	4	0	0
NIFICPP-45	107	197	90	1	3	4	0	0
NIFICPP-46	107	477	370	0	3	4	0	0
NIFICPP-46	109	135	26	1	5	3	1	0
NIFICPP-46	109	465	356	1	4	3	1	0
NIFICPP-46	109	127	18	1	3	4	1	1
NIFICPP-46	112	114	2	1	3	5	1	0
NIFICPP-46	112	477	365	0	3	4	0	1
NIFICPP-46	112	204	92	1	3	4	1	1
NIFICPP-46	112	207	95	1	3	4	0	1
NIFICPP-46	112	123	11	1	3	4	1	0
NIFICPP-46	113	133	20	1	3	4	1	1
NIFICPP-47	113	114	1	1	3	4	1	0
NIFICPP-47	114	123	9	1	3	4	1	0
NIFICPP-47	114	138	24	1	3	4	1	0
NIFICPP-47	114	115	1	1	3	4	0	0
NIFICPP-47	114	134	20	1	3	4	1	0
NIFICPP-47	114	127	13	1	3	4	1	1
NIFICPP-47	121	134	13	1	3	1	1	0
NIFICPP-47	121	143	22	1	3	5	0	0
NIFICPP-47	121	127	6	1	3	5	1	0
NIFICPP-47	121	373	252	1	3	4	1	4
NIFICPP-48	122	477	355	0	3	4	0	1
NIFICPP-48	122	123	1	1	3	4	1	0
NIFICPP-48	126	477	351	0	3	4	0	0
NIFICPP-48	126	197	71	1	3	5	0	0
NIFICPP-48	126	127	1	1	3	4	1	0
NIFICPP-48	126	477	351	0	3	5	0	0
NIFICPP-48	126	143	17	1	3	5	1	0
NIFICPP-48	126	466	340	1	3	1	0	0
NIFICPP-48	127	128	1	1	3	1	1	0
NIFICPP-48	127	129	2	1	3	3	1	0
NIFICPP-49	128	477	349	0	3	5	0	0
NIFICPP-49	130	143	13	1	3	5	1	0
NIFICPP-49	130	143	13	1	3	5	1	0
NIFICPP-49	130	477	347	0	3	5	0	0
NIFICPP-49	130	143	13	1	3	5	1	0
NIFICPP-49	133	135	2	1	3	1	1	0
NIFICPP-49	134	477	343	0	3	1	0	0
NIFICPP-49	135	143	8	1	3	4	0	0
NIFICPP-49	137	140	3	1	3	4	1	2
NIFICPP-50	137	149	12	1	3	4	1	2
NIFICPP-50	137	143	6	1	3	4	0	2
NIFICPP-50	137	143	6	1	3	4	0	2
NIFICPP-50	141	143	2	1	3	1	0	0
NIFICPP-50	141	477	336	0	3	5	1	0
NIFICPP-50	141	477	336	0	3	5	0	0
NIFICPP-50	141	477	336	0	3	1	0	0
NIFICPP-50	142	149	7	1	3	3	0	0
NIFICPP-50	142	149	7	1	3	4	1	0
NIFICPP-50	143	315	172	1	3	1	0	0
NIFICPP-51	144	149	5	1	3	1	0	0
NIFICPP-51	144	148	4	1	3	1	0	0
NIFICPP-51	145	156	11	1	3	4	1	1
NIFICPP-51	147	149	2	1	3	1	1	0
NIFICPP-51	148	205	57	1	3	4	0	2
NIFICPP-51	148	185	37	1	3	4	0	0
NIFICPP-51	148	477	329	0	3	1	0	0
NIFICPP-51	149	156	7	1	3	2	1	0
NIFICPP-51	149	477	328	0	3	1	0	0
NIFICPP-51	149	157	8	1	3	3	0	0
NIFICPP-52	150	477	327	0	3	2	1	0
NIFICPP-52	150	213	63	1	3	2	1	0
NIFICPP-52	153	199	46	1	3	1	0	1
NIFICPP-52	154	155	1	1	4	1	1	0
NIFICPP-52	154	157	3	1	3	1	1	0
NIFICPP-52	154	157	3	1	3	5	1	0
NIFICPP-52	155	268	113	1	3	1	1	0
NIFICPP-52	155	477	322	0	3	1	0	0
NIFICPP-52	155	162	7	1	3	1	1	0
NIFICPP-53	155	477	322	0	3	3	0	0
NIFICPP-53	156	157	1	1	3	3	1	0
NIFICPP-53	156	477	321	0	4	4	0	0
NIFICPP-53	161	183	22	1	3	1	1	0
NIFICPP-53	161	182	21	1	3	4	1	1
NIFICPP-53	161	164	3	1	3	4	0	1
NIFICPP-53	162	164	2	1	3	4	0	0
NIFICPP-53	162	268	106	1	3	5	1	0
NIFICPP-53	170	179	9	1	4	1	1	1
NIFICPP-53	171	477	306	0	3	1	0	0
NIFICPP-54	171	178	7	1	4	4	0	0
NIFICPP-54	174	178	4	1	4	4	0	0
NIFICPP-54	175	477	302	0	3	1	0	0
NIFICPP-54	176	182	6	1	3	1	1	0
NIFICPP-54	176	213	37	1	3	5	1	0
NIFICPP-54	176	477	301	0	3	2	0	0
NIFICPP-54	177	179	2	1	4	1	1	0
NIFICPP-54	178	183	5	1	3	2	1	0
NIFICPP-54	179	477	298	0	3	5	0	0
NIFICPP-54	179	477	298	0	3	1	0	0
NIFICPP-55	179	477	298	0	3	1	1	0
NIFICPP-55	183	184	1	1	3	3	1	0
NIFICPP-55	183	477	294	0	3	1	0	0
NIFICPP-55	185	186	1	1	3	4	0	0
NIFICPP-55	185	213	28	1	2	5	1	0
NIFICPP-55	186	207	21	1	3	4	0	0
NIFICPP-55	192	213	21	1	3	4	1	0
NIFICPP-55	193	196	3	1	3	1	1	0
NIFICPP-55	197	412	215	1	3	1	1	0
NIFICPP-55	197	477	280	0	3	1	0	0
NIFICPP-56	197	477	280	0	3	4	0	0
NIFICPP-56	198	204	6	1	3	4	0	0
NIFICPP-56	198	204	6	1	3	1	0	0
NIFICPP-56	199	477	278	0	3	4	0	1
NIFICPP-56	199	477	278	0	3	4	0	0
NIFICPP-56	199	477	278	0	3	4	0	0
NIFICPP-56	199	477	278	0	3	1	0	0
NIFICPP-56	200	477	277	0	3	5	0	0
NIFICPP-56	202	204	2	1	3	1	1	1
NIFICPP-56	202	204	2	1	3	1	1	1
NIFICPP-57	203	477	274	0	4	4	0	0
NIFICPP-57	203	477	274	0	3	4	0	1
NIFICPP-57	203	204	1	1	3	4	0	0
NIFICPP-57	204	218	14	1	3	5	1	0
NIFICPP-57	204	205	1	1	3	1	0	1
NIFICPP-57	204	205	1	1	1	1	1	1
NIFICPP-57	205	477	272	0	3	1	1	0
NIFICPP-57	206	269	63	1	3	1	1	0
NIFICPP-57	207	268	61	1	3	5	1	0
NIFICPP-57	207	437	230	1	2	1	1	0
NIFICPP-58	210	212	2	1	1	1	1	1
NIFICPP-58	210	477	267	0	4	1	0	0
NIFICPP-58	210	214	4	1	1	1	1	0
NIFICPP-58	210	214	4	1	1	1	1	0
NIFICPP-58	210	213	3	1	1	1	1	1
NIFICPP-58	210	477	267	0	3	5	0	0
NIFICPP-58	211	212	1	1	3	4	1	0
NIFICPP-58	212	213	1	1	3	1	1	0
NIFICPP-58	212	214	2	1	1	1	0	0
NIFICPP-58	214	218	4	1	3	4	1	0
NIFICPP-59	214	218	4	1	3	1	1	0
NIFICPP-59	215	268	53	1	3	5	0	0
NIFICPP-59	217	239	22	1	3	5	1	0
NIFICPP-59	217	477	260	0	3	5	0	0
NIFICPP-59	217	218	1	1	3	4	1	0
NIFICPP-59	220	262	42	1	3	5	1	0
NIFICPP-59	220	262	42	1	3	5	1	0
NIFICPP-59	226	227	1	1	3	4	0	0
NIFICPP-59	226	239	13	1	3	1	1	0
NIFICPP-59	226	477	251	0	3	2	0	0
NIFICPP-60	231	239	8	1	3	5	1	0
NIFICPP-60	232	239	7	1	3	5	1	0
NIFICPP-60	249	256	7	1	3	4	1	0
NIFICPP-60	252	309	57	1	3	5	1	0
NIFICPP-60	253	254	1	1	3	1	1	0
NIFICPP-60	253	477	224	0	3	4	0	1
NIFICPP-60	256	257	1	1	3	4	1	0
NIFICPP-60	256	257	1	1	2	4	1	0
NIFICPP-60	259	465	206	1	3	4	1	0
NIFICPP-60	259	477	218	0	3	4	0	2
NIFICPP-61	259	262	3	1	3	4	1	0
NIFICPP-61	260	477	217	0	3	4	0	0
NIFICPP-61	260	477	217	0	3	4	0	1
NIFICPP-61	261	262	1	1	3	4	1	0
NIFICPP-61	262	263	1	1	3	4	1	0
NIFICPP-61	262	477	215	0	3	1	1	0
NIFICPP-61	263	267	4	1	3	1	1	0
NIFICPP-61	263	283	20	1	3	2	1	0
NIFICPP-61	268	284	16	1	3	2	1	0
NIFICPP-61	269	477	208	0	3	2	0	0
NIFICPP-62	269	477	208	0	3	2	0	0
NIFICPP-62	269	477	208	0	3	5	0	0
NIFICPP-62	269	477	208	0	3	2	0	0
NIFICPP-62	269	294	25	1	3	2	1	0
NIFICPP-62	269	284	15	1	3	1	1	0
NIFICPP-62	274	283	9	1	5	4	1	0
NIFICPP-62	274	275	1	1	5	4	1	0
NIFICPP-62	275	309	34	1	5	4	1	0
NIFICPP-62	275	276	1	1	3	1	1	0
NIFICPP-62	275	477	202	0	3	4	0	0
NIFICPP-63	276	277	1	1	5	4	1	0
NIFICPP-63	276	277	1	1	5	4	1	0
NIFICPP-63	276	437	161	1	3	5	0	0
NIFICPP-63	276	477	201	0	3	5	0	0
NIFICPP-63	276	284	8	1	3	1	1	0
NIFICPP-63	277	283	6	1	3	1	1	0
NIFICPP-63	280	282	2	1	4	5	1	0
NIFICPP-63	280	281	1	1	4	5	1	0
NIFICPP-63	281	302	21	1	4	5	1	0
NIFICPP-63	283	477	194	0	2	1	0	0
NIFICPP-64	284	303	19	1	4	5	1	0
NIFICPP-64	287	311	24	1	4	2	1	0
NIFICPP-64	288	290	2	1	3	1	1	0
NIFICPP-64	289	290	1	1	1	1	1	0
NIFICPP-64	289	318	29	1	4	2	1	0
NIFICPP-64	289	319	30	1	1	4	1	0
NIFICPP-64	289	477	188	0	1	4	0	0
NIFICPP-64	289	291	2	1	1	4	1	0
NIFICPP-64	289	317	28	1	1	4	1	0
NIFICPP-64	290	309	19	1	4	4	1	0
NIFICPP-65	293	296	3	1	3	1	1	0
NIFICPP-65	294	477	183	0	3	4	0	0
NIFICPP-65	294	305	11	1	3	4	1	0
NIFICPP-65	295	309	14	1	1	4	1	0
NIFICPP-65	296	317	21	1	4	4	1	0
NIFICPP-65	297	477	180	0	3	1	0	0
NIFICPP-65	297	298	1	1	3	4	0	0
NIFICPP-65	301	477	176	0	2	5	0	0
NIFICPP-65	301	477	176	0	3	4	0	0
NIFICPP-65	301	303	2	1	3	4	1	0
NIFICPP-66	301	477	176	0	3	4	0	0
NIFICPP-66	302	303	1	1	3	4	0	0
NIFICPP-66	302	477	175	0	3	2	0	0
NIFICPP-66	302	303	1	1	2	1	1	0
NIFICPP-66	309	310	1	1	1	4	1	0
NIFICPP-66	314	477	163	0	3	4	0	0
NIFICPP-66	315	477	162	0	3	4	0	0
NIFICPP-66	315	437	122	1	3	4	1	0
NIFICPP-66	316	317	1	1	2	4	1	0
NIFICPP-66	317	477	160	0	3	4	0	0
NIFICPP-67	317	477	160	0	3	4	0	0
NIFICPP-67	317	477	160	0	3	4	0	0
NIFICPP-67	317	465	148	1	3	2	0	0
NIFICPP-67	317	477	160	0	3	5	0	0
NIFICPP-67	317	477	160	0	3	5	0	0
NIFICPP-67	317	318	1	1	3	1	1	0
NIFICPP-67	318	477	159	0	4	4	0	0
NIFICPP-67	318	319	1	1	3	5	1	0
NIFICPP-67	318	477	159	0	4	5	1	0
NIFICPP-67	318	477	159	0	3	4	1	0
NIFICPP-68	319	322	3	1	3	4	1	0
NIFICPP-68	322	437	115	1	3	4	1	0
NIFICPP-68	322	416	94	1	3	4	1	0
NIFICPP-68	322	477	155	0	3	4	0	0
NIFICPP-68	323	330	7	1	3	1	1	0
NIFICPP-68	329	437	108	1	4	4	1	0
NIFICPP-68	330	437	107	1	4	4	1	0
NIFICPP-68	331	477	146	0	3	4	0	0
NIFICPP-68	331	332	1	1	3	1	1	0
NIFICPP-68	338	345	7	1	4	4	1	0
NIFICPP-69	339	340	1	1	3	1	1	0
NIFICPP-69	339	343	4	1	3	3	1	0
NIFICPP-69	339	416	77	1	3	4	0	0
NIFICPP-69	339	347	8	1	3	4	1	0
NIFICPP-69	339	477	138	0	3	4	0	0
NIFICPP-69	339	386	47	1	1	1	1	0
NIFICPP-69	346	477	131	0	3	4	0	0
NIFICPP-69	350	373	23	1	3	4	1	0
NSTALL-14	40	41	1	1	4	5	1	0
NSTALL-14	62	237	175	1	1	4	1	4
NSTALL-14	104	105	1	1	4	5	1	0
NSTALL-14	180	181	1	1	5	3	1	0
NSTALL-14	213	214	1	1	4	5	1	0
NSTALL-14	224	230	6	1	4	5	1	0
NSTALL-14	265	266	1	1	1	3	1	0
NSTALL-14	265	266	1	1	1	3	1	0
NSTALL-15	265	266	1	1	4	3	1	0
NSTALL-15	273	477	204	0	3	1	0	2
NSTALL-15	273	477	204	0	3	1	0	1
NSTALL-15	277	477	200	0	4	3	0	0
NSTALL-15	281	355	74	1	5	1	1	0
NSTALL-15	352	354	2	1	4	5	1	0
NVOKER-23	43	44	1	1	4	5	1	0
NVOKER-23	78	89	11	1	3	2	1	2
NVOKER-23	98	108	10	1	4	5	1	0
NVOKER-23	98	130	32	1	4	5	1	0
NVOKER-23	112	113	1	1	3	4	1	0
NVOKER-23	130	131	1	1	4	3	1	0
NVOKER-23	131	145	14	1	3	5	1	1
NVOKER-23	203	213	10	1	4	5	1	0
NVOKER-24	206	382	176	1	4	1	0	0
NVOKER-24	213	382	169	1	3	1	0	0
NVOKER-24	233	477	244	0	4	4	0	0
NVOKER-24	264	375	111	1	1	1	1	1
NVOKER-24	285	477	192	0	4	5	1	0
NVOKER-24	322	382	60	1	3	4	1	0
AR-24	38	52	14	1	3	1	0	2
AR-24	38	88	50	1	4	1	1	0
AR-24	43	44	1	1	4	5	1	0
AR-24	74	75	1	1	4	3	0	1
AR-24	74	411	337	1	4	2	0	0
AR-24	86	88	2	1	1	1	1	0
AR-25	103	138	35	1	4	3	1	0
AR-25	136	137	1	1	4	5	1	1
AR-25	169	477	308	0	4	1	0	1
AR-25	171	380	209	1	4	1	0	1
AR-25	208	209	1	1	4	5	1	0
AR-25	220	242	22	1	4	5	1	0
AR-25	265	477	212	0	4	2	0	0
AR-25	295	296	1	1	3	2	0	0
AR-25	316	477	161	0	3	1	1	2
AR-26	319	339	20	1	4	4	1	1
AR-26	339	340	1	1	4	5	1	1
ARSIGNER-5	10	477	467	0	3	1	0	0
ARSIGNER-5	43	44	1	1	4	5	1	0
ARSIGNER-5	298	299	1	1	3	4	1	0
ARSIGNER-5	298	299	1	1	3	4	1	0
ARSIGNER-5	305	306	1	1	3	5	1	0
AVADOC-50	1	226	225	1	3	1	0	0
AVADOC-51	1	477	476	0	3	3	1	0
AVADOC-51	19	20	1	1	3	1	0	1
AVADOC-51	37	82	45	1	4	1	1	0
AVADOC-51	39	348	309	1	3	4	1	1
AVADOC-51	43	334	291	1	3	1	1	0
AVADOC-51	43	82	39	1	4	5	1	0
AVADOC-51	60	477	417	0	4	4	0	1
AVADOC-51	65	68	3	1	3	1	1	4
AVADOC-51	80	81	1	1	3	1	0	1
AVADOC-51	82	142	60	1	2	1	0	0
AVADOC-52	82	140	58	1	4	5	1	0
AVADOC-52	82	143	61	1	4	5	1	0
AVADOC-52	87	140	53	1	3	1	0	1
AVADOC-52	102	334	232	1	4	1	0	0
AVADOC-52	104	140	36	1	1	5	0	1
AVADOC-52	109	477	368	0	3	1	0	1
AVADOC-52	123	352	229	1	3	1	1	1
AVADOC-52	156	368	212	1	3	1	1	1
AVADOC-52	156	229	73	1	3	1	1	0
AVADOC-52	176	477	301	0	2	4	0	0
AVADOC-53	188	189	1	1	4	4	1	0
AVADOC-53	197	198	1	1	3	1	0	0
AVADOC-53	220	221	1	1	3	1	1	0
AVADOC-53	220	221	1	1	4	1	1	0
AVADOC-53	227	327	100	1	3	4	1	0
AVADOC-53	229	230	1	1	4	5	1	0
AVADOC-53	234	327	93	1	1	1	0	0
AVADOC-53	252	333	81	1	4	1	1	0
AVADOC-53	261	322	61	1	3	1	1	1
AVADOC-53	270	477	207	0	3	1	0	4
AVADOC-54	283	326	43	1	1	1	0	0
AVADOC-54	290	343	53	1	3	1	0	1
AVADOC-54	300	327	27	1	3	1	1	2
AVADOC-54	316	342	26	1	3	1	1	0
AVADOC-54	316	337	21	1	3	1	1	1
AVADOC-54	322	477	155	0	3	5	0	0
AVADOC-54	330	331	1	1	5	4	1	0
AVADOC-54	332	336	4	1	4	1	0	1
AVADOC-54	336	342	6	1	4	1	1	2
AVADOC-54	352	362	10	1	4	1	1	0
AVADOC-55	352	362	10	1	4	5	0	0
AVADOC-55	352	356	4	1	3	5	1	0
AVADOC-55	352	362	10	1	2	5	1	0
AVADOC-55	355	356	1	1	3	1	0	1
AVADOC-55	355	359	4	1	3	1	1	0
AVADOC-55	355	379	24	1	3	1	1	1
AVADOC-55	356	361	5	1	3	1	1	0
AVADOC-55	361	362	1	1	3	3	1	0
AVADOC-55	362	363	1	1	3	4	1	0
AVADOC-55	363	477	114	0	3	1	0	1
AVADOC-59	198	457	259	1	4	1	0	0
DEPRSCAN-	43	44	1	1	4	5	1	0
DEPS-1	29	54	25	1	3	4	1	0
DEPS-1	43	44	1	1	4	5	1	0
DEPS-1	76	477	401	0	3	2	0	0
DEPS-1	86	477	391	0	3	1	0	0
DEPS-1	207	477	270	0	3	2	0	0
DEPS-1	209	477	268	0	4	5	1	0
LINK-1	22	23	1	1	4	5	1	0
LINK-1	43	44	1	1	4	5	1	0
LINK-1	62	63	1	1	3	1	0	1
LINK-1	67	68	1	1	4	5	1	0
LINK-1	69	70	1	1	4	4	1	0
LINK-1	82	83	1	1	4	4	1	0
LINK-1	114	115	1	1	4	5	1	0
LINK-1	137	138	1	1	4	5	1	0
LINK-1	138	139	1	1	3	2	1	0
LINK-1	179	182	3	1	3	5	0	2
LINK-2	182	183	1	1	4	5	1	1
LINK-2	182	183	1	1	4	5	1	1
LINK-2	216	217	1	1	4	5	1	0
LINK-2	229	230	1	1	3	1	1	0
LINK-2	244	245	1	1	4	5	1	0
LINK-2	250	251	1	1	4	5	1	0
LINK-2	250	253	3	1	2	4	1	0
LINK-2	253	340	87	1	3	1	0	1
LINK-2	253	254	1	1	4	4	1	1
LINK-2	255	415	160	1	4	5	1	0
LINK-3	258	277	19	1	4	5	1	0
LINK-3	306	307	1	1	4	5	1	0
LINK-3	340	341	1	1	4	5	1	0
LINK-3	340	341	1	1	4	5	1	0
LINK-3	348	349	1	1	4	5	1	0
LINK-	7	8	1	1	4	5	1	0
LINK-	16	477	461	0	3	2	0	0
MOD-1	22	23	1	1	4	5	1	0
MOD-1	43	44	1	1	4	5	1	0
MOD-1	69	70	1	1	4	4	1	0
MOD-1	82	83	1	1	4	4	1	0
MOD-1	180	181	1	1	1	5	1	0
MOD-1	218	219	1	1	4	5	1	0
MOD-1	244	245	1	1	4	5	1	0
MOD-1	250	477	227	0	1	1	1	0
MOD-1	258	259	1	1	4	5	1	0
MOD-1	306	307	1	1	4	5	1	0
MOD-2	345	382	37	1	3	1	1	0
MOD-	7	8	1	1	4	5	1	0
INKCHECK-3	43	44	1	1	4	5	1	0
INKCHECK-3	209	210	1	1	4	5	1	0
INKCHECK-3	209	210	1	1	4	5	1	0
EMONIC-44	2	15	13	1	3	5	0	0
EMONIC-44	2	13	11	1	3	5	1	0
EMONIC-44	2	15	13	1	3	5	0	1
EMONIC-44	2	15	13	1	3	5	0	0
EMONIC-44	2	12	10	1	3	1	1	0
EMONIC-44	3	23	20	1	3	5	1	0
EMONIC-45	12	13	1	1	3	2	1	0
EMONIC-45	12	15	3	1	3	3	1	0
EMONIC-45	14	15	1	1	3	1	1	1
EMONIC-45	15	16	1	1	3	5	1	1
EMONIC-45	15	20	5	1	3	5	1	0
EMONIC-45	18	52	34	1	3	4	1	0
EMONIC-45	23	52	29	1	3	3	1	0
EMONIC-45	28	39	11	1	3	4	1	0
EMONIC-45	29	147	118	1	3	3	1	0
EMONIC-45	30	39	9	1	3	1	0	1
EMONIC-46	31	33	2	1	3	4	1	0
EMONIC-46	34	35	1	1	3	3	1	0
EMONIC-46	34	477	443	0	3	5	0	0
EMONIC-46	35	39	4	1	3	1	1	0
EMONIC-46	39	477	438	0	3	2	0	0
EMONIC-46	45	69	24	1	3	1	1	0
EMONIC-46	53	61	8	1	3	4	1	0
EMONIC-46	53	65	12	1	3	4	1	0
EMONIC-46	65	67	2	1	3	2	1	0
EMONIC-46	67	68	1	1	3	4	1	0
EMONIC-47	67	69	2	1	3	4	1	0
EMONIC-47	67	69	2	1	3	4	1	0
EMONIC-47	67	69	2	1	3	4	1	0
EMONIC-47	67	69	2	1	3	4	1	0
EMONIC-47	67	69	2	1	3	4	1	0
EMONIC-47	67	69	2	1	3	4	1	0
EMONIC-47	67	69	2	1	3	4	1	0
EMONIC-47	67	68	1	1	3	2	1	0
EMONIC-47	77	477	400	0	3	2	0	0
EMONIC-47	79	81	2	1	3	3	0	0
EMONIC-48	97	230	133	1	3	2	1	0
EMONIC-48	112	136	24	1	3	5	1	0
EMONIC-48	112	148	36	1	3	5	1	0
EMONIC-48	112	209	97	1	3	5	1	0
EMONIC-48	133	163	30	1	3	5	1	0
EMONIC-48	136	156	20	1	3	3	1	0
EMONIC-48	154	161	7	1	3	5	1	0
EMONIC-48	155	163	8	1	3	5	1	0
EMONIC-48	155	163	8	1	3	5	1	0
EMONIC-48	155	163	8	1	3	5	1	0
EMONIC-49	155	163	8	1	3	5	1	0
EMONIC-49	155	163	8	1	3	5	1	0
EMONIC-49	155	163	8	1	3	5	1	0
EMONIC-49	155	161	6	1	3	5	1	0
EMONIC-49	156	157	1	1	3	4	1	0
EMONIC-49	161	162	1	1	3	3	2	0
EMONIC-49	162	163	1	1	3	1	1	0
EMONIC-49	190	477	287	0	3	2	0	0
EMONIC-49	202	477	275	0	3	5	0	0
EMONIC-49	217	220	3	1	3	5	1	0
EMONIC-50	230	252	22	1	3	4	1	0
EMONIC-50	248	250	2	1	3	4	1	0
EMONIC-50	248	477	229	0	3	4	0	0
EMONIC-50	265	477	212	0	3	4	0	0
EMONIC-50	266	271	5	1	3	5	1	0
EMONIC-50	266	281	15	1	3	5	1	0
EMONIC-50	266	477	211	0	2	4	1	0
EMONIC-50	268	477	209	0	3	5	0	0
EMONIC-50	271	477	206	0	3	5	0	0
EMONIC-50	275	382	107	1	3	5	1	0
EMONIC-51	275	315	40	1	3	5	1	0
EMONIC-51	339	477	138	0	3	2	0	0
EMONIC-51	355	357	2	1	3	4	1	0
G-633	0	1	1	1	3	1	0	0
G-633	3	457	454	1	3	1	0	0
G-633	6	40	34	1	4	5	1	0
G-633	8	477	469	0	4	4	0	0
G-633	8	23	15	1	3	1	0	0
G-633	11	12	1	1	4	1	0	1
G-633	12	13	1	1	5	1	0	0
G-634	15	34	19	1	4	4	1	0
G-634	17	19	2	1	4	4	1	0
G-634	17	111	94	1	5	5	0	0
G-634	17	160	143	1	4	5	1	0
G-634	18	477	459	0	3	2	0	1
G-634	21	373	352	1	3	1	1	2
G-634	23	477	454	0	3	2	0	2
G-634	23	477	454	0	3	4	0	0
G-635	28	29	1	1	3	1	0	2
G-635	29	477	448	0	3	2	0	0
G-635	34	48	14	1	5	4	1	2
G-635	35	41	6	1	3	5	1	2
G-635	36	477	441	0	3	4	0	0
G-635	36	477	441	0	3	1	1	0
G-635	37	477	440	0	3	1	1	0
G-635	37	477	440	0	3	4	0	1
G-635	43	258	215	1	4	1	1	3
G-635	43	383	340	1	4	1	0	0
G-636	44	121	77	1	1	3	0	1
G-636	46	47	1	1	3	1	0	1
G-636	47	78	31	1	4	4	1	0
G-636	47	112	65	1	4	4	1	0
G-636	48	160	112	1	4	4	1	0
G-636	50	111	61	1	5	1	0	0
G-636	58	477	419	0	4	1	0	0
G-636	63	169	106	1	3	1	0	0
G-637	63	65	2	1	5	1	1	0
G-637	64	477	413	0	3	4	0	1
G-637	66	134	68	1	3	1	1	1
G-637	67	477	410	0	3	1	0	0
G-637	68	435	367	1	4	1	1	1
G-637	70	477	407	0	3	1	0	0
G-637	76	77	1	1	3	3	1	1
G-637	77	477	400	0	3	4	1	0
G-637	77	477	400	0	3	4	2	0
G-638	78	477	399	0	4	4	0	1
G-638	79	134	55	1	3	1	1	2
G-638	81	211	130	1	3	1	1	2
G-638	86	477	391	0	3	1	0	0
G-638	87	477	390	0	3	1	1	4
G-638	88	126	38	1	3	1	1	2
G-638	88	477	389	0	5	5	0	0
G-638	91	159	68	1	3	1	1	4
G-638	93	477	384	0	3	4	1	0
G-639	98	324	226	1	3	4	0	0
G-639	99	292	193	1	4	4	1	0
G-639	101	477	376	0	3	2	0	1
G-639	102	212	110	1	3	1	0	0
G-639	103	477	374	0	4	4	0	0
G-639	104	105	1	1	3	1	0	0
G-639	108	477	369	0	2	1	0	0
G-639	110	457	347	1	3	1	0	0
G-639	112	477	365	0	4	3	1	0
G-640	113	272	159	1	1	1	0	0
G-640	121	477	356	0	4	1	1	2
G-640	122	477	355	0	3	1	0	0
G-640	124	129	5	1	3	1	1	0
G-640	128	129	1	1	3	1	0	0
G-640	129	477	348	0	3	1	0	1
G-640	126	129	3	1	4	1	0	0
G-640	130	131	1	1	3	2	0	0
G-640	130	131	1	1	2	2	0	0
G-640	130	131	1	1	2	2	0	0
G-641	130	139	9	1	4	1	1	1
G-641	130	137	7	1	4	4	1	0
G-641	135	301	166	1	2	1	1	2
G-641	140	477	337	0	3	3	0	2
G-641	141	258	117	1	4	4	1	2
G-641	141	266	125	1	3	1	1	1
G-641	143	278	135	1	3	1	0	0
G-641	145	364	219	1	4	1	0	0
G-641	149	150	1	1	1	1	0	1
G-641	149	150	1	1	3	1	0	1
G-642	150	477	327	0	3	1	1	0
G-642	150	151	1	1	3	1	0	0
G-642	156	168	12	1	3	1	0	1
G-642	158	159	1	1	3	5	1	1
G-642	159	211	52	1	4	5	1	0
G-642	161	411	250	1	3	1	0	0
G-642	165	166	1	1	3	1	0	0
G-642	165	166	1	1	3	1	0	0
G-642	165	166	1	1	3	1	0	0
G-642	167	367	200	1	2	1	1	1
G-643	169	477	308	0	3	1	0	0
G-643	171	172	1	1	2	1	0	0
G-643	171	477	306	0	4	1	0	0
G-643	175	411	236	1	3	1	0	0
G-643	176	477	301	0	3	1	0	0
G-643	177	477	300	0	4	4	0	0
G-643	178	477	299	0	3	1	0	0
G-643	179	477	298	0	3	4	1	1
G-643	182	477	295	0	3	1	0	2
G-644	188	282	94	1	4	4	0	2
G-644	190	477	287	0	4	5	0	0
G-644	191	477	286	0	5	1	0	0
G-644	195	477	282	0	4	3	0	2
G-644	195	457	262	1	3	1	0	0
G-644	196	477	281	0	3	1	0	0
G-644	199	209	10	1	4	5	1	2
G-645	204	477	273	0	3	4	0	0
G-645	212	213	1	1	3	1	0	0
G-645	215	216	1	1	3	1	0	2
G-645	216	477	261	0	3	2	0	0
G-645	217	305	88	1	4	1	0	0
G-645	225	477	252	0	4	4	1	1
G-645	225	477	252	0	3	1	0	0
G-645	225	226	1	1	4	1	0	0
G-645	227	228	1	1	3	1	0	1
G-646	228	477	249	0	3	1	0	0
G-646	233	235	2	1	3	1	0	0
G-646	238	239	1	1	5	4	1	0
G-646	239	240	1	1	3	1	0	0
G-646	241	477	236	0	4	1	1	0
G-647	241	242	1	1	2	1	0	0
G-647	248	477	229	0	3	4	0	0
G-647	251	256	5	1	4	1	1	2
G-647	251	256	5	1	5	5	1	2
G-647	253	477	224	0	3	1	0	0
G-647	253	255	2	1	5	3	1	1
G-647	256	411	155	1	2	4	0	0
G-647	257	258	1	1	3	5	1	3
G-647	258	273	15	1	5	5	1	0
G-648	258	315	57	1	4	4	1	4
G-648	268	399	131	1	3	1	0	0
G-648	269	477	208	0	3	4	0	0
G-648	269	307	38	1	4	1	0	0
G-648	270	271	1	1	1	1	0	0
G-648	274	278	4	1	3	5	1	0
G-648	278	477	199	0	2	4	0	1
G-648	278	279	1	1	4	1	0	4
G-648	281	282	1	1	3	5	1	3
G-649	283	296	13	1	1	1	1	2
G-649	284	286	2	1	5	5	1	3
G-649	287	296	9	1	4	4	1	0
G-649	288	418	130	1	3	1	0	0
G-649	288	411	123	1	3	1	1	0
G-649	289	290	1	1	3	5	1	2
G-649	293	296	3	1	4	5	1	0
G-649	296	297	1	1	2	1	0	0
G-649	298	457	159	1	3	2	0	0
G-650	302	399	97	1	3	1	0	0
G-650	303	411	108	1	4	1	0	0
G-650	303	399	96	1	3	4	0	0
G-650	304	329	25	1	2	1	0	1
G-650	307	309	2	1	4	1	0	1
G-650	307	314	7	1	2	1	1	2
G-650	307	452	145	1	3	1	1	1
G-650	308	477	169	0	4	2	1	0
G-650	310	399	89	1	2	1	0	0
G-650	311	312	1	1	4	5	0	1
G-651	312	313	1	1	4	1	0	1
G-651	312	477	165	0	3	4	0	0
G-651	313	477	164	0	4	5	1	2
G-651	313	367	54	1	5	4	1	1
G-651	315	316	1	1	4	4	1	2
G-651	318	326	8	1	3	1	0	0
G-651	321	322	1	1	3	1	0	0
G-651	321	322	1	1	3	3	0	0
G-652	321	371	50	1	5	4	1	0
G-652	322	383	61	1	4	4	1	4
G-652	323	477	154	0	3	5	1	0
G-652	329	330	1	1	3	1	0	0
G-652	330	412	82	1	3	5	0	0
G-652	330	370	40	1	3	5	1	2
G-652	330	399	69	1	3	5	0	0
G-652	330	399	69	1	3	5	0	0
G-652	330	359	29	1	2	1	1	1
G-653	331	372	41	1	2	1	1	3
G-653	332	336	4	1	3	1	0	0
G-653	332	379	47	1	3	1	1	1
G-653	337	477	140	0	5	5	0	0
G-653	337	411	74	1	3	1	0	0
G-653	340	341	1	1	3	1	0	0
G-653	342	447	105	1	3	3	1	2
G-653	351	352	1	1	3	1	0	0
G-654	352	477	125	0	3	1	0	0
G-654	353	370	17	1	3	5	0	1
G-654	357	411	54	1	3	1	0	0
G-654	360	452	92	1	3	1	1	1
G-654	360	361	1	1	3	3	1	0
G-654	362	477	115	0	4	4	0	0
G-657	203	477	274	0	3	2	1	0
GSITE-32	33	35	2	1	3	1	0	1
GSITE-32	72	199	127	1	3	1	0	1
GSITE-32	76	240	164	1	2	3	0	2
GSITE-32	76	130	54	1	3	5	0	3
GSITE-32	86	87	1	1	2	1	0	0
GSITE-33	86	188	102	1	2	3	0	0
GSITE-33	88	477	389	0	4	1	0	0
GSITE-33	95	182	87	1	2	3	0	1
GSITE-33	101	102	1	1	3	1	0	0
GSITE-33	51	111	60	1	3	1	0	0
GSITE-33	136	137	1	1	4	1	0	0
GSITE-33	184	477	293	0	3	1	0	0
GSITE-33	191	199	8	1	4	1	0	0
GSITE-33	196	199	3	1	3	1	0	0
GSITE-34	199	200	1	1	3	1	0	0
GSITE-34	203	244	41	1	3	1	0	1
GSITE-34	207	212	5	1	4	1	0	0
GSITE-34	207	211	4	1	4	4	0	0
GSITE-34	212	213	1	1	3	1	0	0
GSITE-34	212	213	1	1	1	1	0	0
GSITE-34	227	228	1	1	5	1	0	0
GSITE-34	228	477	249	0	3	1	0	0
GSITE-34	235	477	242	0	3	4	0	0
GSITE-35	235	236	1	1	5	4	0	0
GSITE-35	235	477	242	0	3	4	0	0
GSITE-35	235	477	242	0	3	4	0	0
GSITE-35	255	477	222	0	3	4	0	0
GSITE-35	267	268	1	1	5	1	0	0
GSITE-35	287	477	190	0	3	1	0	0
GSITE-35	303	477	174	0	4	4	0	0
GSITE-35	318	319	1	1	5	1	0	0
GSITE-35	336	477	141	0	5	1	0	0
GSITE-36	341	346	5	1	3	3	0	2
GSITE-36	349	350	1	1	4	4	0	0
GSITE-36	349	477	128	0	4	4	0	0
ATCH-1	43	422	379	1	4	5	1	0
ATCH-1	63	477	414	0	2	1	0	1
ATCH-2	63	477	414	0	3	2	0	1
DF-8	37	146	109	1	3	3	1	1
DF-8	60	61	1	1	3	3	1	1
DF-8	114	115	1	1	3	3	1	1
DF-8	146	477	331	0	3	4	0	1
DF-9	205	206	1	1	4	5	1	0
DF-9	206	207	1	1	4	5	1	0
H-12	43	61	18	1	4	5	1	0
H-12	62	63	1	1	3	3	1	0
H-12	62	63	1	1	3	5	1	0
H-12	62	63	1	1	3	5	1	0
H-12	62	63	1	1	3	5	1	0
H-13	62	63	1	1	3	5	1	0
H-13	62	63	1	1	3	5	1	0
H-13	62	64	2	1	3	3	1	1
H-13	62	64	2	1	3	3	1	0
H-13	62	64	2	1	3	3	1	0
H-13	67	76	9	1	1	1	1	1
H-13	76	77	1	1	3	5	1	0
H-13	76	77	1	1	3	3	1	0
H-13	76	77	1	1	3	3	1	2
H-13	76	77	1	1	3	1	1	1
H-14	76	77	1	1	1	1	1	1
H-14	76	77	1	1	3	3	1	0
H-14	77	81	4	1	3	1	0	0
H-14	78	80	2	1	3	1	0	1
H-14	84	88	4	1	4	2	1	1
H-14	88	89	1	1	1	3	1	0
H-14	88	89	1	1	5	3	1	0
H-14	88	89	1	1	4	5	1	0
H-14	89	90	1	1	4	5	1	0
H-14	89	90	1	1	4	5	1	0
H-15	89	90	1	1	4	4	0	0
H-15	90	91	1	1	4	4	1	1
H-15	156	477	321	0	4	4	0	1
H-15	203	204	1	1	4	5	1	0
H-15	210	310	100	1	3	4	1	1
H-15	333	341	8	1	3	1	0	1
H-15	334	335	1	1	4	5	1	0
H-15	334	335	1	1	4	5	1	0
H-15	334	335	1	1	4	5	1	0
H-15	334	335	1	1	4	5	1	0
H-16	342	477	135	0	3	2	0	4
H-16	342	477	135	0	3	4	0	0
IR-36	43	119	76	1	4	5	1	1
IR-36	59	130	71	1	3	1	1	1
IR-36	69	166	97	1	3	5	1	4
IR-36	69	119	50	1	3	1	0	3
IR-36	69	70	1	1	4	1	1	1
IR-36	88	116	28	1	3	4	1	4
IR-36	95	97	2	1	3	3	1	0
IR-36	119	120	1	1	3	3	1	0
IR-36	119	120	1	1	3	3	1	0
IR-37	147	173	26	1	4	1	1	1
IR-37	170	172	2	1	3	1	0	1
IR-37	173	174	1	1	3	3	1	0
IR-37	181	477	296	0	4	1	0	2
IR-37	190	477	287	0	4	1	0	3
IR-37	231	375	144	1	3	2	1	0
IR-37	256	477	221	0	3	1	0	0
IR-37	317	331	14	1	4	1	0	0
IR-37	345	477	132	0	3	1	0	0
LUGIN-33	1	5	4	1	3	3	1	1
LUGIN-33	14	280	266	1	3	3	1	1
LUGIN-33	123	132	9	1	4	5	1	0
LUGIN-33	123	139	16	1	1	5	1	0
LUGIN-33	123	124	1	1	3	5	1	0
LUGIN-33	130	280	150	1	1	1	1	1
LUGIN-33	131	282	151	1	3	1	1	0
LUGIN-33	132	133	1	1	2	5	1	0
LUGIN-33	135	280	145	1	3	1	0	0
LUGIN-34	145	477	332	0	3	5	0	0
LUGIN-34	165	477	312	0	4	4	0	2
LUGIN-34	229	280	51	1	4	5	1	0
LUGIN-34	278	477	199	0	3	1	0	0
LUGIN-34	300	301	1	1	3	3	1	0
LUGIN-34	332	477	145	0	3	1	0	0
LUGIN-34	354	355	1	1	3	1	1	0
LUGIN-34	357	459	102	1	3	2	0	0
LUGINTESTING-5	76	77	1	1	3	3	1	1
LUGINTESTING-5	87	477	390	0	4	3	1	0
LUGINTESTING-5	106	477	371	0	3	1	0	0
LUGINTESTING-5	106	477	371	0	3	4	0	0
LUGINTESTING-5	175	477	302	0	1	5	1	0
LUGINTESTING-6	235	477	242	0	3	5	0	0
MD-25	9	477	468	0	3	3	0	0
MD-25	16	17	1	1	3	1	1	0
MD-25	43	120	77	1	4	5	1	0
MD-25	51	55	4	1	4	1	1	0
MD-25	52	77	25	1	3	1	0	1
MD-25	71	117	46	1	3	4	0	2
MD-25	77	79	2	1	3	2	1	0
MD-25	103	116	13	1	3	1	1	1
MD-25	109	116	7	1	3	1	1	2
MD-25	115	118	3	1	3	1	1	3
MD-26	115	116	1	1	3	4	0	1
MD-26	115	116	1	1	3	4	1	2
MD-26	120	121	1	1	4	5	1	0
MD-26	142	145	3	1	4	4	1	1
MD-26	148	149	1	1	3	4	1	0
MD-26	158	171	13	1	3	4	0	0
MD-26	161	287	126	1	3	1	1	1
MD-26	169	411	242	1	3	1	0	0
MD-26	170	173	3	1	3	1	1	0
MD-26	195	477	282	0	3	2	0	0
MD-27	274	275	1	1	3	3	1	0
MD-27	275	276	1	1	3	5	1	0
MD-27	275	286	11	1	3	2	1	0
MD-27	282	477	195	0	3	1	0	0
MD-27	288	300	12	1	3	3	0	0
MD-27	302	457	155	1	3	5	1	0
OM-17	4	5	1	1	3	2	1	1
OM-17	26	30	4	1	5	5	1	0
OM-17	27	28	1	1	3	3	1	0
OM-17	27	28	1	1	3	3	1	0
OM-17	27	30	3	1	3	3	1	0
OM-18	29	30	1	1	3	3	1	0
OM-18	29	30	1	1	3	3	1	1
OM-18	30	31	1	1	3	3	1	1
OM-18	50	51	1	1	3	3	1	2
OM-18	82	88	6	1	2	5	2	2
OM-18	165	169	4	1	3	5	0	3
OM-18	169	178	9	1	4	4	1	3
OM-18	171	192	21	1	4	4	1	0
OM-18	172	173	1	1	3	5	1	0
OM-18	172	173	1	1	3	4	1	0
OM-19	173	174	1	1	5	4	1	0
OM-19	173	174	1	1	4	4	1	0
OM-19	174	175	1	1	4	5	1	0
OM-19	182	192	10	1	4	5	1	0
OM-19	184	185	1	1	3	5	1	1
OM-19	185	186	1	1	3	5	1	1
OM-19	188	477	289	0	4	5	1	2
OM-19	188	240	52	1	4	5	1	0
OM-19	188	250	62	1	5	5	1	0
OM-19	200	201	1	1	3	3	1	1
OM-20	200	477	277	0	3	3	0	1
OM-20	201	202	1	1	3	3	1	0
OM-20	208	209	1	1	3	1	1	0
OM-20	208	209	1	1	4	4	1	0
OM-20	210	237	27	1	3	5	0	0
OM-20	217	222	5	1	3	2	1	4
OM-20	237	238	1	1	3	3	1	1
OM-20	238	477	239	0	4	5	1	0
OM-20	251	477	226	0	3	5	1	1
OM-20	255	384	129	1	2	1	1	0
OM-21	278	477	199	0	2	4	1	1
OM-21	301	386	85	1	3	4	0	1
OM-21	342	398	56	1	3	5	1	0
OM-21	361	477	116	0	4	5	1	0
T-4	196	197	1	1	3	5	1	0
T-4	196	197	1	1	3	4	0	0
T-4	308	309	1	1	3	2	0	0
T-4	329	477	148	0	3	1	0	0
AR-7	15	53	38	1	3	5	1	0
AR-7	43	53	10	1	4	5	1	0
AR-7	87	88	1	1	1	3	1	0
AR-7	88	89	1	1	1	1	1	0
AR-7	132	153	21	1	1	5	1	0
AR-7	132	167	35	1	1	5	0	1
AR-7	153	154	1	1	4	5	1	1
AR-7	186	187	1	1	4	4	1	0
AR-7	187	188	1	1	1	1	1	0
AR-7	203	208	5	1	4	5	1	0
AR-8	230	231	1	1	4	5	1	0
AR-8	346	347	1	1	3	1	0	0
ELEASE-100	53	477	424	0	3	4	0	0
ELEASE-100	59	477	418	0	3	3	0	1
ELEASE-100	59	477	418	0	3	3	0	1
ELEASE-100	59	75	16	1	3	3	0	2
ELEASE-100	63	477	414	0	3	1	0	0
ELEASE-100	63	64	1	1	3	4	1	0
ELEASE-100	72	477	405	0	3	2	0	0
ELEASE-100	82	83	1	1	3	4	1	0
ELEASE-100	146	477	331	0	3	1	0	0
ELEASE-100	178	179	1	1	3	1	1	0
ELEASE-101	204	236	32	1	4	5	1	0
ELEASE-101	217	477	260	0	3	4	0	0
ELEASE-101	226	477	251	0	4	4	0	0
ELEASE-101	259	457	198	1	3	1	0	0
ELEASE-101	268	477	209	0	3	2	0	0
ELEASE-101	270	477	207	0	3	2	0	0
ELEASE-101	295	477	182	0	1	1	0	1
ELEASE-101	306	477	171	0	3	1	0	0
ELEASE-99	30	477	447	0	3	1	0	0
ELEASE-99	39	44	5	1	3	1	1	1
ELEASE-99	40	41	1	1	3	2	1	0
ELEASE-99	52	477	425	0	3	1	0	0
EPOSITORY-4	43	98	55	1	4	5	1	0
EPOSITORY-4	98	99	1	1	4	5	1	0
EPOSITORY-4	173	174	1	1	4	4	1	0
EPOSITORY-4	173	174	1	1	4	5	1	0
ESOLVER-4	16	211	195	1	5	4	0	0
ESOLVER-4	26	27	1	1	3	1	0	0
ESOLVER-4	41	63	22	1	3	4	1	0
ESOLVER-4	60	477	417	0	4	4	0	0
ESOLVER-4	76	77	1	1	3	3	1	3
ESOLVER-4	85	86	1	1	3	1	1	2
ESOLVER-4	159	270	111	1	3	2	1	0
ESOLVER-4	171	202	31	1	4	4	1	0
ESOLVER-4	193	202	9	1	4	4	1	0
ESOLVER-5	206	267	61	1	4	1	1	2
ESOLVER-5	211	212	1	1	4	5	1	0
ESOLVER-5	214	267	53	1	3	1	0	0
ESOLVER-5	217	432	215	1	3	5	1	0
ESOLVER-5	235	236	1	1	3	1	0	1
ESOLVER-5	235	411	176	1	3	1	0	2
ESOLVER-5	245	477	232	0	3	4	0	1
ESOLVER-5	272	273	1	1	3	5	1	0
ESOLVER-5	272	273	1	1	3	5	1	0
ESOLVER-5	272	273	1	1	3	5	1	0
ESOLVER-6	282	283	1	1	1	1	1	2
ESOLVER-6	287	342	55	1	2	1	1	0
ESOLVER-6	296	477	181	0	4	1	0	0
ESOLVER-6	305	319	14	1	3	4	1	0
ESOLVER-6	337	342	5	1	3	5	1	2
ESOURCES-24	43	52	9	1	4	5	1	0
ESOURCES-24	52	53	1	1	1	1	1	0
ESOURCES-24	87	88	1	1	1	3	1	0
ESOURCES-24	88	89	1	1	4	5	1	0
ESOURCES-24	94	95	1	1	3	3	1	0
ESOURCES-24	103	104	1	1	3	1	0	0
ESOURCES-24	50	112	62	1	5	4	1	0
ESOURCES-24	112	113	1	1	4	5	1	0
ESOURCES-24	203	204	1	1	4	5	1	0
M-197	1	477	476	0	3	5	0	0
M-197	52	433	381	1	4	1	1	0
M-197	104	105	1	1	3	5	0	0
M-197	106	433	327	1	3	3	0	0
M-197	106	477	371	0	3	3	0	1
M-197	110	111	1	1	3	1	0	0
M-197	130	433	303	1	3	1	0	0
M-197	132	477	345	0	3	3	1	0
M-197	144	145	1	1	3	5	0	0
M-198	163	477	314	0	3	1	1	0
M-198	176	477	301	0	2	2	1	0
M-198	182	433	251	1	3	1	0	0
M-198	212	477	265	0	4	1	1	0
M-198	285	477	192	0	4	1	0	0
RESOURCES-10	43	216	173	1	4	5	1	1
RESOURCES-10	83	173	90	1	4	5	1	1
RESOURCES-10	83	216	133	1	1	1	0	0
RESOURCES-10	142	477	335	0	3	1	0	1
RESOURCES-10	216	217	1	1	4	5	1	0
RESOURCES-10	216	217	1	1	4	5	1	0
RESOURCES-10	216	217	1	1	4	5	1	0
RESOURCES-11	258	265	7	1	4	5	1	0
RESOURCES-11	294	300	6	1	3	5	1	0
CMPUB-3	43	44	1	1	4	5	1	0
CMPUB-3	166	167	1	1	3	5	1	3
CMPUB-3	204	342	138	1	4	5	0	1
CMPUB-3	306	477	171	0	4	5	1	1
HADE-27	10	457	447	1	3	1	0	0
HADE-27	17	457	440	1	4	4	0	0
HADE-27	40	477	437	0	4	5	0	0
HADE-27	41	44	3	1	3	1	1	0
HADE-27	66	477	411	0	4	1	0	0
HADE-27	81	91	10	1	3	1	1	1
HADE-27	81	82	1	1	4	5	1	0
HADE-27	81	91	10	1	1	4	1	1
HADE-27	89	91	2	1	4	4	1	0
HADE-27	90	91	1	1	4	5	1	0
HADE-28	90	91	1	1	4	5	1	0
HADE-28	90	91	1	1	4	5	1	0
HADE-28	91	92	1	1	5	5	1	0
HADE-28	91	92	1	1	4	4	1	0
HADE-28	91	477	386	0	3	1	0	2
HADE-28	91	477	386	0	3	4	0	1
HADE-28	91	477	386	0	4	4	0	1
HADE-28	99	477	378	0	3	4	0	0
HADE-28	149	477	328	0	3	1	0	0
HADE-28	162	230	68	1	3	1	1	0
HADE-29	167	444	277	1	3	1	0	0
HADE-29	168	314	146	1	3	1	1	1
HADE-29	175	477	302	0	4	1	0	0
HADE-29	196	197	1	1	3	4	1	0
HADE-29	207	210	3	1	4	5	1	0
HADE-29	213	477	264	0	3	1	0	0
HADE-29	230	231	1	1	4	5	1	0
HADE-29	238	477	239	0	3	1	1	0
HADE-29	239	477	238	0	4	1	0	1
HADE-29	249	302	53	1	4	5	1	0
HADE-30	261	273	12	1	3	2	0	0
HADE-30	275	276	1	1	3	3	1	1
HADE-30	291	309	18	1	3	1	1	1
HADE-30	302	303	1	1	3	4	1	0
HADE-30	324	477	153	0	4	4	0	0
HADE-30	345	346	1	1	3	1	0	1
HADE-30	348	477	129	0	3	2	0	0
HADE-30	348	477	129	0	3	2	0	0
HADE-30	352	477	125	0	3	2	0	0
HADE-30	354	444	90	1	4	1	1	0
HADE-31	354	355	1	1	3	1	0	0
HADE-31	337	477	140	0	5	1	1	0
HARED-67	3	4	1	1	3	1	1	2
HARED-67	10	62	52	1	4	1	0	0
HARED-67	15	62	47	1	4	1	0	0
HARED-67	27	28	1	1	4	4	1	0
HARED-67	27	28	1	1	4	4	1	0
HARED-67	28	61	33	1	4	4	1	0
HARED-68	32	62	30	1	4	4	0	0
HARED-68	42	43	1	1	4	5	1	0
HARED-68	46	348	302	1	3	5	1	0
HARED-68	53	54	1	1	4	4	1	0
HARED-68	53	477	424	0	4	4	1	0
HARED-68	55	81	26	1	4	5	1	0
HARED-68	55	477	422	0	4	4	0	1
HARED-68	62	477	415	0	3	4	0	0
HARED-68	62	63	1	1	4	5	1	0
HARED-69	62	63	1	1	3	4	1	0
HARED-69	62	63	1	1	4	4	1	0
HARED-69	62	63	1	1	4	5	1	0
HARED-69	62	63	1	1	4	5	1	0
HARED-69	62	63	1	1	4	5	1	0
HARED-69	64	180	116	1	1	4	1	0
HARED-69	64	65	1	1	4	4	1	0
HARED-69	64	68	4	1	4	4	1	0
HARED-69	68	180	112	1	2	3	1	0
HARED-69	68	69	1	1	4	5	1	0
HARED-70	71	73	2	1	4	5	1	0
HARED-70	73	81	8	1	1	4	1	0
HARED-70	76	77	1	1	4	4	1	0
HARED-70	80	180	100	1	2	3	1	0
HARED-70	80	477	397	0	4	2	1	1
HARED-70	81	180	99	1	4	4	1	0
HARED-70	81	82	1	1	4	4	1	0
HARED-70	82	83	1	1	4	5	1	0
HARED-70	82	83	1	1	1	5	1	1
HARED-70	82	477	395	0	1	5	1	0
HARED-71	83	84	1	1	1	1	1	1
HARED-71	87	88	1	1	4	3	1	0
HARED-71	87	88	1	1	1	3	1	0
HARED-71	95	96	1	1	4	5	1	0
HARED-71	95	96	1	1	4	5	1	0
HARED-71	95	118	23	1	4	5	1	0
HARED-71	96	97	1	1	4	3	1	0
HARED-71	98	99	1	1	4	5	1	0
HARED-71	104	131	27	1	2	5	1	1
HARED-71	104	154	50	1	4	5	0	1
HARED-72	105	320	215	1	3	5	0	0
HARED-72	105	320	215	1	4	5	1	0
HARED-72	118	119	1	1	1	1	1	0
HARED-72	118	119	1	1	1	1	1	0
HARED-72	121	188	67	1	4	5	1	0
HARED-72	125	320	195	1	2	5	1	1
HARED-72	125	188	63	1	1	5	1	0
HARED-72	128	131	3	1	4	5	1	0
HARED-72	145	146	1	1	3	3	1	0
HARED-73	153	174	21	1	4	5	1	0
HARED-73	153	188	35	1	4	5	0	1
HARED-73	154	155	1	1	4	5	1	1
HARED-73	154	155	1	1	4	5	1	0
HARED-73	159	160	1	1	4	5	1	0
HARED-73	171	188	17	1	4	4	1	0
HARED-73	174	188	14	1	4	5	1	0
HARED-73	174	175	1	1	1	5	1	0
HARED-73	180	188	8	1	1	5	1	0
HARED-74	180	181	1	1	4	5	1	0
HARED-74	181	182	1	1	4	3	1	0
HARED-74	181	187	6	1	4	1	1	0
HARED-74	188	189	1	1	2	3	1	0
HARED-74	188	189	1	1	4	5	1	0
HARED-74	188	189	1	1	4	5	1	0
HARED-74	201	208	7	1	4	5	1	0
HARED-74	206	207	1	1	2	4	1	0
HARED-74	207	209	2	1	3	1	1	0
HARED-75	207	209	2	1	3	1	1	0
HARED-75	215	216	1	1	4	5	1	0
HARED-75	218	477	259	0	4	5	1	0
HARED-75	220	221	1	1	4	4	1	0
HARED-75	221	233	12	1	4	5	1	0
HARED-75	244	245	1	1	4	5	1	0
HARED-75	244	245	1	1	4	5	1	0
HARED-75	244	245	1	1	4	5	1	0
HARED-75	244	245	1	1	4	5	1	0
HARED-75	248	312	64	1	4	5	1	0
HARED-76	273	349	76	1	1	2	0	1
HARED-76	275	280	5	1	3	1	1	1
HARED-76	277	278	1	1	2	1	0	0
HARED-76	281	477	196	0	3	4	0	2
HARED-76	298	299	1	1	3	4	1	0
HARED-76	312	313	1	1	4	4	1	0
HARED-76	312	477	165	0	3	3	0	0
HARED-76	312	477	165	0	3	4	1	0
HARED-76	312	477	165	0	3	1	0	0
HARED-77	313	317	4	1	4	4	1	3
HARED-77	313	477	164	0	4	5	1	0
HARED-77	317	339	22	1	1	1	0	1
HARED-77	320	321	1	1	4	4	1	1
HARED-77	320	321	1	1	4	5	1	0
HARED-77	320	321	1	1	4	5	1	0
HARED-77	320	321	1	1	4	5	1	0
HARED-77	322	358	36	1	4	4	1	0
HARED-77	334	335	1	1	3	1	1	1
HARED-77	335	336	1	1	4	5	1	0
HARED-78	339	341	2	1	4	4	1	0
HARED-78	339	390	51	1	4	5	1	2
HARED-78	340	358	18	1	4	1	1	1
HARED-78	340	358	18	1	4	1	1	0
HARED-78	344	351	7	1	3	3	0	1
HARED-78	351	477	126	0	4	1	0	0
HARED-78	352	353	1	1	3	1	1	1
HARED-78	358	396	38	1	3	2	1	4
HARED-78	359	477	118	0	3	4	0	1
HARED-78	360	361	1	1	4	5	1	0
HARED-79	360	361	1	1	4	5	1	0
HARED-79	360	411	51	1	4	5	1	0
ITE-80	1	60	59	1	4	1	1	2
ITE-80	6	477	471	0	3	4	0	1
ITE-80	15	57	42	1	3	4	0	1
ITE-80	36	38	2	1	4	1	1	1
ITE-81	37	174	137	1	1	1	0	0
ITE-81	52	93	41	1	4	4	1	0
ITE-81	63	113	50	1	3	1	1	0
ITE-81	88	89	1	1	3	5	0	0
ITE-81	90	91	1	1	3	5	1	0
ITE-81	92	221	129	1	2	1	0	1
ITE-81	104	113	9	1	3	1	1	1
ITE-81	112	113	1	1	3	1	1	3
ITE-81	112	113	1	1	3	4	1	1
ITE-82	112	477	365	0	3	5	1	2
ITE-82	113	114	1	1	3	3	1	0
ITE-82	118	454	336	1	1	1	0	2
ITE-82	128	477	349	0	3	1	1	2
ITE-82	132	477	345	0	3	4	0	1
ITE-82	149	150	1	1	3	1	0	0
ITE-82	229	477	248	0	3	1	0	0
ITE-82	302	318	16	1	3	3	1	3
ITE-82	316	318	2	1	3	3	1	2
ITE-83	317	477	160	0	3	4	0	2
KINS-14	69	70	1	1	3	4	1	1
KINS-14	81	153	72	1	1	1	1	0
KINS-14	184	201	17	1	3	1	1	0
OURCES-10	38	477	439	0	4	1	0	0
OURCES-10	52	54	2	1	4	1	1	1
OURCES-10	52	53	1	1	4	5	1	0
OURCES-11	52	54	2	1	4	4	1	1
OURCES-11	80	81	1	1	4	5	1	0
OURCES-11	80	81	1	1	4	5	1	0
OURCES-11	86	477	391	0	3	2	1	1
OURCES-11	94	95	1	1	1	5	1	0
OURCES-11	101	477	376	0	3	1	0	0
OURCES-11	153	203	50	1	4	5	1	0
OURCES-11	203	204	1	1	4	5	1	0
OURCES-11	244	245	1	1	4	5	1	0
OURCES-11	316	477	161	0	3	1	0	0
TAGE-2	119	120	1	1	4	5	1	0
OMCAT-31	52	477	425	0	3	5	1	0
OMCAT-31	150	477	327	0	3	5	0	0
OMCAT-31	183	477	294	0	4	1	0	0
OMCAT-31	249	477	228	0	1	1	0	0
OOLCHAINS-2	52	88	36	1	4	4	1	0
OOLCHAINS-2	127	128	1	1	3	3	1	0
OOLCHAINS-2	203	233	30	1	4	5	1	0
ERIFIER-2	52	62	10	1	4	4	1	0
ERIFIER-2	88	89	1	1	1	1	1	0
ERIFIER-2	88	118	30	1	1	1	1	0
ERIFIER-2	118	119	1	1	4	5	1	0
ERIFIER-2	153	154	1	1	4	5	1	0
ERIFIER-3	177	178	1	1	3	1	0	0
ERIFIER-3	210	211	1	1	4	5	1	0
ERIFIER-3	230	231	1	1	4	4	1	0
ERIFIER-3	230	233	3	1	4	4	1	0
AR-41	14	15	1	1	3	1	0	0
AR-41	52	62	10	1	4	4	1	0
AR-41	90	91	1	1	4	5	1	0
AR-41	90	91	1	1	4	5	1	0
AR-41	116	477	361	0	3	1	0	0
AR-41	125	126	1	1	2	5	1	0
AR-41	129	152	23	1	1	5	1	1
AR-41	186	477	291	0	3	1	0	0
AR-41	203	204	1	1	4	5	1	0
AR-42	310	477	167	0	3	1	0	0
AR-42	351	411	60	1	3	1	0	0
NET-1	35	477	442	0	3	5	0	0
NET-10	72	477	405	0	3	4	0	0
NET-100	269	477	208	0	3	1	0	0
NET-100	269	477	208	0	3	2	0	0
NET-100	270	477	207	0	3	5	0	0
NET-100	270	477	207	0	5	3	0	0
NET-100	270	477	207	0	4	2	0	0
NET-100	274	477	203	0	3	5	0	0
NET-100	274	477	203	0	3	1	0	0
NET-100	274	477	203	0	3	1	0	0
NET-100	274	477	203	0	3	2	0	0
NET-100	274	477	203	0	3	2	0	1
NET-10	72	477	405	0	3	4	0	0
NET-101	274	477	203	0	3	2	0	0
NET-101	274	477	203	0	3	4	0	0
NET-101	274	477	203	0	3	4	0	0
NET-101	274	477	203	0	3	4	0	0
NET-101	274	477	203	0	3	4	0	0
NET-101	274	477	203	0	3	4	0	0
NET-101	274	477	203	0	3	2	0	0
NET-101	275	477	202	0	4	1	0	0
NET-101	275	477	202	0	4	2	0	0
NET-101	275	477	202	0	3	2	0	0
NET-10	72	477	405	0	4	4	0	0
NET-102	275	477	202	0	4	2	0	0
NET-102	275	477	202	0	4	2	0	0
NET-102	275	477	202	0	3	2	0	0
NET-102	275	477	202	0	3	2	0	0
NET-102	276	477	201	0	3	4	0	0
NET-102	276	477	201	0	3	4	0	0
NET-102	276	477	201	0	3	4	0	0
NET-102	277	477	200	0	4	1	0	0
NET-102	277	477	200	0	3	2	0	0
NET-102	278	477	199	0	3	2	0	0
NET-10	72	477	405	0	4	4	0	0
NET-103	278	477	199	0	3	2	0	0
NET-103	280	477	197	0	3	2	0	0
NET-103	280	477	197	0	3	2	0	0
NET-103	280	477	197	0	3	1	0	0
NET-103	280	477	197	0	3	2	0	0
NET-103	280	477	197	0	3	4	0	0
NET-103	280	477	197	0	3	5	0	4
NET-103	280	477	197	0	3	5	0	0
NET-103	280	477	197	0	3	5	0	0
NET-103	280	477	197	0	3	5	0	0
NET-10	72	91	19	1	1	1	0	0
NET-104	280	477	197	0	3	5	0	0
NET-104	280	477	197	0	3	5	0	0
NET-104	280	477	197	0	3	5	0	0
NET-104	280	477	197	0	3	5	0	0
NET-104	280	477	197	0	3	3	0	1
NET-104	280	477	197	0	3	3	0	1
NET-104	280	477	197	0	3	3	0	2
NET-104	280	477	197	0	3	3	0	1
NET-104	280	477	197	0	3	3	0	1
NET-104	280	477	197	0	3	3	0	1
NET-10	72	477	405	0	3	4	0	0
NET-105	280	477	197	0	3	5	0	3
NET-105	280	477	197	0	3	3	0	1
NET-105	280	477	197	0	3	3	0	1
NET-105	280	477	197	0	3	3	0	1
NET-105	280	477	197	0	3	5	0	0
NET-105	280	477	197	0	3	5	0	0
NET-105	280	477	197	0	3	3	0	1
NET-105	280	477	197	0	3	3	0	1
NET-105	280	477	197	0	3	3	0	1
NET-105	280	477	197	0	3	3	0	0
NET-10	72	477	405	0	3	1	0	0
NET-106	280	477	197	0	3	3	0	0
NET-106	280	477	197	0	3	3	0	0
NET-106	280	477	197	0	3	3	0	0
NET-106	281	477	196	0	3	4	0	0
NET-106	281	477	196	0	3	5	0	0
NET-106	281	477	196	0	3	5	0	0
NET-106	281	477	196	0	3	5	0	0
NET-10	73	477	404	0	3	2	0	0
NET-107	281	477	196	0	3	5	0	0
NET-107	281	477	196	0	3	5	0	0
NET-107	281	477	196	0	3	5	0	0
NET-107	281	477	196	0	3	4	0	0
NET-107	281	282	1	1	3	3	0	1
NET-107	281	477	196	0	3	1	0	0
NET-107	281	477	196	0	3	5	0	0
NET-107	281	477	196	0	3	5	0	0
NET-107	282	477	195	0	4	1	0	0
NET-10	73	477	404	0	3	4	0	0
NET-108	282	350	68	1	3	1	0	0
NET-108	282	350	68	1	3	1	0	0
NET-108	282	378	96	1	3	1	0	0
NET-108	282	477	195	0	3	5	0	0
NET-108	282	477	195	0	3	4	0	0
NET-108	282	477	195	0	3	4	0	0
NET-108	282	477	195	0	3	4	0	0
NET-108	282	477	195	0	3	5	0	0
NET-108	282	477	195	0	3	1	0	0
NET-108	282	477	195	0	3	1	0	0
NET-10	74	477	403	0	3	4	0	0
NET-109	282	477	195	0	3	1	0	0
NET-109	282	477	195	0	3	1	0	0
NET-109	282	477	195	0	3	1	0	0
NET-109	283	477	194	0	4	2	0	0
NET-109	285	477	192	0	4	4	0	1
NET-109	286	477	191	0	4	4	0	0
NET-109	287	477	190	0	3	4	0	0
NET-109	287	308	21	1	3	5	0	0
NET-109	287	477	190	0	3	5	0	0
NET-109	287	477	190	0	3	5	0	0
NET-1	35	477	442	0	3	5	0	0
NET-11	75	188	113	1	3	3	0	0
NET-110	287	477	190	0	3	5	0	0
NET-110	288	477	189	0	3	3	0	0
NET-110	289	477	188	0	3	5	0	0
NET-110	289	305	16	1	3	5	0	2
NET-110	289	291	2	1	3	1	0	0
NET-110	289	302	13	1	3	1	0	2
NET-110	289	477	188	0	3	5	0	3
NET-11	77	98	21	1	3	4	0	0
NET-111	289	477	188	0	3	3	0	1
NET-111	289	302	13	1	3	3	0	1
NET-111	289	477	188	0	3	4	0	0
NET-111	289	477	188	0	3	1	0	0
NET-111	289	477	188	0	3	1	0	0
NET-111	289	477	188	0	3	1	0	0
NET-111	289	305	16	1	3	3	0	1
NET-111	289	477	188	0	3	5	0	0
NET-111	290	477	187	0	3	5	0	3
NET-111	290	477	187	0	3	5	0	0
NET-11	77	477	400	0	3	1	0	0
NET-112	290	477	187	0	3	5	0	0
NET-112	290	477	187	0	3	5	0	0
NET-112	290	477	187	0	3	5	0	0
NET-112	290	477	187	0	3	5	0	0
NET-112	290	477	187	0	3	5	0	0
NET-112	290	477	187	0	3	5	0	0
NET-112	290	477	187	0	3	5	0	0
NET-112	290	477	187	0	3	5	0	0
NET-112	290	477	187	0	3	2	0	1
NET-112	290	477	187	0	3	2	0	1
NET-11	77	477	400	0	3	4	0	0
NET-113	290	477	187	0	3	2	0	1
NET-113	290	477	187	0	3	2	0	0
NET-113	290	477	187	0	3	2	0	0
NET-113	290	477	187	0	3	3	0	0
NET-113	290	477	187	0	3	3	0	0
NET-113	290	477	187	0	3	3	0	0
NET-113	290	477	187	0	3	3	0	0
NET-113	290	477	187	0	3	3	0	0
NET-113	290	477	187	0	3	3	0	0
NET-113	290	477	187	0	3	3	0	0
NET-11	78	161	83	1	3	4	0	0
NET-114	290	477	187	0	3	3	0	0
NET-114	290	477	187	0	3	3	0	0
NET-114	290	477	187	0	3	3	0	0
NET-114	290	477	187	0	3	3	0	0
NET-114	290	477	187	0	3	3	0	0
NET-114	290	477	187	0	3	3	0	0
NET-114	290	477	187	0	3	3	0	0
NET-114	290	477	187	0	3	3	0	0
NET-114	290	477	187	0	3	3	0	0
NET-114	290	477	187	0	3	3	0	0
NET-11	78	477	399	0	3	1	0	0
NET-115	290	477	187	0	3	3	0	0
NET-115	290	477	187	0	3	3	0	0
NET-115	290	477	187	0	3	4	0	0
NET-115	294	307	13	1	3	5	0	0
NET-115	294	477	183	0	3	5	0	0
NET-115	294	477	183	0	3	5	0	0
NET-115	294	307	13	1	3	5	0	0
NET-115	294	307	13	1	3	5	0	0
NET-115	294	307	13	1	3	5	0	0
NET-115	294	477	183	0	3	5	0	0
NET-11	78	93	15	1	3	5	0	0
NET-116	294	477	183	0	3	5	0	0
NET-116	294	477	183	0	3	5	0	0
NET-116	294	477	183	0	3	5	0	0
NET-116	294	413	119	1	3	4	0	0
NET-116	294	477	183	0	3	5	0	0
NET-116	294	477	183	0	3	3	0	0
NET-116	294	477	183	0	3	3	0	0
NET-116	294	477	183	0	3	3	0	0
NET-116	294	477	183	0	3	3	0	0
NET-116	294	305	11	1	3	3	0	0
NET-11	78	477	399	0	3	5	0	0
NET-117	294	477	183	0	3	5	0	0
NET-117	295	477	182	0	3	5	0	0
NET-117	296	378	82	1	4	4	0	0
NET-117	296	477	181	0	3	2	0	0
NET-117	297	477	180	0	4	1	0	0
NET-117	298	378	80	1	3	5	0	0
NET-117	298	378	80	1	3	5	0	0
NET-117	298	477	179	0	3	3	0	0
NET-117	298	477	179	0	3	4	0	0
NET-117	298	477	179	0	3	2	0	0
NET-11	78	477	399	0	4	4	0	0
NET-118	299	477	178	0	3	2	0	0
NET-118	301	477	176	0	3	4	0	0
NET-118	302	477	175	0	3	5	0	0
NET-118	302	477	175	0	3	5	0	0
NET-118	303	477	174	0	3	5	0	0
NET-118	303	477	174	0	3	1	0	0
NET-118	303	477	174	0	3	3	0	0
NET-118	303	477	174	0	2	5	0	0
NET-118	304	477	173	0	3	5	0	0
NET-118	304	477	173	0	3	5	0	0
NET-11	78	477	399	0	3	2	0	0
NET-119	304	477	173	0	3	5	0	0
NET-119	304	477	173	0	3	5	0	0
NET-119	304	381	77	1	3	5	0	0
NET-119	305	477	172	0	4	1	0	0
NET-119	306	477	171	0	3	4	0	0
NET-119	307	477	170	0	3	4	0	0
NET-119	308	477	169	0	2	1	0	0
NET-119	308	477	169	0	3	5	0	0
NET-119	308	316	8	1	3	5	0	0
NET-119	308	477	169	0	3	3	0	0
NET-1	35	477	442	0	3	3	0	0
NET-12	79	477	398	0	3	2	0	0
NET-120	308	477	169	0	3	3	0	0
NET-120	309	477	168	0	3	5	0	0
NET-120	309	477	168	0	3	5	0	0
NET-120	309	477	168	0	4	4	0	0
NET-120	310	477	167	0	4	5	0	0
NET-120	310	477	167	0	3	2	0	0
NET-120	310	477	167	0	3	5	0	0
NET-120	312	477	165	0	3	4	0	0
NET-120	312	477	165	0	4	4	0	0
NET-12	79	188	109	1	3	3	0	0
NET-121	315	477	162	0	4	2	0	0
NET-121	316	477	161	0	3	4	0	0
NET-121	317	477	160	0	3	5	0	0
NET-121	318	477	159	0	3	1	0	0
NET-121	318	477	159	0	3	5	0	0
NET-121	318	477	159	0	3	4	0	0
NET-121	318	477	159	0	3	4	0	0
NET-121	319	477	158	0	3	5	0	0
NET-121	322	477	155	0	3	3	0	0
NET-12	79	119	40	1	3	4	0	0
NET-122	322	477	155	0	3	3	0	0
NET-122	322	477	155	0	3	3	0	0
NET-122	323	477	154	0	3	4	0	0
NET-122	323	477	154	0	3	4	0	0
NET-122	323	477	154	0	3	4	0	0
NET-122	324	477	153	0	3	5	0	0
NET-122	324	477	153	0	3	5	0	0
NET-122	328	477	149	0	3	2	0	0
NET-122	328	477	149	0	3	2	0	0
NET-122	328	477	149	0	3	4	0	0
NET-12	80	119	39	1	3	5	0	0
NET-123	329	477	148	0	3	5	0	0
NET-123	329	477	148	0	3	4	0	0
NET-123	329	477	148	0	3	5	0	0
NET-123	330	477	147	0	3	4	0	0
NET-123	331	337	6	1	3	1	0	0
NET-123	332	362	30	1	4	5	0	0
NET-123	333	477	144	0	4	3	0	0
NET-123	334	477	143	0	3	3	0	0
NET-123	334	477	143	0	3	3	0	0
NET-123	334	336	2	1	3	5	0	0
NET-12	80	477	397	0	4	4	0	0
NET-124	334	477	143	0	4	4	0	0
NET-124	336	477	141	0	3	4	0	0
NET-124	336	477	141	0	3	5	0	0
NET-124	336	477	141	0	3	2	0	2
NET-124	336	477	141	0	3	4	0	0
NET-124	336	477	141	0	3	2	0	0
NET-124	336	477	141	0	3	3	0	0
NET-124	337	477	140	0	3	2	0	0
NET-12	80	477	397	0	3	4	0	0
NET-125	338	477	139	0	3	1	0	0
NET-125	338	477	139	0	3	5	0	0
NET-125	338	477	139	0	3	4	0	0
NET-125	339	477	138	0	3	3	0	0
NET-125	342	477	135	0	4	2	0	0
NET-125	343	477	134	0	4	4	0	0
NET-125	343	350	7	1	3	4	0	0
NET-125	344	477	133	0	3	1	0	0
NET-125	344	477	133	0	3	4	0	0
NET-12	80	477	397	0	3	4	0	0
NET-126	344	477	133	0	3	5	0	0
NET-126	344	345	1	1	3	1	0	0
NET-126	344	345	1	1	4	5	0	1
NET-126	344	477	133	0	3	4	0	1
NET-126	345	477	132	0	3	4	0	0
NET-126	350	477	127	0	3	4	0	0
NET-126	350	477	127	0	3	1	0	0
NET-126	350	477	127	0	3	5	0	0
NET-126	350	477	127	0	3	4	0	1
NET-12	80	161	81	1	4	1	0	0
NET-127	350	477	127	0	3	4	0	0
NET-127	351	477	126	0	4	5	0	0
NET-127	351	477	126	0	4	5	0	0
NET-127	351	477	126	0	4	5	0	0
NET-127	353	380	27	1	4	4	0	0
NET-127	354	477	123	0	3	5	0	0
NET-127	354	477	123	0	3	5	0	0
NET-127	354	477	123	0	3	5	0	0
NET-127	354	477	123	0	3	5	0	0
NET-127	354	477	123	0	3	5	0	0
NET-12	80	99	19	1	3	4	0	0
NET-128	354	477	123	0	3	5	0	0
NET-128	354	477	123	0	3	5	0	0
NET-128	354	477	123	0	4	5	0	0
NET-128	359	477	118	0	3	5	0	0
NET-128	360	477	117	0	4	5	0	0
NET-128	360	477	117	0	4	4	0	0
NET-128	360	477	117	0	4	5	0	0
NET-12	80	477	397	0	3	1	0	0
NET-1	35	477	442	0	3	4	0	0
NET-13	80	477	397	0	3	1	0	0
NET-13	80	182	102	1	4	4	0	0
NET-13	80	161	81	1	5	1	0	0
NET-13	80	120	40	1	3	2	0	0
NET-13	81	94	13	1	3	3	0	0
NET-13	82	477	395	0	4	4	0	0
NET-13	82	477	395	0	3	4	0	0
NET-13	84	477	393	0	4	1	0	0
NET-13	84	477	393	0	3	5	0	0
NET-13	84	477	393	0	3	4	0	0
NET-1	37	66	29	1	3	3	0	2
NET-14	84	93	9	1	4	4	0	0
NET-14	84	477	393	0	4	4	0	0
NET-14	85	87	2	1	3	5	0	0
NET-14	85	206	121	1	3	5	0	0
NET-14	85	477	392	0	3	1	0	0
NET-14	85	477	392	0	3	4	0	0
NET-14	85	477	392	0	3	4	0	0
NET-14	85	477	392	0	3	4	0	0
NET-14	85	477	392	0	4	1	0	0
NET-14	85	92	7	1	2	1	0	1
NET-1	37	477	440	0	3	4	0	1
NET-15	85	477	392	0	2	1	0	0
NET-15	85	477	392	0	2	1	0	0
NET-15	85	477	392	0	2	1	0	0
NET-15	85	477	392	0	2	1	0	0
NET-15	85	477	392	0	2	1	0	0
NET-15	85	105	20	1	2	1	0	0
NET-15	85	477	392	0	4	1	0	0
NET-15	85	477	392	0	2	1	0	0
NET-15	85	477	392	0	2	1	0	0
NET-15	85	477	392	0	2	1	0	0
NET-1	37	86	49	1	3	3	0	0
NET-16	85	477	392	0	2	1	0	0
NET-16	85	477	392	0	2	1	0	0
NET-16	85	477	392	0	2	1	0	0
NET-16	85	477	392	0	2	1	0	0
NET-16	85	477	392	0	2	1	0	0
NET-16	85	477	392	0	2	1	0	0
NET-16	85	477	392	0	2	1	0	0
NET-16	85	477	392	0	2	1	0	0
NET-16	85	477	392	0	2	1	0	0
NET-16	85	477	392	0	2	1	0	0
NET-1	38	39	1	1	3	5	0	0
NET-17	85	477	392	0	2	1	0	0
NET-17	85	98	13	1	2	1	0	0
NET-17	85	94	9	1	2	1	0	0
NET-17	85	477	392	0	2	1	0	0
NET-17	85	477	392	0	4	1	0	0
NET-17	85	477	392	0	4	1	0	0
NET-17	85	477	392	0	4	1	0	0
NET-17	85	477	392	0	4	1	0	0
NET-17	85	477	392	0	4	1	0	0
NET-17	85	477	392	0	4	1	0	0
NET-1	40	477	437	0	3	1	0	0
NET-18	85	477	392	0	4	1	0	0
NET-18	85	477	392	0	4	1	0	0
NET-18	85	477	392	0	4	1	0	0
NET-18	85	94	9	1	4	1	0	0
NET-18	85	477	392	0	4	1	0	0
NET-18	85	477	392	0	4	1	0	0
NET-18	85	477	392	0	4	1	0	0
NET-18	85	477	392	0	4	1	0	0
NET-18	85	477	392	0	4	1	0	0
NET-18	85	477	392	0	4	1	0	0
NET-1	51	477	426	0	3	5	0	0
NET-19	85	94	9	1	4	1	0	0
NET-19	85	477	392	0	4	1	0	0
NET-19	85	477	392	0	4	1	0	0
NET-19	85	94	9	1	4	1	0	0
NET-19	85	477	392	0	4	1	0	0
NET-19	85	93	8	1	4	1	0	0
NET-19	85	477	392	0	4	1	0	0
NET-19	85	477	392	0	4	1	0	0
NET-19	85	477	392	0	4	1	0	0
NET-19	85	477	392	0	4	1	0	0
NET-2	51	477	426	0	3	3	0	0
NET-20	85	477	392	0	4	1	0	0
NET-20	85	477	392	0	4	1	0	0
NET-20	85	93	8	1	4	1	0	0
NET-20	85	477	392	0	4	1	0	0
NET-20	85	477	392	0	4	1	0	0
NET-20	85	477	392	0	4	1	0	0
NET-20	85	477	392	0	4	1	0	0
NET-20	85	98	13	1	4	1	0	0
NET-20	85	477	392	0	3	1	0	0
NET-20	85	90	5	1	3	1	0	0
NET-2	51	477	426	0	3	3	0	1
NET-21	85	477	392	0	3	1	0	0
NET-21	85	477	392	0	3	1	0	0
NET-21	85	477	392	0	3	1	0	0
NET-21	85	477	392	0	3	1	0	0
NET-21	85	477	392	0	3	1	0	0
NET-21	85	477	392	0	3	1	0	0
NET-21	85	477	392	0	3	1	0	0
NET-21	85	477	392	0	3	1	0	0
NET-21	85	94	9	1	3	1	0	0
NET-21	85	477	392	0	3	1	0	1
NET-2	57	477	420	0	3	2	0	0
NET-22	85	477	392	0	3	1	0	0
NET-22	85	477	392	0	3	1	0	0
NET-22	85	477	392	0	3	1	0	0
NET-22	85	477	392	0	3	1	0	0
NET-22	85	477	392	0	3	1	0	0
NET-22	85	477	392	0	3	1	0	0
NET-22	85	477	392	0	3	1	0	0
NET-22	85	92	7	1	3	1	0	0
NET-22	85	93	8	1	3	1	0	0
NET-22	85	477	392	0	3	1	0	0
NET-2	57	477	420	0	3	2	0	0
NET-23	85	477	392	0	3	1	0	0
NET-23	85	477	392	0	3	1	0	0
NET-23	85	477	392	0	3	1	0	0
NET-23	85	477	392	0	3	1	0	0
NET-23	85	477	392	0	3	1	0	0
NET-23	85	477	392	0	3	4	0	0
NET-23	85	477	392	0	3	1	0	0
NET-23	85	477	392	0	3	1	0	0
NET-23	85	87	2	1	3	1	0	0
NET-23	85	183	98	1	3	5	0	0
NET-2	57	477	420	0	3	3	0	0
NET-24	85	477	392	0	3	4	0	0
NET-24	85	477	392	0	3	3	0	0
NET-24	85	161	76	1	4	4	0	0
NET-24	86	477	391	0	4	4	0	0
NET-24	86	219	133	1	3	4	0	0
NET-24	86	477	391	0	1	4	0	0
NET-24	86	477	391	0	3	4	0	0
NET-24	86	477	391	0	3	4	0	0
NET-24	86	128	42	1	3	4	0	0
NET-24	87	477	390	0	3	4	0	0
NET-2	59	477	418	0	3	3	0	0
NET-25	87	477	390	0	3	4	0	0
NET-25	87	366	279	1	3	4	0	0
NET-25	87	477	390	0	3	5	0	0
NET-25	87	477	390	0	3	5	0	0
NET-25	87	477	390	0	3	4	0	0
NET-25	88	263	175	1	3	1	0	0
NET-25	88	93	5	1	3	5	0	0
NET-25	88	161	73	1	4	4	0	0
NET-25	89	477	388	0	3	4	0	0
NET-25	89	477	388	0	3	4	0	0
NET-2	59	477	418	0	3	5	0	0
NET-26	91	477	386	0	3	1	0	0
NET-26	91	477	386	0	3	4	0	1
NET-26	91	477	386	0	3	2	0	0
NET-26	91	477	386	0	3	5	0	0
NET-26	91	477	386	0	3	4	0	0
NET-26	92	477	385	0	3	4	0	0
NET-26	92	477	385	0	3	1	0	0
NET-26	93	477	384	0	3	1	0	0
NET-26	93	477	384	0	3	1	0	1
NET-2	59	477	418	0	3	3	0	0
NET-27	93	477	384	0	3	1	0	0
NET-27	93	94	1	1	3	1	0	0
NET-27	93	94	1	1	3	1	0	0
NET-27	93	477	384	0	3	1	0	0
NET-27	93	477	384	0	3	1	0	1
NET-27	93	477	384	0	3	1	0	0
NET-27	93	477	384	0	3	1	0	0
NET-27	93	99	6	1	2	1	0	0
NET-27	93	94	1	1	3	1	0	0
NET-27	93	477	384	0	3	4	0	0
NET-2	59	477	418	0	3	3	0	0
NET-28	93	99	6	1	3	1	0	0
NET-28	93	477	384	0	3	2	0	0
NET-28	93	100	7	1	4	1	0	0
NET-28	93	120	27	1	3	1	0	0
NET-28	94	477	383	0	4	4	0	0
NET-28	94	182	88	1	3	4	0	0
NET-28	94	100	6	1	3	1	0	0
NET-28	94	95	1	1	3	1	0	0
NET-28	94	161	67	1	4	4	0	0
NET-28	95	477	382	0	2	1	0	0
NET-2	60	477	417	0	3	1	0	0
NET-29	95	477	382	0	3	2	0	0
NET-29	95	477	382	0	3	1	0	0
NET-29	95	161	66	1	4	4	0	0
NET-29	96	477	381	0	3	4	0	0
NET-29	96	477	381	0	3	1	0	0
NET-29	96	477	381	0	4	4	0	0
NET-29	98	477	379	0	4	4	0	0
NET-29	98	188	90	1	4	4	0	0
NET-29	98	205	107	1	3	4	0	0
NET-29	99	477	378	0	3	4	0	0
NET-3	65	477	412	0	3	4	0	0
NET-30	99	477	378	0	3	1	0	0
NET-30	99	477	378	0	3	1	0	0
NET-30	99	477	378	0	3	4	0	0
NET-30	99	263	164	1	3	1	0	0
NET-30	99	261	162	1	3	4	0	0
NET-30	99	205	106	1	4	1	0	0
NET-30	99	477	378	0	3	4	0	0
NET-30	100	161	61	1	3	4	0	0
NET-30	100	477	377	0	4	4	0	0
NET-30	100	477	377	0	4	2	0	0
NET-3	65	67	2	1	3	2	0	0
NET-31	100	477	377	0	4	2	0	0
NET-31	101	477	376	0	4	4	0	0
NET-31	101	477	376	0	3	4	0	0
NET-31	101	477	376	0	4	1	0	1
NET-31	101	477	376	0	3	4	0	0
NET-31	101	477	376	0	3	1	0	0
NET-31	101	477	376	0	3	4	0	0
NET-31	101	477	376	0	3	4	0	0
NET-31	102	477	375	0	3	4	0	0
NET-31	102	477	375	0	3	2	0	0
NET-3	65	91	26	1	4	4	0	0
NET-32	102	477	375	0	3	5	0	0
NET-32	104	477	373	0	4	4	0	0
NET-32	104	119	15	1	3	4	0	0
NET-32	105	477	372	0	3	4	0	0
NET-32	105	263	158	1	3	1	0	0
NET-32	105	477	372	0	4	2	0	0
NET-32	106	477	371	0	3	1	0	0
NET-32	106	107	1	1	1	1	0	0
NET-32	106	107	1	1	3	4	0	0
NET-32	106	477	371	0	3	4	0	0
NET-3	65	477	412	0	4	1	0	0
NET-33	106	477	371	0	3	4	0	0
NET-33	107	477	370	0	3	4	0	0
NET-33	107	477	370	0	3	2	0	0
NET-33	108	477	369	0	4	1	0	0
NET-33	108	477	369	0	4	1	0	0
NET-33	108	477	369	0	4	4	0	0
NET-33	108	477	369	0	4	4	0	0
NET-33	108	477	369	0	4	4	0	0
NET-33	108	477	369	0	3	1	0	0
NET-33	109	161	52	1	4	4	0	0
NET-3	65	72	7	1	3	3	0	0
NET-34	109	477	368	0	4	4	0	0
NET-34	109	477	368	0	4	4	0	0
NET-34	109	161	52	1	3	4	0	0
NET-34	109	477	368	0	1	1	0	0
NET-34	109	477	368	0	4	4	0	0
NET-34	109	477	368	0	3	4	0	0
NET-34	109	477	368	0	3	5	0	0
NET-34	109	477	368	0	3	5	0	0
NET-34	110	477	367	0	3	2	0	0
NET-3	65	477	412	0	5	4	0	0
NET-35	110	477	367	0	3	5	0	0
NET-35	111	477	366	0	3	1	0	0
NET-35	111	161	50	1	4	4	0	0
NET-35	111	205	94	1	3	1	0	0
NET-35	111	477	366	0	3	5	0	0
NET-35	111	119	8	1	3	4	0	0
NET-35	112	477	365	0	3	1	0	0
NET-35	112	477	365	0	3	2	0	0
NET-35	113	477	364	0	3	4	0	0
NET-35	113	477	364	0	3	1	0	0
NET-3	65	91	26	1	3	2	0	0
NET-36	115	477	362	0	3	4	0	0
NET-36	115	477	362	0	1	1	0	0
NET-36	115	477	362	0	3	1	0	0
NET-36	115	477	362	0	3	1	0	0
NET-36	116	477	361	0	3	5	0	0
NET-36	116	477	361	0	3	1	0	0
NET-36	117	477	360	0	3	2	0	0
NET-36	117	477	360	0	3	1	0	0
NET-36	119	182	63	1	3	4	0	0
NET-36	119	182	63	1	3	4	0	0
NET-3	65	477	412	0	3	2	0	0
NET-37	119	477	358	0	3	4	0	0
NET-37	119	477	358	0	3	1	0	0
NET-37	120	477	357	0	3	4	0	0
NET-37	120	477	357	0	3	1	0	0
NET-37	120	477	357	0	3	5	0	0
NET-37	120	477	357	0	3	5	0	0
NET-37	120	477	357	0	3	5	0	0
NET-37	120	477	357	0	3	5	0	0
NET-37	120	477	357	0	3	5	0	0
NET-3	65	477	412	0	3	4	0	0
NET-38	120	477	357	0	3	5	0	0
NET-38	120	477	357	0	3	5	0	0
NET-38	120	477	357	0	3	5	0	0
NET-38	120	477	357	0	3	2	0	0
NET-38	120	477	357	0	3	2	0	0
NET-38	120	477	357	0	3	2	0	0
NET-38	120	477	357	0	3	4	0	0
NET-38	120	205	85	1	3	5	0	0
NET-38	120	205	85	1	3	5	0	0
NET-38	120	205	85	1	3	5	0	0
NET-3	65	477	412	0	4	4	0	0
NET-39	120	205	85	1	3	5	0	0
NET-39	122	477	355	0	3	2	0	0
NET-39	122	477	355	0	3	5	0	0
NET-39	122	477	355	0	3	2	0	0
NET-39	122	477	355	0	3	5	0	0
NET-39	122	477	355	0	4	4	0	0
NET-39	122	477	355	0	3	4	0	0
NET-39	123	477	354	0	5	4	0	0
NET-39	123	477	354	0	3	2	0	0
NET-39	123	477	354	0	3	5	0	0
NET-	15	477	462	0	3	4	0	0
NET-4	65	477	412	0	3	4	0	0
NET-40	123	477	354	0	3	4	0	0
NET-40	123	124	1	1	3	4	0	0
NET-40	123	477	354	0	3	4	0	0
NET-40	124	477	353	0	2	1	0	0
NET-40	126	477	351	0	3	5	0	0
NET-40	126	205	79	1	3	5	0	0
NET-40	127	477	350	0	3	3	0	0
NET-40	127	477	350	0	3	4	0	0
NET-40	127	477	350	0	3	4	0	0
NET-40	127	130	3	1	1	1	0	0
NET-4	65	477	412	0	3	1	0	0
NET-41	127	477	350	0	3	4	0	0
NET-41	127	477	350	0	3	4	0	0
NET-41	129	135	6	1	4	4	0	0
NET-41	129	205	76	1	3	1	0	0
NET-41	130	477	347	0	3	2	0	0
NET-41	130	477	347	0	3	1	0	0
NET-41	131	205	74	1	3	4	0	0
NET-41	132	477	345	0	3	3	0	0
NET-41	133	140	7	1	3	5	0	0
NET-41	133	477	344	0	3	5	0	0
NET-4	65	68	3	1	3	4	0	0
NET-42	133	477	344	0	3	5	0	0
NET-42	133	477	344	0	3	1	0	0
NET-42	134	477	343	0	3	2	0	0
NET-42	134	161	27	1	4	4	0	0
NET-42	135	477	342	0	3	4	0	0
NET-42	135	477	342	0	4	4	0	0
NET-42	135	477	342	0	3	5	0	0
NET-42	136	477	341	0	3	1	0	0
NET-42	136	366	230	1	3	4	0	1
NET-42	136	477	341	0	2	1	0	0
NET-4	65	68	3	1	3	4	0	0
NET-43	136	182	46	1	4	4	0	0
NET-43	137	477	340	0	4	1	0	1
NET-43	137	205	68	1	3	4	0	0
NET-43	139	477	338	0	3	2	0	0
NET-43	139	205	66	1	3	1	0	0
NET-43	140	477	337	0	3	4	0	0
NET-43	140	477	337	0	3	1	0	0
NET-43	140	477	337	0	3	4	0	0
NET-43	140	148	8	1	3	3	0	0
NET-43	140	182	42	1	4	4	0	0
NET-4	65	80	15	1	3	4	0	0
NET-44	140	477	337	0	3	5	0	0
NET-44	140	477	337	0	3	5	0	0
NET-44	140	477	337	0	3	5	0	0
NET-44	140	477	337	0	3	2	0	0
NET-44	140	477	337	0	3	5	0	0
NET-44	140	477	337	0	3	5	0	0
NET-44	140	477	337	0	3	5	0	0
NET-44	140	477	337	0	3	5	0	0
NET-44	140	477	337	0	3	5	0	0
NET-44	140	477	337	0	3	3	0	0
NET-4	65	477	412	0	3	1	0	0
NET-45	140	477	337	0	3	5	0	0
NET-45	140	477	337	0	3	5	0	0
NET-45	140	477	337	0	3	5	0	0
NET-45	140	477	337	0	3	5	0	0
NET-45	141	477	336	0	3	4	0	0
NET-45	141	142	1	1	3	5	0	0
NET-45	141	477	336	0	3	5	0	0
NET-45	141	142	1	1	3	5	0	0
NET-45	141	142	1	1	3	5	0	0
NET-45	141	183	42	1	3	1	0	0
NET-4	65	477	412	0	4	4	0	0
NET-46	141	182	41	1	4	4	0	0
NET-4	65	85	20	1	3	4	0	0
NET-47	143	477	334	0	3	4	0	0
NET-47	143	149	6	1	3	4	0	0
NET-47	143	219	76	1	3	4	0	0
NET-47	143	477	334	0	3	1	0	0
NET-47	143	477	334	0	3	5	0	0
NET-47	143	477	334	0	3	5	0	0
NET-47	144	477	333	0	3	5	0	0
NET-47	144	477	333	0	3	1	0	0
NET-47	144	205	61	1	3	1	0	0
NET-47	144	477	333	0	3	2	0	0
NET-4	65	224	159	1	3	4	0	0
NET-48	144	205	61	1	3	2	0	0
NET-48	146	477	331	0	4	5	0	0
NET-48	146	477	331	0	4	5	0	0
NET-48	146	477	331	0	4	5	0	0
NET-48	146	477	331	0	4	5	0	0
NET-48	146	477	331	0	4	5	0	0
NET-48	146	477	331	0	4	5	0	0
NET-48	146	477	331	0	4	5	0	0
NET-48	146	147	1	1	4	5	0	0
NET-48	146	477	331	0	4	5	0	0
NET-4	65	161	96	1	3	5	0	0
NET-49	147	477	330	0	3	4	0	0
NET-49	147	477	330	0	3	4	0	0
NET-49	148	477	329	0	3	5	0	0
NET-49	148	477	329	0	4	5	0	0
NET-49	148	477	329	0	4	5	0	0
NET-49	148	172	24	1	4	5	0	0
NET-49	148	172	24	1	4	5	0	0
NET-49	148	477	329	0	4	5	0	0
NET-49	148	477	329	0	3	5	0	0
NET-	16	80	64	1	3	4	0	0
NET-5	65	477	412	0	3	1	0	0
NET-50	149	477	328	0	3	5	0	0
NET-50	150	205	55	1	3	1	0	0
NET-50	150	161	11	1	4	4	0	0
NET-50	151	205	54	1	3	2	0	0
NET-50	151	205	54	1	3	4	0	0
NET-50	152	477	325	0	3	5	0	0
NET-50	154	477	323	0	3	1	0	0
NET-50	154	477	323	0	3	1	0	0
NET-50	154	477	323	0	3	5	0	0
NET-50	154	155	1	1	3	5	0	0
NET-5	65	120	55	1	3	5	0	0
NET-51	154	155	1	1	3	5	0	0
NET-51	154	477	323	0	3	5	0	0
NET-51	154	477	323	0	3	5	0	0
NET-51	154	477	323	0	3	5	0	0
NET-51	154	477	323	0	3	5	0	0
NET-51	154	477	323	0	3	5	0	0
NET-51	155	477	322	0	3	4	0	0
NET-51	155	477	322	0	3	1	0	0
NET-51	155	477	322	0	3	5	0	0
NET-5	65	120	55	1	3	5	0	0
NET-52	155	477	322	0	4	1	0	1
NET-52	155	477	322	0	3	4	0	0
NET-52	155	477	322	0	3	4	0	0
NET-52	156	178	22	1	3	4	0	0
NET-52	156	200	44	1	5	2	0	0
NET-52	157	161	4	1	3	4	0	0
NET-52	157	235	78	1	5	1	0	1
NET-52	157	477	320	0	3	1	0	0
NET-52	157	178	21	1	3	4	0	0
NET-52	157	477	320	0	3	2	0	0
NET-5	65	120	55	1	3	5	0	0
NET-53	157	205	48	1	3	2	0	0
NET-53	158	477	319	0	3	4	0	0
NET-53	158	477	319	0	4	4	0	0
NET-53	158	477	319	0	3	2	0	0
NET-53	161	205	44	1	5	4	0	0
NET-53	161	477	316	0	4	4	0	0
NET-53	162	477	315	0	4	2	0	0
NET-53	162	477	315	0	3	5	0	0
NET-53	162	477	315	0	3	4	0	0
NET-53	163	224	61	1	3	4	0	0
NET-5	65	120	55	1	3	5	0	0
NET-54	163	168	5	1	4	4	0	0
NET-54	163	477	314	0	3	1	0	0
NET-54	163	477	314	0	4	5	0	0
NET-54	163	477	314	0	1	1	0	0
NET-54	163	477	314	0	3	1	0	0
NET-54	164	477	313	0	3	1	0	1
NET-54	164	477	313	0	4	5	0	0
NET-54	164	477	313	0	3	2	0	0
NET-54	164	477	313	0	3	1	0	0
NET-5	65	120	55	1	3	5	0	0
NET-55	164	477	313	0	3	5	0	0
NET-55	165	477	312	0	4	1	0	0
NET-55	165	205	40	1	4	4	0	0
NET-55	167	263	96	1	3	4	0	0
NET-55	167	477	310	0	3	5	0	0
NET-55	168	477	309	0	3	5	0	0
NET-55	168	477	309	0	3	1	0	0
NET-55	169	477	308	0	3	4	0	0
NET-55	170	205	35	1	3	3	0	0
NET-5	65	120	55	1	3	5	0	0
NET-56	170	199	29	1	3	2	0	0
NET-56	171	205	34	1	3	4	0	0
NET-56	173	205	32	1	3	1	0	0
NET-56	173	477	304	0	2	1	0	0
NET-56	173	477	304	0	2	1	0	0
NET-56	175	477	302	0	4	1	0	0
NET-56	175	477	302	0	3	5	0	0
NET-56	175	477	302	0	4	4	0	0
NET-56	175	477	302	0	3	5	0	0
NET-56	175	477	302	0	3	5	0	0
NET-5	65	477	412	0	3	4	0	0
NET-57	175	477	302	0	3	5	0	0
NET-57	175	477	302	0	3	5	0	0
NET-57	175	477	302	0	3	2	0	0
NET-57	175	477	302	0	3	2	0	0
NET-57	175	477	302	0	3	5	0	0
NET-57	175	477	302	0	3	1	0	0
NET-57	175	178	3	1	3	1	0	0
NET-57	175	477	302	0	3	1	0	0
NET-57	175	477	302	0	3	1	0	0
NET-57	175	477	302	0	3	1	0	0
NET-5	66	70	4	1	3	2	0	0
NET-58	175	269	94	1	3	5	0	0
NET-58	175	477	302	0	3	5	0	0
NET-58	175	477	302	0	3	5	0	0
NET-58	175	477	302	0	3	5	0	0
NET-58	175	477	302	0	3	3	0	0
NET-58	175	477	302	0	3	5	0	0
NET-58	175	477	302	0	3	5	0	0
NET-58	175	477	302	0	3	4	0	0
NET-58	175	477	302	0	3	5	0	0
NET-5	66	477	411	0	3	2	0	0
NET-59	175	477	302	0	3	5	0	0
NET-59	175	477	302	0	3	5	0	0
NET-59	175	477	302	0	3	5	0	0
NET-59	176	477	301	0	4	4	0	0
NET-59	176	477	301	0	4	4	0	0
NET-59	176	477	301	0	3	1	0	0
NET-59	176	477	301	0	3	5	0	0
NET-59	176	477	301	0	3	5	0	0
NET-59	176	477	301	0	3	5	0	0
NET-59	176	477	301	0	4	4	0	0
NET-	35	477	442	0	3	5	0	0
NET-6	66	477	411	0	3	1	0	0
NET-60	177	477	300	0	3	1	0	0
NET-60	177	477	300	0	1	1	0	0
NET-60	178	263	85	1	3	4	0	0
NET-60	178	263	85	1	3	4	0	0
NET-60	178	477	299	0	3	4	0	0
NET-60	178	477	299	0	4	4	0	0
NET-60	178	263	85	1	3	4	0	0
NET-60	178	205	27	1	3	1	0	0
NET-60	178	200	22	1	3	5	0	0
NET-60	179	263	84	1	3	4	0	0
NET-6	66	477	411	0	1	3	0	0
NET-61	179	263	84	1	3	4	0	0
NET-61	179	225	46	1	3	4	0	0
NET-61	179	477	298	0	3	2	0	0
NET-61	179	263	84	1	3	4	0	0
NET-61	179	477	298	0	3	4	0	0
NET-61	180	477	297	0	2	1	0	0
NET-61	181	477	296	0	1	1	0	0
NET-61	181	205	24	1	4	4	0	0
NET-61	182	205	23	1	3	2	0	0
NET-61	183	477	294	0	3	5	0	0
NET-6	66	477	411	0	3	4	0	0
NET-62	183	477	294	0	3	5	0	0
NET-62	184	477	293	0	3	4	0	0
NET-62	185	477	292	0	2	1	0	0
NET-62	185	477	292	0	3	1	0	0
NET-62	185	205	20	1	3	2	0	0
NET-62	186	263	77	1	3	4	0	0
NET-62	186	477	291	0	3	4	0	0
NET-62	186	477	291	0	3	5	0	0
NET-62	186	477	291	0	2	1	0	0
NET-62	186	477	291	0	3	4	0	0
NET-6	66	80	14	1	3	3	0	0
NET-63	188	477	289	0	3	5	0	0
NET-63	188	477	289	0	3	5	0	0
NET-63	188	477	289	0	3	5	0	0
NET-63	188	226	38	1	2	1	0	0
NET-63	188	219	31	1	2	1	0	0
NET-63	188	219	31	1	2	3	0	0
NET-63	188	477	289	0	2	1	0	0
NET-63	188	477	289	0	3	5	0	0
NET-63	188	477	289	0	2	3	0	0
NET-63	188	477	289	0	2	1	0	0
NET-6	66	477	411	0	3	3	0	0
NET-64	188	219	31	1	2	1	0	0
NET-64	188	477	289	0	3	5	0	0
NET-64	188	477	289	0	3	5	0	0
NET-64	189	263	74	1	3	4	0	0
NET-64	189	477	288	0	3	2	0	0
NET-64	189	477	288	0	3	5	0	0
NET-64	189	477	288	0	3	5	0	0
NET-64	189	477	288	0	3	5	0	0
NET-64	189	477	288	0	3	5	0	0
NET-64	189	477	288	0	3	4	0	0
NET-6	66	477	411	0	3	3	0	0
NET-65	190	477	287	0	3	4	0	0
NET-65	190	217	27	1	3	5	0	0
NET-65	190	477	287	0	3	4	0	0
NET-65	191	477	286	0	3	5	0	0
NET-65	191	477	286	0	4	5	0	0
NET-65	191	477	286	0	3	5	0	0
NET-65	191	204	13	1	3	1	0	0
NET-65	191	477	286	0	3	1	0	0
NET-65	191	477	286	0	3	1	0	0
NET-65	191	477	286	0	3	1	0	0
NET-6	66	477	411	0	3	3	0	0
NET-66	191	221	30	1	3	1	0	1
NET-66	191	204	13	1	3	1	0	0
NET-66	191	193	2	1	3	1	0	0
NET-66	191	204	13	1	3	1	0	0
NET-66	191	477	286	0	3	1	0	0
NET-66	191	200	9	1	3	1	0	0
NET-66	191	226	35	1	3	1	0	0
NET-66	191	200	9	1	3	1	0	0
NET-66	191	477	286	0	3	1	0	0
NET-6	66	67	1	1	3	3	0	0
NET-67	192	477	285	0	3	1	0	0
NET-67	193	477	284	0	2	3	0	0
NET-67	193	477	284	0	2	1	0	0
NET-67	193	477	284	0	4	3	0	0
NET-67	193	263	70	1	3	4	0	0
NET-67	193	263	70	1	3	4	0	0
NET-67	193	477	284	0	4	1	0	0
NET-67	194	477	283	0	1	1	0	0
NET-67	196	205	9	1	3	4	0	0
NET-67	196	477	281	0	3	4	0	0
NET-6	67	477	410	0	3	2	0	0
NET-68	196	477	281	0	3	1	0	0
NET-68	197	477	280	0	3	1	0	0
NET-68	197	263	66	1	3	4	0	0
NET-68	197	477	280	0	3	4	0	0
NET-68	197	477	280	0	3	4	0	0
NET-68	198	205	7	1	3	2	0	0
NET-68	198	477	279	0	3	1	0	1
NET-68	198	477	279	0	4	1	0	0
NET-68	200	477	277	0	2	1	0	0
NET-68	200	477	277	0	3	2	0	1
NET-6	67	477	410	0	4	5	0	0
NET-69	201	477	276	0	3	4	0	0
NET-69	203	477	274	0	3	2	0	0
NET-69	203	477	274	0	3	1	0	0
NET-69	203	477	274	0	3	1	0	0
NET-69	204	477	273	0	3	1	0	0
NET-69	204	221	17	1	3	1	0	0
NET-69	204	477	273	0	3	1	0	1
NET-69	204	477	273	0	3	1	0	0
NET-69	204	477	273	0	3	1	0	0
NET-69	204	477	273	0	3	1	0	0
NET-	35	477	442	0	3	4	0	0
NET-7	67	477	410	0	3	4	0	0
NET-70	204	205	1	1	3	1	0	1
NET-70	204	205	1	1	3	1	0	1
NET-70	204	477	273	0	3	1	0	1
NET-70	204	477	273	0	3	4	0	0
NET-70	204	477	273	0	3	5	0	0
NET-70	204	288	84	1	3	5	0	0
NET-70	204	477	273	0	3	5	0	0
NET-70	204	277	73	1	3	3	0	0
NET-70	204	477	273	0	3	3	0	0
NET-70	204	205	1	1	3	3	0	0
NET-7	68	72	4	1	3	2	0	0
NET-71	204	205	1	1	3	4	0	0
NET-71	204	477	273	0	4	1	0	0
NET-71	205	477	272	0	3	5	0	0
NET-71	205	350	145	1	3	1	0	0
NET-71	205	383	178	1	3	5	0	0
NET-71	206	477	271	0	3	5	0	0
NET-71	206	477	271	0	3	5	0	0
NET-71	206	477	271	0	3	5	0	0
NET-71	206	477	271	0	3	5	0	0
NET-7	68	477	409	0	3	4	0	0
NET-72	206	280	74	1	3	5	0	0
NET-72	206	477	271	0	3	5	0	0
NET-72	206	477	271	0	3	5	0	0
NET-72	206	477	271	0	3	5	0	0
NET-72	206	477	271	0	3	5	0	0
NET-72	206	477	271	0	3	5	0	0
NET-72	206	477	271	0	3	5	0	0
NET-72	206	477	271	0	3	5	0	0
NET-72	206	477	271	0	3	5	0	0
NET-7	68	477	409	0	3	2	0	0
NET-73	206	477	271	0	3	5	0	0
NET-73	206	477	271	0	3	5	0	0
NET-73	206	477	271	0	3	5	0	0
NET-73	206	477	271	0	3	5	0	0
NET-73	206	477	271	0	3	5	0	0
NET-73	206	477	271	0	3	5	0	0
NET-73	206	229	23	1	3	1	0	0
NET-73	206	477	271	0	3	5	0	0
NET-73	206	477	271	0	3	5	0	0
NET-7	70	477	407	0	3	5	0	0
NET-74	206	477	271	0	3	5	0	0
NET-74	206	477	271	0	3	5	0	1
NET-74	206	477	271	0	3	5	0	0
NET-74	206	477	271	0	3	5	0	0
NET-74	207	337	130	1	3	1	0	0
NET-74	207	477	270	0	3	4	0	0
NET-74	210	477	267	0	4	2	0	0
NET-74	210	477	267	0	3	1	0	0
NET-74	210	477	267	0	4	5	0	0
NET-74	211	477	266	0	3	4	0	0
NET-7	70	477	407	0	3	5	0	0
NET-75	211	477	266	0	3	1	0	0
NET-75	211	477	266	0	3	1	0	0
NET-75	211	477	266	0	3	5	0	0
NET-75	211	477	266	0	3	5	0	0
NET-75	211	477	266	0	3	5	0	0
NET-75	211	477	266	0	3	5	0	0
NET-75	211	477	266	0	3	5	0	0
NET-75	211	477	266	0	3	5	0	0
NET-75	211	477	266	0	3	5	0	0
NET-75	211	477	266	0	3	5	0	0
NET-7	70	374	304	1	3	3	0	0
NET-76	211	477	266	0	3	5	0	0
NET-76	211	477	266	0	3	5	0	0
NET-76	211	477	266	0	3	5	0	0
NET-76	211	477	266	0	3	5	0	0
NET-76	211	477	266	0	3	5	0	0
NET-76	211	477	266	0	3	1	0	0
NET-76	212	477	265	0	3	4	0	0
NET-76	212	477	265	0	3	1	0	0
NET-76	212	477	265	0	3	1	0	0
NET-76	212	477	265	0	3	4	0	0
NET-7	70	477	407	0	3	3	0	0
NET-77	212	216	4	1	3	1	0	0
NET-77	212	213	1	1	3	5	0	0
NET-77	212	213	1	1	3	5	0	0
NET-77	212	477	265	0	3	1	0	0
NET-77	214	477	263	0	3	5	0	0
NET-77	214	477	263	0	3	5	0	0
NET-77	216	477	261	0	4	4	0	0
NET-77	217	477	260	0	3	1	0	0
NET-77	217	477	260	0	4	4	0	0
NET-7	70	477	407	0	3	3	0	0
NET-78	217	477	260	0	3	1	0	0
NET-78	217	477	260	0	2	1	0	0
NET-78	217	477	260	0	2	1	0	0
NET-78	217	477	260	0	2	1	0	0
NET-78	217	477	260	0	3	3	0	0
NET-78	217	477	260	0	3	2	0	0
NET-78	217	477	260	0	2	1	0	0
NET-78	218	477	259	0	3	1	0	0
NET-78	218	477	259	0	3	1	0	0
NET-7	70	477	407	0	3	3	0	0
NET-79	219	477	258	0	3	4	0	0
NET-79	219	477	258	0	4	4	0	0
NET-79	219	232	13	1	3	1	0	0
NET-79	219	331	112	1	3	5	0	0
NET-79	219	477	258	0	4	4	0	0
NET-79	220	477	257	0	3	4	0	0
NET-79	220	477	257	0	3	1	0	0
NET-79	220	277	57	1	3	1	0	0
NET-79	220	477	257	0	3	1	0	1
NET-79	220	477	257	0	3	1	0	0
NET-	35	94	59	1	3	4	0	0
NET-8	70	477	407	0	4	2	0	0
NET-80	224	477	253	0	3	5	0	0
NET-80	224	226	2	1	3	1	0	0
NET-80	224	477	253	0	3	1	0	0
NET-80	224	477	253	0	3	1	0	0
NET-80	224	477	253	0	3	1	0	0
NET-80	224	234	10	1	3	1	0	0
NET-80	224	477	253	0	3	1	0	0
NET-80	224	477	253	0	3	4	0	1
NET-80	224	234	10	1	3	1	0	0
NET-80	224	249	25	1	3	1	0	0
NET-8	70	477	407	0	4	1	0	0
NET-81	224	477	253	0	3	1	0	0
NET-81	224	477	253	0	3	1	0	0
NET-81	224	249	25	1	3	1	0	0
NET-81	224	235	11	1	3	1	0	0
NET-81	224	235	11	1	3	1	0	0
NET-81	224	477	253	0	3	1	0	0
NET-81	224	477	253	0	3	1	0	0
NET-81	224	477	253	0	3	1	0	0
NET-81	224	294	70	1	3	5	0	0
NET-81	224	238	14	1	3	5	0	0
NET-8	70	477	407	0	4	3	0	0
NET-82	224	477	253	0	3	5	0	0
NET-82	224	477	253	0	3	5	0	0
NET-82	224	269	45	1	3	5	0	0
NET-82	226	477	251	0	3	4	0	0
NET-82	226	477	251	0	2	4	0	0
NET-82	226	477	251	0	2	4	0	0
NET-82	226	477	251	0	3	2	0	0
NET-82	226	477	251	0	2	4	0	0
NET-82	226	477	251	0	3	5	0	0
NET-82	226	477	251	0	2	3	0	0
NET-8	71	263	192	1	3	1	0	0
NET-83	226	249	23	1	3	4	0	0
NET-83	226	248	22	1	2	5	0	0
NET-83	226	477	251	0	3	2	0	0
NET-83	226	274	48	1	2	4	0	0
NET-83	227	294	67	1	3	4	0	0
NET-83	227	477	250	0	3	5	0	0
NET-83	231	477	246	0	3	1	0	0
NET-8	71	477	406	0	3	1	0	0
NET-84	231	477	246	0	3	5	0	0
NET-84	231	477	246	0	3	1	0	0
NET-84	231	477	246	0	3	1	0	0
NET-84	231	477	246	0	3	1	0	0
NET-84	232	263	31	1	3	4	0	0
NET-84	232	263	31	1	3	4	0	0
NET-8	71	72	1	1	4	4	0	0
NET-85	232	263	31	1	3	4	0	0
NET-85	232	477	245	0	3	3	0	0
NET-85	232	477	245	0	3	4	0	0
NET-85	232	477	245	0	3	1	0	0
NET-85	233	269	36	1	3	2	0	0
NET-85	234	263	29	1	3	4	0	0
NET-85	234	477	243	0	3	1	0	0
NET-85	235	477	242	0	3	4	0	0
NET-85	235	239	4	1	3	4	0	0
NET-85	236	244	8	1	3	4	0	0
NET-8	71	94	23	1	3	1	0	1
NET-86	236	477	241	0	3	4	0	0
NET-86	238	239	1	1	3	5	0	0
NET-86	238	477	239	0	3	5	0	0
NET-86	238	477	239	0	3	5	0	0
NET-86	238	477	239	0	3	5	0	0
NET-86	238	477	239	0	3	1	0	0
NET-86	238	249	11	1	3	3	0	0
NET-86	239	477	238	0	3	2	0	0
NET-86	239	477	238	0	3	5	0	0
NET-86	239	477	238	0	3	5	0	0
NET-8	71	477	406	0	3	4	0	0
NET-87	239	477	238	0	3	5	0	0
NET-87	239	294	55	1	3	5	0	0
NET-87	239	477	238	0	3	5	0	0
NET-87	239	477	238	0	3	4	0	0
NET-87	240	477	237	0	3	5	0	0
NET-87	241	477	236	0	5	4	0	0
NET-87	242	477	235	0	3	4	0	0
NET-87	242	477	235	0	3	5	0	0
NET-87	242	477	235	0	3	3	0	0
NET-87	242	477	235	0	3	3	0	0
NET-8	71	477	406	0	3	3	0	0
NET-88	242	374	132	1	3	3	0	0
NET-88	242	374	132	1	3	3	0	0
NET-88	243	261	18	1	3	4	0	0
NET-88	245	477	232	0	3	2	0	0
NET-88	245	477	232	0	3	4	0	0
NET-88	246	477	231	0	3	3	0	0
NET-88	246	477	231	0	3	3	0	0
NET-88	246	477	231	0	3	3	0	0
NET-88	246	477	231	0	3	3	0	0
NET-88	246	477	231	0	3	3	0	0
NET-8	71	477	406	0	4	1	0	0
NET-89	246	374	128	1	3	3	0	0
NET-89	246	477	231	0	3	3	0	0
NET-89	246	477	231	0	3	3	0	0
NET-89	246	477	231	0	3	3	0	0
NET-89	246	374	128	1	3	3	0	0
NET-89	246	477	231	0	3	3	0	0
NET-89	246	477	231	0	3	3	0	0
NET-89	246	344	98	1	3	3	0	0
NET-89	246	477	231	0	3	3	0	0
NET-89	246	477	231	0	3	3	0	0
NET-	35	477	442	0	3	4	0	0
NET-9	71	477	406	0	3	5	0	0
NET-90	246	477	231	0	3	3	0	0
NET-90	246	477	231	0	3	3	0	0
NET-90	246	477	231	0	3	3	0	0
NET-90	246	477	231	0	3	3	0	0
NET-90	246	374	128	1	3	3	0	0
NET-90	246	477	231	0	3	3	0	0
NET-90	246	477	231	0	3	3	0	0
NET-90	247	477	230	0	3	3	0	0
NET-90	247	263	16	1	3	4	0	0
NET-90	249	263	14	1	3	4	0	0
NET-9	71	72	1	1	3	5	0	0
NET-91	249	477	228	0	3	4	0	0
NET-91	249	477	228	0	2	4	0	0
NET-91	252	477	225	0	3	2	0	0
NET-91	252	477	225	0	3	5	0	0
NET-91	252	477	225	0	3	5	0	0
NET-91	252	477	225	0	3	5	0	0
NET-91	252	477	225	0	3	5	0	0
NET-91	252	477	225	0	3	5	0	0
NET-91	252	477	225	0	3	5	0	0
NET-91	252	477	225	0	3	5	0	0
NET-9	71	78	7	1	3	4	0	0
NET-92	252	477	225	0	3	1	0	0
NET-92	252	263	11	1	3	4	0	0
NET-92	252	477	225	0	3	2	0	0
NET-92	252	477	225	0	3	2	0	0
NET-92	252	477	225	0	3	2	0	0
NET-92	252	477	225	0	3	2	0	0
NET-92	252	477	225	0	3	5	0	0
NET-92	252	477	225	0	3	2	0	0
NET-92	252	477	225	0	3	2	0	0
NET-9	71	477	406	0	3	2	0	0
NET-93	252	477	225	0	3	2	0	0
NET-93	252	477	225	0	3	2	0	0
NET-93	252	477	225	0	3	2	0	0
NET-93	252	477	225	0	3	2	0	0
NET-93	252	477	225	0	3	2	0	0
NET-93	252	477	225	0	3	2	0	0
NET-93	252	477	225	0	3	4	0	0
NET-93	252	477	225	0	3	2	0	0
NET-93	252	477	225	0	3	4	0	0
NET-93	253	477	224	0	1	2	0	0
NET-9	71	477	406	0	3	5	0	0
NET-94	253	477	224	0	3	2	0	0
NET-94	253	477	224	0	3	2	0	0
NET-94	253	294	41	1	3	5	0	0
NET-94	253	294	41	1	3	5	0	0
NET-94	253	294	41	1	3	5	0	0
NET-94	253	294	41	1	3	5	0	0
NET-94	253	294	41	1	3	5	0	0
NET-94	253	477	224	0	3	5	0	0
NET-94	254	477	223	0	3	1	0	0
NET-94	255	477	222	0	4	4	0	0
NET-9	71	477	406	0	3	1	0	0
NET-95	255	263	8	1	3	4	0	0
NET-95	255	310	55	1	4	3	0	0
NET-95	256	477	221	0	3	1	0	0
NET-95	256	263	7	1	3	4	0	0
NET-95	257	477	220	0	3	5	0	0
NET-95	258	477	219	0	4	4	0	0
NET-95	259	477	218	0	3	5	0	0
NET-95	260	477	217	0	3	5	0	0
NET-95	260	477	217	0	3	5	0	0
NET-95	260	477	217	0	3	5	0	0
NET-9	71	119	48	1	3	3	0	0
NET-96	260	477	217	0	3	5	0	0
NET-96	260	477	217	0	4	4	0	0
NET-96	260	477	217	0	4	3	0	0
NET-96	260	270	10	1	3	4	0	0
NET-96	260	477	217	0	3	5	0	0
NET-96	260	477	217	0	3	3	0	0
NET-96	260	477	217	0	3	5	0	0
NET-96	260	477	217	0	3	3	0	0
NET-96	260	263	3	1	3	4	0	0
NET-96	261	477	216	0	3	4	0	0
NET-9	72	477	405	0	3	4	0	0
NET-97	261	268	7	1	3	3	0	0
NET-97	262	350	88	1	3	5	0	0
NET-97	262	477	215	0	3	5	0	0
NET-97	262	477	215	0	4	1	0	0
NET-97	262	477	215	0	3	1	0	0
NET-97	262	477	215	0	3	2	0	0
NET-97	262	477	215	0	3	2	0	0
NET-97	262	477	215	0	3	5	0	1
NET-97	262	477	215	0	3	2	0	0
NET-9	72	477	405	0	4	5	0	1
NET-98	263	477	214	0	3	1	0	0
NET-98	263	277	14	1	2	3	0	0
NET-98	263	477	214	0	4	1	0	0
NET-98	266	477	211	0	3	5	0	0
NET-98	266	477	211	0	3	5	0	0
NET-98	266	294	28	1	3	5	0	0
NET-98	268	477	209	0	3	5	0	0
NET-98	268	477	209	0	3	1	0	0
NET-98	268	477	209	0	4	3	0	0
NET-98	268	477	209	0	4	3	0	0
NET-9	72	477	405	0	3	1	0	0
NET-99	268	477	209	0	4	4	0	0
NET-99	268	477	209	0	3	1	0	0
NET-99	268	477	209	0	3	4	0	0
NET-99	268	477	209	0	3	1	0	0
NET-99	268	477	209	0	3	1	0	0
NET-99	268	477	209	0	3	1	0	0
NET-99	269	477	208	0	3	5	0	0
NET-99	269	477	208	0	4	4	0	0
NET-99	269	477	208	0	4	1	0	0
NET-99	269	477	208	0	3	2	0	0
FACES-418	6	7	1	1	3	1	1	0
FACES-418	8	11	3	1	3	1	4	0
FACES-418	9	10	1	1	4	1	1	0
FACES-418	15	16	1	1	5	1	1	1
FACES-418	16	301	285	1	4	1	3	0
FACES-419	17	21	4	1	3	1	1	0
FACES-419	18	19	1	1	3	1	1	0
FACES-419	19	20	1	1	3	1	1	0
FACES-419	21	22	1	1	4	1	1	0
FACES-419	23	24	1	1	4	1	1	0
FACES-419	23	24	1	1	4	1	1	0
FACES-419	28	29	1	1	3	4	1	0
FACES-419	39	42	3	1	4	1	2	0
FACES-419	39	42	3	1	4	1	1	0
FACES-419	41	46	5	1	3	1	2	1
FACES-420	43	77	34	1	3	1	0	0
FACES-420	43	44	1	1	3	1	1	0
FACES-420	43	45	2	1	3	4	1	0
FACES-420	69	79	10	1	3	1	1	1
FACES-420	78	93	15	1	2	1	1	0
FACES-420	79	86	7	1	4	1	1	0
FACES-420	80	81	1	1	4	1	1	0
FACES-420	80	81	1	1	5	1	1	0
FACES-420	81	84	3	1	5	1	1	0
FACES-420	83	99	16	1	3	3	0	0
FACES-421	83	86	3	1	3	1	1	0
FACES-421	85	86	1	1	5	1	1	0
FACES-421	85	86	1	1	5	1	1	0
FACES-421	86	87	1	1	5	1	1	0
FACES-421	87	142	55	1	4	4	0	0
FACES-421	88	89	1	1	5	1	1	0
FACES-421	91	92	1	1	4	1	1	0
FACES-421	92	93	1	1	5	1	1	0
FACES-421	93	94	1	1	4	4	2	1
FACES-421	93	94	1	1	4	4	2	0
FACES-422	94	95	1	1	5	1	1	0
FACES-422	95	96	1	1	4	1	1	0
FACES-422	98	102	4	1	3	1	1	1
FACES-422	100	122	22	1	2	1	0	0
FACES-422	101	290	189	1	3	1	1	0
FACES-422	102	477	375	0	3	4	0	0
FACES-422	113	114	1	1	4	1	1	0
FACES-422	122	185	63	1	3	1	1	0
FACES-422	122	123	1	1	3	1	2	0
FACES-422	126	162	36	1	3	1	1	0
FACES-423	127	130	3	1	2	1	1	0
FACES-423	148	149	1	1	4	1	1	0
FACES-423	148	150	2	1	3	1	1	1
FACES-423	150	477	327	0	4	1	0	1
FACES-423	151	152	1	1	4	1	1	0
FACES-423	154	155	1	1	4	4	1	0
FACES-423	157	158	1	1	5	4	1	0
FACES-423	162	163	1	1	4	4	2	0
FACES-423	162	438	276	1	3	1	0	0
FACES-423	165	178	13	1	4	4	2	0
FACES-424	169	171	2	1	2	1	1	0
FACES-424	172	173	1	1	3	1	1	0
FACES-424	175	177	2	1	4	4	1	0
FACES-424	177	178	1	1	3	4	1	0
FACES-424	185	217	32	1	4	4	0	0
FACES-424	186	377	191	1	3	1	0	0
FACES-424	189	477	288	0	3	1	0	0
FACES-424	192	196	4	1	4	4	2	0
FACES-424	195	196	1	1	4	1	2	0
FACES-424	217	218	1	1	4	4	2	0
FACES-425	220	438	218	1	3	1	0	0
FACES-425	246	371	125	1	3	1	2	0
FACES-425	255	256	1	1	3	1	4	0
FACES-425	267	268	1	1	3	1	0	1
FACES-425	290	293	3	1	3	3	1	0
FACES-425	290	293	3	1	3	3	1	0
FACES-425	292	343	51	1	3	3	1	0
FACES-425	293	294	1	1	4	4	1	0
FACES-425	293	294	1	1	3	3	1	0
FACES-425	293	294	1	1	3	3	1	0
FACES-426	295	297	2	1	4	1	3	0
FACES-426	301	302	1	1	4	4	1	0
FACES-426	309	310	1	1	3	1	2	0
FACES-426	311	312	1	1	3	3	1	0
FACES-426	311	312	1	1	3	3	1	0
FACES-426	311	477	166	0	3	3	1	0
FACES-426	325	330	5	1	3	1	3	0
FACES-426	326	338	12	1	3	1	3	0
FACES-426	326	327	1	1	4	1	0	0
FACES-426	329	332	3	1	3	4	1	0
FACES-427	332	333	1	1	3	1	2	0
FACES-427	337	338	1	1	4	4	2	0
FACES-427	338	339	1	1	3	4	1	0
FACES-427	338	343	5	1	4	1	4	0
FACES-427	343	344	1	1	3	4	2	0
FACES-427	358	359	1	1	4	4	2	0
FACES-427	358	359	1	1	4	4	1	0
FACES-427	358	359	1	1	4	4	1	0
FACESTEST-7	127	128	1	1	3	1	0	0
RIAD-25	33	99	66	1	4	4	0	1
RIAD-25	33	94	61	1	3	4	0	0
RIAD-25	35	477	442	0	4	4	0	0
RIAD-26	35	477	442	0	4	4	0	0
RIAD-26	73	94	21	1	4	5	0	0
RIAD-26	73	99	26	1	4	5	0	0
RIAD-26	101	124	23	1	3	3	0	0
RIAD-26	133	320	187	1	2	3	0	1
RIAD-26	141	477	336	0	4	4	0	0
RIAD-26	155	156	1	1	5	4	0	0
RIAD-26	156	157	1	1	4	4	0	1
RIAD-26	156	477	321	0	4	4	0	0
RIAD-26	253	477	224	0	4	4	0	0
RIAD-27	253	477	224	0	4	2	0	0
RIAD-27	253	477	224	0	4	2	0	0
RIAD-27	253	346	93	1	4	4	0	0
RIAD-27	253	477	224	0	4	5	1	0
RIAD-27	290	298	8	1	3	1	1	1
RIAD-27	290	477	187	0	3	3	1	0
RIAD-27	290	477	187	0	4	3	0	0
RIAD-27	319	320	1	1	5	1	0	0
RIAD-27	328	477	149	0	3	2	0	0
RIAD-27	328	477	149	0	3	2	0	0
RIAD-28	328	477	149	0	3	4	0	0
RIAD-28	347	348	1	1	4	1	1	1
RIAD-28	350	351	1	1	3	4	1	1
MO-	60	179	119	1	4	2	1	0
MO-1	60	344	284	1	4	5	1	1
MO-10	161	477	316	0	3	4	0	0
MO-10	162	165	3	1	4	4	1	1
MO-10	162	175	13	1	3	4	1	2
MO-10	162	171	9	1	3	2	1	2
MO-10	164	183	19	1	4	5	1	0
MO-10	164	165	1	1	4	5	1	0
MO-10	164	199	35	1	4	5	1	0
MO-10	164	165	1	1	3	3	1	0
MO-10	164	165	1	1	3	3	1	0
MO-10	164	165	1	1	3	3	1	0
MO-1	60	434	374	1	4	4	0	0
MO-11	164	165	1	1	3	3	1	0
MO-11	164	168	4	1	3	4	1	1
MO-11	165	166	1	1	3	3	1	0
MO-11	165	186	21	1	3	3	1	0
MO-11	165	166	1	1	4	3	1	0
MO-11	165	166	1	1	3	3	1	0
MO-11	165	166	1	1	3	3	0	0
MO-11	165	199	34	1	4	5	1	0
MO-11	172	220	48	1	3	4	1	0
MO-11	172	477	305	0	3	4	0	1
MO-1	60	162	102	1	3	2	1	3
MO-12	172	477	305	0	3	4	0	0
MO-12	173	477	304	0	3	4	0	0
MO-12	174	175	1	1	3	4	1	1
MO-12	174	176	2	1	3	4	1	1
MO-12	175	182	7	1	3	4	1	2
MO-12	176	183	7	1	3	1	1	2
MO-12	176	220	44	1	3	4	1	0
MO-12	176	177	1	1	4	4	1	0
MO-12	177	298	121	1	3	4	1	2
MO-12	177	291	114	1	3	4	1	1
MO-1	60	477	417	0	3	3	0	0
MO-13	177	477	300	0	3	4	0	0
MO-13	177	233	56	1	3	5	1	1
MO-13	178	477	299	0	3	4	0	0
MO-13	178	179	1	1	3	5	1	0
MO-13	178	477	299	0	3	5	0	0
MO-13	178	434	256	1	3	5	0	0
MO-13	178	220	42	1	3	3	1	1
MO-13	180	477	297	0	3	4	0	1
MO-13	184	218	34	1	3	5	1	0
MO-13	184	232	48	1	3	4	1	2
MO-1	60	302	242	1	3	4	1	0
MO-14	185	477	292	0	3	4	0	0
MO-14	185	193	8	1	4	4	1	2
MO-14	186	228	42	1	4	4	1	0
MO-14	186	386	200	1	3	3	1	4
MO-14	188	477	289	0	4	5	0	4
MO-14	188	477	289	0	4	5	0	0
MO-14	188	477	289	0	4	5	0	0
MO-14	188	477	289	0	3	5	0	0
MO-14	188	477	289	0	4	5	0	0
MO-14	188	477	289	0	4	5	0	0
MO-1	60	296	236	1	3	5	1	4
MO-15	188	477	289	0	4	5	0	0
MO-15	189	218	29	1	3	4	1	1
MO-15	189	220	31	1	3	4	1	4
MO-15	190	413	223	1	4	3	0	1
MO-15	190	413	223	1	4	3	0	1
MO-15	192	477	285	0	3	5	0	0
MO-15	192	382	190	1	3	5	0	0
MO-15	192	434	242	1	3	5	0	4
MO-15	192	434	242	1	3	5	0	2
MO-15	192	434	242	1	3	5	0	3
MO-1	60	178	118	1	3	4	1	1
MO-16	193	220	27	1	3	4	1	0
MO-16	193	194	1	1	4	4	1	0
MO-16	194	413	219	1	4	4	1	0
MO-16	198	199	1	1	3	3	1	0
MO-16	199	200	1	1	3	4	1	0
MO-16	199	200	1	1	3	1	1	0
MO-16	203	220	17	1	3	4	1	0
MO-16	217	218	1	1	3	4	1	0
MO-16	217	231	14	1	3	4	1	0
MO-16	217	477	260	0	3	4	0	0
MO-1	60	477	417	0	5	4	1	0
MO-17	217	477	260	0	3	4	0	0
MO-17	217	218	1	1	3	4	1	0
MO-17	217	219	2	1	4	4	1	1
MO-17	217	219	2	1	3	1	0	0
MO-17	218	221	3	1	4	4	1	0
MO-17	218	219	1	1	5	4	1	0
MO-17	219	220	1	1	3	4	1	1
MO-17	219	220	1	1	4	1	1	1
MO-17	220	231	11	1	3	5	1	0
MO-17	220	233	13	1	3	5	1	0
MO-1	60	179	119	1	3	4	1	0
MO-18	221	231	10	1	3	4	1	0
MO-18	225	226	1	1	3	1	1	1
MO-18	225	388	163	1	2	4	1	0
MO-18	227	228	1	1	3	4	1	0
MO-18	228	231	3	1	3	4	1	0
MO-18	228	305	77	1	3	4	0	0
MO-18	228	477	249	0	3	2	1	0
MO-18	228	477	249	0	4	5	1	0
MO-18	228	477	249	0	3	5	1	0
MO-18	228	477	249	0	4	5	1	0
MO-1	60	165	105	1	4	4	0	0
MO-19	228	477	249	0	4	5	1	0
MO-19	228	477	249	0	4	5	1	0
MO-19	229	231	2	1	3	3	1	1
MO-19	230	413	183	1	3	3	0	0
MO-19	230	477	247	0	3	4	0	0
MO-19	230	477	247	0	3	4	0	0
MO-19	231	477	246	0	3	4	0	0
MO-19	231	232	1	1	5	3	1	0
MO-19	231	477	246	0	3	4	0	0
MO-19	233	477	244	0	3	4	0	0
MO-	60	199	139	1	4	3	1	0
MO-2	60	200	140	1	4	2	1	2
MO-20	233	304	71	1	3	3	0	0
MO-20	233	477	244	0	3	3	0	0
MO-20	235	308	73	1	4	1	1	0
MO-20	239	303	64	1	3	1	1	1
MO-20	240	303	63	1	3	1	1	1
MO-20	240	477	237	0	3	1	0	0
MO-20	240	477	237	0	3	4	0	0
MO-20	240	477	237	0	3	1	0	0
MO-20	241	477	236	0	3	1	0	2
MO-20	241	308	67	1	3	1	0	0
MO-2	60	477	417	0	3	2	1	0
MO-21	247	434	187	1	3	3	0	0
MO-21	248	249	1	1	3	3	1	1
MO-21	248	294	46	1	3	3	1	1
MO-21	252	283	31	1	3	3	1	3
MO-21	252	253	1	1	3	1	1	0
MO-21	252	282	30	1	4	3	1	1
MO-21	253	325	72	1	3	3	1	4
MO-21	254	282	28	1	3	3	1	0
MO-21	255	283	28	1	4	3	1	0
MO-21	282	477	195	0	3	3	0	0
MO-2	60	434	374	1	3	4	0	0
MO-22	283	308	25	1	4	3	1	1
MO-22	283	477	194	0	3	1	0	1
MO-22	289	477	188	0	3	3	0	0
MO-22	290	477	187	0	3	1	0	0
MO-22	291	303	12	1	3	2	1	1
MO-22	295	296	1	1	2	3	1	1
MO-22	295	477	182	0	3	2	0	0
MO-22	295	477	182	0	3	2	0	0
MO-22	295	477	182	0	3	2	0	0
MO-22	295	328	33	1	3	5	1	4
MO-2	60	134	74	1	3	2	1	1
MO-23	295	308	13	1	3	4	1	3
MO-23	295	302	7	1	3	4	1	1
MO-23	295	308	13	1	3	4	1	2
MO-23	295	302	7	1	3	4	1	2
MO-23	295	333	38	1	3	4	0	1
MO-23	296	298	2	1	3	4	1	3
MO-23	297	477	180	0	3	4	0	0
MO-23	298	310	12	1	3	4	1	2
MO-23	298	301	3	1	3	4	1	1
MO-23	298	302	4	1	3	3	1	1
MO-2	60	477	417	0	4	5	0	0
MO-24	299	300	1	1	3	4	1	0
MO-24	301	308	7	1	4	4	1	0
MO-24	301	308	7	1	4	4	1	0
MO-24	301	434	133	1	4	4	0	0
MO-24	301	344	43	1	4	4	1	0
MO-24	302	318	16	1	3	4	1	1
MO-24	302	303	1	1	3	3	1	1
MO-24	303	477	174	0	3	4	0	4
MO-24	303	304	1	1	3	4	1	0
MO-24	303	477	174	0	4	4	0	0
MO-2	60	347	287	1	4	3	1	2
MO-25	303	477	174	0	3	4	0	1
MO-25	303	325	22	1	3	4	1	1
MO-25	303	305	2	1	3	4	1	1
MO-25	303	422	119	1	4	4	0	1
MO-25	304	326	22	1	3	3	1	0
MO-25	304	477	173	0	4	1	0	0
MO-25	304	477	173	0	4	1	0	0
MO-25	304	305	1	1	3	1	0	0
MO-25	305	477	172	0	3	1	0	0
MO-25	305	325	20	1	3	4	1	1
MO-2	62	66	4	1	3	2	1	0
MO-26	305	310	5	1	3	4	1	0
MO-26	305	477	172	0	4	4	0	0
MO-26	305	477	172	0	3	4	0	0
MO-26	308	434	126	1	3	4	0	0
MO-26	308	477	169	0	3	4	0	0
MO-26	308	477	169	0	3	4	0	0
MO-26	308	318	10	1	3	4	1	0
MO-26	308	318	10	1	3	1	1	3
MO-26	308	318	10	1	3	4	1	1
MO-26	309	310	1	1	4	4	1	0
MO-2	63	330	267	1	3	2	1	3
MO-27	310	337	27	1	4	4	1	1
MO-27	310	477	167	0	3	4	0	2
MO-27	310	337	27	1	3	1	1	0
MO-27	310	477	167	0	3	4	0	0
MO-27	310	477	167	0	3	4	1	0
MO-27	310	434	124	1	4	4	0	0
MO-27	312	477	165	0	3	4	0	0
MO-27	312	477	165	0	3	4	0	3
MO-27	312	477	165	0	4	4	0	1
MO-27	315	318	3	1	3	4	1	0
MO-2	63	64	1	1	3	1	1	0
MO-28	316	317	1	1	3	3	1	1
MO-28	316	477	161	0	4	4	0	0
MO-28	318	477	159	0	3	4	0	1
MO-28	318	326	8	1	3	3	1	0
MO-28	321	477	156	0	3	4	0	0
MO-28	321	477	156	0	3	5	0	0
MO-28	321	324	3	1	3	5	1	0
MO-28	321	477	156	0	4	4	0	1
MO-28	321	477	156	0	4	1	0	0
MO-28	321	477	156	0	4	1	0	1
MO-2	63	64	1	1	3	3	1	0
MO-29	321	323	2	1	3	4	0	0
MO-29	321	477	156	0	3	4	0	0
MO-29	321	477	156	0	3	3	0	1
MO-29	321	336	15	1	2	1	1	0
MO-29	322	336	14	1	3	3	1	1
MO-29	322	477	155	0	4	4	0	0
MO-29	322	477	155	0	4	4	0	0
MO-29	322	477	155	0	3	4	0	0
MO-29	323	477	154	0	3	4	0	0
MO-29	324	477	153	0	3	1	0	0
MO-	60	224	164	1	3	4	1	3
MO-3	64	133	69	1	3	3	1	1
MO-30	324	325	1	1	3	1	1	0
MO-30	324	477	153	0	3	4	0	0
MO-30	325	477	152	0	3	1	0	0
MO-30	329	330	1	1	3	3	1	0
MO-30	333	477	144	0	4	1	0	0
MO-30	333	336	3	1	3	3	1	0
MO-30	336	337	1	1	3	3	1	0
MO-30	337	338	1	1	3	1	1	0
MO-30	337	477	140	0	4	5	0	0
MO-30	338	477	139	0	3	4	0	1
MO-3	64	87	23	1	3	4	1	0
MO-31	338	344	6	1	3	3	1	0
MO-31	339	343	4	1	3	4	1	0
MO-31	339	477	138	0	3	4	0	1
MO-31	339	477	138	0	3	4	0	0
MO-31	340	477	137	0	3	1	0	0
MO-31	343	344	1	1	5	3	1	1
MO-31	343	344	1	1	3	1	1	0
MO-31	345	477	132	0	3	4	0	0
MO-31	346	347	1	1	5	4	0	0
MO-31	347	348	1	1	4	4	1	0
MO-3	67	172	105	1	3	2	1	3
MO-32	350	477	127	0	3	4	1	0
MO-3	71	477	406	0	3	5	0	0
MO-3	71	72	1	1	4	2	1	0
MO-3	73	165	92	1	4	4	1	0
MO-3	77	78	1	1	4	4	1	0
MO-3	77	172	95	1	3	5	1	0
MO-3	77	94	17	1	3	5	1	0
MO-3	77	82	5	1	3	5	1	0
MO-	60	165	105	1	4	4	0	0
MO-4	77	78	1	1	3	5	1	0
MO-4	77	169	92	1	3	5	1	0
MO-4	79	91	12	1	3	4	1	1
MO-4	82	83	1	1	3	4	1	0
MO-4	86	232	146	1	3	4	1	1
MO-4	86	144	58	1	3	2	1	3
MO-4	128	143	15	1	3	1	1	2
MO-4	128	140	12	1	3	4	1	0
MO-4	128	165	37	1	3	4	1	4
MO-4	128	155	27	1	3	1	1	2
MO-	60	232	172	1	4	1	1	0
MO-5	128	179	51	1	3	1	1	4
MO-5	129	218	89	1	4	4	1	2
MO-5	129	155	26	1	3	4	1	4
MO-5	129	134	5	1	3	4	1	1
MO-5	129	183	54	1	3	1	1	2
MO-5	129	217	88	1	3	1	1	1
MO-5	129	434	305	1	4	4	0	2
MO-5	129	232	103	1	4	4	0	0
MO-5	129	477	348	0	4	2	1	4
MO-5	129	190	61	1	3	2	1	2
MO-	60	232	172	1	3	5	1	4
MO-6	129	413	284	1	3	5	0	4
MO-6	129	200	71	1	4	1	1	1
MO-6	129	199	70	1	3	2	1	4
MO-6	129	171	42	1	4	4	1	0
MO-6	129	225	96	1	3	1	1	2
MO-6	129	217	88	1	3	4	1	2
MO-6	133	143	10	1	4	5	1	1
MO-6	134	147	13	1	3	4	1	1
MO-6	134	147	13	1	3	4	1	1
MO-6	134	477	343	0	3	4	0	0
MO-	60	129	69	1	3	4	1	1
MO-7	134	220	86	1	4	4	1	1
MO-7	134	190	56	1	3	4	1	4
MO-7	134	169	35	1	4	4	1	2
MO-7	136	179	43	1	3	4	1	4
MO-7	137	165	28	1	4	4	1	0
MO-7	137	179	42	1	4	4	1	1
MO-7	137	147	10	1	4	5	1	0
MO-7	137	154	17	1	3	5	0	0
MO-7	137	155	18	1	4	5	1	0
MO-7	137	154	17	1	4	5	1	0
MO-	60	305	245	1	3	2	1	0
MO-8	140	434	294	1	4	1	0	0
MO-8	142	218	76	1	3	4	1	1
MO-8	143	294	151	1	3	5	1	3
MO-8	143	165	22	1	4	5	1	0
MO-8	143	477	334	0	4	4	0	0
MO-8	143	232	89	1	4	4	0	1
MO-8	144	477	333	0	4	4	0	0
MO-8	148	171	23	1	3	1	1	0
MO-8	148	232	84	1	4	4	0	0
MO-8	149	231	82	1	4	1	1	0
MO-	60	305	245	1	3	2	1	0
MO-9	153	434	281	1	4	4	0	0
MO-9	155	477	322	0	5	4	1	2
MO-9	155	477	322	0	3	2	1	2
MO-9	155	434	279	1	4	4	0	0
MO-9	155	172	17	1	4	4	1	0
MO-9	155	164	9	1	4	4	1	0
MO-9	158	247	89	1	3	4	1	3
MO-9	161	165	4	1	3	1	1	1
MO-9	161	247	86	1	3	4	1	1
MO-9	161	247	86	1	3	4	1	1
T-64	6	7	1	1	3	4	1	0
T-64	7	477	470	0	3	2	1	0
T-65	10	477	467	0	3	1	0	0
T-65	18	21	3	1	3	1	0	0
T-65	19	21	2	1	3	4	0	0
T-65	28	477	449	0	4	1	0	0
T-65	35	36	1	1	3	1	0	0
T-65	38	477	439	0	4	1	0	0
T-65	44	477	433	0	3	2	0	0
T-65	60	63	3	1	3	1	0	0
T-65	101	477	376	0	5	1	0	0
T-66	157	477	320	0	4	4	0	0
T-66	161	477	316	0	3	1	0	0
T-66	295	477	182	0	5	5	1	0
T-66	354	477	123	0	4	1	0	0
TBEANS-100	176	177	1	1	4	1	0	2
TBEANS-100	176	177	1	1	4	3	0	1
TBEANS-100	176	477	301	0	4	4	0	1
TBEANS-100	177	477	300	0	3	1	0	0
TBEANS-100	177	477	300	0	2	1	0	0
TBEANS-100	177	477	300	0	4	3	0	0
TBEANS-100	177	477	300	0	3	1	0	0
TBEANS-100	177	477	300	0	4	1	0	0
TBEANS-100	177	477	300	0	3	1	0	0
TBEANS-100	178	385	207	1	4	3	1	1
TBEANS-101	178	477	299	0	3	1	0	0
TBEANS-101	178	179	1	1	3	1	1	0
TBEANS-101	178	477	299	0	3	1	0	0
TBEANS-101	179	477	298	0	3	1	0	0
TBEANS-101	179	477	298	0	3	5	0	0
TBEANS-101	179	180	1	1	3	1	0	0
TBEANS-101	181	224	43	1	3	3	1	0
TBEANS-101	181	477	296	0	3	1	0	0
TBEANS-101	182	477	295	0	3	1	0	0
TBEANS-101	182	205	23	1	3	1	0	0
TBEANS-102	183	477	294	0	3	1	0	0
TBEANS-102	184	247	63	1	4	3	1	0
TBEANS-102	184	477	293	0	4	2	0	0
TBEANS-102	184	477	293	0	4	4	0	0
TBEANS-102	184	477	293	0	3	1	0	0
TBEANS-102	185	477	292	0	3	1	0	0
TBEANS-102	185	221	36	1	3	1	0	0
TBEANS-102	186	477	291	0	3	1	0	0
TBEANS-102	186	188	2	1	3	1	1	0
TBEANS-102	186	477	291	0	3	4	0	0
TBEANS-103	189	190	1	1	4	3	0	0
TBEANS-103	189	477	288	0	3	1	0	0
TBEANS-103	189	477	288	0	4	1	0	0
TBEANS-103	189	477	288	0	3	1	0	0
TBEANS-103	190	477	287	0	4	1	0	0
TBEANS-103	190	477	287	0	2	5	0	0
TBEANS-103	190	477	287	0	4	4	0	0
TBEANS-103	190	477	287	0	3	1	1	1
TBEANS-103	191	192	1	1	3	1	0	0
TBEANS-103	191	477	286	0	3	1	0	0
TBEANS-104	191	477	286	0	4	1	1	0
TBEANS-104	192	477	285	0	3	1	0	0
TBEANS-104	193	273	80	1	5	1	1	0
TBEANS-104	193	231	38	1	3	1	1	0
TBEANS-104	194	477	283	0	3	4	0	0
TBEANS-104	195	196	1	1	3	4	0	0
TBEANS-104	195	477	282	0	4	1	0	0
TBEANS-104	196	477	281	0	4	1	0	0
TBEANS-104	196	199	3	1	4	1	1	0
TBEANS-104	196	199	3	1	4	1	1	0
TBEANS-105	196	477	281	0	4	3	0	0
TBEANS-105	196	477	281	0	4	1	0	0
TBEANS-105	197	198	1	1	2	1	1	0
TBEANS-105	197	477	280	0	3	4	0	0
TBEANS-105	197	477	280	0	4	1	0	0
TBEANS-105	197	477	280	0	3	1	0	0
TBEANS-105	198	477	279	0	3	1	0	0
TBEANS-105	198	217	19	1	3	1	0	0
TBEANS-105	198	477	279	0	3	1	1	0
TBEANS-105	198	477	279	0	3	1	0	0
TBEANS-106	198	477	279	0	3	4	0	0
TBEANS-106	199	260	61	1	3	1	0	1
TBEANS-106	200	477	277	0	3	1	0	0
TBEANS-106	200	224	24	1	3	4	1	0
TBEANS-106	201	256	55	1	4	1	1	0
TBEANS-106	201	224	23	1	3	1	1	0
TBEANS-106	202	477	275	0	3	1	0	0
TBEANS-106	203	268	65	1	4	1	1	0
TBEANS-106	203	477	274	0	3	1	0	0
TBEANS-106	203	204	1	1	2	1	1	1
TBEANS-107	204	477	273	0	3	1	0	0
TBEANS-107	204	269	65	1	1	1	0	0
TBEANS-107	204	477	273	0	4	1	0	0
TBEANS-107	205	477	272	0	3	1	0	0
TBEANS-107	206	477	271	0	3	3	0	0
TBEANS-107	207	273	66	1	4	1	1	0
TBEANS-107	207	477	270	0	5	1	0	0
TBEANS-107	207	477	270	0	3	1	0	0
TBEANS-107	207	477	270	0	3	1	0	0
TBEANS-107	207	477	270	0	3	1	0	0
TBEANS-108	207	477	270	0	3	1	0	0
TBEANS-108	207	323	116	1	3	1	1	0
TBEANS-108	207	477	270	0	3	1	0	0
TBEANS-108	207	218	11	1	3	1	1	0
TBEANS-108	209	477	268	0	3	1	0	0
TBEANS-108	210	274	64	1	3	1	1	1
TBEANS-108	210	384	174	1	3	1	1	0
TBEANS-108	210	477	267	0	4	1	0	0
TBEANS-108	211	405	194	1	5	1	0	0
TBEANS-108	211	477	266	0	3	4	0	0
TBEANS-109	211	477	266	0	3	2	0	0
TBEANS-109	211	477	266	0	4	1	0	0
TBEANS-109	211	477	266	0	3	1	0	0
TBEANS-109	211	477	266	0	4	1	0	0
TBEANS-109	212	213	1	1	2	1	0	0
TBEANS-109	212	477	265	0	3	1	0	0
TBEANS-109	212	274	62	1	4	1	1	1
TBEANS-109	213	477	264	0	3	1	0	0
TBEANS-109	213	217	4	1	3	1	0	0
TBEANS-109	213	477	264	0	3	1	1	0
TBEANS-110	213	477	264	0	3	1	1	0
TBEANS-110	213	477	264	0	4	4	1	0
TBEANS-110	213	477	264	0	4	4	1	0
TBEANS-110	213	477	264	0	3	1	0	0
TBEANS-110	213	477	264	0	4	1	0	0
TBEANS-110	213	477	264	0	3	1	1	0
TBEANS-110	213	477	264	0	3	1	0	0
TBEANS-110	213	477	264	0	3	1	0	0
TBEANS-110	214	224	10	1	4	4	0	0
TBEANS-110	214	246	32	1	4	1	1	0
TBEANS-111	214	477	263	0	3	1	0	0
TBEANS-111	214	477	263	0	3	1	0	0
TBEANS-111	214	215	1	1	2	1	1	0
TBEANS-111	215	477	262	0	3	1	0	0
TBEANS-111	217	246	29	1	3	1	0	0
TBEANS-111	217	477	260	0	4	1	0	0
TBEANS-111	217	477	260	0	3	1	0	0
TBEANS-111	218	219	1	1	2	1	0	1
TBEANS-111	218	477	259	0	3	3	0	0
TBEANS-111	218	246	28	1	4	1	1	0
TBEANS-112	218	219	1	1	3	1	0	0
TBEANS-112	219	477	258	0	3	1	0	0
TBEANS-112	220	477	257	0	3	1	0	0
TBEANS-112	220	477	257	0	2	1	0	0
TBEANS-112	220	477	257	0	4	1	0	0
TBEANS-112	220	269	49	1	1	1	0	0
TBEANS-112	220	477	257	0	3	4	0	0
TBEANS-112	221	477	256	0	4	5	0	0
TBEANS-112	221	477	256	0	3	1	0	0
TBEANS-112	221	477	256	0	3	1	0	0
TBEANS-113	221	405	184	1	5	1	2	0
TBEANS-113	222	477	255	0	3	1	0	0
TBEANS-113	222	477	255	0	3	1	0	0
TBEANS-113	223	477	254	0	4	4	1	0
TBEANS-113	224	286	62	1	3	1	0	0
TBEANS-113	224	477	253	0	3	4	0	0
TBEANS-113	224	477	253	0	3	1	1	0
TBEANS-113	225	477	252	0	3	1	0	0
TBEANS-113	225	269	44	1	1	1	0	0
TBEANS-113	225	477	252	0	2	1	0	0
TBEANS-114	226	477	251	0	4	1	0	0
TBEANS-114	227	251	24	1	3	1	1	1
TBEANS-114	227	477	250	0	3	1	0	0
TBEANS-114	227	477	250	0	3	1	0	0
TBEANS-114	227	230	3	1	3	1	1	0
TBEANS-114	228	372	144	1	3	4	1	3
TBEANS-114	228	477	249	0	3	1	0	0
TBEANS-114	229	276	47	1	3	1	1	1
TBEANS-114	229	399	170	1	3	1	1	0
TBEANS-114	229	477	248	0	3	1	0	0
TBEANS-115	230	477	247	0	3	3	0	0
TBEANS-115	231	237	6	1	3	1	1	0
TBEANS-115	231	232	1	1	3	3	1	1
TBEANS-115	231	477	246	0	3	1	0	0
TBEANS-115	231	477	246	0	3	1	0	0
TBEANS-115	231	477	246	0	4	4	0	0
TBEANS-115	232	477	245	0	4	1	0	0
TBEANS-115	232	477	245	0	2	1	1	3
TBEANS-115	232	477	245	0	3	4	0	0
TBEANS-115	232	337	105	1	1	1	1	2
TBEANS-116	232	477	245	0	3	1	0	2
TBEANS-116	232	233	1	1	3	3	1	2
TBEANS-116	232	233	1	1	3	3	1	0
TBEANS-116	232	233	1	1	3	3	1	0
TBEANS-116	232	237	5	1	3	3	1	0
TBEANS-116	232	233	1	1	3	3	1	0
TBEANS-116	233	239	6	1	3	1	1	1
TBEANS-116	233	251	18	1	3	1	0	1
TBEANS-116	233	477	244	0	3	1	0	0
TBEANS-116	233	394	161	1	2	1	1	0
TBEANS-117	233	255	22	1	3	3	1	0
TBEANS-117	233	242	9	1	3	1	1	1
TBEANS-117	233	237	4	1	3	3	1	1
TBEANS-117	233	477	244	0	3	1	0	0
TBEANS-117	234	255	21	1	3	3	1	0
TBEANS-117	234	248	14	1	3	3	1	0
TBEANS-117	234	384	150	1	3	3	0	0
TBEANS-117	234	477	243	0	4	1	0	0
TBEANS-117	234	477	243	0	4	1	0	0
TBEANS-117	235	366	131	1	2	1	0	0
TBEANS-118	235	255	20	1	3	3	1	0
TBEANS-118	235	247	12	1	4	1	0	0
TBEANS-118	235	247	12	1	3	1	0	0
TBEANS-118	235	247	12	1	3	1	0	0
TBEANS-118	235	236	1	1	1	1	0	0
TBEANS-118	235	477	242	0	3	1	0	0
TBEANS-118	235	477	242	0	4	1	0	0
TBEANS-118	235	477	242	0	4	1	0	0
TBEANS-118	235	477	242	0	4	1	0	0
TBEANS-118	236	240	4	1	3	1	0	0
TBEANS-119	236	248	12	1	3	1	1	0
TBEANS-119	237	477	240	0	3	1	0	0
TBEANS-119	237	477	240	0	3	1	0	0
TBEANS-119	238	263	25	1	1	1	0	0
TBEANS-119	238	477	239	0	3	1	0	0
TBEANS-119	240	477	237	0	2	1	0	0
TBEANS-119	240	477	237	0	3	1	0	0
TBEANS-119	241	302	61	1	3	1	1	1
TBEANS-119	241	242	1	1	3	1	0	0
TBEANS-119	241	477	236	0	4	1	0	0
TBEANS-120	241	477	236	0	4	4	0	0
TBEANS-120	241	477	236	0	4	2	0	0
TBEANS-120	242	477	235	0	2	2	0	0
TBEANS-120	243	477	234	0	3	1	1	0
TBEANS-120	244	477	233	0	3	4	0	0
TBEANS-120	244	245	1	1	3	1	1	0
TBEANS-120	245	477	232	0	3	1	0	0
TBEANS-120	245	477	232	0	3	1	0	0
TBEANS-120	246	477	231	0	3	1	0	0
TBEANS-120	246	477	231	0	2	1	0	0
TBEANS-121	246	477	231	0	3	3	0	0
TBEANS-121	246	477	231	0	3	1	0	0
TBEANS-121	246	477	231	0	4	1	0	0
TBEANS-121	246	477	231	0	3	4	0	0
TBEANS-121	246	477	231	0	5	4	0	0
TBEANS-121	247	477	230	0	3	1	0	0
TBEANS-121	247	477	230	0	3	1	0	0
TBEANS-121	247	318	71	1	2	1	1	0
TBEANS-121	247	248	1	1	3	1	0	0
TBEANS-121	248	477	229	0	3	4	0	0
TBEANS-122	248	477	229	0	4	1	0	0
TBEANS-122	248	251	3	1	3	3	0	0
TBEANS-122	248	251	3	1	2	1	1	1
TBEANS-122	248	477	229	0	3	1	1	1
TBEANS-122	248	273	25	1	3	1	1	0
TBEANS-122	249	250	1	1	2	1	1	0
TBEANS-122	249	251	2	1	3	3	0	0
TBEANS-122	249	362	113	1	3	1	1	1
TBEANS-122	249	273	24	1	3	4	1	0
TBEANS-122	250	273	23	1	3	1	0	0
TBEANS-123	252	477	225	0	3	4	0	0
TBEANS-123	253	477	224	0	3	4	0	0
TBEANS-123	253	477	224	0	2	1	0	0
TBEANS-123	253	262	9	1	3	3	1	0
TBEANS-123	253	477	224	0	3	1	0	0
TBEANS-123	253	477	224	0	3	1	0	0
TBEANS-123	253	262	9	1	3	1	1	0
TBEANS-123	253	274	21	1	2	1	1	0
TBEANS-123	253	440	187	1	3	1	1	0
TBEANS-123	254	268	14	1	3	3	1	0
TBEANS-124	254	477	223	0	3	1	0	0
TBEANS-124	254	268	14	1	3	3	1	0
TBEANS-124	254	268	14	1	3	3	1	0
TBEANS-124	254	268	14	1	3	3	1	0
TBEANS-124	255	312	57	1	3	1	0	1
TBEANS-124	255	477	222	0	3	2	0	0
TBEANS-124	255	477	222	0	3	1	0	0
TBEANS-124	255	477	222	0	3	1	0	0
TBEANS-124	255	257	2	1	3	3	1	0
TBEANS-124	255	273	18	1	3	1	1	0
TBEANS-125	256	477	221	0	3	1	0	0
TBEANS-125	256	422	166	1	3	1	1	0
TBEANS-125	256	289	33	1	3	1	1	1
TBEANS-125	256	257	1	1	3	1	0	1
TBEANS-125	257	258	1	1	3	3	1	0
TBEANS-125	257	477	220	0	3	1	0	0
TBEANS-125	258	450	192	1	3	1	0	0
TBEANS-125	258	477	219	0	5	1	0	0
TBEANS-125	259	477	218	0	4	1	0	0
TBEANS-125	259	477	218	0	4	1	0	0
TBEANS-126	259	440	181	1	3	1	1	0
TBEANS-126	259	273	14	1	4	1	1	0
TBEANS-126	260	286	26	1	3	4	0	0
TBEANS-126	260	477	217	0	3	4	0	0
TBEANS-126	260	477	217	0	3	2	0	0
TBEANS-126	261	477	216	0	3	5	0	2
TBEANS-126	261	477	216	0	3	2	0	0
TBEANS-126	261	477	216	0	3	1	0	0
TBEANS-126	261	477	216	0	4	4	0	0
TBEANS-126	261	477	216	0	2	1	0	0
TBEANS-127	261	477	216	0	4	1	0	0
TBEANS-127	262	268	6	1	3	1	1	0
TBEANS-127	262	477	215	0	4	1	0	0
TBEANS-127	263	477	214	0	4	1	1	0
TBEANS-127	263	477	214	0	3	1	0	0
TBEANS-127	263	268	5	1	3	3	1	0
TBEANS-127	263	267	4	1	3	2	1	0
TBEANS-127	263	477	214	0	4	1	0	0
TBEANS-127	263	477	214	0	3	4	1	0
TBEANS-127	263	477	214	0	3	4	0	0
TBEANS-128	264	477	213	0	4	1	0	0
TBEANS-128	264	477	213	0	3	3	0	0
TBEANS-128	264	477	213	0	4	4	0	0
TBEANS-128	264	477	213	0	3	1	0	0
TBEANS-128	264	477	213	0	4	1	0	0
TBEANS-128	265	273	8	1	3	1	1	0
TBEANS-128	265	477	212	0	4	1	0	0
TBEANS-128	265	477	212	0	3	1	0	0
TBEANS-128	265	273	8	1	3	4	1	0
TBEANS-128	266	267	1	1	3	1	1	0
TBEANS-129	266	477	211	0	4	1	0	0
TBEANS-129	266	477	211	0	4	4	0	0
TBEANS-129	266	273	7	1	3	4	1	0
TBEANS-129	266	273	7	1	3	4	1	0
TBEANS-129	266	357	91	1	3	4	1	0
TBEANS-129	266	273	7	1	3	4	1	0
TBEANS-129	267	477	210	0	2	1	0	1
TBEANS-129	267	477	210	0	2	1	0	2
TBEANS-129	267	477	210	0	3	1	0	1
TBEANS-129	267	477	210	0	3	1	0	0
TBEANS-130	267	477	210	0	3	1	0	0
TBEANS-130	267	477	210	0	3	1	0	1
TBEANS-130	267	275	8	1	2	1	0	0
TBEANS-130	268	477	209	0	3	1	0	0
TBEANS-130	268	477	209	0	3	1	0	0
TBEANS-130	268	477	209	0	3	3	0	0
TBEANS-130	268	477	209	0	3	1	1	0
TBEANS-130	269	477	208	0	3	1	0	0
TBEANS-130	269	308	39	1	2	1	1	0
TBEANS-130	269	477	208	0	3	1	0	0
TBEANS-131	269	477	208	0	4	3	0	0
TBEANS-131	270	477	207	0	4	3	0	0
TBEANS-131	270	477	207	0	3	4	0	0
TBEANS-131	270	278	8	1	3	3	1	1
TBEANS-131	270	477	207	0	3	4	0	0
TBEANS-131	270	477	207	0	3	1	0	0
TBEANS-131	270	273	3	1	3	1	1	0
TBEANS-131	271	477	206	0	4	1	0	0
TBEANS-131	272	273	1	1	3	5	1	0
TBEANS-131	272	477	205	0	3	1	0	0
TBEANS-132	272	477	205	0	3	1	0	1
TBEANS-132	272	362	90	1	1	3	1	1
TBEANS-132	272	273	1	1	3	5	0	0
TBEANS-132	272	358	86	1	3	5	1	0
TBEANS-132	272	273	1	1	3	5	1	0
TBEANS-132	272	273	1	1	3	5	1	0
TBEANS-132	272	273	1	1	3	5	1	0
TBEANS-132	272	477	205	0	3	1	0	1
TBEANS-132	273	276	3	1	3	5	1	0
TBEANS-132	273	280	7	1	3	5	1	1
TBEANS-133	273	276	3	1	3	5	1	0
TBEANS-133	274	477	203	0	3	1	0	0
TBEANS-133	274	477	203	0	3	1	0	0
TBEANS-133	274	477	203	0	3	2	0	0
TBEANS-133	274	477	203	0	3	4	0	0
TBEANS-133	274	287	13	1	3	3	0	0
TBEANS-133	274	477	203	0	3	1	0	0
TBEANS-133	274	477	203	0	3	5	0	0
TBEANS-133	274	477	203	0	2	1	0	0
TBEANS-133	275	477	202	0	3	1	0	0
TBEANS-134	276	314	38	1	3	1	0	1
TBEANS-134	276	335	59	1	2	1	1	0
TBEANS-134	276	300	24	1	1	1	1	0
TBEANS-134	276	304	28	1	3	1	0	2
TBEANS-134	276	357	81	1	3	4	1	0
TBEANS-134	276	287	11	1	2	3	0	1
TBEANS-134	276	353	77	1	4	1	1	1
TBEANS-134	276	277	1	1	3	5	1	0
TBEANS-134	276	277	1	1	3	5	1	0
TBEANS-134	276	477	201	0	3	1	0	0
TBEANS-135	276	277	1	1	3	1	1	0
TBEANS-135	277	278	1	1	3	5	1	0
TBEANS-135	277	309	32	1	3	1	1	0
TBEANS-135	277	311	34	1	3	1	0	0
TBEANS-135	277	477	200	0	4	4	1	0
TBEANS-135	277	294	17	1	1	1	1	0
TBEANS-135	277	477	200	0	3	1	0	0
TBEANS-135	277	314	37	1	3	1	0	1
TBEANS-135	277	477	200	0	3	1	0	1
TBEANS-135	277	304	27	1	1	1	1	2
TBEANS-136	277	477	200	0	4	5	0	0
TBEANS-136	277	477	200	0	3	4	1	0
TBEANS-136	278	477	199	0	3	1	0	0
TBEANS-136	278	477	199	0	3	1	0	0
TBEANS-136	278	477	199	0	3	1	0	0
TBEANS-136	278	477	199	0	3	1	0	0
TBEANS-136	278	477	199	0	3	1	0	0
TBEANS-136	278	477	199	0	4	1	0	0
TBEANS-136	278	477	199	0	4	1	0	0
TBEANS-136	278	301	23	1	1	1	0	0
TBEANS-137	278	477	199	0	3	1	0	0
TBEANS-137	278	280	2	1	3	5	1	1
TBEANS-137	278	337	59	1	3	5	1	0
TBEANS-137	279	477	198	0	3	4	0	0
TBEANS-137	279	477	198	0	3	1	1	0
TBEANS-137	279	477	198	0	3	1	1	0
TBEANS-137	279	313	34	1	3	1	0	0
TBEANS-137	279	477	198	0	3	1	0	0
TBEANS-137	279	281	2	1	3	1	1	0
TBEANS-137	279	477	198	0	3	4	0	0
TBEANS-138	280	477	197	0	3	1	0	0
TBEANS-138	280	303	23	1	3	1	1	0
TBEANS-138	280	303	23	1	3	1	0	1
TBEANS-138	280	303	23	1	3	1	1	0
TBEANS-138	280	303	23	1	3	1	1	0
TBEANS-138	280	360	80	1	3	5	1	0
TBEANS-138	280	357	77	1	4	1	1	0
TBEANS-138	280	477	197	0	3	1	0	0
TBEANS-138	281	477	196	0	4	2	0	0
TBEANS-138	282	477	195	0	4	1	0	0
TBEANS-139	282	477	195	0	3	4	0	0
TBEANS-139	282	283	1	1	5	1	1	0
TBEANS-139	282	405	123	1	5	1	0	0
TBEANS-139	282	477	195	0	5	1	0	0
TBEANS-139	282	477	195	0	4	1	0	0
TBEANS-139	282	477	195	0	5	1	0	0
TBEANS-139	282	477	195	0	3	1	0	0
TBEANS-139	282	381	99	1	3	1	0	0
TBEANS-139	282	477	195	0	3	1	0	0
TBEANS-139	282	477	195	0	4	1	0	0
TBEANS-140	282	477	195	0	4	1	0	0
TBEANS-140	283	477	194	0	2	1	0	0
TBEANS-140	283	477	194	0	3	4	0	0
TBEANS-140	283	311	28	1	3	1	1	0
TBEANS-140	283	353	70	1	4	1	1	0
TBEANS-140	283	477	194	0	4	1	0	0
TBEANS-140	283	477	194	0	4	1	0	0
TBEANS-140	283	477	194	0	4	1	0	0
TBEANS-140	283	477	194	0	4	1	0	0
TBEANS-140	284	461	177	1	2	2	0	0
TBEANS-141	284	477	193	0	3	4	0	0
TBEANS-141	284	477	193	0	3	4	0	0
TBEANS-141	284	477	193	0	3	4	0	0
TBEANS-141	284	477	193	0	4	1	0	0
TBEANS-141	285	433	148	1	4	1	2	0
TBEANS-141	286	287	1	1	1	1	1	1
TBEANS-141	286	477	191	0	3	1	0	0
TBEANS-141	286	477	191	0	3	1	0	0
TBEANS-141	286	477	191	0	4	1	0	0
TBEANS-141	286	313	27	1	4	1	1	0
TBEANS-142	286	306	20	1	3	5	1	0
TBEANS-142	286	477	191	0	4	1	1	0
TBEANS-142	287	477	190	0	3	1	0	0
TBEANS-142	287	304	17	1	2	1	0	1
TBEANS-142	287	477	190	0	3	1	0	0
TBEANS-142	287	477	190	0	3	1	0	0
TBEANS-142	287	309	22	1	3	1	1	0
TBEANS-142	287	477	190	0	4	1	0	0
TBEANS-142	287	477	190	0	3	1	0	0
TBEANS-142	287	477	190	0	5	1	0	0
TBEANS-143	287	477	190	0	4	1	0	0
TBEANS-143	288	477	189	0	3	1	1	0
TBEANS-143	288	477	189	0	3	1	0	0
TBEANS-143	288	477	189	0	4	1	0	0
TBEANS-143	288	477	189	0	3	1	0	0
TBEANS-143	288	477	189	0	3	1	0	0
TBEANS-143	288	477	189	0	3	1	1	0
TBEANS-143	288	477	189	0	3	1	0	0
TBEANS-143	288	306	18	1	1	1	1	0
TBEANS-143	289	477	188	0	3	1	0	0
TBEANS-144	289	335	46	1	2	1	1	0
TBEANS-144	289	477	188	0	3	4	0	0
TBEANS-144	289	477	188	0	3	1	0	0
TBEANS-144	289	297	8	1	3	1	1	0
TBEANS-144	290	477	187	0	3	4	0	0
TBEANS-144	290	477	187	0	3	1	0	0
TBEANS-144	290	477	187	0	3	1	0	0
TBEANS-144	290	477	187	0	3	1	0	0
TBEANS-144	290	399	109	1	3	1	0	0
TBEANS-144	290	291	1	1	3	1	0	0
TBEANS-145	290	291	1	1	3	1	0	0
TBEANS-145	290	477	187	0	3	1	0	0
TBEANS-145	290	477	187	0	3	1	0	0
TBEANS-145	290	477	187	0	3	1	0	0
TBEANS-145	290	477	187	0	4	1	0	0
TBEANS-145	290	477	187	0	4	1	0	0
TBEANS-145	290	477	187	0	4	1	0	0
TBEANS-145	290	386	96	1	4	1	1	0
TBEANS-145	290	393	103	1	4	1	1	0
TBEANS-145	290	477	187	0	4	1	0	0
TBEANS-146	290	477	187	0	4	4	0	0
TBEANS-146	291	293	2	1	5	4	1	0
TBEANS-146	291	477	186	0	4	4	0	0
TBEANS-146	291	293	2	1	3	4	1	0
TBEANS-146	291	292	1	1	3	4	0	0
TBEANS-146	291	477	186	0	3	1	0	0
TBEANS-146	291	297	6	1	5	1	0	0
TBEANS-146	291	477	186	0	3	1	0	0
TBEANS-146	291	477	186	0	3	1	0	0
TBEANS-146	291	477	186	0	5	1	0	0
TBEANS-147	291	477	186	0	3	1	0	0
TBEANS-147	291	477	186	0	3	1	0	0
TBEANS-147	292	477	185	0	3	1	0	0
TBEANS-147	292	477	185	0	3	1	0	0
TBEANS-147	292	477	185	0	3	1	0	0
TBEANS-147	292	477	185	0	3	5	0	0
TBEANS-147	292	477	185	0	3	5	0	0
TBEANS-147	292	477	185	0	4	1	0	0
TBEANS-147	292	405	113	1	3	4	1	1
TBEANS-147	292	477	185	0	4	5	1	0
TBEANS-148	292	477	185	0	3	1	0	0
TBEANS-148	292	357	65	1	3	1	1	1
TBEANS-148	293	477	184	0	3	4	0	0
TBEANS-148	293	477	184	0	3	1	0	0
TBEANS-148	293	477	184	0	3	1	0	0
TBEANS-148	293	477	184	0	4	1	0	0
TBEANS-148	293	477	184	0	3	1	0	0
TBEANS-148	293	477	184	0	4	1	0	0
TBEANS-148	293	477	184	0	4	1	0	0
TBEANS-148	293	477	184	0	3	1	0	0
TBEANS-149	293	405	112	1	3	1	1	0
TBEANS-149	293	477	184	0	4	1	0	0
TBEANS-149	293	477	184	0	3	1	1	0
TBEANS-149	293	477	184	0	4	1	0	0
TBEANS-149	293	477	184	0	3	1	0	0
TBEANS-149	294	477	183	0	3	1	0	0
TBEANS-149	294	477	183	0	3	4	0	0
TBEANS-149	294	311	17	1	3	1	0	0
TBEANS-149	294	302	8	1	3	5	1	0
TBEANS-149	294	477	183	0	3	5	0	0
TBEANS-150	294	477	183	0	5	4	0	0
TBEANS-150	294	477	183	0	3	5	0	0
TBEANS-150	294	477	183	0	3	5	0	0
TBEANS-150	294	477	183	0	4	1	1	0
TBEANS-150	294	477	183	0	4	1	0	0
TBEANS-150	294	477	183	0	3	5	0	0
TBEANS-150	294	477	183	0	3	5	0	0
TBEANS-150	294	298	4	1	1	1	1	0
TBEANS-150	294	477	183	0	5	4	0	0
TBEANS-150	294	477	183	0	5	1	0	0
TBEANS-151	294	477	183	0	3	1	0	0
TBEANS-151	294	477	183	0	3	1	0	0
TBEANS-151	294	295	1	1	3	1	0	0
TBEANS-151	294	295	1	1	3	1	0	0
TBEANS-151	294	477	183	0	3	5	0	0
TBEANS-151	294	477	183	0	3	1	0	0
TBEANS-151	294	477	183	0	4	5	0	0
TBEANS-151	294	477	183	0	3	1	0	0
TBEANS-151	294	477	183	0	5	5	0	0
TBEANS-151	294	477	183	0	4	5	0	0
TBEANS-152	294	477	183	0	4	1	0	0
TBEANS-152	294	477	183	0	4	1	0	0
TBEANS-152	294	477	183	0	3	1	0	0
TBEANS-152	295	477	182	0	4	1	0	0
TBEANS-152	295	477	182	0	4	1	0	0
TBEANS-152	295	477	182	0	2	1	0	0
TBEANS-152	295	477	182	0	4	1	0	0
TBEANS-152	295	477	182	0	3	1	0	0
TBEANS-152	295	477	182	0	4	1	0	0
TBEANS-152	295	296	1	1	3	5	1	0
TBEANS-153	295	477	182	0	3	1	0	0
TBEANS-153	295	477	182	0	4	1	0	0
TBEANS-153	295	477	182	0	3	1	0	0
TBEANS-153	295	477	182	0	3	1	0	0
TBEANS-153	295	477	182	0	3	5	0	0
TBEANS-153	295	477	182	0	3	1	0	0
TBEANS-153	295	477	182	0	3	5	0	0
TBEANS-153	296	477	181	0	2	1	0	0
TBEANS-153	296	297	1	1	5	1	1	0
TBEANS-153	296	477	181	0	3	4	0	0
TBEANS-154	296	477	181	0	3	4	0	0
TBEANS-154	296	477	181	0	4	1	0	0
TBEANS-154	296	477	181	0	3	1	0	0
TBEANS-154	296	477	181	0	3	1	0	0
TBEANS-154	296	477	181	0	3	1	0	0
TBEANS-154	296	477	181	0	3	1	0	0
TBEANS-154	296	297	1	1	3	1	0	0
TBEANS-154	296	477	181	0	3	5	0	0
TBEANS-154	296	477	181	0	4	1	0	0
TBEANS-154	296	477	181	0	3	1	0	0
TBEANS-155	296	297	1	1	3	1	1	0
TBEANS-155	297	477	180	0	4	1	0	0
TBEANS-155	297	300	3	1	1	1	1	0
TBEANS-155	297	298	1	1	3	1	0	0
TBEANS-155	297	477	180	0	3	2	0	0
TBEANS-155	297	477	180	0	4	1	0	0
TBEANS-155	297	477	180	0	3	2	0	0
TBEANS-155	297	477	180	0	3	1	0	0
TBEANS-155	297	477	180	0	3	1	0	0
TBEANS-155	298	477	179	0	3	1	0	0
TBEANS-156	298	477	179	0	3	1	1	0
TBEANS-156	298	477	179	0	3	1	0	0
TBEANS-156	298	477	179	0	3	1	0	0
TBEANS-156	298	300	2	1	1	1	1	0
TBEANS-156	298	477	179	0	3	1	0	0
TBEANS-156	298	477	179	0	3	1	0	0
TBEANS-156	298	299	1	1	3	1	0	0
TBEANS-156	298	477	179	0	3	1	0	0
TBEANS-156	298	477	179	0	3	3	0	0
TBEANS-156	298	477	179	0	3	1	0	0
TBEANS-157	299	477	178	0	3	1	0	0
TBEANS-157	300	477	177	0	3	1	0	0
TBEANS-157	300	477	177	0	3	1	0	0
TBEANS-157	300	477	177	0	3	1	0	0
TBEANS-157	300	477	177	0	4	1	0	0
TBEANS-157	301	310	9	1	3	3	1	0
TBEANS-157	301	305	4	1	3	1	1	0
TBEANS-157	301	309	8	1	3	1	1	0
TBEANS-157	301	311	10	1	3	1	0	0
TBEANS-157	302	477	175	0	3	1	0	0
TBEANS-158	302	303	1	1	3	1	0	0
TBEANS-158	302	477	175	0	3	1	0	0
TBEANS-158	302	477	175	0	3	4	0	0
TBEANS-158	303	477	174	0	3	4	0	1
TBEANS-158	303	477	174	0	3	3	0	0
TBEANS-158	303	477	174	0	3	4	0	0
TBEANS-158	303	477	174	0	3	4	0	1
TBEANS-158	303	477	174	0	3	1	0	1
TBEANS-158	303	477	174	0	3	5	1	0
TBEANS-158	303	477	174	0	5	1	0	0
TBEANS-159	303	477	174	0	4	4	0	0
TBEANS-159	304	305	1	1	3	1	0	0
TBEANS-159	304	314	10	1	3	1	0	1
TBEANS-159	304	477	173	0	3	1	0	0
TBEANS-159	304	477	173	0	3	1	0	0
TBEANS-159	304	477	173	0	4	1	0	0
TBEANS-159	304	477	173	0	3	1	0	0
TBEANS-159	304	477	173	0	4	1	1	0
TBEANS-159	304	395	91	1	3	2	0	2
TBEANS-159	305	477	172	0	3	1	0	0
TBEANS-160	305	477	172	0	4	5	0	0
TBEANS-160	305	477	172	0	4	4	0	0
TBEANS-160	305	477	172	0	3	1	1	0
TBEANS-160	305	477	172	0	3	1	0	0
TBEANS-160	306	477	171	0	3	5	0	0
TBEANS-160	306	336	30	1	3	4	1	0
TBEANS-160	306	477	171	0	4	1	0	0
TBEANS-160	307	477	170	0	3	1	0	0
TBEANS-160	307	308	1	1	3	1	0	0
TBEANS-160	307	477	170	0	3	1	0	1
TBEANS-161	308	477	169	0	3	1	2	0
TBEANS-161	308	309	1	1	3	1	0	0
TBEANS-161	308	477	169	0	3	1	0	0
TBEANS-161	308	386	78	1	4	1	1	0
TBEANS-161	308	405	97	1	2	1	1	0
TBEANS-161	308	477	169	0	4	1	0	0
TBEANS-161	309	477	168	0	3	1	1	0
TBEANS-161	309	310	1	1	3	1	1	1
TBEANS-161	309	477	168	0	3	1	0	0
TBEANS-161	310	477	167	0	3	1	0	0
TBEANS-162	310	477	167	0	3	1	0	1
TBEANS-162	310	312	2	1	3	1	0	0
TBEANS-162	310	327	17	1	3	2	1	0
TBEANS-162	310	477	167	0	3	1	0	0
TBEANS-162	310	311	1	1	4	1	0	0
TBEANS-162	310	477	167	0	3	2	0	0
TBEANS-162	310	477	167	0	3	1	0	0
TBEANS-162	310	477	167	0	3	4	0	0
TBEANS-162	310	312	2	1	1	1	1	0
TBEANS-162	311	477	166	0	3	1	0	0
TBEANS-163	311	477	166	0	3	1	0	0
TBEANS-163	311	477	166	0	3	1	0	0
TBEANS-163	311	477	166	0	5	1	0	0
TBEANS-163	311	477	166	0	4	1	0	0
TBEANS-163	311	477	166	0	3	1	0	0
TBEANS-163	311	477	166	0	4	4	0	0
TBEANS-163	312	477	165	0	3	1	0	0
TBEANS-163	312	315	3	1	1	1	0	0
TBEANS-163	312	477	165	0	2	1	1	0
TBEANS-163	312	477	165	0	4	1	0	0
TBEANS-164	312	477	165	0	3	4	0	0
TBEANS-164	312	477	165	0	3	4	0	0
TBEANS-164	312	477	165	0	3	4	0	0
TBEANS-164	312	477	165	0	3	1	0	0
TBEANS-164	312	477	165	0	3	4	0	0
TBEANS-164	312	477	165	0	3	4	0	0
TBEANS-164	312	477	165	0	3	2	0	0
TBEANS-164	312	477	165	0	3	2	0	0
TBEANS-164	312	477	165	0	3	2	0	0
TBEANS-164	312	477	165	0	3	2	0	0
TBEANS-165	312	477	165	0	3	2	0	0
TBEANS-165	312	477	165	0	3	2	0	0
TBEANS-165	312	477	165	0	3	1	0	0
TBEANS-165	312	477	165	0	3	1	0	0
TBEANS-165	312	477	165	0	3	1	0	1
TBEANS-165	313	477	164	0	3	1	0	0
TBEANS-165	313	477	164	0	4	4	0	0
TBEANS-165	314	477	163	0	3	5	0	0
TBEANS-165	314	315	1	1	3	1	1	4
TBEANS-165	315	477	162	0	4	4	0	0
TBEANS-166	315	477	162	0	4	4	0	0
TBEANS-166	315	477	162	0	3	1	0	0
TBEANS-166	315	477	162	0	4	4	1	0
TBEANS-166	315	405	90	1	4	1	1	1
TBEANS-166	316	317	1	1	3	5	1	0
TBEANS-166	316	317	1	1	3	5	1	0
TBEANS-166	316	317	1	1	3	5	1	0
TBEANS-166	316	356	40	1	3	5	1	0
TBEANS-166	316	477	161	0	3	1	0	0
TBEANS-166	316	477	161	0	3	1	0	0
TBEANS-167	316	477	161	0	3	4	0	0
TBEANS-167	316	477	161	0	3	1	0	0
TBEANS-167	316	477	161	0	3	2	0	0
TBEANS-167	317	410	93	1	3	4	1	1
TBEANS-167	317	452	135	1	3	1	0	1
TBEANS-167	317	432	115	1	3	4	1	0
TBEANS-167	317	366	49	1	3	1	1	0
TBEANS-167	317	371	54	1	3	4	0	0
TBEANS-167	317	477	160	0	3	2	0	0
TBEANS-167	317	477	160	0	3	2	0	0
TBEANS-168	317	477	160	0	3	4	0	0
TBEANS-168	317	477	160	0	3	4	0	1
TBEANS-168	317	477	160	0	3	4	0	1
TBEANS-168	317	477	160	0	3	4	0	0
TBEANS-168	317	477	160	0	4	1	0	0
TBEANS-168	317	477	160	0	2	1	0	0
TBEANS-168	318	477	159	0	3	1	0	0
TBEANS-168	318	477	159	0	3	4	0	0
TBEANS-168	318	477	159	0	3	1	0	0
TBEANS-168	318	477	159	0	3	1	0	0
TBEANS-169	318	477	159	0	3	4	0	0
TBEANS-169	318	461	143	1	3	1	0	0
TBEANS-169	318	477	159	0	4	4	0	0
TBEANS-169	318	439	121	1	3	1	0	1
TBEANS-169	318	477	159	0	3	1	0	0
TBEANS-169	318	477	159	0	3	4	0	0
TBEANS-169	318	477	159	0	3	2	0	0
TBEANS-169	319	463	144	1	4	1	0	0
TBEANS-169	319	323	4	1	4	1	1	0
TBEANS-169	319	477	158	0	3	1	0	0
TBEANS-170	319	477	158	0	4	1	0	0
TBEANS-170	320	477	157	0	4	1	0	0
TBEANS-170	320	477	157	0	3	5	0	0
TBEANS-170	321	413	92	1	3	1	1	0
TBEANS-170	321	477	156	0	2	1	0	0
TBEANS-170	322	323	1	1	3	1	0	0
TBEANS-170	322	402	80	1	3	1	0	0
TBEANS-170	322	477	155	0	3	4	0	0
TBEANS-170	322	477	155	0	3	1	0	0
TBEANS-170	322	477	155	0	3	4	0	0
TBEANS-171	322	477	155	0	3	4	0	0
TBEANS-171	322	477	155	0	3	4	0	0
TBEANS-171	322	477	155	0	3	4	0	0
TBEANS-171	322	477	155	0	3	4	0	0
TBEANS-171	322	477	155	0	3	4	0	0
TBEANS-171	322	324	2	1	5	4	1	0
TBEANS-171	323	477	154	0	3	1	1	1
TBEANS-171	323	477	154	0	3	1	0	0
TBEANS-171	324	327	3	1	3	4	1	0
TBEANS-171	324	325	1	1	1	3	1	1
TBEANS-172	324	325	1	1	1	3	0	1
TBEANS-172	324	477	153	0	4	1	0	0
TBEANS-172	324	477	153	0	3	1	0	0
TBEANS-172	324	477	153	0	3	4	0	0
TBEANS-172	324	477	153	0	4	5	0	0
TBEANS-172	325	477	152	0	3	4	1	0
TBEANS-172	325	477	152	0	3	4	0	0
TBEANS-172	325	327	2	1	3	1	1	0
TBEANS-172	325	402	77	1	3	1	1	0
TBEANS-172	325	334	9	1	3	1	1	0
TBEANS-173	325	477	152	0	3	5	1	0
TBEANS-173	325	477	152	0	3	1	0	0
TBEANS-173	325	477	152	0	4	1	0	0
TBEANS-173	325	327	2	1	1	1	1	1
TBEANS-173	325	332	7	1	3	5	1	0
TBEANS-173	326	354	28	1	3	3	1	0
TBEANS-173	326	477	151	0	3	1	0	0
TBEANS-173	326	477	151	0	3	1	0	0
TBEANS-173	326	477	151	0	3	1	1	0
TBEANS-173	326	477	151	0	3	1	0	0
TBEANS-174	327	477	150	0	4	1	0	0
TBEANS-174	327	477	150	0	3	1	0	1
TBEANS-174	328	329	1	1	3	4	0	1
TBEANS-174	328	477	149	0	3	1	0	0
TBEANS-174	328	477	149	0	5	5	0	1
TBEANS-174	328	477	149	0	3	1	0	0
TBEANS-174	328	477	149	0	3	1	0	0
TBEANS-174	328	329	1	1	4	1	0	0
TBEANS-174	329	477	148	0	5	1	0	0
TBEANS-174	329	477	148	0	4	1	0	0
TBEANS-175	329	477	148	0	3	1	0	0
TBEANS-175	329	477	148	0	4	1	0	0
TBEANS-175	329	332	3	1	4	1	0	1
TBEANS-175	329	477	148	0	3	2	0	0
TBEANS-175	330	477	147	0	3	1	0	0
TBEANS-175	330	477	147	0	3	4	0	0
TBEANS-175	330	477	147	0	3	1	0	0
TBEANS-175	330	477	147	0	3	1	0	0
TBEANS-175	330	477	147	0	3	1	1	0
TBEANS-175	331	477	146	0	4	1	1	0
TBEANS-176	331	477	146	0	4	4	0	0
TBEANS-176	332	361	29	1	3	1	0	0
TBEANS-176	332	358	26	1	3	5	1	0
TBEANS-176	333	477	144	0	4	4	0	0
TBEANS-176	333	477	144	0	3	1	0	0
TBEANS-176	334	477	143	0	4	1	0	1
TBEANS-176	334	477	143	0	3	2	0	0
TBEANS-176	334	477	143	0	4	2	0	0
TBEANS-176	335	405	70	1	3	1	1	0
TBEANS-176	336	477	141	0	2	1	0	0
TBEANS-177	336	477	141	0	3	1	0	0
TBEANS-177	336	477	141	0	3	2	0	0
TBEANS-177	336	477	141	0	4	1	0	0
TBEANS-177	337	477	140	0	3	4	0	0
TBEANS-177	337	432	95	1	3	1	1	0
TBEANS-177	337	463	126	1	4	1	0	1
TBEANS-177	337	477	140	0	3	1	1	0
TBEANS-177	338	477	139	0	3	4	0	0
TBEANS-177	338	477	139	0	3	4	0	0
TBEANS-177	338	477	139	0	3	2	0	0
TBEANS-178	339	432	93	1	3	1	1	2
TBEANS-178	339	477	138	0	3	1	0	1
TBEANS-178	339	477	138	0	3	4	1	0
TBEANS-178	339	477	138	0	4	5	0	0
TBEANS-178	340	477	137	0	4	1	0	0
TBEANS-178	340	477	137	0	4	1	0	0
TBEANS-178	340	477	137	0	3	1	0	0
TBEANS-178	342	477	135	0	3	1	0	0
TBEANS-178	342	477	135	0	3	1	0	0
TBEANS-178	342	477	135	0	3	1	0	0
TBEANS-179	342	477	135	0	3	1	0	1
TBEANS-179	343	477	134	0	4	1	0	0
TBEANS-179	344	477	133	0	3	1	1	0
TBEANS-179	344	387	43	1	3	2	1	0
TBEANS-179	345	365	20	1	3	1	0	0
TBEANS-179	347	477	130	0	3	1	0	0
TBEANS-179	347	477	130	0	3	1	1	0
TBEANS-179	347	477	130	0	3	1	2	0
TBEANS-179	348	477	129	0	3	2	0	0
TBEANS-179	350	477	127	0	4	1	0	0
TBEANS-180	350	354	4	1	1	1	1	0
TBEANS-180	350	477	127	0	3	1	0	0
TBEANS-180	351	477	126	0	2	4	0	0
TBEANS-180	351	366	15	1	1	1	1	0
TBEANS-180	352	477	125	0	3	1	1	0
TBEANS-180	352	477	125	0	3	1	0	0
TBEANS-180	352	477	125	0	3	1	0	1
TBEANS-180	352	388	36	1	4	1	1	0
TBEANS-180	353	477	124	0	3	1	0	0
TBEANS-180	353	477	124	0	3	1	0	0
TBEANS-181	354	356	2	1	3	1	0	1
TBEANS-181	354	477	123	0	3	1	0	1
TBEANS-181	355	477	122	0	3	1	0	0
TBEANS-181	355	477	122	0	3	1	0	0
TBEANS-181	355	356	1	1	2	1	1	1
TBEANS-181	355	356	1	1	3	1	0	0
TBEANS-181	355	477	122	0	3	1	0	0
TBEANS-181	356	477	121	0	3	1	0	0
TBEANS-181	356	362	6	1	1	1	1	0
TBEANS-181	356	477	121	0	3	1	0	0
TBEANS-182	356	458	102	1	1	1	0	0
TBEANS-182	357	477	120	0	3	1	0	0
TBEANS-182	358	477	119	0	3	1	0	0
TBEANS-182	358	477	119	0	3	1	0	0
TBEANS-182	358	477	119	0	2	1	0	0
TBEANS-182	358	359	1	1	3	1	0	0
TBEANS-182	358	359	1	1	2	1	0	0
TBEANS-182	358	359	1	1	3	5	1	0
TBEANS-182	358	359	1	1	3	5	1	0
TBEANS-182	358	360	2	1	3	5	1	0
TBEANS-183	358	361	3	1	3	5	1	0
TBEANS-183	358	362	4	1	3	5	1	0
TBEANS-183	358	361	3	1	3	5	1	0
TBEANS-183	359	477	118	0	4	1	0	0
TBEANS-183	359	368	9	1	4	1	1	0
TBEANS-183	359	477	118	0	4	1	0	0
TBEANS-183	359	477	118	0	2	1	0	0
TBEANS-183	359	362	3	1	2	1	1	0
TBEANS-183	360	477	117	0	3	1	0	0
TBEANS-183	360	477	117	0	4	1	0	0
TBEANS-184	360	477	117	0	3	1	0	0
TBEANS-184	361	477	116	0	3	1	0	0
TBEANS-184	361	477	116	0	3	1	0	0
TBEANS-184	361	477	116	0	3	1	0	0
TBEANS-184	362	477	115	0	2	1	0	0
TBEANS-184	362	440	78	1	2	1	1	2
TBEANS-184	363	477	114	0	3	1	0	0
TBEANS-184	363	391	28	1	3	1	0	0
TBEANS-23	0	477	477	0	3	1	0	2
TBEANS-23	0	56	56	1	3	1	1	0
TBEANS-23	0	477	477	0	3	1	0	0
TBEANS-23	0	56	56	1	2	1	0	1
TBEANS-23	0	477	477	0	4	1	0	0
TBEANS-24	0	174	174	1	2	1	1	0
TBEANS-24	1	477	476	0	3	4	0	0
TBEANS-24	1	477	476	0	3	1	0	0
TBEANS-24	1	477	476	0	3	4	0	0
TBEANS-24	2	477	475	0	3	4	0	0
TBEANS-24	2	477	475	0	3	1	0	1
TBEANS-24	2	96	94	1	3	1	1	1
TBEANS-24	4	47	43	1	3	1	1	1
TBEANS-24	4	477	473	0	3	4	0	0
TBEANS-24	4	59	55	1	5	1	0	0
TBEANS-25	5	115	110	1	3	1	1	0
TBEANS-25	6	85	79	1	3	1	1	0
TBEANS-25	6	17	11	1	3	1	1	0
TBEANS-25	7	47	40	1	3	1	1	0
TBEANS-25	7	477	470	0	2	1	0	0
TBEANS-25	7	477	470	0	3	4	0	0
TBEANS-25	7	477	470	0	3	4	0	0
TBEANS-25	7	477	470	0	3	4	0	0
TBEANS-25	7	14	7	1	3	1	1	0
TBEANS-25	8	477	469	0	3	1	0	0
TBEANS-26	9	477	468	0	3	4	0	0
TBEANS-26	9	477	468	0	3	4	0	0
TBEANS-26	9	86	77	1	3	1	0	3
TBEANS-26	9	270	261	1	3	1	0	0
TBEANS-26	10	477	467	0	3	1	0	0
TBEANS-26	10	477	467	0	3	1	0	0
TBEANS-26	10	477	467	0	3	1	0	0
TBEANS-26	10	477	467	0	3	1	0	0
TBEANS-26	10	477	467	0	3	1	0	0
TBEANS-26	10	477	467	0	4	4	0	0
TBEANS-27	11	477	466	0	4	1	0	0
TBEANS-27	11	477	466	0	3	1	0	1
TBEANS-27	11	477	466	0	4	4	0	0
TBEANS-27	11	477	466	0	3	1	0	0
TBEANS-27	11	477	466	0	3	4	0	0
TBEANS-27	11	477	466	0	3	4	0	0
TBEANS-27	11	19	8	1	1	1	1	0
TBEANS-27	11	18	7	1	3	1	0	0
TBEANS-27	12	477	465	0	3	1	0	0
TBEANS-27	12	477	465	0	3	1	0	0
TBEANS-28	12	477	465	0	3	1	0	0
TBEANS-28	13	14	1	1	5	4	0	0
TBEANS-28	13	71	58	1	3	1	0	2
TBEANS-28	15	50	35	1	3	1	1	0
TBEANS-28	15	90	75	1	4	1	1	1
TBEANS-28	16	112	96	1	3	1	1	0
TBEANS-28	16	86	70	1	4	1	0	1
TBEANS-28	16	477	461	0	3	1	0	0
TBEANS-28	16	477	461	0	3	1	0	0
TBEANS-28	17	477	460	0	3	2	0	0
TBEANS-29	17	252	235	1	3	4	0	1
TBEANS-29	17	477	460	0	3	4	0	0
TBEANS-29	17	112	95	1	2	1	1	0
TBEANS-29	17	477	460	0	3	4	0	0
TBEANS-29	18	477	459	0	3	1	0	0
TBEANS-29	18	54	36	1	3	1	1	0
TBEANS-29	18	477	459	0	3	4	0	0
TBEANS-29	18	126	108	1	3	5	0	0
TBEANS-29	19	477	458	0	4	1	0	1
TBEANS-29	20	47	27	1	2	1	1	1
TBEANS-30	21	477	456	0	3	4	0	0
TBEANS-30	21	477	456	0	3	1	0	0
TBEANS-30	21	477	456	0	3	1	0	0
TBEANS-30	21	22	1	1	3	1	0	0
TBEANS-30	21	22	1	1	3	1	0	0
TBEANS-30	21	129	108	1	4	1	1	0
TBEANS-30	21	26	5	1	3	1	0	0
TBEANS-30	21	22	1	1	3	1	0	0
TBEANS-30	21	91	70	1	3	1	1	0
TBEANS-30	21	98	77	1	3	1	1	0
TBEANS-31	21	29	8	1	3	1	0	0
TBEANS-31	21	34	13	1	3	1	0	0
TBEANS-31	21	133	112	1	3	1	1	0
TBEANS-31	21	22	1	1	3	1	1	0
TBEANS-31	21	29	8	1	3	1	1	2
TBEANS-31	21	29	8	1	3	1	1	1
TBEANS-31	21	22	1	1	3	1	0	1
TBEANS-31	21	140	119	1	3	1	1	0
TBEANS-31	21	24	3	1	3	1	1	0
TBEANS-31	21	477	456	0	3	1	0	0
TBEANS-32	21	477	456	0	3	1	0	0
TBEANS-32	21	477	456	0	3	1	0	1
TBEANS-32	22	477	455	0	3	1	0	0
TBEANS-32	23	27	4	1	3	1	0	0
TBEANS-32	23	24	1	1	3	1	1	0
TBEANS-32	23	477	454	0	3	4	0	0
TBEANS-32	23	433	410	1	2	1	1	0
TBEANS-32	23	477	454	0	3	1	0	0
TBEANS-32	23	24	1	1	3	1	1	0
TBEANS-32	23	477	454	0	3	4	0	0
TBEANS-33	23	190	167	1	1	3	1	0
TBEANS-33	24	126	102	1	3	1	0	0
TBEANS-33	24	477	453	0	3	1	0	0
TBEANS-33	24	477	453	0	3	1	0	0
TBEANS-33	24	477	453	0	3	1	0	0
TBEANS-33	24	87	63	1	4	1	1	0
TBEANS-33	25	477	452	0	3	1	0	0
TBEANS-33	25	87	62	1	3	1	0	0
TBEANS-33	25	477	452	0	5	1	0	0
TBEANS-33	26	477	451	0	3	1	0	0
TBEANS-34	26	477	451	0	4	4	0	0
TBEANS-34	26	364	338	1	3	5	1	1
TBEANS-34	28	117	89	1	4	4	1	0
TBEANS-34	28	477	449	0	3	1	0	0
TBEANS-34	28	230	202	1	5	1	1	0
TBEANS-34	28	115	87	1	3	1	1	0
TBEANS-34	28	477	449	0	2	1	0	1
TBEANS-34	29	477	448	0	3	4	0	0
TBEANS-34	29	477	448	0	4	1	0	0
TBEANS-34	30	477	447	0	3	1	0	0
TBEANS-35	30	477	447	0	3	1	0	0
TBEANS-35	31	477	446	0	3	4	0	0
TBEANS-35	32	477	445	0	3	1	0	1
TBEANS-35	33	56	23	1	4	4	1	0
TBEANS-35	35	477	442	0	3	1	0	0
TBEANS-35	36	477	441	0	3	1	0	0
TBEANS-35	36	477	441	0	3	1	0	0
TBEANS-35	36	93	57	1	3	1	1	0
TBEANS-35	36	477	441	0	3	4	0	0
TBEANS-35	37	477	440	0	3	1	0	0
TBEANS-36	37	477	440	0	3	4	0	0
TBEANS-36	37	73	36	1	3	1	0	0
TBEANS-36	37	477	440	0	3	1	0	0
TBEANS-36	37	79	42	1	1	1	1	0
TBEANS-36	37	47	10	1	3	1	1	0
TBEANS-36	38	327	289	1	3	4	0	0
TBEANS-36	38	126	88	1	3	5	0	0
TBEANS-36	38	477	439	0	3	4	0	0
TBEANS-36	38	477	439	0	3	4	0	0
TBEANS-36	38	218	180	1	3	1	1	0
TBEANS-37	38	477	439	0	3	2	0	0
TBEANS-37	39	477	438	0	3	1	0	0
TBEANS-37	39	477	438	0	3	1	0	1
TBEANS-37	39	123	84	1	1	1	1	1
TBEANS-37	41	477	436	0	3	1	0	0
TBEANS-37	41	477	436	0	3	1	0	0
TBEANS-37	42	477	435	0	3	1	0	0
TBEANS-37	43	477	434	0	4	4	0	0
TBEANS-37	43	477	434	0	3	1	0	0
TBEANS-37	44	424	380	1	3	1	2	0
TBEANS-38	45	477	432	0	3	4	0	0
TBEANS-38	45	477	432	0	3	5	0	0
TBEANS-38	45	477	432	0	3	5	0	0
TBEANS-38	45	477	432	0	3	5	0	0
TBEANS-38	45	477	432	0	3	5	0	0
TBEANS-38	45	477	432	0	3	1	0	0
TBEANS-38	45	477	432	0	3	2	0	0
TBEANS-38	45	477	432	0	3	4	0	0
TBEANS-38	45	477	432	0	3	5	0	0
TBEANS-38	45	477	432	0	3	1	0	0
TBEANS-39	45	477	432	0	3	2	0	0
TBEANS-39	45	477	432	0	3	5	0	0
TBEANS-39	45	477	432	0	3	5	0	0
TBEANS-39	45	477	432	0	3	5	0	0
TBEANS-39	45	477	432	0	3	5	0	0
TBEANS-39	45	477	432	0	3	4	0	0
TBEANS-39	45	477	432	0	3	2	0	0
TBEANS-39	45	477	432	0	3	2	0	0
TBEANS-39	45	477	432	0	3	2	0	0
TBEANS-39	45	477	432	0	3	5	0	0
TBEANS-40	45	477	432	0	4	1	0	0
TBEANS-40	47	477	430	0	3	1	0	0
TBEANS-40	47	114	67	1	3	1	1	0
TBEANS-40	47	273	226	1	3	1	1	0
TBEANS-40	47	111	64	1	4	1	1	1
TBEANS-40	48	61	13	1	4	1	1	0
TBEANS-40	48	249	201	1	4	1	1	0
TBEANS-40	48	87	39	1	4	1	1	0
TBEANS-40	48	91	43	1	5	1	1	0
TBEANS-40	48	477	429	0	3	2	0	0
TBEANS-41	49	115	66	1	3	1	1	0
TBEANS-41	49	86	37	1	3	1	1	0
TBEANS-41	51	477	426	0	4	2	0	0
TBEANS-41	51	477	426	0	3	1	0	0
TBEANS-41	51	57	6	1	1	1	0	0
TBEANS-41	52	477	425	0	3	4	0	0
TBEANS-41	52	477	425	0	3	1	0	1
TBEANS-41	52	273	221	1	3	1	1	1
TBEANS-41	52	477	425	0	4	4	0	0
TBEANS-41	53	477	424	0	4	4	0	0
TBEANS-42	54	477	423	0	3	1	0	0
TBEANS-42	54	477	423	0	3	1	0	0
TBEANS-42	55	477	422	0	3	4	0	0
TBEANS-42	55	477	422	0	3	4	0	0
TBEANS-42	55	477	422	0	3	1	0	0
TBEANS-42	55	477	422	0	4	4	0	0
TBEANS-42	56	477	421	0	3	1	0	0
TBEANS-42	56	477	421	0	3	4	0	1
TBEANS-42	56	477	421	0	3	2	0	0
TBEANS-42	56	83	27	1	3	2	0	0
TBEANS-43	56	477	421	0	3	1	0	0
TBEANS-43	57	270	213	1	3	4	1	0
TBEANS-43	57	477	420	0	3	4	0	0
TBEANS-43	58	230	172	1	3	3	0	0
TBEANS-43	58	477	419	0	3	1	0	0
TBEANS-43	59	477	418	0	3	4	0	0
TBEANS-43	59	477	418	0	3	4	0	0
TBEANS-43	59	477	418	0	3	1	0	0
TBEANS-43	60	157	97	1	3	1	1	0
TBEANS-43	60	477	417	0	3	4	0	0
TBEANS-44	61	477	416	0	4	4	0	0
TBEANS-44	62	126	64	1	3	4	0	0
TBEANS-44	62	477	415	0	3	5	0	0
TBEANS-44	62	477	415	0	3	4	0	0
TBEANS-44	63	115	52	1	3	1	1	0
TBEANS-44	63	477	414	0	3	1	0	0
TBEANS-44	63	477	414	0	3	1	0	0
TBEANS-44	64	477	413	0	3	2	0	0
TBEANS-44	64	477	413	0	4	4	0	0
TBEANS-44	64	101	37	1	4	1	1	0
TBEANS-45	65	477	412	0	3	1	0	0
TBEANS-45	65	84	19	1	4	1	1	0
TBEANS-45	65	477	412	0	3	1	0	0
TBEANS-45	65	477	412	0	3	1	0	0
TBEANS-45	65	477	412	0	3	1	0	0
TBEANS-45	65	477	412	0	3	1	0	0
TBEANS-45	68	477	409	0	3	1	0	0
TBEANS-45	68	477	409	0	3	1	0	0
TBEANS-45	70	477	407	0	3	1	0	0
TBEANS-45	70	477	407	0	3	1	0	0
TBEANS-46	70	477	407	0	4	1	0	0
TBEANS-46	71	92	21	1	3	1	1	2
TBEANS-46	71	99	28	1	2	1	0	0
TBEANS-46	72	142	70	1	5	1	1	1
TBEANS-46	72	477	405	0	4	4	0	0
TBEANS-46	72	86	14	1	5	1	1	0
TBEANS-46	72	477	405	0	3	1	0	0
TBEANS-46	72	477	405	0	2	3	0	3
TBEANS-46	72	477	405	0	3	1	0	1
TBEANS-46	73	477	404	0	3	1	0	0
TBEANS-47	73	402	329	1	5	1	1	0
TBEANS-47	73	477	404	0	4	4	0	0
TBEANS-47	73	477	404	0	3	1	0	0
TBEANS-47	73	477	404	0	3	1	0	0
TBEANS-47	73	477	404	0	3	1	0	0
TBEANS-47	73	477	404	0	3	1	0	1
TBEANS-47	73	477	404	0	3	1	0	0
TBEANS-47	74	80	6	1	5	1	0	0
TBEANS-47	74	224	150	1	5	1	0	0
TBEANS-47	74	95	21	1	5	4	1	0
TBEANS-48	74	101	27	1	5	1	1	0
TBEANS-48	74	149	75	1	5	4	1	0
TBEANS-48	75	174	99	1	2	1	0	0
TBEANS-48	75	477	402	0	3	4	0	0
TBEANS-48	75	477	402	0	3	4	0	0
TBEANS-48	76	477	401	0	3	1	0	0
TBEANS-48	77	292	215	1	3	1	0	0
TBEANS-48	77	477	400	0	3	1	0	0
TBEANS-48	77	477	400	0	4	1	0	0
TBEANS-48	78	477	399	0	3	1	0	0
TBEANS-49	79	80	1	1	3	1	0	0
TBEANS-49	79	174	95	1	2	1	1	0
TBEANS-49	79	99	20	1	2	1	0	0
TBEANS-49	79	477	398	0	4	1	0	0
TBEANS-49	79	477	398	0	4	1	0	0
TBEANS-49	80	477	397	0	4	1	0	0
TBEANS-49	80	477	397	0	4	1	0	0
TBEANS-49	80	133	53	1	4	1	1	0
TBEANS-49	80	133	53	1	4	4	1	0
TBEANS-49	80	477	397	0	4	2	0	0
TBEANS-50	80	477	397	0	4	2	0	0
TBEANS-50	80	477	397	0	4	1	0	0
TBEANS-50	81	357	276	1	3	1	1	0
TBEANS-50	81	477	396	0	3	4	0	1
TBEANS-50	81	477	396	0	3	4	0	0
TBEANS-50	81	477	396	0	3	4	0	0
TBEANS-50	81	477	396	0	3	1	0	0
TBEANS-50	81	477	396	0	3	1	0	0
TBEANS-50	81	174	93	1	2	1	1	1
TBEANS-50	81	82	1	1	3	1	0	0
TBEANS-51	81	477	396	0	3	1	0	0
TBEANS-51	81	477	396	0	3	1	0	0
TBEANS-51	81	477	396	0	3	4	0	0
TBEANS-51	81	477	396	0	3	1	0	0
TBEANS-51	81	477	396	0	4	4	0	0
TBEANS-51	81	477	396	0	3	4	0	0
TBEANS-51	81	477	396	0	4	4	0	0
TBEANS-51	82	225	143	1	3	1	1	1
TBEANS-51	82	287	205	1	4	1	0	0
TBEANS-51	82	477	395	0	3	4	0	2
TBEANS-52	82	477	395	0	3	1	0	0
TBEANS-52	83	477	394	0	4	4	0	0
TBEANS-52	83	98	15	1	3	3	0	1
TBEANS-52	84	477	393	0	3	1	0	0
TBEANS-52	84	477	393	0	3	1	0	0
TBEANS-52	84	477	393	0	3	1	0	0
TBEANS-52	84	477	393	0	3	1	0	0
TBEANS-52	84	477	393	0	3	1	0	0
TBEANS-52	84	477	393	0	3	1	0	0
TBEANS-52	84	477	393	0	3	1	0	0
TBEANS-53	85	477	392	0	3	1	0	2
TBEANS-53	85	477	392	0	3	1	0	0
TBEANS-53	85	477	392	0	2	1	0	1
TBEANS-53	85	477	392	0	4	1	0	0
TBEANS-53	86	477	391	0	3	4	0	0
TBEANS-53	86	477	391	0	3	1	0	0
TBEANS-53	86	115	29	1	3	1	1	0
TBEANS-53	86	477	391	0	3	1	0	0
TBEANS-53	86	203	117	1	2	1	0	4
TBEANS-53	86	92	6	1	3	1	1	1
TBEANS-54	86	477	391	0	4	1	0	0
TBEANS-54	86	477	391	0	5	1	0	0
TBEANS-54	86	477	391	0	3	1	0	0
TBEANS-54	87	477	390	0	3	1	0	0
TBEANS-54	87	477	390	0	3	1	0	1
TBEANS-54	87	477	390	0	3	1	1	0
TBEANS-54	87	88	1	1	3	1	0	1
TBEANS-54	87	88	1	1	3	1	1	0
TBEANS-54	87	477	390	0	4	1	0	0
TBEANS-54	87	477	390	0	3	1	0	0
TBEANS-55	87	477	390	0	3	1	0	0
TBEANS-55	87	477	390	0	4	1	0	0
TBEANS-55	88	477	389	0	4	1	0	0
TBEANS-55	88	477	389	0	4	1	0	0
TBEANS-55	88	300	212	1	3	1	0	0
TBEANS-55	89	477	388	0	3	2	0	0
TBEANS-55	89	477	388	0	3	1	0	0
TBEANS-55	89	90	1	1	2	4	1	0
TBEANS-55	90	477	387	0	3	1	0	0
TBEANS-55	90	477	387	0	3	1	0	0
TBEANS-56	90	91	1	1	1	1	1	0
TBEANS-56	90	477	387	0	3	2	0	0
TBEANS-56	90	477	387	0	3	2	0	0
TBEANS-56	91	477	386	0	4	1	0	0
TBEANS-56	91	114	23	1	3	1	1	1
TBEANS-56	91	322	231	1	3	1	1	1
TBEANS-56	91	92	1	1	4	1	0	1
TBEANS-56	91	300	209	1	3	1	0	0
TBEANS-56	91	477	386	0	3	1	0	0
TBEANS-56	91	289	198	1	3	1	0	0
TBEANS-57	91	477	386	0	4	4	0	0
TBEANS-57	91	115	24	1	3	1	1	0
TBEANS-57	91	477	386	0	3	1	0	1
TBEANS-57	91	477	386	0	3	1	0	0
TBEANS-57	92	112	20	1	4	1	1	0
TBEANS-57	92	477	385	0	3	1	0	0
TBEANS-57	92	477	385	0	4	1	0	0
TBEANS-57	92	115	23	1	3	1	1	0
TBEANS-57	92	477	385	0	4	1	0	0
TBEANS-57	92	477	385	0	4	1	0	0
TBEANS-58	92	477	385	0	4	1	0	0
TBEANS-58	92	477	385	0	4	1	0	0
TBEANS-58	92	477	385	0	4	1	0	0
TBEANS-58	93	314	221	1	2	1	0	1
TBEANS-58	93	477	384	0	3	1	0	0
TBEANS-58	93	477	384	0	3	1	0	1
TBEANS-58	93	357	264	1	2	1	1	1
TBEANS-58	93	477	384	0	4	1	0	0
TBEANS-58	93	477	384	0	3	1	0	0
TBEANS-58	93	477	384	0	4	1	0	0
TBEANS-59	93	477	384	0	3	1	0	0
TBEANS-59	93	477	384	0	3	1	0	0
TBEANS-59	93	117	24	1	3	1	1	0
TBEANS-59	93	477	384	0	3	1	0	2
TBEANS-59	93	477	384	0	3	1	0	0
TBEANS-59	93	477	384	0	3	1	0	0
TBEANS-59	93	477	384	0	4	1	0	0
TBEANS-59	93	368	275	1	3	1	0	1
TBEANS-59	94	477	383	0	3	1	0	0
TBEANS-59	94	477	383	0	3	1	0	0
TBEANS-60	94	477	383	0	3	4	0	0
TBEANS-60	94	402	308	1	3	1	0	1
TBEANS-60	94	410	316	1	3	1	1	0
TBEANS-60	94	477	383	0	3	1	0	0
TBEANS-60	94	111	17	1	3	1	1	0
TBEANS-60	94	477	383	0	4	1	0	0
TBEANS-60	95	477	382	0	3	1	0	0
TBEANS-60	95	477	382	0	3	1	0	0
TBEANS-60	95	477	382	0	3	1	0	0
TBEANS-60	95	314	219	1	3	1	0	1
TBEANS-61	95	477	382	0	4	1	0	0
TBEANS-61	95	477	382	0	3	1	0	0
TBEANS-61	95	477	382	0	3	1	0	0
TBEANS-61	95	477	382	0	3	3	0	0
TBEANS-61	95	477	382	0	4	4	0	0
TBEANS-61	95	115	20	1	1	1	0	0
TBEANS-61	95	477	382	0	3	1	0	0
TBEANS-61	95	99	4	1	3	1	1	1
TBEANS-61	96	129	33	1	3	1	1	0
TBEANS-61	96	477	381	0	3	4	0	1
TBEANS-62	96	128	32	1	1	1	1	0
TBEANS-62	97	225	128	1	3	1	1	0
TBEANS-62	97	477	380	0	5	1	0	0
TBEANS-62	97	477	380	0	3	1	0	0
TBEANS-62	97	477	380	0	4	1	0	0
TBEANS-62	97	477	380	0	4	1	0	0
TBEANS-62	97	477	380	0	5	1	0	0
TBEANS-62	98	477	379	0	3	1	0	0
TBEANS-62	98	477	379	0	3	4	0	0
TBEANS-62	98	477	379	0	3	1	0	0
TBEANS-63	98	477	379	0	3	1	0	0
TBEANS-63	99	477	378	0	3	1	0	0
TBEANS-63	99	477	378	0	3	1	0	0
TBEANS-63	99	410	311	1	2	1	1	0
TBEANS-63	99	477	378	0	3	1	0	0
TBEANS-63	99	405	306	1	3	1	1	1
TBEANS-63	99	151	52	1	3	3	1	0
TBEANS-63	99	477	378	0	3	1	0	0
TBEANS-63	100	477	377	0	3	1	0	1
TBEANS-63	100	477	377	0	3	1	0	0
TBEANS-64	100	477	377	0	4	1	0	0
TBEANS-64	100	477	377	0	3	4	0	0
TBEANS-64	100	477	377	0	3	1	0	0
TBEANS-64	100	252	152	1	3	1	1	0
TBEANS-64	100	477	377	0	3	1	0	0
TBEANS-64	100	477	377	0	3	1	0	0
TBEANS-64	100	477	377	0	2	1	0	0
TBEANS-64	100	477	377	0	5	1	0	0
TBEANS-64	101	129	28	1	3	1	1	0
TBEANS-64	101	106	5	1	3	1	1	0
TBEANS-65	101	477	376	0	3	1	0	0
TBEANS-65	101	477	376	0	4	1	0	0
TBEANS-65	101	477	376	0	4	1	0	0
TBEANS-65	101	477	376	0	3	1	0	0
TBEANS-65	101	114	13	1	1	1	1	1
TBEANS-65	102	477	375	0	3	1	0	1
TBEANS-65	102	477	375	0	2	1	0	0
TBEANS-65	102	477	375	0	3	1	0	0
TBEANS-65	102	477	375	0	3	1	0	0
TBEANS-65	102	477	375	0	3	1	0	0
TBEANS-66	102	477	375	0	3	1	0	0
TBEANS-66	102	106	4	1	4	1	0	0
TBEANS-66	102	477	375	0	3	1	0	0
TBEANS-66	102	477	375	0	2	1	0	2
TBEANS-66	102	477	375	0	4	1	0	0
TBEANS-66	104	477	373	0	4	1	0	0
TBEANS-66	104	477	373	0	3	1	0	0
TBEANS-66	104	477	373	0	4	1	0	0
TBEANS-66	104	477	373	0	4	1	0	0
TBEANS-66	105	477	372	0	4	1	0	0
TBEANS-67	105	477	372	0	4	1	0	0
TBEANS-67	105	112	7	1	3	1	0	0
TBEANS-67	105	477	372	0	3	1	0	0
TBEANS-67	106	273	167	1	4	1	1	0
TBEANS-67	106	477	371	0	3	1	0	0
TBEANS-67	106	477	371	0	3	1	0	0
TBEANS-67	106	477	371	0	3	1	0	0
TBEANS-67	106	477	371	0	2	1	0	0
TBEANS-67	106	477	371	0	3	1	0	0
TBEANS-67	106	477	371	0	3	1	0	0
TBEANS-68	106	121	15	1	3	1	0	0
TBEANS-68	106	477	371	0	3	1	0	0
TBEANS-68	106	477	371	0	3	1	0	0
TBEANS-68	107	477	370	0	3	1	0	0
TBEANS-68	107	477	370	0	3	1	0	0
TBEANS-68	107	477	370	0	3	1	0	0
TBEANS-68	107	477	370	0	3	1	0	0
TBEANS-68	107	477	370	0	3	1	0	0
TBEANS-68	107	477	370	0	4	1	0	0
TBEANS-68	107	477	370	0	3	1	0	0
TBEANS-69	107	477	370	0	3	1	0	1
TBEANS-69	107	231	124	1	3	1	1	0
TBEANS-69	107	477	370	0	3	4	0	0
TBEANS-69	107	477	370	0	4	1	0	0
TBEANS-69	107	133	26	1	4	4	1	0
TBEANS-69	107	108	1	1	4	4	0	0
TBEANS-69	107	477	370	0	3	1	0	0
TBEANS-69	108	111	3	1	3	1	0	1
TBEANS-69	108	113	5	1	1	1	1	1
TBEANS-69	108	477	369	0	2	1	0	0
TBEANS-70	108	109	1	1	1	4	0	0
TBEANS-70	108	477	369	0	3	1	0	0
TBEANS-70	108	174	66	1	2	1	0	0
TBEANS-70	108	477	369	0	3	1	0	0
TBEANS-70	108	477	369	0	3	1	0	0
TBEANS-70	108	477	369	0	3	1	0	0
TBEANS-70	108	477	369	0	3	1	0	0
TBEANS-70	109	477	368	0	3	2	0	0
TBEANS-70	109	477	368	0	3	1	0	0
TBEANS-70	110	119	9	1	3	1	1	0
TBEANS-71	111	115	4	1	3	1	1	0
TBEANS-71	111	477	366	0	4	1	0	0
TBEANS-71	111	117	6	1	4	1	1	0
TBEANS-71	111	133	22	1	4	1	1	0
TBEANS-71	111	477	366	0	3	1	0	0
TBEANS-71	112	477	365	0	3	1	0	0
TBEANS-71	112	273	161	1	4	1	1	0
TBEANS-71	112	477	365	0	3	1	0	0
TBEANS-71	112	117	5	1	5	4	1	0
TBEANS-71	112	477	365	0	2	2	0	0
TBEANS-72	112	477	365	0	4	1	0	0
TBEANS-72	113	133	20	1	2	1	1	0
TBEANS-72	113	477	364	0	3	1	0	1
TBEANS-72	113	277	164	1	3	1	0	0
TBEANS-72	113	357	244	1	3	1	0	0
TBEANS-72	114	477	363	0	3	4	0	0
TBEANS-72	114	477	363	0	3	4	0	0
TBEANS-72	114	477	363	0	3	4	0	0
TBEANS-72	114	477	363	0	3	4	0	0
TBEANS-72	114	357	243	1	3	4	0	0
TBEANS-73	114	477	363	0	3	4	0	0
TBEANS-73	114	255	141	1	3	4	1	0
TBEANS-73	114	477	363	0	3	4	0	0
TBEANS-73	114	276	162	1	3	4	0	0
TBEANS-73	114	133	19	1	3	1	1	0
TBEANS-73	115	477	362	0	3	1	0	0
TBEANS-73	115	477	362	0	3	1	0	0
TBEANS-73	115	477	362	0	3	1	0	0
TBEANS-73	116	477	361	0	5	4	0	0
TBEANS-73	116	390	274	1	3	1	1	0
TBEANS-74	116	260	144	1	4	1	1	0
TBEANS-74	117	477	360	0	3	4	0	0
TBEANS-74	117	477	360	0	3	1	0	0
TBEANS-74	117	459	342	1	3	4	1	1
TBEANS-74	117	477	360	0	3	1	0	0
TBEANS-74	117	118	1	1	3	1	1	0
TBEANS-74	117	477	360	0	5	1	0	0
TBEANS-74	118	452	334	1	5	1	1	3
TBEANS-74	118	477	359	0	4	1	0	0
TBEANS-74	119	198	79	1	3	1	0	0
TBEANS-75	119	477	358	0	3	1	0	0
TBEANS-75	119	477	358	0	3	1	0	0
TBEANS-75	119	477	358	0	3	1	0	0
TBEANS-75	119	477	358	0	3	1	0	0
TBEANS-75	119	477	358	0	3	1	0	0
TBEANS-75	119	477	358	0	4	1	0	0
TBEANS-75	120	121	1	1	3	1	0	0
TBEANS-75	121	123	2	1	3	1	0	0
TBEANS-75	121	142	21	1	3	4	0	0
TBEANS-75	122	133	11	1	4	1	1	0
TBEANS-76	122	123	1	1	3	1	0	0
TBEANS-76	123	477	354	0	3	4	0	0
TBEANS-76	123	477	354	0	3	2	0	0
TBEANS-76	123	477	354	0	3	5	0	0
TBEANS-76	123	162	39	1	4	1	1	0
TBEANS-76	123	477	354	0	3	1	0	0
TBEANS-76	125	477	352	0	3	1	0	0
TBEANS-76	125	477	352	0	3	4	0	0
TBEANS-76	125	477	352	0	3	5	0	0
TBEANS-76	126	477	351	0	3	1	1	1
TBEANS-77	126	402	276	1	4	4	0	0
TBEANS-77	126	477	351	0	3	5	1	0
TBEANS-77	126	477	351	0	3	5	0	0
TBEANS-77	126	477	351	0	3	5	0	0
TBEANS-77	127	197	70	1	3	1	0	0
TBEANS-77	127	477	350	0	3	2	0	0
TBEANS-77	128	477	349	0	4	1	0	0
TBEANS-77	129	162	33	1	4	1	1	0
TBEANS-77	129	169	40	1	4	1	0	0
TBEANS-77	129	477	348	0	4	1	0	0
TBEANS-78	129	477	348	0	3	1	0	0
TBEANS-78	130	271	141	1	3	1	1	0
TBEANS-78	131	477	346	0	4	1	0	0
TBEANS-78	131	477	346	0	3	1	0	0
TBEANS-78	131	477	346	0	4	3	0	0
TBEANS-78	131	144	13	1	3	1	1	0
TBEANS-78	131	477	346	0	3	1	0	0
TBEANS-78	132	477	345	0	3	1	0	0
TBEANS-78	132	477	345	0	4	1	0	0
TBEANS-78	133	169	36	1	3	1	0	0
TBEANS-79	133	477	344	0	3	1	0	0
TBEANS-79	134	197	63	1	3	1	1	0
TBEANS-79	134	318	184	1	4	1	1	0
TBEANS-79	134	477	343	0	3	1	0	0
TBEANS-79	134	256	122	1	4	1	0	2
TBEANS-79	134	138	4	1	4	1	1	0
TBEANS-79	135	477	342	0	3	1	0	0
TBEANS-79	135	136	1	1	1	1	0	0
TBEANS-79	135	175	40	1	2	1	0	0
TBEANS-79	135	477	342	0	4	1	0	0
TBEANS-80	135	477	342	0	3	1	0	0
TBEANS-80	135	477	342	0	4	1	0	0
TBEANS-80	136	219	83	1	3	3	0	0
TBEANS-80	136	247	111	1	3	3	1	0
TBEANS-80	136	317	181	1	3	3	1	0
TBEANS-80	136	273	137	1	3	3	1	0
TBEANS-80	136	477	341	0	3	3	0	0
TBEANS-80	136	192	56	1	3	4	0	0
TBEANS-80	136	477	341	0	4	4	0	0
TBEANS-80	136	477	341	0	3	1	0	0
TBEANS-81	136	477	341	0	3	1	0	0
TBEANS-81	137	477	340	0	3	1	0	0
TBEANS-81	137	477	340	0	4	1	0	0
TBEANS-81	137	186	49	1	3	1	0	1
TBEANS-81	137	477	340	0	3	1	0	0
TBEANS-81	137	477	340	0	3	1	0	0
TBEANS-81	137	477	340	0	3	4	0	0
TBEANS-81	137	155	18	1	1	1	1	0
TBEANS-81	137	477	340	0	3	1	0	0
TBEANS-81	137	477	340	0	3	1	0	1
TBEANS-82	139	477	338	0	3	1	0	0
TBEANS-82	140	477	337	0	3	1	0	0
TBEANS-82	141	477	336	0	3	1	1	0
TBEANS-82	141	169	28	1	3	1	1	0
TBEANS-82	141	167	26	1	3	1	1	0
TBEANS-82	141	163	22	1	3	1	1	0
TBEANS-82	141	155	14	1	3	1	0	1
TBEANS-82	141	155	14	1	3	1	0	1
TBEANS-82	141	142	1	1	3	1	0	0
TBEANS-82	141	155	14	1	3	1	1	0
TBEANS-83	141	157	16	1	3	1	1	1
TBEANS-83	141	157	16	1	3	1	1	1
TBEANS-83	141	160	19	1	3	1	1	0
TBEANS-83	141	169	28	1	3	1	1	0
TBEANS-83	141	142	1	1	3	1	0	0
TBEANS-83	141	169	28	1	3	1	1	0
TBEANS-83	141	142	1	1	3	1	0	1
TBEANS-83	141	167	26	1	3	1	1	0
TBEANS-83	141	155	14	1	3	1	1	0
TBEANS-83	141	162	21	1	3	1	1	0
TBEANS-84	141	162	21	1	3	1	1	0
TBEANS-84	141	162	21	1	3	1	1	3
TBEANS-84	141	162	21	1	3	1	1	3
TBEANS-84	141	162	21	1	3	1	1	2
TBEANS-84	141	167	26	1	3	1	1	0
TBEANS-84	141	142	1	1	3	1	0	0
TBEANS-84	141	167	26	1	3	1	1	0
TBEANS-84	141	162	21	1	3	1	1	0
TBEANS-84	141	167	26	1	3	1	1	0
TBEANS-84	141	477	336	0	4	1	1	0
TBEANS-85	141	477	336	0	4	1	0	1
TBEANS-85	142	161	19	1	4	4	1	0
TBEANS-85	142	206	64	1	5	1	1	0
TBEANS-85	142	180	38	1	3	1	1	1
TBEANS-85	142	143	1	1	3	1	1	0
TBEANS-85	142	143	1	1	3	1	1	0
TBEANS-85	142	225	83	1	3	1	1	2
TBEANS-85	142	248	106	1	3	1	1	1
TBEANS-85	142	143	1	1	3	1	0	0
TBEANS-85	143	247	104	1	3	1	0	0
TBEANS-86	143	224	81	1	4	4	0	0
TBEANS-86	143	477	334	0	3	1	0	0
TBEANS-86	144	261	117	1	4	1	1	0
TBEANS-86	144	232	88	1	4	1	0	0
TBEANS-86	144	477	333	0	3	1	1	0
TBEANS-86	144	477	333	0	3	1	0	0
TBEANS-86	145	173	28	1	2	1	0	0
TBEANS-86	146	477	331	0	3	1	0	0
TBEANS-86	146	477	331	0	3	1	0	0
TBEANS-86	146	477	331	0	3	1	0	0
TBEANS-87	146	273	127	1	3	4	1	1
TBEANS-87	147	477	330	0	4	4	0	0
TBEANS-87	147	477	330	0	3	4	0	0
TBEANS-87	148	477	329	0	4	4	0	0
TBEANS-87	148	477	329	0	4	3	0	0
TBEANS-87	148	477	329	0	4	4	0	0
TBEANS-87	148	203	55	1	1	1	1	0
TBEANS-87	148	477	329	0	3	1	1	0
TBEANS-87	148	477	329	0	3	1	0	0
TBEANS-87	148	477	329	0	3	1	0	0
TBEANS-88	148	477	329	0	5	1	0	0
TBEANS-88	148	477	329	0	4	1	0	0
TBEANS-88	148	304	156	1	1	1	1	2
TBEANS-88	149	477	328	0	3	1	0	0
TBEANS-88	149	477	328	0	4	1	0	0
TBEANS-88	149	477	328	0	2	1	0	0
TBEANS-88	149	477	328	0	3	1	0	0
TBEANS-88	149	477	328	0	3	1	0	0
TBEANS-88	149	477	328	0	3	1	0	0
TBEANS-88	149	477	328	0	3	1	0	0
TBEANS-89	149	477	328	0	3	1	0	0
TBEANS-89	149	477	328	0	3	1	0	0
TBEANS-89	149	178	29	1	1	1	1	0
TBEANS-89	150	273	123	1	3	1	1	1
TBEANS-89	150	477	327	0	3	1	0	0
TBEANS-89	150	477	327	0	3	1	0	0
TBEANS-89	150	164	14	1	3	1	1	0
TBEANS-89	150	477	327	0	3	1	0	0
TBEANS-89	150	477	327	0	3	1	0	1
TBEANS-89	150	477	327	0	3	1	0	0
TBEANS-90	151	477	326	0	3	1	0	0
TBEANS-90	151	477	326	0	4	1	0	0
TBEANS-90	151	477	326	0	3	1	0	0
TBEANS-90	151	477	326	0	3	1	0	0
TBEANS-90	151	477	326	0	3	4	0	0
TBEANS-90	151	153	2	1	3	1	1	0
TBEANS-90	152	402	250	1	3	1	1	0
TBEANS-90	153	154	1	1	3	1	0	0
TBEANS-90	154	477	323	0	3	1	0	0
TBEANS-90	154	477	323	0	4	1	1	0
TBEANS-91	154	477	323	0	3	1	0	0
TBEANS-91	154	477	323	0	3	1	0	0
TBEANS-91	154	155	1	1	3	1	2	0
TBEANS-91	154	477	323	0	3	1	0	0
TBEANS-91	154	477	323	0	4	4	0	0
TBEANS-91	154	477	323	0	3	1	0	0
TBEANS-91	154	477	323	0	3	1	0	0
TBEANS-91	154	477	323	0	3	1	0	0
TBEANS-91	154	477	323	0	3	1	1	0
TBEANS-91	154	477	323	0	3	1	0	0
TBEANS-92	155	217	62	1	3	1	0	1
TBEANS-92	155	477	322	0	4	4	0	0
TBEANS-92	155	477	322	0	3	1	0	0
TBEANS-92	155	477	322	0	3	1	0	0
TBEANS-92	156	477	321	0	3	1	0	0
TBEANS-92	156	477	321	0	3	1	0	0
TBEANS-92	156	477	321	0	3	1	0	0
TBEANS-92	156	477	321	0	3	4	0	0
TBEANS-92	156	477	321	0	4	1	0	0
TBEANS-92	156	477	321	0	4	4	0	0
TBEANS-93	156	477	321	0	3	4	0	0
TBEANS-93	157	477	320	0	2	1	0	0
TBEANS-93	157	166	9	1	2	1	0	0
TBEANS-93	157	477	320	0	3	1	0	0
TBEANS-93	157	477	320	0	4	1	1	0
TBEANS-93	157	477	320	0	3	1	0	0
TBEANS-93	158	477	319	0	3	1	0	0
TBEANS-93	158	477	319	0	3	1	0	0
TBEANS-93	158	242	84	1	3	1	1	0
TBEANS-93	158	477	319	0	3	1	0	0
TBEANS-94	158	477	319	0	5	1	1	1
TBEANS-94	158	477	319	0	3	1	0	0
TBEANS-94	159	179	20	1	3	4	1	0
TBEANS-94	159	179	20	1	3	2	1	0
TBEANS-94	159	179	20	1	3	2	1	0
TBEANS-94	159	179	20	1	3	2	1	0
TBEANS-94	159	262	103	1	3	2	1	0
TBEANS-94	160	179	19	1	3	4	1	0
TBEANS-94	160	179	19	1	3	2	1	0
TBEANS-94	160	179	19	1	3	2	1	0
TBEANS-95	160	179	19	1	3	2	1	0
TBEANS-95	161	248	87	1	4	1	1	0
TBEANS-95	162	477	315	0	4	1	0	0
TBEANS-95	162	271	109	1	2	1	1	0
TBEANS-95	162	477	315	0	4	4	1	0
TBEANS-95	163	477	314	0	3	1	0	0
TBEANS-95	163	271	108	1	3	1	1	1
TBEANS-95	164	477	313	0	3	1	0	0
TBEANS-95	164	477	313	0	3	1	0	0
TBEANS-95	165	477	312	0	4	1	0	0
TBEANS-96	165	477	312	0	3	1	1	0
TBEANS-96	165	477	312	0	4	1	0	0
TBEANS-96	166	477	311	0	4	1	0	0
TBEANS-96	166	184	18	1	2	1	1	1
TBEANS-96	167	477	310	0	3	1	0	0
TBEANS-96	167	407	240	1	3	1	1	0
TBEANS-96	168	477	309	0	3	1	1	0
TBEANS-96	168	477	309	0	3	1	0	0
TBEANS-96	168	477	309	0	4	1	0	0
TBEANS-96	168	477	309	0	3	1	0	0
TBEANS-97	169	477	308	0	3	1	0	0
TBEANS-97	169	172	3	1	1	1	0	0
TBEANS-97	169	477	308	0	4	1	0	0
TBEANS-97	170	477	307	0	3	2	0	0
TBEANS-97	170	204	34	1	2	1	1	2
TBEANS-97	172	271	99	1	3	1	1	0
TBEANS-97	172	477	305	0	4	1	0	0
TBEANS-97	172	271	99	1	4	4	1	0
TBEANS-97	172	477	305	0	4	1	0	0
TBEANS-97	172	175	3	1	3	1	0	1
TBEANS-98	172	273	101	1	3	1	1	1
TBEANS-98	172	477	305	0	3	1	0	0
TBEANS-98	173	477	304	0	3	1	0	0
TBEANS-98	173	477	304	0	3	1	0	0
TBEANS-98	173	477	304	0	3	1	0	0
TBEANS-98	173	477	304	0	3	1	0	0
TBEANS-98	173	174	1	1	2	1	1	0
TBEANS-98	174	251	77	1	3	3	1	1
TBEANS-98	174	477	303	0	3	1	0	0
TBEANS-98	174	477	303	0	3	1	0	0
TBEANS-99	174	188	14	1	3	1	1	0
TBEANS-99	175	477	302	0	3	1	0	0
TBEANS-99	175	477	302	0	3	1	0	0
TBEANS-99	175	477	302	0	3	1	0	0
TBEANS-99	175	477	302	0	2	1	0	0
TBEANS-99	176	177	1	1	3	1	0	1
TBEANS-99	176	477	301	0	3	1	0	0
TBEANS-99	176	407	231	1	4	1	1	0
TBEANS-99	176	199	23	1	4	1	1	0
TBEANS-99	176	184	8	1	4	4	1	0
FI-472	1	7	6	1	3	2	1	0
FI-472	1	477	476	0	4	2	0	0
FI-472	1	2	1	1	2	1	1	0
FI-473	2	3	1	1	3	1	1	1
FI-473	2	324	322	1	3	2	1	1
FI-473	2	477	475	0	4	4	0	0
FI-473	2	3	1	1	3	1	1	0
FI-473	2	3	1	1	2	1	1	1
FI-473	2	443	441	1	3	1	2	0
FI-473	2	131	129	1	3	4	1	0
FI-473	3	477	474	0	3	1	0	0
FI-473	3	4	1	1	3	1	1	1
FI-473	3	7	4	1	3	1	1	0
FI-474	4	5	1	1	3	1	1	1
FI-474	4	5	1	1	3	1	1	0
FI-474	4	5	1	1	3	1	1	0
FI-474	5	84	79	1	4	2	1	0
FI-474	5	21	16	1	4	4	1	1
FI-474	6	477	471	0	4	4	0	0
FI-474	7	477	470	0	3	1	0	0
FI-474	7	30	23	1	3	1	1	0
FI-474	7	16	9	1	4	4	1	0
FI-474	7	8	1	1	3	1	1	0
FI-475	7	8	1	1	4	1	1	0
FI-475	8	11	3	1	3	1	1	0
FI-475	8	10	2	1	3	1	1	0
FI-475	8	477	469	0	3	4	0	0
FI-475	8	10	2	1	4	1	1	0
FI-475	8	477	469	0	4	4	0	0
FI-475	8	15	7	1	3	1	1	0
FI-475	8	477	469	0	5	4	0	0
FI-475	8	477	469	0	5	4	0	0
FI-475	9	16	7	1	3	1	1	0
FI-476	9	477	468	0	4	5	0	0
FI-476	9	18	9	1	3	1	1	2
FI-476	9	409	400	1	3	1	0	1
FI-476	9	15	6	1	4	4	1	0
FI-476	9	10	1	1	3	4	1	0
FI-476	9	15	6	1	4	1	0	0
FI-476	10	18	8	1	3	5	1	0
FI-476	10	11	1	1	2	1	1	0
FI-476	10	12	2	1	3	4	1	0
FI-476	11	12	1	1	3	1	1	0
FI-477	11	17	6	1	4	1	1	0
FI-477	11	477	466	0	3	3	0	4
FI-477	11	49	38	1	2	1	1	1
FI-477	11	60	49	1	3	1	1	1
FI-477	11	71	60	1	3	1	1	0
FI-477	11	477	466	0	3	4	0	0
FI-477	14	477	463	0	3	1	0	0
FI-477	14	77	63	1	3	1	1	0
FI-477	14	477	463	0	4	2	0	0
FI-477	14	477	463	0	4	2	0	0
FI-478	15	16	1	1	3	1	0	0
FI-478	15	16	1	1	4	1	1	0
FI-478	15	16	1	1	3	1	1	0
FI-478	15	477	462	0	3	4	0	0
FI-478	15	16	1	1	4	1	1	0
FI-478	16	477	461	0	3	2	0	0
FI-478	16	31	15	1	4	4	1	0
FI-478	16	477	461	0	4	5	0	0
FI-478	16	92	76	1	3	5	1	0
FI-478	16	477	461	0	4	2	0	0
FI-479	17	23	6	1	3	4	1	0
FI-479	17	19	2	1	5	4	1	0
FI-479	17	477	460	0	3	1	0	0
FI-479	17	477	460	0	3	4	0	0
FI-479	17	49	32	1	3	4	1	0
FI-479	17	18	1	1	4	1	1	0
FI-479	18	22	4	1	3	1	0	1
FI-479	18	477	459	0	4	2	0	0
FI-479	19	477	458	0	4	1	0	0
FI-479	19	21	2	1	3	1	1	0
FI-480	20	71	51	1	5	4	1	0
FI-480	20	24	4	1	3	1	1	1
FI-480	21	477	456	0	3	1	0	0
FI-480	21	22	1	1	3	1	1	0
FI-480	22	24	2	1	3	1	0	0
FI-480	22	477	455	0	4	1	0	0
FI-480	22	287	265	1	1	4	1	2
FI-480	22	477	455	0	3	4	0	0
FI-480	22	23	1	1	3	1	0	1
FI-480	22	100	78	1	3	2	1	2
FI-481	23	477	454	0	4	4	0	0
FI-481	23	287	264	1	3	4	1	0
FI-481	23	477	454	0	4	1	0	0
FI-481	23	477	454	0	4	4	0	0
FI-481	23	51	28	1	3	4	1	1
FI-481	24	51	27	1	3	4	1	0
FI-481	24	51	27	1	3	1	1	1
FI-481	24	477	453	0	4	1	0	0
FI-481	25	37	12	1	3	1	1	0
FI-481	25	47	22	1	3	4	1	0
FI-482	25	477	452	0	3	4	0	0
FI-482	25	71	46	1	3	4	1	0
FI-482	25	163	138	1	3	1	0	1
FI-482	27	30	3	1	3	4	1	0
FI-482	27	30	3	1	2	4	1	1
FI-482	28	477	449	0	2	1	0	0
FI-482	28	32	4	1	4	4	1	0
FI-482	28	56	28	1	4	4	1	0
FI-482	29	37	8	1	3	1	1	0
FI-482	29	477	448	0	4	4	0	0
FI-483	29	39	10	1	3	1	1	0
FI-483	29	477	448	0	4	1	0	0
FI-483	30	477	447	0	3	1	3	0
FI-483	30	71	41	1	3	2	1	0
FI-483	30	36	6	1	3	1	1	0
FI-483	30	66	36	1	3	1	1	0
FI-483	31	47	16	1	3	4	1	0
FI-483	32	37	5	1	1	1	1	0
FI-483	33	417	384	1	3	4	0	0
FI-483	33	58	25	1	3	4	1	0
FI-484	35	43	8	1	5	4	1	0
FI-484	35	39	4	1	3	1	1	0
FI-484	35	190	155	1	4	1	0	1
FI-484	35	477	442	0	4	1	0	0
FI-484	36	37	1	1	3	1	1	1
FI-484	36	477	441	0	3	2	0	0
FI-484	36	38	2	1	4	4	1	1
FI-484	36	477	441	0	3	1	0	0
FI-484	37	38	1	1	3	4	1	0
FI-484	37	73	36	1	3	5	1	0
FI-485	37	477	440	0	3	5	0	0
FI-485	37	477	440	0	3	5	0	0
FI-485	37	477	440	0	3	5	0	0
FI-485	37	39	2	1	3	1	1	0
FI-485	38	477	439	0	4	4	0	0
FI-485	38	64	26	1	3	1	1	1
FI-485	38	39	1	1	3	1	1	0
FI-485	38	98	60	1	3	4	1	0
FI-485	38	39	1	1	3	1	1	0
FI-485	39	66	27	1	4	1	1	0
FI-486	39	477	438	0	4	4	0	0
FI-486	39	477	438	0	4	4	0	0
FI-486	39	98	59	1	4	4	1	1
FI-486	39	40	1	1	3	1	1	1
FI-486	39	84	45	1	1	1	1	0
FI-486	39	477	438	0	4	1	0	0
FI-486	40	41	1	1	2	1	1	1
FI-486	41	477	436	0	3	4	0	1
FI-486	42	477	435	0	3	1	0	0
FI-486	42	43	1	1	3	1	1	0
FI-487	42	67	25	1	3	4	1	0
FI-487	42	477	435	0	3	1	0	0
FI-487	42	63	21	1	2	2	1	1
FI-487	42	477	435	0	3	3	0	1
FI-487	42	43	1	1	3	1	1	1
FI-487	43	477	434	0	3	5	0	0
FI-487	43	58	15	1	4	4	1	0
FI-487	44	65	21	1	2	4	0	0
FI-487	44	477	433	0	3	4	0	2
FI-487	44	477	433	0	3	4	0	1
FI-488	44	58	14	1	4	4	1	0
FI-488	45	477	432	0	3	2	0	1
FI-488	45	80	35	1	3	1	1	2
FI-488	45	91	46	1	3	1	1	0
FI-488	45	46	1	1	3	1	1	1
FI-488	46	79	33	1	3	4	1	3
FI-488	47	408	361	1	4	4	1	0
FI-488	47	477	430	0	3	1	0	0
FI-488	47	77	30	1	3	1	0	0
FI-488	47	196	149	1	2	1	1	0
FI-489	47	477	430	0	3	1	0	0
FI-489	49	50	1	1	3	1	0	1
FI-489	49	352	303	1	3	1	1	1
FI-489	49	64	15	1	3	1	1	0
FI-489	50	51	1	1	2	1	1	0
FI-489	50	86	36	1	3	5	1	0
FI-489	50	70	20	1	3	5	0	1
FI-489	50	477	427	0	3	5	0	0
FI-489	51	477	426	0	3	1	0	0
FI-489	51	477	426	0	4	1	0	0
FI-490	51	477	426	0	4	1	0	0
FI-490	51	55	4	1	3	1	0	0
FI-490	51	77	26	1	3	1	1	0
FI-490	52	53	1	1	3	1	1	0
FI-490	53	477	424	0	5	4	0	1
FI-490	53	477	424	0	3	1	0	0
FI-490	53	168	115	1	3	2	1	0
FI-490	53	164	111	1	3	1	1	0
FI-490	54	477	423	0	4	2	1	0
FI-490	56	477	421	0	4	1	0	0
FI-491	56	57	1	1	5	1	1	0
FI-491	56	477	421	0	3	1	0	0
FI-491	56	77	21	1	3	4	1	0
FI-491	57	477	420	0	4	1	0	0
FI-491	57	435	378	1	4	2	0	0
FI-491	57	458	401	1	4	4	1	0
FI-491	58	60	2	1	3	1	1	0
FI-491	58	79	21	1	3	2	1	2
FI-491	58	74	16	1	4	4	1	0
FI-491	58	477	419	0	3	4	0	0
FI-492	59	60	1	1	3	1	1	0
FI-492	60	477	417	0	4	4	0	0
FI-492	60	62	2	1	5	4	1	0
FI-492	60	114	54	1	3	4	1	0
FI-492	60	477	417	0	3	1	0	0
FI-492	60	63	3	1	2	1	1	1
FI-492	60	192	132	1	3	1	0	2
FI-492	60	100	40	1	4	2	1	0
FI-492	61	66	5	1	3	3	1	1
FI-492	61	66	5	1	4	4	1	0
FI-493	61	197	136	1	3	1	1	0
FI-493	62	477	415	0	3	3	0	0
FI-493	63	92	29	1	3	4	1	2
FI-493	63	324	261	1	4	4	1	1
FI-493	63	477	414	0	3	1	0	0
FI-493	63	73	10	1	4	4	1	0
FI-493	64	70	6	1	3	1	1	0
FI-493	64	65	1	1	4	1	1	0
FI-493	64	129	65	1	3	4	1	0
FI-493	64	65	1	1	3	4	0	1
FI-494	64	65	1	1	3	4	0	1
FI-494	64	99	35	1	5	4	1	0
FI-494	64	128	64	1	3	4	1	1
FI-494	65	477	412	0	3	4	0	0
FI-494	65	70	5	1	3	1	1	0
FI-494	66	67	1	1	3	1	1	0
FI-494	66	477	411	0	3	2	0	1
FI-494	66	477	411	0	4	5	0	0
FI-494	66	67	1	1	3	1	1	0
FI-494	66	67	1	1	3	4	1	0
FI-495	66	74	8	1	4	1	1	0
FI-495	66	74	8	1	3	4	1	0
FI-495	67	114	47	1	3	1	1	0
FI-495	67	70	3	1	3	1	1	0
FI-495	67	477	410	0	3	1	0	0
FI-495	67	71	4	1	3	1	1	1
FI-495	67	68	1	1	3	1	0	1
FI-495	68	477	409	0	4	4	0	0
FI-495	68	70	2	1	3	1	1	0
FI-495	68	74	6	1	3	1	1	0
FI-496	70	71	1	1	3	1	1	0
FI-496	70	80	10	1	4	4	0	0
FI-496	70	71	1	1	4	1	1	0
FI-496	70	169	99	1	3	2	1	2
FI-496	70	477	407	0	3	4	0	0
FI-496	70	477	407	0	3	1	0	0
FI-496	70	71	1	1	3	1	1	0
FI-496	70	71	1	1	3	1	1	0
FI-496	71	72	1	1	3	1	1	0
FI-496	71	72	1	1	3	1	1	0
FI-497	71	477	406	0	3	1	0	0
FI-497	72	134	62	1	3	1	1	0
FI-497	72	73	1	1	3	1	1	0
FI-497	72	74	2	1	3	1	1	1
FI-497	72	477	405	0	3	1	0	0
FI-497	72	408	336	1	3	2	1	0
FI-497	72	73	1	1	3	1	1	0
FI-497	72	84	12	1	4	4	1	0
FI-497	73	74	1	1	4	1	1	0
FI-497	73	77	4	1	4	1	1	0
FI-498	73	134	61	1	5	1	1	0
FI-498	73	76	3	1	3	4	1	0
FI-498	74	168	94	1	3	2	1	0
FI-498	74	477	403	0	3	1	0	2
FI-498	74	78	4	1	4	2	0	1
FI-498	74	477	403	0	3	4	0	0
FI-498	74	477	403	0	3	1	0	1
FI-498	74	142	68	1	4	4	1	0
FI-498	74	141	67	1	3	1	1	0
FI-498	75	81	6	1	3	4	1	1
FI-499	77	93	16	1	3	4	0	0
FI-499	77	78	1	1	5	4	1	0
FI-499	77	477	400	0	4	4	0	0
FI-499	78	91	13	1	3	1	1	0
FI-499	78	477	399	0	3	4	0	0
FI-499	78	106	28	1	1	3	1	1
FI-499	78	79	1	1	1	1	1	1
FI-499	78	105	27	1	3	1	1	0
FI-499	79	86	7	1	3	4	1	0
FI-499	79	80	1	1	4	4	1	0
FI-500	79	114	35	1	3	1	1	0
FI-500	80	477	397	0	4	1	0	0
FI-500	80	477	397	0	3	5	0	0
FI-500	80	477	397	0	3	1	0	0
FI-500	80	477	397	0	2	5	0	0
FI-500	80	477	397	0	3	1	0	0
FI-500	80	160	80	1	3	3	1	1
FI-500	81	336	255	1	3	1	0	0
FI-500	81	84	3	1	4	1	1	0
FI-500	81	84	3	1	4	1	1	0
FI-501	81	477	396	0	3	1	0	0
FI-501	81	82	1	1	2	1	1	0
FI-501	81	84	3	1	3	1	1	0
FI-501	81	82	1	1	3	4	1	0
FI-501	82	477	395	0	3	1	0	0
FI-501	82	114	32	1	4	2	1	0
FI-501	84	477	393	0	3	4	0	0
FI-501	84	88	4	1	4	4	1	0
FI-501	84	434	350	1	4	4	1	0
FI-501	85	477	392	0	4	4	0	0
FI-502	85	477	392	0	3	3	0	0
FI-502	85	91	6	1	4	4	1	0
FI-502	85	161	76	1	3	2	1	0
FI-502	86	477	391	0	3	4	0	0
FI-502	86	150	64	1	4	1	1	0
FI-502	86	477	391	0	3	4	0	0
FI-502	86	87	1	1	3	1	1	0
FI-502	86	93	7	1	3	4	1	0
FI-502	86	477	391	0	3	4	0	1
FI-502	86	477	391	0	3	4	0	1
FI-503	86	87	1	1	3	1	1	0
FI-503	87	88	1	1	3	1	0	0
FI-503	87	88	1	1	3	1	1	0
FI-503	87	91	4	1	1	1	1	1
FI-503	88	92	4	1	3	1	1	0
FI-503	91	92	1	1	4	4	1	0
FI-503	92	477	385	0	3	4	0	0
FI-503	92	93	1	1	4	1	1	0
FI-503	92	477	385	0	4	4	0	0
FI-503	93	477	384	0	3	1	0	0
FI-504	93	477	384	0	3	4	0	0
FI-504	93	150	57	1	4	4	1	0
FI-504	93	98	5	1	4	4	1	0
FI-504	94	95	1	1	2	1	1	0
FI-504	94	165	71	1	2	4	1	0
FI-504	94	95	1	1	4	1	1	0
FI-504	95	96	1	1	3	1	0	0
FI-504	95	96	1	1	3	1	1	0
FI-504	95	96	1	1	5	1	1	0
FI-504	95	130	35	1	3	1	1	1
FI-505	95	96	1	1	3	1	1	0
FI-505	96	273	177	1	3	2	1	0
FI-505	96	142	46	1	3	2	1	0
FI-505	96	477	381	0	3	4	0	0
FI-505	96	165	69	1	3	4	1	0
FI-505	96	100	4	1	3	4	1	0
FI-505	97	477	380	0	2	2	0	0
FI-505	98	190	92	1	3	4	0	1
FI-505	98	477	379	0	3	2	0	0
FI-505	98	183	85	1	3	4	1	0
FI-506	98	239	141	1	3	1	1	0
FI-506	98	477	379	0	3	1	0	0
FI-506	98	109	11	1	4	4	1	0
FI-506	98	99	1	1	5	4	1	1
FI-506	99	128	29	1	3	4	1	0
FI-506	99	100	1	1	3	1	1	0
FI-506	99	144	45	1	3	4	1	0
FI-506	99	477	378	0	3	1	0	0
FI-506	99	380	281	1	3	2	0	0
FI-506	99	123	24	1	3	4	0	1
FI-507	99	477	378	0	3	1	0	2
FI-507	100	477	377	0	3	2	0	0
FI-507	100	477	377	0	4	4	0	0
FI-507	100	143	43	1	3	1	1	0
FI-507	100	101	1	1	4	4	1	2
FI-507	101	112	11	1	3	1	1	0
FI-507	101	127	26	1	3	4	0	1
FI-507	101	134	33	1	3	4	1	1
FI-507	101	109	8	1	3	4	1	0
FI-507	101	136	35	1	3	4	0	1
FI-508	102	477	375	0	2	1	0	0
FI-508	102	477	375	0	4	4	0	0
FI-508	102	113	11	1	3	1	1	0
FI-508	102	206	104	1	4	4	1	0
FI-508	105	243	138	1	3	2	0	0
FI-508	105	107	2	1	3	1	1	0
FI-508	105	477	372	0	3	1	0	0
FI-508	106	477	371	0	4	1	0	0
FI-508	106	477	371	0	4	4	0	0
FI-508	106	107	1	1	3	4	0	0
FI-509	107	116	9	1	3	4	1	0
FI-509	107	477	370	0	4	1	0	0
FI-509	107	115	8	1	3	1	1	0
FI-509	107	477	370	0	4	1	0	0
FI-509	107	477	370	0	4	1	0	0
FI-509	108	109	1	1	4	1	1	0
FI-509	108	109	1	1	3	1	1	0
FI-509	108	109	1	1	3	4	1	0
FI-509	108	477	369	0	3	1	0	0
FI-509	108	113	5	1	3	1	1	1
FI-510	109	136	27	1	3	1	1	2
FI-510	109	240	131	1	3	4	0	1
FI-510	109	477	368	0	3	2	0	0
FI-510	109	477	368	0	3	2	0	0
FI-510	109	477	368	0	3	2	0	0
FI-510	110	117	7	1	4	4	1	0
FI-510	111	112	1	1	4	4	1	0
FI-510	112	477	365	0	3	2	0	0
FI-510	112	113	1	1	3	4	1	0
FI-510	112	142	30	1	3	1	1	0
FI-511	112	135	23	1	3	1	1	0
FI-511	112	135	23	1	3	1	1	0
FI-511	112	135	23	1	3	1	1	0
FI-511	112	134	22	1	3	2	1	1
FI-511	113	133	20	1	3	4	1	0
FI-511	113	477	364	0	3	4	0	0
FI-511	113	115	2	1	4	4	1	0
FI-511	113	477	364	0	3	1	0	0
FI-511	113	220	107	1	4	4	1	0
FI-511	114	115	1	1	3	1	1	1
FI-512	114	115	1	1	4	4	1	0
FI-512	114	130	16	1	4	4	1	0
FI-512	114	149	35	1	3	4	1	2
FI-512	115	116	1	1	3	4	1	0
FI-512	115	116	1	1	3	4	1	0
FI-512	115	477	362	0	3	1	0	0
FI-512	115	477	362	0	3	1	0	0
FI-512	116	477	361	0	3	4	0	0
FI-512	116	477	361	0	3	1	0	0
FI-512	117	119	2	1	4	4	1	0
FI-513	118	131	13	1	4	4	1	0
FI-513	119	120	1	1	2	1	0	1
FI-513	119	477	358	0	2	1	1	1
FI-513	119	149	30	1	3	2	1	1
FI-513	119	122	3	1	3	1	1	0
FI-513	120	126	6	1	3	4	1	0
FI-513	120	127	7	1	3	1	0	0
FI-513	120	477	357	0	4	1	0	0
FI-513	121	128	7	1	3	1	1	0
FI-513	121	477	356	0	4	4	0	2
FI-514	121	477	356	0	3	1	0	0
FI-514	121	154	33	1	3	1	1	0
FI-514	121	122	1	1	3	1	1	0
FI-514	121	158	37	1	3	4	1	0
FI-514	122	477	355	0	3	1	0	0
FI-514	122	168	46	1	3	1	1	0
FI-514	122	140	18	1	3	4	1	1
FI-514	122	260	138	1	3	4	1	1
FI-514	122	149	27	1	3	1	1	0
FI-514	123	477	354	0	2	2	0	0
FI-515	123	126	3	1	3	1	1	0
FI-515	123	477	354	0	3	4	0	0
FI-515	123	126	3	1	4	1	1	0
FI-515	123	126	3	1	3	4	1	1
FI-515	123	126	3	1	3	1	1	0
FI-515	124	477	353	0	3	4	0	0
FI-515	124	128	4	1	3	4	1	0
FI-515	125	477	352	0	3	4	0	0
FI-515	126	477	351	0	4	1	0	0
FI-515	126	127	1	1	3	1	1	0
FI-516	126	477	351	0	3	4	0	0
FI-516	126	127	1	1	4	1	1	0
FI-516	126	477	351	0	3	4	0	0
FI-516	126	127	1	1	4	1	1	0
FI-516	126	134	8	1	3	4	1	1
FI-516	126	477	351	0	3	1	0	0
FI-516	127	477	350	0	4	2	0	0
FI-516	127	128	1	1	3	1	1	0
FI-516	127	128	1	1	4	4	1	0
FI-516	127	142	15	1	3	3	1	2
FI-517	127	132	5	1	3	2	1	1
FI-517	127	143	16	1	4	4	1	0
FI-517	127	420	293	1	4	4	1	0
FI-517	127	135	8	1	4	1	1	0
FI-517	127	477	350	0	3	3	0	2
FI-517	127	156	29	1	3	5	1	0
FI-517	127	477	350	0	3	5	0	4
FI-517	128	477	349	0	2	1	0	0
FI-517	128	477	349	0	3	4	0	0
FI-517	128	477	349	0	4	4	0	0
FI-518	128	129	1	1	4	1	1	0
FI-518	129	296	167	1	3	4	1	1
FI-518	129	477	348	0	3	4	0	0
FI-518	129	477	348	0	3	4	0	0
FI-518	130	477	347	0	3	1	0	0
FI-518	130	131	1	1	4	4	0	1
FI-518	130	141	11	1	1	1	1	1
FI-518	130	477	347	0	4	4	0	0
FI-518	133	165	32	1	3	1	1	0
FI-518	133	134	1	1	3	1	1	0
FI-519	133	134	1	1	3	4	1	0
FI-519	133	142	9	1	3	1	1	1
FI-519	133	169	36	1	4	4	1	0
FI-519	133	169	36	1	3	1	1	0
FI-519	133	134	1	1	3	1	1	0
FI-519	134	183	49	1	3	2	1	0
FI-519	134	198	64	1	3	1	1	0
FI-519	134	136	2	1	4	1	1	0
FI-519	134	150	16	1	3	4	1	1
FI-519	135	477	342	0	4	5	0	0
FI-520	135	158	23	1	1	1	1	0
FI-520	135	477	342	0	4	1	0	0
FI-520	135	136	1	1	3	1	1	0
FI-520	135	477	342	0	3	4	0	0
FI-520	135	136	1	1	2	1	1	0
FI-520	135	137	2	1	4	1	1	0
FI-520	136	477	341	0	3	4	0	0
FI-520	136	166	30	1	3	4	1	0
FI-520	136	155	19	1	2	1	1	1
FI-520	136	165	29	1	1	4	1	1
FI-521	136	477	341	0	4	5	0	1
FI-521	136	477	341	0	4	5	0	1
FI-521	136	477	341	0	4	5	0	1
FI-521	137	477	340	0	4	4	0	0
FI-521	137	165	28	1	3	2	1	0
FI-521	137	148	11	1	3	4	1	0
FI-521	137	157	20	1	3	4	1	0
FI-521	137	138	1	1	3	4	1	0
FI-521	139	477	338	0	4	1	0	0
FI-521	140	144	4	1	3	3	1	0
FI-522	140	141	1	1	3	1	1	0
FI-522	140	165	25	1	3	4	1	0
FI-522	140	144	4	1	3	1	1	1
FI-522	140	477	337	0	3	4	0	0
FI-522	140	477	337	0	3	4	0	0
FI-522	141	142	1	1	3	1	1	0
FI-522	141	477	336	0	3	4	0	0
FI-522	141	477	336	0	3	1	0	1
FI-522	141	142	1	1	3	4	1	1
FI-522	142	144	2	1	3	4	1	0
FI-523	142	143	1	1	3	1	1	0
FI-523	142	165	23	1	3	2	1	0
FI-523	142	477	335	0	3	2	0	0
FI-523	143	144	1	1	4	4	1	0
FI-523	143	477	334	0	4	1	0	0
FI-523	143	477	334	0	3	1	0	0
FI-523	144	477	333	0	3	1	0	0
FI-523	144	162	18	1	3	1	1	0
FI-523	144	464	320	1	4	1	1	0
FI-523	144	261	117	1	3	2	1	0
FI-524	144	165	21	1	3	4	1	1
FI-524	144	157	13	1	3	4	1	0
FI-524	144	146	2	1	3	1	1	0
FI-524	145	477	332	0	3	2	0	0
FI-524	146	148	2	1	3	1	1	0
FI-524	147	149	2	1	2	1	1	0
FI-524	147	477	330	0	3	1	0	0
FI-524	148	151	3	1	4	4	1	0
FI-524	148	477	329	0	3	2	0	2
FI-524	148	164	16	1	4	4	1	0
FI-525	148	149	1	1	3	3	1	0
FI-525	148	477	329	0	5	1	0	0
FI-525	149	165	16	1	4	4	1	0
FI-525	149	477	328	0	3	1	0	0
FI-525	149	477	328	0	3	4	0	0
FI-525	150	477	327	0	3	4	0	0
FI-525	150	477	327	0	4	4	0	0
FI-525	151	165	14	1	3	4	1	0
FI-525	151	176	25	1	4	4	2	0
FI-525	151	477	326	0	3	1	0	0
FI-526	153	156	3	1	3	1	1	0
FI-526	153	155	2	1	4	4	1	0
FI-526	154	156	2	1	3	4	1	0
FI-526	154	156	2	1	4	1	1	0
FI-526	154	158	4	1	3	4	1	0
FI-526	154	477	323	0	3	4	0	0
FI-526	154	169	15	1	3	4	1	0
FI-526	154	438	284	1	4	4	1	0
FI-526	155	156	1	1	3	1	1	0
FI-526	155	477	322	0	4	1	0	0
FI-527	155	477	322	0	3	1	0	4
FI-527	155	157	2	1	3	4	1	0
FI-527	156	157	1	1	3	4	0	0
FI-527	156	158	2	1	3	1	0	0
FI-527	156	168	12	1	3	1	1	0
FI-527	156	235	79	1	3	1	1	0
FI-527	157	158	1	1	4	4	0	0
FI-527	157	198	41	1	3	1	1	0
FI-527	157	171	14	1	3	1	2	0
FI-527	157	158	1	1	3	4	1	1
FI-528	157	158	1	1	3	1	1	0
FI-528	157	158	1	1	3	1	1	0
FI-528	158	242	84	1	3	4	0	0
FI-528	158	165	7	1	1	1	1	0
FI-528	158	160	2	1	4	4	1	0
FI-528	159	477	318	0	3	3	0	2
FI-528	159	160	1	1	3	4	1	0
FI-528	159	164	5	1	3	4	1	0
FI-528	159	161	2	1	3	1	1	0
FI-528	160	191	31	1	4	4	1	0
FI-529	161	162	1	1	4	1	1	0
FI-529	161	477	316	0	4	4	0	0
FI-529	161	477	316	0	3	4	0	0
FI-529	161	162	1	1	3	4	1	1
FI-529	161	477	316	0	3	4	0	0
FI-529	161	477	316	0	3	4	0	0
FI-529	161	477	316	0	3	4	0	1
FI-529	161	162	1	1	5	4	1	0
FI-529	161	162	1	1	5	3	1	0
FI-529	162	168	6	1	5	3	0	0
FI-530	162	477	315	0	4	3	0	0
FI-530	162	477	315	0	4	3	0	0
FI-530	162	477	315	0	2	2	0	0
FI-530	162	165	3	1	3	4	1	1
FI-530	163	198	35	1	4	1	1	0
FI-530	163	198	35	1	3	1	1	0
FI-530	163	477	314	0	3	4	0	1
FI-530	163	477	314	0	3	4	0	0
FI-530	163	164	1	1	3	1	1	0
FI-530	164	165	1	1	5	4	1	0
FI-531	164	199	35	1	2	1	0	0
FI-531	164	165	1	1	3	4	1	1
FI-531	164	190	26	1	3	1	1	0
FI-531	164	477	313	0	3	1	0	0
FI-531	165	168	3	1	4	4	0	0
FI-531	165	477	312	0	3	1	0	0
FI-531	165	178	13	1	3	1	2	0
FI-531	166	168	2	1	4	1	1	0
FI-531	166	439	273	1	3	2	1	0
FI-531	168	169	1	1	4	4	1	0
FI-532	169	477	308	0	4	4	0	0
FI-532	169	170	1	1	3	4	0	1
FI-532	169	170	1	1	3	1	1	0
FI-532	169	177	8	1	1	3	1	2
FI-532	170	197	27	1	3	4	0	2
FI-532	170	171	1	1	3	2	1	2
FI-532	170	225	55	1	3	2	0	0
FI-532	170	261	91	1	3	2	1	0
FI-532	171	477	306	0	4	1	0	0
FI-532	172	477	305	0	3	4	0	0
FI-533	172	175	3	1	4	1	1	1
FI-533	172	276	104	1	3	1	1	0
FI-533	173	176	3	1	3	1	1	0
FI-533	173	412	239	1	3	2	1	1
FI-533	174	183	9	1	3	4	1	0
FI-533	175	477	302	0	3	4	0	1
FI-533	175	176	1	1	3	4	1	0
FI-533	176	196	20	1	3	5	1	0
FI-533	176	458	282	1	4	2	1	0
FI-533	176	179	3	1	4	4	1	0
FI-534	176	477	301	0	3	1	0	0
FI-534	176	198	22	1	3	1	1	1
FI-534	177	210	33	1	3	1	1	0
FI-534	177	179	2	1	4	1	1	0
FI-534	177	178	1	1	4	1	1	0
FI-534	177	477	300	0	4	4	0	0
FI-534	178	477	299	0	3	2	0	1
FI-534	178	477	299	0	3	1	0	0
FI-534	178	477	299	0	4	1	0	0
FI-534	178	179	1	1	3	1	2	0
FI-535	178	217	39	1	4	4	1	0
FI-535	179	477	298	0	3	1	0	0
FI-535	179	191	12	1	4	4	1	0
FI-535	179	239	60	1	3	2	1	0
FI-535	179	180	1	1	4	4	1	0
FI-535	179	190	11	1	4	1	1	0
FI-535	180	183	3	1	3	4	1	0
FI-535	181	243	62	1	3	2	0	1
FI-535	181	183	2	1	3	2	0	1
FI-535	182	183	1	1	3	2	1	0
FI-536	182	477	295	0	3	1	0	0
FI-536	182	183	1	1	2	1	2	0
FI-536	182	183	1	1	3	1	2	0
FI-536	183	477	294	0	3	4	0	2
FI-536	183	477	294	0	3	5	0	1
FI-536	183	477	294	0	3	5	0	1
FI-536	183	248	65	1	3	4	1	1
FI-536	183	477	294	0	3	4	1	1
FI-536	183	190	7	1	1	1	2	0
FI-536	183	184	1	1	4	1	0	1
FI-537	183	190	7	1	3	1	2	0
FI-537	183	477	294	0	3	3	0	0
FI-537	183	184	1	1	3	3	1	0
FI-537	183	477	294	0	3	4	0	2
FI-537	183	184	1	1	4	4	2	0
FI-537	184	477	293	0	4	1	0	0
FI-537	184	190	6	1	3	4	1	0
FI-537	185	190	5	1	4	1	2	0
FI-537	185	477	292	0	4	4	0	0
FI-537	185	186	1	1	4	1	0	0
FI-538	185	477	292	0	3	2	0	0
FI-538	185	221	36	1	4	5	1	0
FI-538	186	190	4	1	4	4	1	0
FI-538	186	189	3	1	5	4	0	0
FI-538	186	187	1	1	4	4	1	0
FI-538	186	187	1	1	4	4	1	0
FI-538	186	187	1	1	5	4	1	0
FI-538	186	187	1	1	5	4	1	0
FI-538	187	241	54	1	4	4	1	0
FI-538	188	189	1	1	3	4	1	0
FI-539	188	189	1	1	3	4	1	0
FI-539	188	189	1	1	3	4	1	0
FI-539	187	189	2	1	3	1	0	0
FI-539	189	191	2	1	3	1	1	1
FI-539	189	190	1	1	3	1	1	0
FI-539	189	477	288	0	3	4	0	0
FI-539	189	477	288	0	3	5	0	0
FI-539	189	477	288	0	5	5	0	0
FI-539	190	477	287	0	3	4	0	2
FI-539	190	191	1	1	3	4	2	0
FI-540	190	218	28	1	3	4	1	1
FI-540	190	191	1	1	3	4	1	0
FI-540	190	477	287	0	3	4	0	0
FI-540	190	477	287	0	3	4	0	0
FI-540	190	191	1	1	3	1	0	0
FI-540	190	477	287	0	4	2	0	0
FI-540	191	197	6	1	3	4	1	0
FI-540	191	477	286	0	5	4	0	0
FI-540	191	242	51	1	4	4	1	0
FI-540	191	203	12	1	3	4	1	0
FI-541	191	203	12	1	3	4	1	0
FI-541	191	192	1	1	3	4	0	0
FI-541	191	203	12	1	3	4	1	0
FI-541	191	260	69	1	3	4	1	0
FI-541	192	197	5	1	1	3	1	1
FI-541	192	193	1	1	1	1	2	4
FI-541	192	477	285	0	3	4	0	4
FI-541	192	477	285	0	3	4	0	0
FI-541	192	206	14	1	5	4	1	0
FI-541	192	477	285	0	3	4	0	0
FI-542	192	213	21	1	3	4	1	0
FI-542	193	477	284	0	3	4	0	0
FI-542	193	477	284	0	3	4	0	0
FI-542	193	226	33	1	4	4	1	0
FI-542	193	477	284	0	4	2	0	0
FI-542	193	477	284	0	5	4	0	0
FI-542	193	284	91	1	3	4	1	0
FI-542	193	198	5	1	4	1	1	0
FI-542	193	311	118	1	4	4	1	3
FI-542	193	477	284	0	3	4	0	0
FI-543	196	197	1	1	4	4	1	0
FI-543	196	477	281	0	3	1	0	0
FI-543	196	197	1	1	3	5	1	0
FI-543	197	198	1	1	4	1	0	1
FI-543	197	477	280	0	3	1	0	0
FI-543	197	477	280	0	3	2	0	1
FI-543	197	199	2	1	3	4	0	0
FI-543	197	198	1	1	3	4	1	0
FI-543	198	249	51	1	3	4	1	2
FI-543	198	202	4	1	5	1	1	0
FI-544	198	206	8	1	4	4	1	0
FI-544	198	199	1	1	3	1	0	1
FI-544	198	212	14	1	3	1	1	0
FI-544	198	477	279	0	2	4	0	3
FI-544	198	477	279	0	3	4	0	0
FI-544	200	477	277	0	4	1	0	0
FI-544	203	290	87	1	3	1	1	0
FI-544	203	204	1	1	5	1	1	0
FI-544	203	477	274	0	3	1	0	2
FI-544	203	256	53	1	4	4	1	0
FI-545	204	210	6	1	3	4	1	0
FI-545	204	205	1	1	4	1	1	1
FI-545	204	477	273	0	3	2	0	0
FI-545	205	206	1	1	1	1	1	1
FI-545	205	206	1	1	4	4	1	0
FI-545	205	477	272	0	3	2	0	0
FI-545	205	247	42	1	3	1	1	0
FI-545	205	206	1	1	3	3	0	0
FI-545	205	477	272	0	3	5	0	4
FI-545	205	477	272	0	3	2	0	2
FI-546	205	477	272	0	3	2	0	1
FI-546	205	477	272	0	3	2	0	0
FI-546	205	477	272	0	3	4	0	2
FI-546	206	477	271	0	3	2	0	0
FI-546	206	463	257	1	3	1	1	0
FI-546	206	225	19	1	3	1	1	0
FI-546	206	232	26	1	3	4	1	0
FI-546	206	477	271	0	4	4	0	0
FI-546	207	275	68	1	3	4	1	0
FI-546	207	240	33	1	4	4	1	2
FI-547	208	477	269	0	3	4	0	0
FI-547	210	211	1	1	3	1	1	0
FI-547	210	477	267	0	4	4	0	0
FI-547	211	214	3	1	3	4	1	4
FI-547	211	253	42	1	3	1	1	1
FI-547	211	212	1	1	3	4	1	1
FI-547	212	218	6	1	3	4	1	4
FI-547	212	477	265	0	3	2	0	0
FI-547	212	477	265	0	4	4	0	0
FI-547	212	283	71	1	1	4	1	3
FI-548	212	291	79	1	3	4	1	0
FI-548	213	477	264	0	3	2	0	1
FI-548	213	235	22	1	3	4	1	1
FI-548	213	477	264	0	3	4	0	0
FI-548	213	214	1	1	3	1	1	0
FI-548	214	477	263	0	3	4	0	4
FI-548	214	477	263	0	3	1	0	0
FI-548	214	219	5	1	3	4	1	0
FI-548	215	216	1	1	3	4	0	0
FI-548	215	220	5	1	3	4	1	0
FI-549	217	477	260	0	4	4	0	0
FI-549	217	218	1	1	3	1	1	1
FI-549	218	477	259	0	3	2	0	0
FI-549	218	477	259	0	3	1	0	0
FI-549	218	233	15	1	4	4	1	0
FI-549	218	260	42	1	1	1	1	0
FI-549	218	477	259	0	3	4	0	0
FI-549	219	477	258	0	3	1	0	0
FI-549	219	220	1	1	2	4	0	0
FI-549	219	224	5	1	3	1	1	0
FI-550	219	414	195	1	4	4	1	0
FI-550	219	477	258	0	3	1	0	0
FI-550	220	477	257	0	3	4	0	0
FI-550	220	221	1	1	3	5	0	0
FI-550	220	477	257	0	4	2	0	1
FI-550	220	477	257	0	3	5	0	0
FI-550	221	477	256	0	4	4	0	0
FI-550	221	477	256	0	3	5	0	0
FI-550	221	477	256	0	3	1	0	0
FI-550	221	477	256	0	3	1	0	0
FI-551	222	285	63	1	3	2	1	0
FI-551	223	224	1	1	4	4	0	1
FI-551	224	225	1	1	3	2	0	0
FI-551	225	477	252	0	3	4	0	0
FI-551	225	266	41	1	3	1	1	1
FI-551	225	477	252	0	4	1	0	0
FI-551	225	276	51	1	3	2	1	4
FI-551	225	235	10	1	3	1	1	2
FI-551	225	261	36	1	3	2	1	0
FI-551	225	477	252	0	3	5	0	0
FI-552	226	477	251	0	3	1	0	0
FI-552	226	477	251	0	3	2	0	0
FI-552	227	240	13	1	2	1	1	1
FI-552	227	477	250	0	4	4	0	0
FI-552	227	477	250	0	3	4	0	0
FI-552	227	294	67	1	3	1	1	0
FI-552	227	240	13	1	4	4	1	0
FI-552	227	233	6	1	3	1	1	0
FI-552	227	477	250	0	4	1	0	0
FI-552	227	477	250	0	4	1	0	1
FI-553	227	477	250	0	4	5	0	0
FI-553	228	477	249	0	3	1	0	0
FI-553	228	477	249	0	4	4	0	0
FI-553	228	281	53	1	3	4	1	1
FI-553	228	477	249	0	4	2	0	0
FI-553	230	477	247	0	3	4	0	0
FI-553	230	231	1	1	3	4	0	0
FI-553	231	477	246	0	3	2	0	0
FI-553	231	477	246	0	3	2	0	0
FI-553	231	477	246	0	3	4	0	0
FI-554	231	233	2	1	3	1	1	0
FI-554	232	477	245	0	3	2	0	0
FI-554	232	262	30	1	3	4	1	2
FI-554	232	238	6	1	3	1	1	0
FI-554	232	285	53	1	4	4	1	0
FI-554	232	256	24	1	4	4	0	0
FI-554	233	234	1	1	3	1	0	0
FI-554	233	477	244	0	3	4	0	0
FI-554	233	477	244	0	4	1	0	0
FI-554	233	477	244	0	4	4	0	0
FI-555	235	331	96	1	2	1	1	1
FI-555	235	238	3	1	4	1	1	0
FI-555	235	477	242	0	4	1	0	0
FI-555	235	240	5	1	3	1	1	0
FI-555	235	477	242	0	3	4	0	0
FI-555	238	414	176	1	3	4	0	3
FI-555	238	477	239	0	3	2	0	0
FI-555	239	269	30	1	3	1	1	0
FI-555	239	240	1	1	3	1	1	0
FI-555	239	407	168	1	3	5	0	2
FI-556	240	324	84	1	3	1	1	0
FI-556	240	241	1	1	3	4	1	0
FI-556	240	477	237	0	3	4	0	0
FI-556	240	246	6	1	3	1	0	0
FI-556	241	477	236	0	4	4	0	0
FI-556	241	243	2	1	4	4	1	0
FI-556	243	260	17	1	3	4	1	1
FI-556	245	477	232	0	3	1	0	0
FI-556	245	477	232	0	3	4	0	0
FI-556	245	253	8	1	5	4	1	0
FI-557	246	477	231	0	4	1	0	0
FI-557	246	477	231	0	3	1	0	0
FI-557	246	477	231	0	3	4	0	0
FI-557	246	477	231	0	4	4	0	0
FI-557	246	477	231	0	3	1	0	0
FI-557	247	408	161	1	3	1	1	0
FI-557	248	477	229	0	4	2	0	0
FI-557	248	256	8	1	4	1	1	0
FI-557	248	263	15	1	3	1	1	0
FI-557	249	477	228	0	3	5	0	0
FI-558	249	477	228	0	3	1	0	0
FI-558	249	276	27	1	1	1	1	1
FI-558	250	477	227	0	3	4	0	2
FI-558	252	477	225	0	3	2	0	0
FI-558	252	477	225	0	5	4	0	0
FI-558	252	287	35	1	3	4	0	2
FI-558	253	477	224	0	3	4	0	2
FI-558	253	477	224	0	3	4	0	1
FI-558	254	267	13	1	3	1	1	0
FI-558	254	255	1	1	4	4	0	0
FI-559	254	477	223	0	3	4	0	0
FI-559	254	267	13	1	3	4	1	0
FI-559	255	257	2	1	3	1	1	1
FI-559	255	282	27	1	3	1	0	0
FI-559	255	477	222	0	3	4	0	0
FI-559	256	278	22	1	3	4	1	0
FI-559	256	260	4	1	3	1	1	0
FI-559	256	257	1	1	1	1	1	0
FI-559	256	261	5	1	3	4	1	1
FI-559	257	262	5	1	3	4	1	0
FI-560	257	282	25	1	3	1	1	2
FI-560	257	399	142	1	3	4	1	0
FI-560	259	477	218	0	3	5	0	0
FI-560	260	477	217	0	4	4	0	0
FI-560	260	477	217	0	3	4	0	0
FI-560	260	477	217	0	3	2	0	0
FI-560	260	477	217	0	3	1	0	0
FI-560	261	477	216	0	3	1	0	0
FI-560	261	477	216	0	3	1	0	0
FI-560	261	262	1	1	3	1	1	0
FI-561	261	477	216	0	3	4	0	0
FI-561	261	477	216	0	3	4	0	0
FI-561	261	270	9	1	3	1	1	0
FI-561	261	262	1	1	3	1	1	0
FI-561	261	262	1	1	3	4	1	0
FI-561	262	263	1	1	4	1	1	0
FI-561	262	263	1	1	1	4	1	1
FI-561	262	477	215	0	3	1	0	0
FI-561	262	267	5	1	3	1	1	0
FI-561	262	477	215	0	3	1	0	0
FI-562	263	477	214	0	3	4	0	1
FI-562	263	345	82	1	3	4	1	0
FI-562	263	276	13	1	3	1	1	4
FI-562	263	477	214	0	3	1	0	3
FI-562	263	477	214	0	3	1	0	0
FI-562	265	477	212	0	4	4	0	0
FI-562	266	477	211	0	3	1	0	0
FI-562	266	477	211	0	3	5	0	4
FI-562	266	270	4	1	2	1	1	1
FI-562	266	477	211	0	4	4	0	0
FI-563	266	267	1	1	3	1	1	0
FI-563	266	477	211	0	3	2	0	0
FI-563	266	412	146	1	3	2	0	0
FI-563	267	268	1	1	4	1	1	0
FI-563	267	269	2	1	3	1	1	1
FI-563	267	279	12	1	5	4	1	0
FI-563	268	477	209	0	4	4	0	0
FI-563	268	477	209	0	3	3	0	0
FI-563	268	477	209	0	3	1	0	0
FI-563	269	477	208	0	2	1	0	0
FI-564	269	270	1	1	3	4	1	0
FI-564	269	270	1	1	4	2	0	0
FI-564	269	477	208	0	3	1	0	0
FI-564	269	477	208	0	3	1	0	0
FI-564	269	477	208	0	5	3	0	0
FI-564	270	283	13	1	3	4	1	0
FI-564	270	477	207	0	4	1	0	0
FI-564	270	477	207	0	4	1	0	0
FI-564	271	477	206	0	3	1	0	0
FI-564	272	477	205	0	3	1	0	0
FI-565	273	274	1	1	3	4	1	0
FI-565	273	274	1	1	3	4	0	1
FI-565	273	318	45	1	4	1	1	0
FI-565	273	289	16	1	5	4	1	0
FI-565	273	277	4	1	3	1	0	0
FI-565	273	477	204	0	3	1	0	0
FI-565	274	275	1	1	3	1	1	1
FI-565	274	450	176	1	4	4	0	0
FI-565	274	477	203	0	3	2	0	1
FI-565	275	287	12	1	4	4	1	2
FI-566	276	416	140	1	3	1	2	0
FI-566	277	283	6	1	3	4	1	2
FI-566	277	320	43	1	3	4	1	0
FI-566	277	281	4	1	2	1	1	0
FI-566	277	284	7	1	3	1	1	1
FI-566	280	284	4	1	3	4	1	0
FI-566	280	281	1	1	2	1	1	1
FI-566	280	287	7	1	3	1	1	0
FI-566	280	477	197	0	5	4	0	0
FI-566	280	477	197	0	4	4	0	0
FI-567	280	477	197	0	3	4	0	0
FI-567	281	294	13	1	3	1	0	0
FI-567	281	282	1	1	3	1	1	0
FI-567	281	304	23	1	4	2	1	1
FI-567	281	477	196	0	3	4	0	0
FI-567	282	283	1	1	3	5	1	0
FI-567	282	283	1	1	3	5	1	0
FI-567	282	309	27	1	4	4	1	0
FI-567	282	287	5	1	3	1	1	0
FI-567	282	477	195	0	4	1	0	0
FI-568	282	284	2	1	3	1	1	0
FI-568	283	284	1	1	3	5	1	0
FI-568	283	477	194	0	2	1	0	0
FI-568	283	477	194	0	3	2	0	0
FI-568	283	477	194	0	3	4	0	0
FI-568	283	477	194	0	3	4	0	0
FI-568	283	287	4	1	3	1	1	1
FI-568	283	310	27	1	3	1	0	0
FI-568	283	284	1	1	3	1	1	0
FI-568	284	298	14	1	4	1	0	1
FI-569	284	477	193	0	3	5	0	0
FI-569	284	285	1	1	3	4	1	0
FI-569	284	477	193	0	3	1	0	0
FI-569	284	477	193	0	4	4	0	0
FI-569	284	477	193	0	3	1	0	0
FI-569	284	285	1	1	2	1	1	0
FI-569	284	287	3	1	4	1	1	1
FI-569	285	286	1	1	5	1	1	0
FI-569	286	287	1	1	1	1	1	0
FI-569	287	477	190	0	4	4	0	0
FI-570	287	477	190	0	3	4	0	0
FI-570	287	289	2	1	4	4	1	1
FI-570	287	477	190	0	3	4	0	0
FI-570	287	477	190	0	3	1	0	0
FI-570	287	477	190	0	3	1	0	0
FI-570	287	289	2	1	3	4	1	0
FI-570	288	295	7	1	3	2	1	0
FI-570	288	477	189	0	4	2	0	0
FI-570	288	289	1	1	3	1	1	0
FI-570	288	289	1	1	1	1	1	0
FI-571	288	289	1	1	3	1	1	0
FI-571	288	289	1	1	1	1	1	2
FI-571	288	477	189	0	4	4	0	0
FI-571	288	477	189	0	4	1	0	0
FI-571	288	296	8	1	3	1	1	0
FI-571	289	290	1	1	4	1	1	0
FI-571	289	477	188	0	3	1	0	0
FI-571	289	477	188	0	3	1	0	0
FI-571	289	338	49	1	3	1	1	1
FI-571	289	290	1	1	4	1	1	0
FI-572	289	298	9	1	1	3	1	1
FI-572	289	294	5	1	3	1	1	0
FI-572	290	396	106	1	4	2	1	0
FI-572	290	477	187	0	3	1	0	0
FI-572	290	312	22	1	4	4	1	0
FI-572	291	477	186	0	3	4	0	0
FI-572	291	298	7	1	3	4	1	0
FI-572	291	295	4	1	4	4	1	1
FI-572	291	305	14	1	3	1	1	0
FI-572	291	477	186	0	3	1	0	0
FI-573	291	477	186	0	4	1	0	0
FI-573	291	331	40	1	5	4	0	1
FI-573	291	477	186	0	4	4	0	0
FI-573	294	477	183	0	3	4	0	1
FI-573	294	295	1	1	3	4	1	1
FI-573	294	477	183	0	3	1	0	0
FI-573	294	295	1	1	1	1	1	0
FI-573	294	295	1	1	4	4	1	0
FI-573	294	477	183	0	4	4	0	0
FI-573	295	296	1	1	3	1	1	0
FI-574	295	296	1	1	4	1	1	0
FI-574	295	296	1	1	3	1	1	0
FI-574	295	477	182	0	3	1	0	0
FI-574	295	477	182	0	4	4	0	0
FI-574	296	421	125	1	4	4	1	0
FI-574	296	298	2	1	3	1	1	0
FI-574	296	298	2	1	3	1	1	0
FI-574	296	298	2	1	3	1	1	0
FI-574	296	350	54	1	3	4	1	0
FI-574	297	477	180	0	3	1	0	0
FI-575	297	477	180	0	3	1	0	0
FI-575	297	298	1	1	3	1	0	0
FI-575	297	310	13	1	3	1	1	0
FI-575	297	477	180	0	3	4	0	0
FI-575	297	477	180	0	3	1	0	0
FI-575	298	477	179	0	3	2	0	0
FI-575	298	477	179	0	3	1	0	0
FI-575	298	312	14	1	3	4	1	0
FI-575	298	477	179	0	3	1	0	0
FI-575	298	477	179	0	3	4	0	0
FI-576	298	477	179	0	3	2	0	0
FI-576	298	303	5	1	3	1	1	2
FI-576	301	477	176	0	3	4	0	1
FI-576	301	477	176	0	2	5	0	0
FI-576	301	315	14	1	2	5	0	0
FI-576	301	302	1	1	3	1	1	0
FI-576	301	302	1	1	5	4	1	1
FI-576	302	309	7	1	3	4	1	4
FI-576	302	477	175	0	3	1	0	0
FI-576	302	309	7	1	3	4	1	0
FI-577	302	304	2	1	3	1	1	0
FI-577	303	304	1	1	2	1	1	0
FI-577	303	477	174	0	3	1	0	0
FI-577	303	304	1	1	4	4	1	0
FI-577	303	477	174	0	4	4	0	1
FI-577	303	477	174	0	3	1	0	0
FI-577	304	305	1	1	4	1	1	0
FI-577	304	309	5	1	3	4	1	0
FI-577	304	305	1	1	1	1	0	0
FI-577	304	477	173	0	3	4	0	0
FI-578	304	394	90	1	4	4	1	0
FI-578	304	305	1	1	3	1	1	0
FI-578	304	477	173	0	3	4	0	1
FI-578	305	477	172	0	3	1	0	0
FI-578	305	311	6	1	4	4	1	1
FI-578	307	477	170	0	4	1	0	0
FI-578	308	477	169	0	3	4	0	0
FI-578	308	309	1	1	4	1	1	0
FI-578	308	318	10	1	3	4	1	0
FI-578	308	315	7	1	3	1	1	1
FI-579	308	315	7	1	3	4	1	1
FI-579	308	477	169	0	3	1	0	0
FI-579	309	477	168	0	3	1	0	1
FI-579	309	477	168	0	3	4	0	1
FI-579	309	312	3	1	3	4	1	0
FI-579	309	336	27	1	3	1	1	2
FI-579	309	310	1	1	3	1	1	0
FI-579	310	311	1	1	3	1	1	1
FI-579	310	311	1	1	3	1	1	1
FI-579	310	477	167	0	3	1	0	1
FI-580	310	311	1	1	3	1	1	0
FI-580	310	477	167	0	3	4	0	0
FI-580	311	312	1	1	3	1	1	0
FI-580	311	477	166	0	3	1	0	0
FI-580	311	477	166	0	3	1	1	0
FI-580	311	316	5	1	3	1	1	0
FI-580	312	477	165	0	3	1	0	0
FI-580	312	477	165	0	2	1	0	0
FI-580	312	323	11	1	3	1	0	1
FI-580	312	315	3	1	3	1	1	0
FI-581	312	313	1	1	3	4	1	0
FI-581	314	348	34	1	2	3	0	0
FI-581	315	325	10	1	3	4	1	0
FI-581	315	477	162	0	4	1	0	0
FI-581	315	322	7	1	3	1	1	0
FI-581	315	317	2	1	3	1	1	0
FI-581	315	477	162	0	4	4	0	0
FI-581	316	477	161	0	3	1	0	0
FI-581	317	477	160	0	3	1	0	0
FI-581	317	477	160	0	3	1	0	0
FI-582	317	477	160	0	3	5	0	1
FI-582	318	477	159	0	3	1	0	0
FI-582	318	319	1	1	1	1	1	0
FI-582	318	319	1	1	3	1	1	0
FI-582	318	319	1	1	3	5	1	0
FI-582	318	477	159	0	3	1	0	0
FI-582	318	373	55	1	4	1	1	0
FI-582	319	477	158	0	3	1	0	0
FI-582	319	322	3	1	4	1	1	1
FI-582	320	477	157	0	4	4	0	0
FI-583	320	339	19	1	3	1	1	1
FI-583	322	477	155	0	3	2	0	1
FI-583	323	324	1	1	3	1	0	1
FI-583	323	324	1	1	3	4	1	0
FI-583	323	330	7	1	3	1	1	1
FI-583	324	477	153	0	3	4	0	0
FI-583	324	325	1	1	2	1	1	0
FI-583	325	477	152	0	4	4	0	0
FI-583	325	338	13	1	2	1	1	0
FI-583	326	477	151	0	3	1	0	0
FI-584	328	477	149	0	5	4	0	0
FI-584	329	373	44	1	3	1	1	2
FI-584	330	477	147	0	5	1	0	0
FI-584	330	331	1	1	5	4	1	0
FI-584	330	477	147	0	4	2	0	0
FI-584	330	332	2	1	3	4	1	0
FI-584	331	421	90	1	3	1	1	0
FI-584	331	335	4	1	3	4	1	0
FI-584	331	332	1	1	3	2	0	0
FI-584	332	333	1	1	2	1	1	0
FI-585	332	335	3	1	3	4	1	0
FI-585	332	477	145	0	3	2	0	0
FI-585	332	477	145	0	4	4	0	0
FI-585	332	477	145	0	4	4	0	0
FI-585	332	371	39	1	3	4	1	2
FI-585	332	333	1	1	3	4	1	1
FI-585	333	477	144	0	3	4	0	0
FI-585	333	477	144	0	2	1	0	0
FI-585	333	477	144	0	3	1	0	0
FI-585	333	408	75	1	3	2	1	1
FI-586	335	477	142	0	3	2	0	0
FI-586	335	336	1	1	3	4	0	0
FI-586	336	338	2	1	4	1	1	0
FI-586	337	338	1	1	4	1	1	0
FI-586	337	477	140	0	3	1	0	0
FI-586	337	338	1	1	3	1	0	0
FI-586	337	477	140	0	3	1	0	0
FI-586	337	394	57	1	3	2	1	0
FI-586	337	338	1	1	3	4	1	0
FI-586	337	408	71	1	3	1	1	0
FI-587	338	450	112	1	3	1	0	1
FI-587	338	353	15	1	3	1	1	0
FI-587	338	343	5	1	3	4	1	0
FI-587	339	477	138	0	3	1	0	0
FI-587	339	477	138	0	3	1	0	0
FI-587	339	344	5	1	3	4	1	0
FI-587	339	340	1	1	4	1	1	0
FI-587	339	340	1	1	4	4	1	0
FI-587	339	477	138	0	4	1	0	0
FI-587	339	371	32	1	3	1	1	0
FI-588	339	340	1	1	3	1	0	0
FI-588	340	343	3	1	4	1	1	0
FI-588	340	390	50	1	3	1	0	0
FI-588	340	341	1	1	3	4	1	0
FI-588	340	343	3	1	4	4	1	0
FI-588	343	344	1	1	3	1	1	0
FI-588	343	477	134	0	3	4	0	0
FI-588	344	477	133	0	3	4	0	0
FI-588	344	477	133	0	3	4	0	1
FI-588	344	345	1	1	3	4	1	0
FI-589	344	345	1	1	3	2	1	1
FI-589	344	346	2	1	3	4	1	0
FI-589	345	361	16	1	4	4	1	0
FI-589	345	352	7	1	3	1	1	0
FI-589	346	477	131	0	3	1	0	0
FI-589	347	477	130	0	3	2	0	0
FI-589	347	477	130	0	3	1	0	0
FI-589	347	477	130	0	4	1	0	0
FI-589	349	350	1	1	4	4	1	0
FI-589	349	477	128	0	3	1	0	0
FI-590	350	477	127	0	3	2	0	0
FI-590	350	477	127	0	4	4	0	0
FI-590	350	477	127	0	3	2	0	0
FI-590	350	407	57	1	3	4	1	0
FI-590	350	351	1	1	3	1	1	0
FI-590	351	352	1	1	3	1	1	0
FI-590	351	477	126	0	3	1	0	0
FI-590	351	352	1	1	3	1	0	1
FI-590	351	367	16	1	3	1	1	0
FI-590	352	374	22	1	3	1	1	0
FI-591	352	477	125	0	4	1	0	0
FI-591	352	477	125	0	4	5	0	0
FI-591	352	477	125	0	3	2	0	0
FI-591	353	354	1	1	5	4	1	0
FI-591	353	477	124	0	3	1	0	0
FI-591	355	417	62	1	2	3	1	0
FI-591	356	477	121	0	4	4	0	0
FI-591	361	367	6	1	3	1	1	0
FI-591	361	443	82	1	3	1	2	0
FI-591	361	367	6	1	3	1	1	1
FIREG-10	7	66	59	1	3	2	0	0
FIREG-10	7	477	470	0	4	4	0	0
FIREG-10	7	477	470	0	4	1	0	0
FIREG-10	7	42	35	1	3	5	0	0
FIREG-10	7	477	470	0	4	1	0	0
FIREG-10	7	477	470	0	5	4	0	0
FIREG-10	7	477	470	0	5	4	0	0
FIREG-10	7	477	470	0	5	4	0	0
FIREG-10	8	9	1	1	4	4	1	0
FIREG-10	8	10	2	1	3	4	1	1
FIREG-11	9	477	468	0	4	4	0	1
FIREG-11	9	477	468	0	4	4	0	1
FIREG-11	9	17	8	1	3	5	1	0
FIREG-11	10	477	467	0	3	5	0	0
FIREG-11	10	11	1	1	4	4	0	0
FIREG-11	10	15	5	1	3	4	1	0
FIREG-11	10	15	5	1	3	4	1	0
FIREG-11	10	18	8	1	3	1	1	0
FIREG-11	11	80	69	1	4	3	0	2
FIREG-11	16	18	2	1	4	4	1	1
FIREG-12	17	99	82	1	4	4	1	1
FIREG-12	17	18	1	1	4	3	1	0
FIREG-12	17	18	1	1	3	5	1	0
FIREG-12	18	22	4	1	5	4	1	0
FIREG-12	18	66	48	1	3	1	0	0
FIREG-12	22	23	1	1	4	4	1	1
FIREG-12	22	39	17	1	3	1	1	0
FIREG-12	22	165	143	1	3	4	1	1
FIREG-12	23	29	6	1	3	1	1	0
FIREG-12	24	29	5	1	3	1	1	0
FIREG-13	25	477	452	0	4	1	0	0
FIREG-13	28	29	1	1	4	4	1	0
FIREG-13	28	29	1	1	3	1	1	0
FIREG-13	29	100	71	1	4	4	0	1
FIREG-13	31	70	39	1	4	2	1	0
FIREG-13	31	67	36	1	3	1	1	0
FIREG-13	33	477	444	0	3	4	0	0
FIREG-13	33	477	444	0	5	4	0	0
FIREG-13	33	477	444	0	4	4	0	0
FIREG-13	35	477	442	0	2	1	0	0
FIREG-14	36	127	91	1	3	1	1	0
FIREG-14	37	477	440	0	4	4	0	0
FIREG-14	38	44	6	1	3	1	0	1
FIREG-14	43	477	434	0	3	1	0	0
FIREG-14	44	86	42	1	4	1	1	0
FIREG-14	45	46	1	1	4	1	1	1
FIREG-14	47	67	20	1	3	4	1	0
FIREG-14	49	477	428	0	3	4	0	0
FIREG-14	51	477	426	0	4	4	0	2
FIREG-14	63	64	1	1	1	1	0	0
FIREG-15	64	477	413	0	4	2	0	0
FIREG-15	70	81	11	1	4	4	0	0
FIREG-15	72	477	405	0	3	4	0	0
FIREG-15	73	80	7	1	3	1	1	0
FIREG-15	74	75	1	1	3	1	0	0
FIREG-15	74	127	53	1	4	1	0	0
FIREG-15	80	477	397	0	3	4	0	0
FIREG-15	84	86	2	1	4	4	1	0
FIREG-15	84	98	14	1	4	4	1	0
FIREG-15	85	95	10	1	3	4	0	2
FIREG-16	95	143	48	1	3	2	1	0
FIREG-16	95	96	1	1	4	1	1	1
FIREG-16	101	127	26	1	3	4	1	1
FIREG-16	106	107	1	1	4	4	1	1
FIREG-16	106	115	9	1	3	1	0	0
FIREG-16	106	127	21	1	3	1	0	1
FIREG-16	108	477	369	0	3	2	0	0
FIREG-16	112	126	14	1	3	4	0	1
FIREG-16	114	144	30	1	3	4	0	1
FIREG-17	116	134	18	1	3	1	1	1
FIREG-17	126	127	1	1	3	4	1	0
FIREG-17	148	163	15	1	4	4	1	0
FIREG-17	151	156	5	1	3	4	1	0
FIREG-17	163	164	1	1	3	1	1	0
FIREG-17	163	164	1	1	3	1	1	0
FIREG-17	164	171	7	1	3	3	1	0
FIREG-17	170	477	307	0	3	4	0	0
FIREG-17	175	176	1	1	3	3	1	0
FIREG-17	176	477	301	0	4	4	0	0
FIREG-18	179	180	1	1	3	2	1	0
FIREG-18	179	189	10	1	3	2	1	0
FIREG-18	179	477	298	0	4	2	0	0
FIREG-18	183	477	294	0	3	4	0	0
FIREG-18	183	477	294	0	4	4	0	0
FIREG-18	192	193	1	1	4	3	0	1
FIREG-18	200	262	62	1	3	4	1	0
FIREG-18	206	477	271	0	4	4	0	0
FIREG-18	206	477	271	0	4	4	0	0
FIREG-18	214	477	263	0	4	4	0	1
FIREG-19	218	231	13	1	3	2	1	0
FIREG-19	219	226	7	1	4	4	1	1
FIREG-19	219	232	13	1	3	2	1	0
FIREG-19	224	227	3	1	3	1	1	0
FIREG-19	225	226	1	1	3	2	1	0
FIREG-19	226	290	64	1	4	4	0	0
FIREG-19	228	262	34	1	3	1	1	0
FIREG-19	239	409	170	1	3	1	0	0
FIREG-19	249	260	11	1	3	1	1	0
FIREG-19	260	261	1	1	4	4	1	0
FIREG-20	262	263	1	1	1	4	1	0
FIREG-20	263	268	5	1	3	4	1	0
FIREG-20	264	268	4	1	3	3	1	0
FIREG-20	269	477	208	0	3	1	0	0
FIREG-20	276	352	76	1	1	1	0	1
FIREG-20	277	309	32	1	3	1	1	3
FIREG-20	281	477	196	0	4	4	0	0
FIREG-20	289	477	188	0	3	1	0	0
FIREG-20	298	477	179	0	3	4	0	0
FIREG-20	302	392	90	1	3	4	1	0
FIREG-21	304	305	1	1	5	4	1	0
FIREG-21	317	336	19	1	3	4	1	3
FIREG-21	324	477	153	0	3	4	0	0
FIREG-21	336	436	100	1	3	4	1	3
FIREG-21	336	477	141	0	3	4	0	1
FIREG-21	336	350	14	1	4	4	1	1
FIREG-21	336	477	141	0	3	4	1	0
FIREG-21	340	407	67	1	4	4	1	0
FIREG-21	347	477	130	0	3	1	0	0
FIREG-21	351	477	126	0	3	1	0	0
FIREG-22	351	352	1	1	4	3	1	0
FIREG-22	361	477	116	0	3	4	0	0
FIREG-9	1	477	476	0	3	4	0	0
FIREG-9	1	477	476	0	4	4	0	0
FIREG-9	1	17	16	1	4	4	1	0
FIREG-9	7	9	2	1	5	4	1	0
FIREG-9	7	9	2	1	5	1	1	0
FIREG-9	7	9	2	1	4	1	1	0
FIREG-9	7	8	1	1	4	1	0	0
FIREG-9	7	477	470	0	5	4	0	0
FIREG-9	7	9	2	1	4	4	1	0
MBERS-5	26	119	93	1	1	1	1	2
MBERS-5	26	477	451	0	4	2	1	4
MBERS-5	29	30	1	1	4	1	1	0
MBERS-5	29	350	321	1	5	1	1	0
MBERS-5	31	101	70	1	3	3	1	0
MBERS-5	32	437	405	1	4	3	0	0
MBERS-5	32	42	10	1	4	1	0	0
MBERS-6	32	119	87	1	4	3	1	2
MBERS-6	32	477	445	0	4	3	1	1
MBERS-6	32	477	445	0	5	3	1	1
MBERS-6	32	225	193	1	5	3	1	0
MBERS-6	32	119	87	1	4	3	1	0
MBERS-6	32	113	81	1	3	3	1	0
MBERS-6	34	477	443	0	4	4	0	0
MBERS-6	35	39	4	1	4	2	1	0
MBERS-6	47	477	430	0	3	3	1	1
MBERS-6	49	477	428	0	4	5	1	2
MBERS-7	59	477	418	0	4	5	1	1
MBERS-7	71	72	1	1	4	4	0	0
MBERS-7	79	80	1	1	4	4	0	0
MBERS-7	114	477	363	0	5	3	1	0
MBERS-7	250	477	227	0	3	5	1	0
MBERS-7	250	360	110	1	3	5	1	0
MBERS-7	250	350	100	1	3	5	1	0
MBERS-7	283	477	194	0	3	3	1	0
MBERS-7	333	477	144	0	4	3	1	0
MBERS-7	334	382	48	1	4	4	0	0
MBERS-8	340	347	7	1	1	3	0	1
MBERS-8	341	342	1	1	3	3	0	0
MBERS-8	342	477	135	0	3	5	1	0
MBERS-8	344	350	6	1	4	3	1	0
MBERS-8	347	348	1	1	1	4	1	0
MBERS-8	348	357	9	1	5	3	1	1
MBERS-8	349	356	7	1	3	5	1	0
MBERS-8	356	357	1	1	3	4	1	0
MBERS-8	356	477	121	0	3	4	0	0
MBERS-8	356	371	15	1	3	3	1	0
MBERS-9	357	401	44	1	1	2	0	0
MBERS-9	360	477	117	0	3	4	0	0
TCH-249	1	2	1	1	3	1	1	1
TCH-249	2	3	1	1	4	4	1	1
TCH-249	2	7	5	1	3	2	1	0
TCH-249	8	9	1	1	3	4	1	1
TCH-249	10	28	18	1	3	1	1	1
TCH-249	11	477	466	0	3	4	0	0
TCH-249	11	477	466	0	3	4	0	0
TCH-249	12	17	5	1	3	4	1	0
TCH-249	12	477	465	0	1	1	1	0
TCH-249	15	22	7	1	3	1	1	0
TCH-250	16	143	127	1	4	4	0	0
TCH-250	21	477	456	0	3	4	0	0
TCH-250	22	23	1	1	3	4	1	0
TCH-250	22	23	1	1	3	4	1	0
TCH-250	24	477	453	0	4	4	0	0
TCH-250	26	157	131	1	3	1	1	0
TCH-250	29	477	448	0	4	1	1	0
TCH-250	30	477	447	0	3	1	0	0
TCH-250	30	31	1	1	3	1	1	0
TCH-250	43	91	48	1	4	1	1	0
TCH-251	44	182	138	1	4	4	1	1
TCH-251	49	477	428	0	3	1	1	1
TCH-251	52	477	425	0	3	1	1	0
TCH-251	53	127	74	1	4	1	2	0
TCH-251	53	129	76	1	3	1	0	0
TCH-251	53	477	424	0	3	1	1	0
TCH-251	57	85	28	1	3	4	1	1
TCH-251	62	115	53	1	1	1	1	1
TCH-251	63	93	30	1	1	1	1	3
TCH-251	63	64	1	1	5	4	2	0
TCH-252	63	64	1	1	4	1	2	0
TCH-252	63	64	1	1	4	1	1	0
TCH-252	63	477	414	0	4	4	0	2
TCH-252	63	77	14	1	3	1	1	0
TCH-252	64	70	6	1	3	1	1	1
TCH-252	65	477	412	0	4	1	1	0
TCH-252	65	115	50	1	3	4	1	1
TCH-252	65	115	50	1	4	4	2	0
TCH-252	70	477	407	0	3	1	1	0
TCH-252	70	477	407	0	3	1	0	0
TCH-253	70	158	88	1	4	4	1	0
TCH-253	70	477	407	0	4	4	0	0
TCH-253	70	477	407	0	4	4	0	0
TCH-253	70	101	31	1	4	1	2	0
TCH-253	73	85	12	1	4	4	1	0
TCH-253	73	74	1	1	3	1	1	1
TCH-253	74	85	11	1	4	1	1	0
TCH-253	74	477	403	0	4	4	0	1
TCH-253	74	477	403	0	4	4	0	1
TCH-253	77	99	22	1	3	4	1	0
TCH-254	78	477	399	0	3	2	1	0
TCH-254	79	477	398	0	3	1	0	0
TCH-254	80	477	397	0	3	4	1	0
TCH-254	80	85	5	1	4	4	1	0
TCH-254	81	115	34	1	2	1	1	1
TCH-254	85	91	6	1	4	4	1	0
TCH-254	85	477	392	0	3	4	0	0
TCH-254	87	178	91	1	3	1	1	0
TCH-254	92	98	6	1	3	1	1	0
TCH-254	95	162	67	1	3	1	1	0
TCH-255	96	99	3	1	1	1	1	1
TCH-255	97	101	4	1	1	1	1	1
TCH-255	98	110	12	1	2	1	1	1
TCH-255	98	110	12	1	2	1	1	1
TCH-255	98	99	1	1	3	1	1	1
TCH-255	98	162	64	1	3	5	1	0
TCH-255	98	162	64	1	3	5	1	0
TCH-255	98	162	64	1	3	5	1	0
TCH-255	98	162	64	1	3	5	1	0
TCH-255	98	162	64	1	3	5	1	0
TCH-256	98	162	64	1	3	5	1	0
TCH-256	98	162	64	1	2	5	1	0
TCH-256	98	152	54	1	3	5	1	0
TCH-256	98	162	64	1	3	5	1	0
TCH-256	99	162	63	1	3	5	0	0
TCH-256	99	171	72	1	4	1	1	0
TCH-256	100	101	1	1	5	4	1	1
TCH-256	100	477	377	0	3	1	0	0
TCH-256	102	110	8	1	4	1	1	0
TCH-256	111	115	4	1	1	1	1	1
TCH-257	111	115	4	1	2	1	1	0
TCH-257	112	115	3	1	4	1	1	1
TCH-257	112	115	3	1	3	1	1	1
TCH-257	115	477	362	0	3	4	1	0
TCH-257	117	163	46	1	4	1	1	0
TCH-257	119	129	10	1	2	5	1	0
TCH-257	128	162	34	1	3	4	1	0
TCH-257	134	142	8	1	3	4	1	2
TCH-257	136	163	27	1	3	4	1	1
TCH-257	137	163	26	1	4	4	1	0
TCH-258	140	152	12	1	4	4	1	0
TCH-258	141	158	17	1	2	1	2	2
TCH-258	141	477	336	0	3	4	0	0
TCH-258	143	152	9	1	3	4	1	0
TCH-258	143	152	9	1	4	4	1	0
TCH-258	144	477	333	0	3	1	1	0
TCH-258	147	477	330	0	3	2	0	0
TCH-258	147	148	1	1	3	1	0	0
TCH-258	148	149	1	1	3	1	0	0
TCH-258	148	152	4	1	3	1	1	0
TCH-259	150	152	2	1	3	1	1	1
TCH-259	151	152	1	1	3	1	0	0
TCH-259	154	156	2	1	3	1	1	0
TCH-259	155	156	1	1	3	1	1	0
TCH-259	156	178	22	1	4	4	1	0
TCH-259	158	162	4	1	3	4	1	0
TCH-259	161	477	316	0	3	5	1	0
TCH-259	163	171	8	1	2	1	1	1
TCH-259	163	477	314	0	4	1	1	0
TCH-259	165	477	312	0	3	1	0	1
TCH-260	168	171	3	1	4	4	1	1
TCH-260	168	171	3	1	5	1	1	0
TCH-260	168	269	101	1	4	4	1	0
TCH-260	170	477	307	0	3	4	0	0
TCH-260	170	477	307	0	4	1	0	0
TCH-260	170	477	307	0	3	1	1	0
TCH-260	170	322	152	1	4	1	1	0
TCH-260	171	178	7	1	4	1	1	0
TCH-260	171	477	306	0	4	4	0	0
TCH-260	171	178	7	1	4	1	1	0
TCH-261	172	173	1	1	3	1	0	0
TCH-261	175	178	3	1	3	4	1	0
TCH-261	176	477	301	0	3	4	1	0
TCH-261	178	329	151	1	3	3	1	0
TCH-261	183	191	8	1	3	1	1	0
TCH-261	184	477	293	0	4	2	1	0
TCH-261	190	199	9	1	3	1	1	0
TCH-261	190	191	1	1	5	4	1	0
TCH-261	191	199	8	1	3	1	1	0
TCH-261	191	199	8	1	4	4	1	0
TCH-262	192	196	4	1	3	1	1	0
TCH-262	200	228	28	1	5	5	1	0
TCH-262	200	205	5	1	3	5	1	0
TCH-262	203	279	76	1	4	4	1	0
TCH-262	203	205	2	1	3	1	1	0
TCH-262	204	292	88	1	4	4	1	0
TCH-262	206	477	271	0	5	4	1	0
TCH-262	207	417	210	1	4	4	1	0
TCH-262	207	370	163	1	4	4	1	0
TCH-262	210	385	175	1	3	4	1	0
TCH-263	212	317	105	1	4	4	1	0
TCH-263	212	449	237	1	4	4	1	0
TCH-263	220	228	8	1	4	4	1	0
TCH-263	220	222	2	1	3	4	1	0
TCH-263	225	477	252	0	3	1	0	0
TCH-263	227	279	52	1	3	1	1	0
TCH-263	228	477	249	0	4	4	1	0
TCH-263	229	254	25	1	4	1	1	0
TCH-263	240	477	237	0	3	3	0	0
TCH-263	246	253	7	1	3	1	2	0
TCH-264	246	253	7	1	5	1	1	0
TCH-264	246	279	33	1	4	1	2	0
TCH-264	247	279	32	1	4	1	2	0
TCH-264	254	279	25	1	5	1	1	0
TCH-264	254	279	25	1	3	1	1	0
TCH-264	255	279	24	1	3	1	1	0
TCH-264	259	260	1	1	2	1	0	2
TCH-264	261	270	9	1	3	4	1	0
TCH-264	280	281	1	1	4	4	1	0
TCH-264	281	477	196	0	4	4	1	0
TCH-265	283	477	194	0	3	1	0	1
TCH-265	284	292	8	1	3	4	1	1
TCH-265	287	292	5	1	2	1	1	1
TCH-265	287	382	95	1	4	4	1	1
TCH-265	287	477	190	0	3	4	1	0
TCH-265	287	317	30	1	3	1	1	0
TCH-265	287	370	83	1	3	1	1	0
TCH-265	287	370	83	1	4	4	1	0
TCH-265	289	370	81	1	5	4	1	0
TCH-265	289	340	51	1	5	4	1	0
TCH-266	289	292	3	1	4	4	1	0
TCH-266	289	318	29	1	5	4	1	0
TCH-266	290	477	187	0	4	4	0	0
TCH-266	290	382	92	1	4	4	1	0
TCH-266	292	477	185	0	3	1	1	0
TCH-266	295	360	65	1	3	3	0	3
TCH-266	295	464	169	1	4	4	1	1
TCH-266	296	368	72	1	1	4	1	2
TCH-266	296	340	44	1	3	4	2	0
TCH-266	296	477	181	0	1	1	1	0
TCH-267	301	371	70	1	4	1	0	0
TCH-267	301	477	176	0	3	5	2	2
TCH-267	302	477	175	0	4	5	1	3
TCH-267	310	371	61	1	3	1	1	0
TCH-267	311	340	29	1	5	1	1	0
TCH-267	312	370	58	1	4	4	0	0
TCH-267	318	418	100	1	3	2	1	1
TCH-267	331	477	146	0	3	3	1	0
TCH-267	343	382	39	1	3	4	1	1
TCH-267	345	346	1	1	3	5	0	0
TCH-268	350	382	32	1	5	1	1	0
TCH-268	354	477	123	0	3	1	0	0
TCH-268	360	385	25	1	4	4	1	0
K-711	1	2	1	1	4	4	1	1
K-711	1	477	476	0	3	4	1	0
K-711	1	7	6	1	4	3	1	3
K-711	2	3	1	1	4	3	1	0
K-711	2	8	6	1	3	1	2	0
K-712	2	3	1	1	4	3	3	0
K-712	3	4	1	1	4	4	4	2
K-712	4	5	1	1	3	3	1	1
K-712	4	5	1	1	3	1	1	2
K-712	4	5	1	1	3	4	1	0
K-712	4	7	3	1	3	1	0	1
K-712	4	8	4	1	4	3	4	2
K-712	5	7	2	1	3	3	1	2
K-712	8	9	1	1	4	3	2	1
K-712	8	9	1	1	3	1	0	1
K-713	8	9	1	1	4	3	3	1
K-713	8	17	9	1	2	1	4	0
K-713	9	21	12	1	1	1	3	2
K-713	9	10	1	1	4	5	2	0
K-713	9	10	1	1	4	4	2	0
K-713	9	10	1	1	3	1	0	1
K-713	9	14	5	1	3	1	3	0
K-713	9	14	5	1	3	5	3	1
K-713	9	14	5	1	3	5	3	0
K-713	10	11	1	1	4	4	2	0
K-714	10	11	1	1	4	4	2	0
K-714	10	14	4	1	4	5	3	0
K-714	10	11	1	1	5	5	3	0
K-714	10	11	1	1	4	3	2	0
K-714	10	11	1	1	3	1	0	1
K-714	10	15	5	1	4	5	2	0
K-714	10	14	4	1	3	1	0	1
K-714	11	12	1	1	4	1	3	0
K-714	11	108	97	1	3	5	2	0
K-714	11	12	1	1	4	5	3	1
K-715	11	15	4	1	4	1	0	0
K-715	13	477	464	0	3	4	1	1
K-715	14	15	1	1	4	1	4	1
K-715	14	16	2	1	4	4	2	1
K-715	14	15	1	1	3	1	0	1
K-715	14	15	1	1	3	1	2	0
K-715	14	21	7	1	3	3	3	1
K-715	14	15	1	1	3	4	3	2
K-715	14	15	1	1	3	4	3	2
K-715	14	15	1	1	4	5	3	0
K-716	15	108	93	1	4	3	3	1
K-716	15	16	1	1	5	3	4	2
K-716	15	35	20	1	1	1	3	0
K-716	15	108	93	1	4	3	3	1
K-716	15	16	1	1	3	1	0	1
K-716	15	17	2	1	4	3	2	2
K-716	16	477	461	0	3	1	1	0
K-716	16	17	1	1	3	1	1	3
K-716	16	17	1	1	3	1	3	0
K-716	16	17	1	1	3	1	3	0
K-717	16	17	1	1	3	3	1	2
K-717	16	17	1	1	3	1	3	0
K-717	16	18	2	1	3	3	3	0
K-717	16	37	21	1	3	3	3	0
K-717	16	35	19	1	1	1	3	0
K-717	16	21	5	1	4	4	2	0
K-717	17	18	1	1	4	1	4	1
K-717	17	18	1	1	4	5	2	0
K-717	17	18	1	1	3	1	2	0
K-717	17	18	1	1	4	5	2	0
K-718	18	185	167	1	3	4	2	1
K-718	18	19	1	1	5	5	3	1
K-718	21	477	456	0	4	5	0	3
K-718	21	32	11	1	4	3	2	1
K-718	21	22	1	1	5	5	4	0
K-718	21	28	7	1	4	5	3	1
K-718	21	22	1	1	5	5	3	0
K-718	21	22	1	1	3	1	0	1
K-718	21	58	37	1	3	5	2	0
K-718	21	22	1	1	4	3	3	0
K-719	21	199	178	1	3	5	2	1
K-719	21	79	58	1	4	3	1	2
K-719	22	477	455	0	4	4	1	0
K-719	22	477	455	0	3	4	1	1
K-719	22	302	280	1	2	4	0	0
K-719	23	28	5	1	4	4	2	2
K-719	23	24	1	1	4	4	2	1
K-719	23	24	1	1	3	1	0	1
K-719	23	30	7	1	4	1	3	1
K-719	23	57	34	1	3	1	0	1
K-720	23	26	3	1	3	1	2	0
K-720	24	25	1	1	5	5	3	0
K-720	24	477	453	0	4	5	0	1
K-720	24	45	21	1	3	4	0	1
K-720	24	25	1	1	4	5	4	0
K-720	24	253	229	1	3	1	2	0
K-720	24	477	453	0	3	5	0	0
K-720	24	477	453	0	3	5	1	0
K-720	24	25	1	1	3	1	2	0
K-720	25	71	46	1	4	1	4	0
K-721	25	28	3	1	3	1	0	1
K-721	26	27	1	1	3	1	0	0
K-721	28	477	449	0	3	5	1	0
K-721	28	29	1	1	4	4	2	0
K-721	28	29	1	1	3	1	0	1
K-721	28	29	1	1	3	4	2	0
K-721	28	58	30	1	4	3	2	0
K-721	28	477	449	0	4	5	0	0
K-721	28	29	1	1	3	1	0	1
K-721	29	30	1	1	3	3	4	0
K-722	29	30	1	1	3	3	2	1
K-722	29	30	1	1	3	1	0	1
K-722	30	31	1	1	3	4	3	1
K-722	30	36	6	1	1	1	4	0
K-722	30	477	447	0	4	2	1	0
K-722	30	65	35	1	3	5	2	0
K-722	30	31	1	1	4	1	0	0
K-722	30	31	1	1	5	1	3	1
K-722	30	31	1	1	3	1	0	1
K-722	31	57	26	1	3	1	0	1
K-723	31	477	446	0	3	4	1	0
K-723	31	32	1	1	4	4	2	0
K-723	31	32	1	1	3	4	2	0
K-723	31	303	272	1	4	5	2	1
K-723	32	477	445	0	4	4	0	1
K-723	32	33	1	1	3	4	2	0
K-723	32	33	1	1	3	1	2	0
K-723	32	33	1	1	3	1	2	0
K-723	32	33	1	1	4	5	2	1
K-723	32	57	25	1	3	1	0	0
K-724	32	35	3	1	4	3	4	2
K-724	32	35	3	1	4	1	3	0
K-724	34	73	39	1	4	5	2	0
K-724	35	57	22	1	3	1	0	0
K-724	35	36	1	1	5	1	4	2
K-724	35	57	22	1	3	1	0	1
K-724	36	204	168	1	3	4	3	3
K-724	36	39	3	1	4	3	1	1
K-724	36	38	2	1	4	4	2	0
K-724	36	37	1	1	4	3	2	2
K-725	37	57	20	1	3	1	0	0
K-725	38	39	1	1	3	4	2	0
K-725	38	39	1	1	3	1	2	0
K-725	38	39	1	1	4	4	2	0
K-725	38	477	439	0	2	4	1	0
K-725	39	40	1	1	3	3	4	0
K-725	39	477	438	0	4	4	1	1
K-725	39	58	19	1	4	3	3	2
K-725	39	57	18	1	3	1	0	0
K-725	42	70	28	1	3	4	2	2
K-726	43	477	434	0	4	1	0	0
K-726	43	477	434	0	3	1	1	4
K-726	43	46	3	1	3	4	3	0
K-726	43	477	434	0	3	1	1	2
K-726	43	477	434	0	4	1	0	0
K-726	44	45	1	1	3	1	3	0
K-726	44	45	1	1	3	1	3	0
K-726	44	57	13	1	3	1	0	1
K-726	44	45	1	1	4	3	3	3
K-726	44	45	1	1	3	5	2	1
K-727	44	46	2	1	3	5	2	1
K-727	44	477	433	0	3	5	0	1
K-727	45	52	7	1	4	3	4	1
K-727	45	46	1	1	3	3	2	2
K-727	46	57	11	1	3	1	2	0
K-727	50	51	1	1	4	3	4	0
K-727	51	57	6	1	3	1	0	1
K-727	52	477	425	0	3	4	0	2
K-727	52	477	425	0	4	4	0	1
K-728	52	58	6	1	3	4	2	0
K-728	53	477	424	0	4	1	0	1
K-728	53	59	6	1	3	3	2	1
K-728	53	477	424	0	3	5	0	0
K-728	56	57	1	1	3	1	3	2
K-728	56	57	1	1	3	1	3	2
K-728	56	145	89	1	3	3	1	0
K-728	57	477	420	0	4	1	0	0
K-728	57	282	225	1	4	4	2	0
K-728	57	58	1	1	4	5	4	0
K-729	57	59	2	1	3	4	3	1
K-729	57	58	1	1	4	1	4	0
K-729	57	58	1	1	4	5	4	0
K-729	57	58	1	1	3	1	0	1
K-729	58	59	1	1	3	1	2	1
K-729	58	59	1	1	4	3	2	0
K-729	58	59	1	1	3	1	0	0
K-729	59	78	19	1	3	3	2	1
K-729	59	60	1	1	3	4	2	0
K-729	59	60	1	1	4	5	4	0
K-730	59	477	418	0	3	4	1	2
K-730	59	477	418	0	3	4	0	0
K-730	59	477	418	0	3	4	0	0
K-730	59	63	4	1	3	1	0	1
K-730	63	70	7	1	4	3	3	0
K-730	64	65	1	1	4	5	2	0
K-730	64	65	1	1	4	5	2	0
K-730	64	67	3	1	3	5	2	1
K-730	64	65	1	1	4	5	2	0
K-730	64	65	1	1	4	1	3	1
K-731	64	65	1	1	5	4	2	0
K-731	64	65	1	1	3	1	0	1
K-731	64	113	49	1	3	4	0	0
K-731	64	65	1	1	4	5	3	0
K-731	65	66	1	1	3	3	3	1
K-731	65	66	1	1	4	3	2	1
K-731	65	183	118	1	3	4	2	0
K-731	65	66	1	1	3	1	2	0
K-731	65	477	412	0	3	5	0	0
K-732	66	67	1	1	4	3	3	1
K-732	66	477	411	0	3	1	1	0
K-732	66	67	1	1	4	3	4	1
K-732	66	316	250	1	5	4	2	0
K-732	67	68	1	1	4	3	2	1
K-732	67	68	1	1	5	3	4	0
K-732	67	72	5	1	3	4	2	0
K-732	69	477	408	0	4	4	0	0
K-732	70	477	407	0	4	4	1	0
K-732	70	71	1	1	4	5	3	0
K-733	70	71	1	1	3	5	3	0
K-733	70	72	2	1	3	5	3	0
K-733	70	71	1	1	3	3	2	1
K-733	70	71	1	1	4	5	3	0
K-733	70	184	114	1	3	4	2	0
K-733	71	72	1	1	3	3	4	0
K-733	71	72	1	1	4	3	4	0
K-733	72	78	6	1	3	1	2	0
K-733	72	80	8	1	3	3	2	0
K-733	72	74	2	1	3	1	4	0
K-734	72	98	26	1	3	4	2	1
K-734	72	73	1	1	2	1	2	0
K-734	73	74	1	1	4	5	3	0
K-734	73	122	49	1	3	4	2	1
K-734	73	74	1	1	4	5	2	1
K-734	73	74	1	1	4	5	2	0
K-734	73	74	1	1	3	5	2	0
K-734	74	75	1	1	1	3	4	1
K-734	74	477	403	0	3	4	0	0
K-735	74	75	1	1	4	3	4	1
K-735	74	94	20	1	3	1	0	0
K-735	74	144	70	1	3	4	2	0
K-735	74	80	6	1	3	1	2	3
K-735	74	79	5	1	3	3	2	4
K-735	77	80	3	1	3	1	4	0
K-735	78	79	1	1	3	1	2	0
K-735	78	477	399	0	3	4	1	2
K-735	78	93	15	1	4	5	4	1
K-736	78	87	9	1	3	5	2	2
K-736	78	79	1	1	3	1	0	1
K-736	78	79	1	1	3	1	0	1
K-736	78	79	1	1	3	1	0	1
K-736	79	95	16	1	4	3	3	2
K-736	79	127	48	1	3	1	2	0
K-736	79	80	1	1	4	3	3	1
K-736	79	213	134	1	4	4	3	3
K-736	79	144	65	1	4	3	3	4
K-736	79	80	1	1	3	1	0	1
K-737	80	477	397	0	3	1	1	1
K-737	80	81	1	1	3	1	0	1
K-737	80	477	397	0	4	5	1	0
K-737	80	94	14	1	3	1	0	0
K-737	80	477	397	0	3	4	1	0
K-737	80	81	1	1	3	1	4	0
K-737	80	86	6	1	3	1	0	0
K-737	84	112	28	1	3	4	2	0
K-737	85	86	1	1	4	1	2	0
K-737	85	100	15	1	3	4	2	1
K-738	86	477	391	0	3	4	0	1
K-738	86	477	391	0	3	4	1	0
K-738	87	477	390	0	3	4	1	0
K-738	87	94	7	1	3	1	0	0
K-738	91	93	2	1	4	4	2	0
K-738	92	477	385	0	3	4	0	1
K-738	92	94	2	1	3	1	0	0
K-738	93	98	5	1	5	3	2	1
K-738	93	94	1	1	3	4	2	0
K-738	94	95	1	1	2	1	4	1
K-739	94	477	383	0	3	4	1	0
K-739	94	95	1	1	3	1	0	1
K-739	95	96	1	1	3	4	0	1
K-739	95	99	4	1	3	1	2	0
K-739	98	99	1	1	3	1	2	0
K-739	98	99	1	1	3	1	0	0
K-739	98	99	1	1	3	1	2	0
K-739	98	262	164	1	3	1	1	0
K-739	99	100	1	1	3	1	2	0
K-739	99	100	1	1	3	5	3	1
K-740	99	113	14	1	3	1	0	1
K-740	100	112	12	1	3	1	2	1
K-740	100	113	13	1	3	4	2	0
K-740	100	101	1	1	3	4	2	0
K-740	100	101	1	1	3	1	2	0
K-740	100	113	13	1	3	1	0	0
K-740	100	101	1	1	3	5	2	0
K-740	101	102	1	1	3	3	3	3
K-740	101	102	1	1	3	1	2	0
K-740	101	121	20	1	3	5	2	0
K-741	101	155	54	1	3	5	2	1
K-741	101	267	166	1	3	5	2	0
K-741	101	477	376	0	3	5	1	0
K-741	101	113	12	1	3	1	0	1
K-741	101	116	15	1	3	1	3	0
K-741	102	477	375	0	4	3	0	2
K-741	106	108	2	1	3	4	2	3
K-741	106	113	7	1	3	1	0	0
K-741	107	108	1	1	4	4	2	0
K-741	107	477	370	0	4	3	0	0
K-742	107	109	2	1	4	4	2	0
K-742	107	108	1	1	4	3	2	0
K-742	108	109	1	1	3	3	4	0
K-742	108	477	369	0	3	5	1	1
K-742	108	109	1	1	4	4	2	0
K-742	108	477	369	0	3	4	1	1
K-742	108	109	1	1	4	3	4	0
K-742	108	477	369	0	3	4	0	0
K-742	108	127	19	1	3	1	4	1
K-742	109	113	4	1	3	1	0	1
K-743	112	113	1	1	5	5	4	0
K-743	112	113	1	1	3	1	0	1
K-743	112	113	1	1	5	5	4	0
K-743	112	113	1	1	5	4	2	0
K-743	112	113	1	1	3	4	2	0
K-743	113	114	1	1	4	3	4	1
K-743	113	114	1	1	3	4	2	0
K-743	113	116	3	1	3	4	4	0
K-743	113	114	1	1	4	5	2	0
K-743	113	114	1	1	3	1	0	1
K-744	113	114	1	1	3	4	2	0
K-744	113	114	1	1	4	5	4	0
K-744	113	115	2	1	4	4	3	1
K-744	113	114	1	1	4	3	4	1
K-744	113	114	1	1	3	2	2	0
K-744	113	114	1	1	3	4	2	0
K-744	113	114	1	1	4	5	4	0
K-744	114	115	1	1	5	1	4	1
K-744	114	115	1	1	3	1	0	1
K-744	114	115	1	1	3	1	2	0
K-745	114	477	363	0	3	1	0	0
K-745	115	116	1	1	3	3	3	2
K-745	115	116	1	1	5	3	4	0
K-745	115	116	1	1	5	5	4	0
K-745	115	116	1	1	5	5	4	0
K-745	115	116	1	1	4	3	0	0
K-745	115	477	362	0	3	1	0	0
K-745	116	477	361	0	3	4	1	0
K-745	116	117	1	1	3	5	2	0
K-745	116	205	89	1	3	4	2	1
K-746	116	477	361	0	3	4	0	0
K-746	120	164	44	1	3	1	0	1
K-746	121	122	1	1	4	3	2	0
K-746	121	122	1	1	3	3	0	1
K-746	121	122	1	1	3	4	2	0
K-746	121	122	1	1	3	4	2	0
K-746	121	122	1	1	3	1	4	0
K-746	121	477	356	0	3	1	0	0
K-746	121	122	1	1	4	4	2	0
K-746	121	122	1	1	3	4	2	0
K-747	122	128	6	1	3	4	2	0
K-747	122	154	32	1	3	5	2	1
K-747	122	135	13	1	4	5	3	3
K-747	122	123	1	1	3	1	2	0
K-747	122	477	355	0	3	1	0	0
K-747	123	124	1	1	3	1	2	0
K-747	123	124	1	1	3	1	2	0
K-747	123	129	6	1	4	3	1	1
K-747	123	129	6	1	4	3	1	1
K-747	123	126	3	1	3	1	0	0
K-748	123	155	32	1	3	1	0	0
K-748	126	477	351	0	4	1	0	0
K-748	127	128	1	1	5	3	3	0
K-748	127	128	1	1	4	3	3	0
K-748	127	135	8	1	4	3	0	2
K-748	127	269	142	1	3	1	2	0
K-748	127	304	177	1	3	1	2	1
K-748	128	155	27	1	3	1	0	0
K-748	128	134	6	1	3	4	2	1
K-748	129	477	348	0	4	3	1	0
K-749	129	130	1	1	3	1	4	1
K-749	129	155	26	1	3	1	0	0
K-749	130	131	1	1	4	3	1	1
K-749	133	134	1	1	4	3	3	0
K-749	133	155	22	1	3	1	0	0
K-749	133	477	344	0	3	1	0	0
K-749	134	477	343	0	3	5	0	0
K-749	135	136	1	1	4	4	0	0
K-749	135	477	342	0	3	4	0	1
K-749	135	477	342	0	3	5	0	2
K-750	135	477	342	0	3	5	0	0
K-750	136	477	341	0	3	5	0	0
K-750	136	477	341	0	3	5	0	0
K-750	136	155	19	1	3	1	0	0
K-750	141	477	336	0	4	4	1	0
K-750	142	458	316	1	3	4	0	1
K-750	142	156	14	1	4	4	2	0
K-750	142	477	335	0	3	1	0	0
K-750	143	147	4	1	3	1	2	2
K-750	143	155	12	1	3	1	0	0
K-751	144	249	105	1	3	4	2	4
K-751	144	198	54	1	3	3	2	4
K-751	147	161	14	1	4	3	3	1
K-751	147	148	1	1	3	1	4	0
K-751	147	148	1	1	3	1	2	2
K-751	147	155	8	1	3	1	0	0
K-751	148	149	1	1	4	5	2	0
K-751	148	477	329	0	4	1	0	0
K-751	148	149	1	1	4	3	2	0
K-751	148	155	7	1	3	1	0	0
K-752	150	151	1	1	3	1	2	0
K-752	150	155	5	1	4	1	2	0
K-752	151	154	3	1	3	2	2	0
K-752	154	155	1	1	3	5	0	0
K-752	154	155	1	1	3	1	0	0
K-752	155	161	6	1	3	3	0	0
K-752	155	156	1	1	4	5	2	0
K-752	155	156	1	1	4	5	2	2
K-752	155	164	9	1	3	1	0	1
K-752	156	157	1	1	5	5	2	0
K-753	156	157	1	1	4	4	2	0
K-753	156	164	8	1	3	1	0	1
K-753	156	170	14	1	3	5	2	1
K-753	156	161	5	1	3	5	2	0
K-753	157	477	320	0	4	3	0	0
K-753	157	158	1	1	4	3	1	1
K-753	161	162	1	1	3	3	4	2
K-753	161	162	1	1	4	5	2	0
K-753	161	164	3	1	3	1	0	1
K-753	161	165	4	1	4	3	1	1
K-754	162	167	5	1	3	1	3	1
K-754	163	477	314	0	3	5	0	0
K-754	163	477	314	0	3	5	0	0
K-754	164	165	1	1	4	1	2	1
K-754	164	165	1	1	3	1	0	1
K-754	164	477	313	0	3	5	0	1
K-754	164	165	1	1	3	5	2	0
K-754	165	168	3	1	3	5	3	0
K-754	167	169	2	1	3	1	0	1
K-754	168	477	309	0	3	5	0	0
K-755	168	169	1	1	3	4	2	0
K-755	168	169	1	1	3	1	2	0
K-755	168	262	94	1	3	1	0	0
K-755	169	170	1	1	4	5	2	0
K-755	169	170	1	1	4	5	2	0
K-755	169	171	2	1	3	2	2	0
K-755	169	170	1	1	5	3	3	1
K-755	169	170	1	1	3	1	0	1
K-755	170	171	1	1	3	1	2	1
K-756	170	171	1	1	3	1	0	0
K-756	170	171	1	1	3	4	2	0
K-756	170	171	1	1	3	1	0	1
K-756	170	171	1	1	4	3	2	1
K-756	170	184	14	1	4	1	2	1
K-756	170	204	34	1	3	1	0	0
K-756	171	172	1	1	3	1	2	0
K-756	171	172	1	1	3	1	2	0
K-756	171	204	33	1	3	1	0	0
K-756	172	233	61	1	3	2	2	4
K-757	172	198	26	1	3	5	0	0
K-757	172	183	11	1	3	5	0	1
K-757	172	198	26	1	3	5	0	0
K-757	172	198	26	1	3	5	0	0
K-757	172	198	26	1	3	5	0	1
K-757	172	175	3	1	3	2	3	1
K-757	172	477	305	0	4	3	0	0
K-757	172	219	47	1	3	3	3	0
K-757	172	173	1	1	5	3	3	2
K-757	172	173	1	1	5	3	3	1
K-758	172	204	32	1	3	1	0	0
K-758	175	219	44	1	4	3	3	0
K-758	175	176	1	1	3	3	2	0
K-758	175	176	1	1	4	3	3	0
K-758	175	176	1	1	3	4	2	0
K-758	175	176	1	1	4	3	3	0
K-758	175	176	1	1	4	3	3	0
K-758	175	176	1	1	3	5	3	0
K-758	175	177	2	1	3	1	3	1
K-758	175	205	30	1	3	5	0	2
K-759	176	177	1	1	3	5	3	0
K-759	176	477	301	0	3	4	0	1
K-759	177	178	1	1	3	1	0	1
K-759	178	182	4	1	3	1	4	1
K-759	179	180	1	1	3	1	4	2
K-759	179	186	7	1	4	3	0	1
K-759	179	180	1	1	3	3	4	1
K-759	179	190	11	1	4	1	0	0
K-759	182	183	1	1	4	1	3	2
K-759	182	183	1	1	3	1	0	1
K-760	182	204	22	1	3	1	0	0
K-760	183	184	1	1	4	4	2	1
K-760	183	477	294	0	3	4	0	1
K-760	183	205	22	1	3	5	2	2
K-760	183	184	1	1	3	2	2	0
K-760	184	309	125	1	3	1	4	1
K-760	184	326	142	1	3	1	4	1
K-760	184	219	35	1	4	3	3	1
K-760	184	307	123	1	3	1	4	1
K-760	184	185	1	1	4	3	4	0
K-761	185	186	1	1	3	1	2	4
K-761	185	186	1	1	4	3	4	0
K-761	185	204	19	1	3	1	0	0
K-761	186	309	123	1	3	1	4	0
K-761	186	193	7	1	4	3	2	1
K-761	189	190	1	1	4	4	2	1
K-761	189	190	1	1	4	5	2	0
K-761	189	190	1	1	4	2	2	0
K-761	189	204	15	1	3	1	0	0
K-762	190	191	1	1	4	5	3	0
K-762	190	191	1	1	4	4	2	0
K-762	190	191	1	1	4	3	3	0
K-762	191	203	12	1	3	2	2	2
K-762	191	192	1	1	4	3	3	2
K-762	191	192	1	1	4	5	3	0
K-762	191	197	6	1	3	5	2	0
K-762	192	193	1	1	3	4	2	1
K-762	192	197	5	1	3	5	2	0
K-762	192	193	1	1	3	4	2	0
K-763	192	193	1	1	3	1	4	0
K-763	193	199	6	1	4	3	1	1
K-763	193	194	1	1	4	5	3	0
K-763	193	204	11	1	3	1	0	0
K-763	196	477	281	0	4	5	1	1
K-763	196	477	281	0	3	4	1	2
K-763	196	197	1	1	4	5	2	0
K-763	196	205	9	1	3	5	0	0
K-763	197	198	1	1	3	1	4	1
K-763	197	260	63	1	3	4	2	0
K-764	197	199	2	1	4	4	2	0
K-764	197	198	1	1	4	3	3	1
K-764	197	477	280	0	3	1	0	1
K-764	198	199	1	1	3	5	0	2
K-764	199	200	1	1	3	3	2	0
K-764	199	302	103	1	3	4	2	2
K-764	199	204	5	1	4	5	2	1
K-764	199	200	1	1	4	4	2	0
K-764	199	268	69	1	3	5	2	2
K-764	203	211	8	1	3	2	2	0
K-765	203	204	1	1	4	3	3	0
K-765	203	204	1	1	4	3	3	3
K-765	203	204	1	1	3	1	2	2
K-765	203	240	37	1	4	3	3	1
K-765	204	205	1	1	4	5	2	0
K-765	204	205	1	1	3	5	2	0
K-765	204	233	29	1	4	3	2	2
K-765	204	205	1	1	3	1	0	1
K-765	205	253	48	1	3	3	2	0
K-765	206	210	4	1	3	1	0	0
K-766	206	477	271	0	3	4	1	0
K-766	206	477	271	0	3	5	0	0
K-766	207	208	1	1	3	5	2	0
K-766	207	208	1	1	3	5	2	0
K-766	207	208	1	1	3	5	2	0
K-766	207	208	1	1	3	5	2	0
K-766	207	210	3	1	3	1	0	0
K-766	207	214	7	1	4	3	2	1
K-766	207	477	270	0	4	4	0	0
K-766	207	310	103	1	4	3	1	2
K-767	210	211	1	1	4	5	3	0
K-767	211	477	266	0	3	3	1	0
K-767	212	221	9	1	3	4	2	0
K-767	212	213	1	1	4	5	3	0
K-767	213	214	1	1	3	3	2	0
K-767	213	214	1	1	5	3	3	0
K-767	213	225	12	1	3	1	0	0
K-767	217	219	2	1	5	3	4	1
K-767	217	218	1	1	4	3	3	1
K-767	217	218	1	1	4	3	3	1
K-768	217	477	260	0	4	3	0	1
K-768	217	218	1	1	4	3	2	0
K-768	217	218	1	1	3	3	2	1
K-768	217	477	260	0	4	3	0	1
K-768	217	477	260	0	4	3	1	0
K-768	217	218	1	1	4	3	3	0
K-768	218	219	1	1	3	1	4	2
K-768	218	220	2	1	3	1	4	2
K-768	218	219	1	1	4	4	2	3
K-768	218	219	1	1	4	3	3	1
K-769	218	219	1	1	4	5	3	0
K-769	218	464	246	1	4	4	1	1
K-769	219	221	2	1	3	5	2	0
K-769	219	233	14	1	4	5	2	1
K-769	219	220	1	1	4	1	2	1
K-769	219	220	1	1	3	5	0	1
K-769	219	477	258	0	3	4	0	1
K-769	219	477	258	0	3	5	0	0
K-769	219	477	258	0	3	5	0	0
K-769	219	220	1	1	4	4	2	3
K-770	219	477	258	0	4	3	0	2
K-770	219	221	2	1	3	4	0	0
K-770	220	477	257	0	3	4	0	1
K-770	220	477	257	0	3	4	0	1
K-770	220	221	1	1	4	5	3	0
K-770	220	221	1	1	3	5	2	0
K-770	224	225	1	1	4	4	4	0
K-770	226	227	1	1	4	1	4	0
K-770	226	253	27	1	3	3	1	0
K-770	231	252	21	1	3	4	3	1
K-771	232	255	23	1	3	1	2	1
K-771	232	477	245	0	4	4	0	0
K-771	232	233	1	1	4	1	2	1
K-771	233	234	1	1	4	1	4	2
K-771	233	477	244	0	4	4	0	1
K-771	235	236	1	1	4	1	2	0
K-771	235	260	25	1	3	4	2	0
K-771	238	240	2	1	4	1	2	0
K-771	239	477	238	0	3	4	0	0
K-771	240	367	127	1	3	1	2	0
K-772	240	242	2	1	3	4	4	1
K-772	240	246	6	1	3	1	4	2
K-772	241	254	13	1	3	4	2	0
K-772	241	248	7	1	3	3	1	1
K-772	242	243	1	1	3	1	2	0
K-772	242	477	235	0	3	5	1	2
K-772	242	253	11	1	3	1	0	0
K-772	245	256	11	1	3	4	2	0
K-772	245	302	57	1	3	1	1	2
K-772	246	247	1	1	4	5	3	0
K-773	246	247	1	1	4	5	3	0
K-773	246	451	205	1	4	4	1	0
K-773	246	267	21	1	4	5	2	0
K-773	246	247	1	1	4	4	2	0
K-773	246	247	1	1	4	3	2	0
K-773	248	249	1	1	3	5	2	0
K-773	248	249	1	1	3	3	2	1
K-773	248	254	6	1	3	5	2	0
K-773	248	254	6	1	3	5	2	0
K-773	248	263	15	1	3	4	2	0
K-774	248	477	229	0	3	5	0	0
K-774	248	249	1	1	3	4	4	1
K-774	248	477	229	0	3	5	0	0
K-774	248	477	229	0	3	5	0	0
K-774	250	477	227	0	3	5	1	0
K-774	252	267	15	1	3	3	2	1
K-774	253	477	224	0	3	4	0	1
K-774	253	477	224	0	3	5	0	0
K-774	253	269	16	1	4	5	4	0
K-774	254	255	1	1	3	1	2	0
K-775	254	477	223	0	4	1	0	0
K-775	254	255	1	1	3	1	3	1
K-775	255	256	1	1	3	1	0	0
K-775	255	256	1	1	3	4	2	0
K-775	255	477	222	0	3	4	1	0
K-775	256	262	6	1	1	1	1	0
K-775	256	477	221	0	3	4	0	0
K-775	259	260	1	1	3	4	2	1
K-775	259	274	15	1	3	4	2	3
K-775	260	261	1	1	2	1	0	0
K-776	260	261	1	1	3	4	2	0
K-776	260	261	1	1	3	1	1	0
K-776	260	261	1	1	3	2	1	1
K-776	260	477	217	0	3	4	0	0
K-776	261	282	21	1	3	1	0	0
K-776	261	262	1	1	3	1	2	0
K-776	261	262	1	1	3	1	2	0
K-776	261	262	1	1	4	3	3	1
K-776	261	262	1	1	3	4	2	0
K-776	261	263	2	1	3	4	0	0
K-777	262	274	12	1	3	2	2	0
K-777	262	263	1	1	3	2	2	0
K-777	262	282	20	1	3	1	0	0
K-777	262	263	1	1	3	2	2	0
K-777	262	282	20	1	3	1	0	0
K-777	266	276	10	1	3	1	2	0
K-777	266	267	1	1	3	1	2	0
K-777	267	268	1	1	3	1	2	1
K-777	268	276	8	1	1	1	0	1
K-778	268	477	209	0	3	5	0	1
K-778	269	282	13	1	3	1	0	0
K-778	269	270	1	1	5	4	2	0
K-778	269	273	4	1	4	1	2	2
K-778	269	282	13	1	3	1	0	0
K-778	269	276	7	1	4	3	2	1
K-778	270	271	1	1	3	4	2	1
K-778	270	271	1	1	4	3	2	0
K-778	270	274	4	1	3	4	2	0
K-778	270	271	1	1	4	1	2	2
K-779	270	271	1	1	4	3	2	0
K-779	270	282	12	1	3	1	0	0
K-779	273	274	1	1	4	3	0	0
K-779	273	477	204	0	3	5	0	0
K-779	274	275	1	1	3	1	2	1
K-779	274	282	8	1	3	3	2	1
K-779	274	275	1	1	3	4	2	1
K-779	274	282	8	1	3	1	0	0
K-779	275	281	6	1	3	1	4	0
K-779	275	276	1	1	4	1	2	0
K-780	275	276	1	1	3	1	2	0
K-780	275	276	1	1	3	1	2	1
K-780	275	276	1	1	3	1	2	0
K-780	275	330	55	1	3	1	2	0
K-780	276	282	6	1	3	1	0	0
K-780	276	277	1	1	3	1	2	0
K-780	276	284	8	1	3	3	0	0
K-780	276	287	11	1	3	1	2	0
K-780	280	281	1	1	3	1	4	0
K-780	280	281	1	1	3	5	2	0
K-781	280	282	2	1	3	1	0	0
K-781	280	297	17	1	3	1	0	1
K-781	281	282	1	1	3	1	2	0
K-781	281	282	1	1	5	4	2	0
K-781	282	283	1	1	3	3	3	1
K-781	282	283	1	1	4	4	2	0
K-781	282	338	56	1	3	1	0	0
K-781	282	283	1	1	4	5	0	0
K-781	282	284	2	1	4	1	2	0
K-781	283	477	194	0	3	4	0	0
K-782	283	284	1	1	5	4	2	0
K-782	283	297	14	1	3	4	2	1
K-782	283	284	1	1	5	4	2	0
K-782	283	284	1	1	4	3	3	0
K-782	283	325	42	1	3	4	2	0
K-782	284	338	54	1	3	1	0	0
K-782	284	304	20	1	5	3	3	0
K-782	284	285	1	1	5	3	3	0
K-782	284	289	5	1	4	3	2	1
K-782	284	285	1	1	5	3	3	0
K-783	284	338	54	1	3	1	0	0
K-783	284	285	1	1	5	3	3	0
K-783	286	299	13	1	3	4	3	0
K-783	287	288	1	1	4	3	3	0
K-783	287	289	2	1	3	2	2	0
K-783	287	338	51	1	3	1	0	0
K-783	287	288	1	1	5	3	3	0
K-783	288	291	3	1	3	1	2	2
K-783	288	302	14	1	3	1	2	1
K-783	288	291	3	1	3	3	2	0
K-784	288	338	50	1	3	1	0	0
K-784	288	477	189	0	4	1	0	0
K-784	288	289	1	1	5	3	2	0
K-784	288	289	1	1	4	1	2	0
K-784	289	290	1	1	4	3	2	2
K-784	289	295	6	1	3	1	0	1
K-784	289	477	188	0	3	2	1	0
K-784	289	290	1	1	4	3	1	1
K-784	289	290	1	1	5	3	3	0
K-784	290	298	8	1	4	2	2	0
K-785	290	307	17	1	4	4	4	1
K-785	290	477	187	0	3	4	0	0
K-785	291	296	5	1	3	4	0	1
K-785	291	294	3	1	3	1	3	0
K-785	291	295	4	1	3	4	4	0
K-785	294	303	9	1	3	1	3	0
K-785	295	296	1	1	3	1	2	1
K-785	295	297	2	1	3	1	0	1
K-785	296	297	1	1	3	1	4	1
K-785	296	297	1	1	2	1	0	1
K-786	296	297	1	1	3	4	2	1
K-786	297	303	6	1	4	5	2	0
K-786	297	298	1	1	3	4	2	1
K-786	297	302	5	1	4	2	0	0
K-786	297	304	7	1	4	2	2	0
K-786	299	302	3	1	3	1	0	1
K-786	301	337	36	1	3	2	2	3
K-786	301	304	3	1	2	1	4	4
K-786	302	308	6	1	4	3	2	1
K-786	303	332	29	1	3	1	2	1
K-787	304	305	1	1	5	4	2	0
K-787	304	305	1	1	4	1	2	1
K-787	304	305	1	1	3	4	2	0
K-787	304	305	1	1	3	4	2	0
K-787	304	305	1	1	3	4	2	0
K-787	304	338	34	1	3	1	0	0
K-787	304	311	7	1	1	3	1	2
K-787	305	306	1	1	3	1	2	0
K-787	305	331	26	1	4	5	2	0
K-787	305	306	1	1	4	1	0	1
K-788	305	308	3	1	4	4	2	1
K-788	307	338	31	1	3	1	0	0
K-788	308	309	1	1	3	1	1	0
K-788	309	338	29	1	3	1	0	0
K-788	309	338	29	1	3	1	0	0
K-788	309	310	1	1	3	1	2	1
K-788	310	311	1	1	3	1	2	1
K-788	311	477	166	0	4	1	0	0
K-788	311	338	27	1	3	1	0	0
K-788	312	323	11	1	3	1	2	0
K-789	312	477	165	0	3	1	0	0
K-789	312	477	165	0	4	1	0	0
K-789	315	316	1	1	4	3	4	0
K-789	315	316	1	1	3	3	2	0
K-789	315	316	1	1	4	5	3	0
K-789	315	316	1	1	5	5	2	0
K-789	315	316	1	1	4	5	2	0
K-789	316	323	7	1	4	5	0	0
K-789	316	317	1	1	3	5	4	0
K-789	316	477	161	0	3	4	0	1
K-790	317	318	1	1	3	2	2	0
K-790	317	318	1	1	4	1	3	2
K-790	317	477	160	0	4	3	1	2
K-790	317	318	1	1	3	1	2	0
K-790	317	393	76	1	3	3	2	1
K-790	317	318	1	1	4	3	0	3
K-790	318	366	48	1	3	1	0	0
K-790	319	326	7	1	3	1	0	0
K-790	322	338	16	1	1	3	1	3
K-790	322	338	16	1	1	3	1	3
K-791	323	326	3	1	3	4	2	1
K-791	324	477	153	0	3	4	0	0
K-791	324	325	1	1	4	1	3	0
K-791	324	325	1	1	4	3	3	0
K-791	325	344	19	1	2	1	0	0
K-791	325	331	6	1	5	3	2	1
K-791	325	326	1	1	3	1	2	0
K-791	326	477	151	0	3	4	0	1
K-791	326	332	6	1	3	4	2	1
K-791	329	477	148	0	4	4	0	0
K-792	330	331	1	1	3	1	0	0
K-792	331	477	146	0	3	4	1	0
K-792	331	332	1	1	3	1	2	0
K-792	331	352	21	1	3	4	1	0
K-792	332	339	7	1	3	4	4	0
K-792	332	345	13	1	3	2	0	1
K-792	332	338	6	1	3	1	0	1
K-792	333	334	1	1	3	4	2	0
K-792	335	338	3	1	3	1	4	2
K-793	335	338	3	1	3	5	4	0
K-793	336	337	1	1	3	3	2	1
K-793	336	477	141	0	4	5	0	0
K-793	336	337	1	1	3	2	2	0
K-793	336	337	1	1	3	2	2	0
K-793	336	337	1	1	2	1	4	1
K-793	336	477	141	0	4	4	0	0
K-793	336	477	141	0	3	4	1	0
K-793	336	431	95	1	3	1	1	1
K-793	337	351	14	1	3	5	0	1
K-794	338	339	1	1	3	4	2	0
K-794	338	477	139	0	3	1	1	0
K-794	338	339	1	1	3	5	2	0
K-794	338	343	5	1	5	3	2	1
K-794	338	351	13	1	5	4	2	0
K-794	339	340	1	1	3	5	2	0
K-794	339	372	33	1	3	3	0	0
K-794	339	457	118	1	3	4	1	3
K-794	339	343	4	1	3	3	2	0
K-794	339	477	138	0	4	4	0	0
K-795	343	344	1	1	3	1	1	0
K-795	343	347	4	1	3	1	4	0
K-795	343	344	1	1	3	1	0	2
K-795	343	344	1	1	3	1	3	1
K-795	343	344	1	1	3	3	2	0
K-795	344	477	133	0	3	4	0	0
K-795	344	345	1	1	3	1	1	0
K-795	345	346	1	1	3	1	0	1
K-795	345	346	1	1	3	1	0	1
K-795	346	347	1	1	4	1	1	1
K-796	346	414	68	1	4	5	3	0
K-796	346	347	1	1	3	3	1	0
K-796	346	347	1	1	3	3	2	0
K-796	346	350	4	1	3	1	0	1
K-796	350	352	2	1	3	1	0	1
K-796	350	395	45	1	3	1	0	0
K-796	351	352	1	1	4	1	2	0
K-796	353	354	1	1	3	1	0	0
M-7	107	477	370	0	3	1	0	0
E-107	58	59	1	1	3	1	0	0
E-107	70	71	1	1	4	1	0	0
E-107	113	316	203	1	3	4	0	0
E-107	190	477	287	0	3	4	0	0
E-107	216	477	261	0	3	2	0	0
FTOOLKIT-46	3	477	474	0	4	1	0	0
FTOOLKIT-46	11	477	466	0	3	1	0	0
FTOOLKIT-46	14	477	463	0	4	1	0	0
FTOOLKIT-47	14	477	463	0	4	1	0	0
FTOOLKIT-47	39	477	438	0	3	1	0	0
FTOOLKIT-47	58	477	419	0	3	1	0	0
FTOOLKIT-47	100	477	377	0	3	4	1	0
FTOOLKIT-47	105	133	28	1	3	4	0	0
FTOOLKIT-47	127	133	6	1	3	1	1	0
FTOOLKIT-47	234	477	243	0	3	1	0	0
FTOOLKIT-47	247	477	230	0	4	4	0	0
FTOOLKIT-47	274	275	1	1	3	1	1	0
FTOOLKIT-47	274	477	203	0	3	5	0	0
BIZ-1013	0	1	1	1	4	5	1	1
BIZ-1013	1	158	157	1	3	1	2	1
BIZ-1013	1	477	476	0	4	5	0	0
BIZ-1013	1	12	11	1	3	5	1	0
BIZ-1013	1	12	11	1	3	5	1	0
BIZ-1013	2	477	475	0	4	4	0	0
BIZ-1013	2	44	42	1	4	5	1	0
BIZ-1013	2	477	475	0	4	4	0	0
BIZ-1014	2	5	3	1	3	1	1	0
BIZ-1014	2	158	156	1	1	4	1	0
BIZ-1014	3	4	1	1	3	1	1	0
BIZ-1014	3	4	1	1	5	1	1	0
BIZ-1014	3	4	1	1	5	4	1	0
BIZ-1014	3	477	474	0	1	3	1	0
BIZ-1014	4	32	28	1	4	4	1	1
BIZ-1014	4	10	6	1	3	3	0	1
BIZ-1014	5	6	1	1	4	1	3	0
BIZ-1014	5	6	1	1	4	1	1	0
BIZ-1015	7	477	470	0	4	4	0	0
BIZ-1015	8	477	469	0	4	4	0	0
BIZ-1015	8	477	469	0	4	4	0	2
BIZ-1015	10	11	1	1	3	1	1	0
BIZ-1015	10	11	1	1	4	1	2	0
BIZ-1015	10	477	467	0	4	1	0	0
BIZ-1015	10	398	388	1	4	5	0	0
BIZ-1015	10	477	467	0	4	4	0	0
BIZ-1015	11	12	1	1	4	1	2	0
BIZ-1015	11	12	1	1	4	1	2	0
BIZ-1016	12	48	36	1	3	5	1	0
BIZ-1016	12	23	11	1	3	5	1	0
BIZ-1016	12	23	11	1	3	5	1	0
BIZ-1016	12	23	11	1	3	5	1	0
BIZ-1016	13	477	464	0	4	2	1	0
BIZ-1016	14	477	463	0	5	5	0	0
BIZ-1016	14	15	1	1	4	4	1	0
BIZ-1016	15	16	1	1	3	1	1	1
BIZ-1016	16	477	461	0	4	4	0	0
BIZ-1016	17	23	6	1	3	5	1	0
BIZ-1017	17	18	1	1	3	1	0	0
BIZ-1017	17	26	9	1	3	2	1	0
BIZ-1017	18	19	1	1	3	4	1	0
BIZ-1017	18	26	8	1	3	1	1	0
BIZ-1017	18	477	459	0	4	5	0	0
BIZ-1017	20	41	21	1	4	4	1	0
BIZ-1017	21	352	331	1	4	1	1	1
BIZ-1017	21	22	1	1	5	5	2	0
BIZ-1017	23	477	454	0	4	4	0	0
BIZ-1017	23	24	1	1	3	5	1	0
BIZ-1018	25	39	14	1	4	3	0	1
BIZ-1018	25	26	1	1	4	4	1	0
BIZ-1018	26	264	238	1	3	5	0	0
BIZ-1018	26	28	2	1	3	1	2	0
BIZ-1018	26	477	451	0	3	1	0	1
BIZ-1018	26	48	22	1	3	5	1	0
BIZ-1018	27	477	450	0	3	2	0	2
BIZ-1018	29	477	448	0	2	1	0	0
BIZ-1018	29	38	9	1	4	2	1	0
BIZ-1018	30	117	87	1	5	4	1	0
BIZ-1019	30	477	447	0	3	4	0	0
BIZ-1019	30	477	447	0	5	4	0	0
BIZ-1019	30	477	447	0	5	4	0	0
BIZ-1019	31	477	446	0	5	1	0	0
BIZ-1019	31	477	446	0	4	1	0	1
BIZ-1019	31	57	26	1	4	4	1	0
BIZ-1019	31	32	1	1	4	4	0	0
BIZ-1019	34	477	443	0	5	4	0	0
BIZ-1019	34	477	443	0	5	4	0	0
BIZ-1019	34	71	37	1	5	4	1	0
BIZ-1020	34	70	36	1	5	4	1	0
BIZ-1020	34	71	37	1	4	4	1	0
BIZ-1020	34	71	37	1	4	4	1	0
BIZ-1020	34	477	443	0	4	4	0	0
BIZ-1020	35	36	1	1	5	4	1	0
BIZ-1020	35	301	266	1	2	1	1	1
BIZ-1020	36	49	13	1	3	1	0	2
BIZ-1020	37	48	11	1	5	4	1	0
BIZ-1020	37	54	17	1	3	1	1	0
BIZ-1020	37	40	3	1	3	4	1	0
BIZ-1021	38	173	135	1	4	1	2	0
BIZ-1021	39	477	438	0	4	1	0	2
BIZ-1021	39	348	309	1	4	4	0	0
BIZ-1021	39	477	438	0	5	3	0	0
BIZ-1021	39	323	284	1	4	5	1	4
BIZ-1021	39	477	438	0	4	5	0	1
BIZ-1021	39	477	438	0	4	5	0	0
BIZ-1021	39	477	438	0	4	5	0	0
BIZ-1021	41	42	1	1	3	1	2	0
BIZ-1021	42	212	170	1	3	1	0	0
BIZ-1022	43	124	81	1	3	4	1	0
BIZ-1022	43	477	434	0	4	4	0	0
BIZ-1022	43	50	7	1	4	5	2	0
BIZ-1022	45	46	1	1	4	4	2	0
BIZ-1022	46	477	431	0	4	4	0	0
BIZ-1022	46	477	431	0	5	4	0	0
BIZ-1022	46	477	431	0	3	4	0	0
BIZ-1022	46	51	5	1	3	2	1	1
BIZ-1022	49	51	2	1	3	1	0	0
BIZ-1023	51	477	426	0	3	2	0	1
BIZ-1023	52	477	425	0	4	5	0	0
BIZ-1023	52	54	2	1	3	1	2	1
BIZ-1023	52	477	425	0	3	1	0	0
BIZ-1023	53	477	424	0	4	4	0	0
BIZ-1023	54	55	1	1	3	4	2	0
BIZ-1023	54	264	210	1	5	1	0	0
BIZ-1023	54	477	423	0	3	1	0	0
BIZ-1023	54	477	423	0	3	1	0	0
BIZ-1023	54	477	423	0	4	4	0	0
BIZ-1024	55	56	1	1	4	4	1	1
BIZ-1024	56	477	421	0	4	4	0	0
BIZ-1024	56	477	421	0	4	4	0	0
BIZ-1024	57	58	1	1	4	1	3	0
BIZ-1024	57	58	1	1	4	1	3	0
BIZ-1024	57	195	138	1	4	4	1	0
BIZ-1024	57	355	298	1	3	1	1	0
BIZ-1024	58	59	1	1	3	1	0	1
BIZ-1024	58	477	419	0	3	1	0	1
BIZ-1024	59	183	124	1	3	4	0	0
BIZ-1025	61	62	1	1	3	1	0	0
BIZ-1025	63	477	414	0	4	3	0	1
BIZ-1025	64	477	413	0	4	4	0	0
BIZ-1025	64	67	3	1	4	4	3	0
BIZ-1025	66	70	4	1	4	5	1	0
BIZ-1025	66	477	411	0	4	5	0	0
BIZ-1025	66	477	411	0	4	5	0	0
BIZ-1025	66	254	188	1	4	5	1	0
BIZ-1025	66	85	19	1	4	5	1	0
BIZ-1025	66	248	182	1	4	5	1	0
BIZ-1026	66	248	182	1	4	5	1	0
BIZ-1026	66	248	182	1	4	5	1	0
BIZ-1026	66	250	184	1	4	5	0	0
BIZ-1026	66	254	188	1	4	5	1	0
BIZ-1026	66	254	188	1	4	5	1	0
BIZ-1026	66	254	188	1	4	5	1	0
BIZ-1026	66	254	188	1	4	5	1	0
BIZ-1026	66	254	188	1	4	5	1	0
BIZ-1026	66	181	115	1	4	5	0	0
BIZ-1026	66	254	188	1	4	5	1	0
BIZ-1027	66	254	188	1	4	5	1	0
BIZ-1027	66	477	411	0	4	5	0	0
BIZ-1027	68	74	6	1	4	4	1	1
BIZ-1027	70	71	1	1	4	4	1	0
BIZ-1027	70	71	1	1	3	1	3	1
BIZ-1027	70	71	1	1	3	1	3	0
BIZ-1027	70	71	1	1	3	1	2	0
BIZ-1027	71	73	2	1	3	1	2	1
BIZ-1027	71	74	3	1	3	1	2	0
BIZ-1027	72	477	405	0	4	1	0	0
BIZ-1028	72	73	1	1	4	5	0	0
BIZ-1028	72	77	5	1	4	1	1	0
BIZ-1028	73	119	46	1	3	4	1	0
BIZ-1028	73	74	1	1	4	5	2	0
BIZ-1028	73	477	404	0	4	4	0	0
BIZ-1028	74	477	403	0	4	3	0	4
BIZ-1028	74	294	220	1	4	5	0	0
BIZ-1028	75	477	402	0	3	1	0	0
BIZ-1028	77	477	400	0	4	3	1	1
BIZ-1028	77	78	1	1	4	5	0	0
BIZ-1029	77	78	1	1	4	5	1	0
BIZ-1029	77	477	400	0	4	5	0	0
BIZ-1029	77	477	400	0	3	5	0	0
BIZ-1029	77	477	400	0	4	5	0	0
BIZ-1029	77	477	400	0	4	5	0	0
BIZ-1029	77	477	400	0	4	5	0	0
BIZ-1029	77	299	222	1	4	5	1	0
BIZ-1029	77	477	400	0	4	5	1	0
BIZ-1029	78	477	399	0	4	1	0	0
BIZ-1029	78	82	4	1	4	4	1	0
BIZ-1030	79	345	266	1	4	4	1	1
BIZ-1030	79	85	6	1	3	1	3	0
BIZ-1030	79	477	398	0	4	4	0	0
BIZ-1030	79	477	398	0	4	3	0	1
BIZ-1030	79	126	47	1	1	1	1	3
BIZ-1030	80	99	19	1	4	4	0	1
BIZ-1030	80	298	218	1	3	2	1	4
BIZ-1030	81	477	396	0	3	1	0	1
BIZ-1030	82	477	395	0	3	1	0	0
BIZ-1031	82	477	395	0	3	1	0	0
BIZ-1031	82	477	395	0	3	1	0	0
BIZ-1031	82	117	35	1	3	4	1	0
BIZ-1031	82	477	395	0	3	1	0	0
BIZ-1031	82	299	217	1	3	1	2	0
BIZ-1031	82	327	245	1	3	1	2	0
BIZ-1031	82	117	35	1	4	4	1	0
BIZ-1031	82	162	80	1	3	4	0	0
BIZ-1031	83	477	394	0	4	4	0	1
BIZ-1031	86	477	391	0	3	1	0	0
BIZ-1032	87	477	390	0	4	1	0	0
BIZ-1032	87	147	60	1	3	1	1	0
BIZ-1032	87	477	390	0	5	4	0	1
BIZ-1032	88	89	1	1	5	4	0	0
BIZ-1032	88	89	1	1	5	4	1	0
BIZ-1032	93	477	384	0	3	4	0	0
BIZ-1032	94	341	247	1	4	4	2	0
BIZ-1032	94	311	217	1	4	1	1	1
BIZ-1032	94	311	217	1	4	1	1	1
BIZ-1032	95	96	1	1	4	1	1	0
BIZ-1033	98	341	243	1	4	4	2	0
BIZ-1033	98	477	379	0	4	5	0	0
BIZ-1033	98	100	2	1	4	5	1	0
BIZ-1033	98	477	379	0	4	5	0	0
BIZ-1033	98	195	97	1	4	5	1	0
BIZ-1033	101	102	1	1	4	4	1	0
BIZ-1033	101	103	2	1	4	4	1	0
BIZ-1033	101	131	30	1	3	4	1	0
BIZ-1033	101	477	376	0	3	4	0	0
BIZ-1033	101	110	9	1	3	1	0	0
BIZ-1034	103	477	374	0	3	4	0	0
BIZ-1034	105	187	82	1	4	4	1	2
BIZ-1034	105	272	167	1	3	1	2	0
BIZ-1034	106	477	371	0	4	4	1	0
BIZ-1034	107	477	370	0	4	5	1	0
BIZ-1034	107	477	370	0	4	5	1	0
BIZ-1034	107	477	370	0	4	5	1	0
BIZ-1034	107	477	370	0	4	5	1	0
BIZ-1034	107	477	370	0	4	5	1	0
BIZ-1034	107	477	370	0	4	5	1	0
BIZ-1035	107	477	370	0	4	4	0	0
BIZ-1035	108	477	369	0	4	4	1	0
BIZ-1035	108	477	369	0	4	5	1	0
BIZ-1035	108	477	369	0	4	4	0	0
BIZ-1035	108	119	11	1	4	4	1	0
BIZ-1035	108	173	65	1	4	4	1	0
BIZ-1035	109	477	368	0	4	4	0	0
BIZ-1035	109	266	157	1	4	1	1	0
BIZ-1035	109	477	368	0	4	5	1	0
BIZ-1035	109	477	368	0	4	5	1	0
BIZ-1036	109	477	368	0	4	5	1	0
BIZ-1036	109	477	368	0	4	5	1	0
BIZ-1036	109	173	64	1	4	4	1	0
BIZ-1036	109	190	81	1	4	4	0	0
BIZ-1036	110	111	1	1	3	4	1	1
BIZ-1036	112	477	365	0	4	5	0	0
BIZ-1036	113	477	364	0	4	4	0	0
BIZ-1036	114	159	45	1	4	4	1	1
BIZ-1036	114	247	133	1	4	2	1	0
BIZ-1036	115	116	1	1	3	1	3	1
BIZ-1037	115	143	28	1	3	4	1	1
BIZ-1037	115	116	1	1	4	4	1	0
BIZ-1037	116	253	137	1	3	2	1	0
BIZ-1037	117	477	360	0	5	1	0	0
BIZ-1037	117	127	10	1	4	1	2	0
BIZ-1037	117	477	360	0	3	1	0	0
BIZ-1037	117	477	360	0	4	4	0	0
BIZ-1037	117	453	336	1	3	4	1	0
BIZ-1037	117	477	360	0	3	1	0	0
BIZ-1037	117	477	360	0	4	1	0	0
BIZ-1038	117	118	1	1	3	5	1	0
BIZ-1038	117	477	360	0	4	1	0	0
BIZ-1038	117	477	360	0	4	4	0	0
BIZ-1038	117	247	130	1	4	1	0	0
BIZ-1038	117	250	133	1	5	4	1	0
BIZ-1038	117	301	184	1	4	4	1	0
BIZ-1038	117	477	360	0	3	1	0	0
BIZ-1038	117	477	360	0	3	1	0	0
BIZ-1038	120	121	1	1	3	1	0	0
BIZ-1038	120	155	35	1	3	1	2	0
BIZ-1039	121	477	356	0	4	4	1	4
BIZ-1039	122	173	51	1	3	4	1	0
BIZ-1039	122	123	1	1	3	1	1	0
BIZ-1039	123	131	8	1	5	4	1	2
BIZ-1039	123	124	1	1	4	1	1	0
BIZ-1039	130	131	1	1	3	5	1	0
BIZ-1039	131	194	63	1	3	4	0	1
BIZ-1039	131	477	346	0	3	4	0	1
BIZ-1039	131	208	77	1	3	4	1	1
BIZ-1039	131	477	346	0	3	5	0	0
BIZ-1040	131	133	2	1	3	4	1	0
BIZ-1040	131	132	1	1	4	5	1	1
BIZ-1040	131	305	174	1	4	4	1	0
BIZ-1040	131	477	346	0	3	4	0	0
BIZ-1040	133	148	15	1	4	4	1	1
BIZ-1040	134	135	1	1	3	1	1	1
BIZ-1040	134	137	3	1	3	1	2	0
BIZ-1040	135	477	342	0	3	4	0	0
BIZ-1040	136	144	8	1	4	5	1	0
BIZ-1040	136	145	9	1	4	4	1	1
BIZ-1041	138	143	5	1	4	4	0	0
BIZ-1041	138	319	181	1	4	4	1	0
BIZ-1041	139	143	4	1	4	4	1	0
BIZ-1041	141	164	23	1	4	4	1	0
BIZ-1041	142	248	106	1	5	4	1	1
BIZ-1041	142	149	7	1	4	5	1	0
BIZ-1041	144	145	1	1	3	4	0	1
BIZ-1041	146	477	331	0	4	4	0	1
BIZ-1041	146	477	331	0	4	1	1	1
BIZ-1041	151	152	1	1	4	1	2	0
BIZ-1042	151	152	1	1	3	5	2	0
BIZ-1042	151	152	1	1	4	1	1	0
BIZ-1042	151	477	326	0	4	1	0	0
BIZ-1042	151	154	3	1	3	1	1	0
BIZ-1042	151	346	195	1	3	1	0	0
BIZ-1042	151	235	84	1	4	1	2	0
BIZ-1042	151	477	326	0	3	1	0	0
BIZ-1042	152	477	325	0	4	5	0	0
BIZ-1042	160	170	10	1	4	4	1	0
BIZ-1042	160	170	10	1	4	4	1	0
BIZ-1043	160	171	11	1	4	4	1	0
BIZ-1043	160	171	11	1	4	4	1	0
BIZ-1043	161	477	316	0	3	4	0	1
BIZ-1043	163	164	1	1	5	1	0	0
BIZ-1043	164	477	313	0	4	1	0	0
BIZ-1043	168	169	1	1	3	4	0	0
BIZ-1043	168	169	1	1	4	4	1	0
BIZ-1043	169	182	13	1	4	1	1	1
BIZ-1043	170	239	69	1	4	4	1	1
BIZ-1043	172	190	18	1	3	1	0	1
BIZ-1044	173	477	304	0	3	1	0	0
BIZ-1044	173	190	17	1	3	1	0	0
BIZ-1044	173	190	17	1	3	1	0	0
BIZ-1044	176	226	50	1	4	4	0	0
BIZ-1044	176	477	301	0	3	2	1	0
BIZ-1044	177	320	143	1	4	4	1	0
BIZ-1044	177	320	143	1	4	4	1	0
BIZ-1044	177	320	143	1	4	4	1	0
BIZ-1044	177	320	143	1	4	4	1	0
BIZ-1044	177	366	189	1	4	4	1	0
BIZ-1045	177	367	190	1	4	4	1	0
BIZ-1045	178	320	142	1	4	4	1	0
BIZ-1045	178	302	124	1	4	4	1	0
BIZ-1045	178	179	1	1	4	4	1	0
BIZ-1045	178	477	299	0	5	4	1	0
BIZ-1045	180	181	1	1	1	1	1	0
BIZ-1045	182	184	2	1	3	1	0	3
BIZ-1045	183	453	270	1	3	2	1	0
BIZ-1045	185	186	1	1	4	1	2	0
BIZ-1045	185	250	65	1	4	1	1	1
BIZ-1046	185	191	6	1	4	1	1	3
BIZ-1046	185	477	292	0	4	4	0	0
BIZ-1046	185	248	63	1	4	4	1	1
BIZ-1046	186	187	1	1	4	5	2	1
BIZ-1046	186	341	155	1	4	5	1	0
BIZ-1046	186	264	78	1	4	4	1	0
BIZ-1046	186	197	11	1	4	1	2	0
BIZ-1046	186	191	5	1	4	4	1	1
BIZ-1046	187	477	290	0	4	4	0	0
BIZ-1046	189	341	152	1	4	5	1	0
BIZ-1047	189	477	288	0	4	4	0	0
BIZ-1047	190	191	1	1	4	4	1	1
BIZ-1047	190	191	1	1	5	4	1	1
BIZ-1047	191	192	1	1	5	1	1	1
BIZ-1047	193	437	244	1	4	4	1	0
BIZ-1047	193	195	2	1	4	1	1	0
BIZ-1047	193	477	284	0	3	4	0	0
BIZ-1047	194	477	283	0	4	4	1	0
BIZ-1047	194	477	283	0	4	5	0	0
BIZ-1047	194	477	283	0	4	5	0	0
BIZ-1048	194	477	283	0	4	5	1	0
BIZ-1048	194	477	283	0	4	5	1	0
BIZ-1048	195	477	282	0	3	4	0	0
BIZ-1048	195	196	1	1	3	1	1	0
BIZ-1048	197	198	1	1	3	4	2	1
BIZ-1048	197	219	22	1	4	4	1	0
BIZ-1048	198	208	10	1	5	1	1	0
BIZ-1048	198	199	1	1	4	1	2	0
BIZ-1048	198	342	144	1	4	4	1	0
BIZ-1048	199	477	278	0	4	1	1	0
BIZ-1049	200	477	277	0	3	4	0	0
BIZ-1049	204	205	1	1	4	4	1	1
BIZ-1049	204	208	4	1	4	4	1	1
BIZ-1049	204	248	44	1	5	1	2	0
BIZ-1049	206	207	1	1	3	3	0	0
BIZ-1049	207	221	14	1	4	4	1	0
BIZ-1049	208	477	269	0	3	1	1	0
BIZ-1049	208	477	269	0	5	1	0	0
BIZ-1049	208	432	224	1	3	1	0	0
BIZ-1049	210	211	1	1	3	3	0	0
BIZ-1050	211	477	266	0	3	1	0	0
BIZ-1050	211	212	1	1	3	1	1	0
BIZ-1050	212	213	1	1	3	4	1	0
BIZ-1050	212	214	2	1	4	4	1	0
BIZ-1050	214	218	4	1	3	4	0	0
BIZ-1050	214	216	2	1	3	4	1	0
BIZ-1050	218	219	1	1	4	1	3	1
BIZ-1050	218	477	259	0	4	4	0	0
BIZ-1050	219	228	9	1	3	4	1	0
BIZ-1050	220	221	1	1	3	4	2	1
BIZ-1051	220	254	34	1	3	1	0	0
BIZ-1051	221	247	26	1	3	1	1	1
BIZ-1051	221	477	256	0	4	5	0	0
BIZ-1051	221	227	6	1	5	4	1	0
BIZ-1051	221	229	8	1	3	4	1	1
BIZ-1051	221	269	48	1	4	4	1	0
BIZ-1051	221	250	29	1	4	4	1	0
BIZ-1051	222	223	1	1	3	3	1	1
BIZ-1051	224	477	253	0	3	2	1	1
BIZ-1051	225	477	252	0	4	1	0	0
BIZ-1052	225	432	207	1	4	1	0	0
BIZ-1052	225	227	2	1	5	4	1	0
BIZ-1052	225	477	252	0	5	4	1	0
BIZ-1052	225	226	1	1	3	1	2	0
BIZ-1052	225	228	3	1	3	1	2	1
BIZ-1052	227	477	250	0	3	1	1	0
BIZ-1052	227	477	250	0	3	4	0	0
BIZ-1052	227	477	250	0	3	4	0	0
BIZ-1052	227	477	250	0	3	5	0	0
BIZ-1052	228	477	249	0	4	4	0	0
BIZ-1053	229	235	6	1	3	4	1	0
BIZ-1053	230	231	1	1	3	1	1	1
BIZ-1053	231	477	246	0	3	2	0	0
BIZ-1053	231	341	110	1	4	1	3	0
BIZ-1053	232	245	13	1	3	5	1	1
BIZ-1053	233	239	6	1	3	1	1	1
BIZ-1053	233	477	244	0	3	1	0	2
BIZ-1053	234	242	8	1	3	4	1	0
BIZ-1053	235	477	242	0	3	1	0	0
BIZ-1053	238	477	239	0	3	1	0	0
BIZ-1054	238	249	11	1	4	4	1	1
BIZ-1054	238	477	239	0	5	4	0	0
BIZ-1054	239	328	89	1	4	1	2	0
BIZ-1054	240	241	1	1	3	4	1	0
BIZ-1054	240	245	5	1	3	4	1	0
BIZ-1054	241	242	1	1	4	1	1	0
BIZ-1054	245	250	5	1	4	4	0	0
BIZ-1054	245	247	2	1	3	4	1	0
BIZ-1054	248	249	1	1	3	4	1	0
BIZ-1054	248	249	1	1	3	1	2	0
BIZ-1055	248	249	1	1	3	4	1	0
BIZ-1055	249	477	228	0	3	5	0	0
BIZ-1055	249	477	228	0	3	3	0	0
BIZ-1055	249	360	111	1	4	5	1	0
BIZ-1055	250	251	1	1	3	1	0	0
BIZ-1055	252	264	12	1	3	4	1	0
BIZ-1055	252	477	225	0	4	1	0	0
BIZ-1055	253	254	1	1	3	4	1	0
BIZ-1055	253	254	1	1	3	4	1	0
BIZ-1055	254	255	1	1	3	4	1	0
BIZ-1056	255	256	1	1	3	1	0	1
BIZ-1056	255	477	222	0	3	5	0	0
BIZ-1056	255	290	35	1	4	5	1	1
BIZ-1056	255	290	35	1	4	3	1	1
BIZ-1056	255	256	1	1	4	5	1	0
BIZ-1056	255	477	222	0	4	4	0	0
BIZ-1056	255	256	1	1	3	4	1	0
BIZ-1056	256	402	146	1	3	1	1	2
BIZ-1056	256	264	8	1	3	4	1	0
BIZ-1056	259	281	22	1	4	1	2	0
BIZ-1057	260	264	4	1	3	4	1	0
BIZ-1057	260	477	217	0	4	5	0	0
BIZ-1057	260	261	1	1	3	3	0	0
BIZ-1057	261	477	216	0	3	1	0	2
BIZ-1057	262	327	65	1	3	4	1	1
BIZ-1057	262	477	215	0	4	4	0	0
BIZ-1057	262	263	1	1	4	4	1	0
BIZ-1057	264	477	213	0	3	2	0	0
BIZ-1057	264	477	213	0	3	5	0	1
BIZ-1057	264	477	213	0	3	4	0	1
BIZ-1058	264	355	91	1	3	1	2	1
BIZ-1058	264	477	213	0	3	4	0	0
BIZ-1058	264	477	213	0	3	1	0	0
BIZ-1058	264	299	35	1	3	1	1	2
BIZ-1058	264	299	35	1	4	1	0	0
BIZ-1058	264	477	213	0	3	1	0	0
BIZ-1058	266	326	60	1	3	4	0	1
BIZ-1058	268	477	209	0	3	5	0	0
BIZ-1058	269	355	86	1	3	1	2	0
BIZ-1058	272	301	29	1	4	3	1	2
BIZ-1059	273	477	204	0	3	4	0	1
BIZ-1059	273	274	1	1	3	1	0	1
BIZ-1059	274	477	203	0	2	1	0	0
BIZ-1059	275	285	10	1	3	4	1	1
BIZ-1059	276	277	1	1	3	3	1	0
BIZ-1059	277	477	200	0	3	1	1	0
BIZ-1059	278	477	199	0	4	4	1	0
BIZ-1059	280	304	24	1	3	1	2	0
BIZ-1059	280	301	21	1	4	4	1	1
BIZ-1059	281	296	15	1	4	4	1	0
BIZ-1060	282	295	13	1	4	4	1	0
BIZ-1060	284	477	193	0	4	4	0	0
BIZ-1060	285	287	2	1	4	4	1	0
BIZ-1060	285	287	2	1	4	4	1	0
BIZ-1060	285	361	76	1	3	4	0	1
BIZ-1060	287	288	1	1	4	1	2	0
BIZ-1060	287	421	134	1	4	4	1	0
BIZ-1060	287	477	190	0	4	4	1	0
BIZ-1060	290	296	6	1	5	4	1	0
BIZ-1060	291	477	186	0	4	5	0	0
BIZ-1061	293	477	184	0	3	1	0	0
BIZ-1061	293	322	29	1	4	4	1	0
BIZ-1061	293	477	184	0	3	1	0	0
BIZ-1061	297	477	180	0	3	4	0	0
BIZ-1061	299	477	178	0	5	4	0	0
BIZ-1061	299	312	13	1	3	1	2	0
BIZ-1061	299	301	2	1	3	1	0	1
BIZ-1061	299	300	1	1	4	1	2	0
BIZ-1061	299	300	1	1	3	4	1	2
BIZ-1061	299	300	1	1	3	4	1	1
BIZ-1062	299	376	77	1	4	1	3	1
BIZ-1062	299	376	77	1	3	5	1	1
BIZ-1062	299	432	133	1	3	4	0	0
BIZ-1062	299	327	28	1	3	1	1	0
BIZ-1062	299	477	178	0	5	1	0	0
BIZ-1062	299	349	50	1	4	5	1	2
BIZ-1062	299	477	178	0	3	5	0	0
BIZ-1062	299	477	178	0	3	4	1	0
BIZ-1062	299	327	28	1	4	1	1	0
BIZ-1062	299	477	178	0	3	4	1	0
BIZ-1063	299	477	178	0	3	2	1	0
BIZ-1063	299	312	13	1	3	4	1	0
BIZ-1063	300	477	177	0	4	4	1	0
BIZ-1063	301	477	176	0	4	4	1	1
BIZ-1063	301	477	176	0	4	3	0	1
BIZ-1063	302	375	73	1	3	1	2	1
BIZ-1063	304	477	173	0	3	5	0	0
BIZ-1063	305	306	1	1	3	1	2	0
BIZ-1063	305	398	93	1	4	4	1	0
BIZ-1063	308	477	169	0	4	2	0	0
BIZ-1064	309	310	1	1	3	1	0	1
BIZ-1064	309	310	1	1	4	1	1	0
BIZ-1064	311	341	30	1	4	1	2	0
BIZ-1064	312	477	165	0	3	2	0	0
BIZ-1064	312	477	165	0	3	4	0	0
BIZ-1064	313	477	164	0	5	1	0	0
BIZ-1064	315	316	1	1	4	4	1	0
BIZ-1064	316	326	10	1	4	4	1	1
BIZ-1064	317	318	1	1	4	1	2	1
BIZ-1064	319	320	1	1	4	4	1	0
BIZ-1065	319	477	158	0	3	4	1	0
BIZ-1065	322	326	4	1	4	3	1	0
BIZ-1065	322	326	4	1	4	3	1	1
BIZ-1065	322	341	19	1	3	1	3	0
BIZ-1065	322	341	19	1	1	1	2	0
BIZ-1065	323	336	13	1	3	1	1	0
BIZ-1065	326	477	151	0	3	1	0	0
BIZ-1065	326	327	1	1	4	3	1	1
BIZ-1065	326	346	20	1	4	1	1	1
BIZ-1065	327	328	1	1	3	1	0	0
BIZ-1066	327	477	150	0	3	1	0	0
BIZ-1066	327	378	51	1	4	1	0	0
BIZ-1066	327	355	28	1	3	1	0	0
BIZ-1066	327	462	135	1	3	4	1	1
BIZ-1066	327	376	49	1	2	1	0	0
BIZ-1066	327	477	150	0	4	1	0	1
BIZ-1066	327	378	51	1	3	1	3	0
BIZ-1066	327	356	29	1	3	1	0	0
BIZ-1066	327	355	28	1	4	1	2	0
BIZ-1066	327	477	150	0	3	1	0	0
BIZ-1067	327	328	1	1	2	1	0	1
BIZ-1067	327	477	150	0	3	1	0	0
BIZ-1067	327	477	150	0	3	1	0	0
BIZ-1067	327	374	47	1	3	1	1	3
BIZ-1067	329	477	148	0	3	4	0	0
BIZ-1067	329	477	148	0	3	1	0	0
BIZ-1067	330	341	11	1	3	1	3	0
BIZ-1067	331	340	9	1	4	1	1	1
BIZ-1067	331	477	146	0	1	5	0	1
BIZ-1067	331	477	146	0	4	4	0	0
BIZ-1068	334	379	45	1	3	1	3	1
BIZ-1068	334	355	21	1	4	1	2	1
BIZ-1068	334	366	32	1	4	4	1	2
BIZ-1068	334	477	143	0	3	4	0	0
BIZ-1068	335	477	142	0	3	1	0	0
BIZ-1068	335	477	142	0	4	2	1	0
BIZ-1068	336	477	141	0	3	1	0	1
BIZ-1068	336	477	141	0	3	1	0	0
BIZ-1068	336	477	141	0	3	1	0	3
BIZ-1068	336	376	40	1	3	4	1	1
BIZ-1069	336	477	141	0	3	1	0	0
BIZ-1069	337	368	31	1	4	4	1	1
BIZ-1069	338	477	139	0	4	4	0	0
BIZ-1069	338	477	139	0	3	1	1	3
BIZ-1069	338	346	8	1	3	1	0	2
BIZ-1069	338	424	86	1	4	4	1	0
BIZ-1069	339	340	1	1	3	1	2	0
BIZ-1069	341	477	136	0	4	4	0	0
BIZ-1069	341	477	136	0	4	4	0	0
BIZ-1069	341	349	8	1	4	4	1	0
BIZ-1070	343	428	85	1	4	4	1	1
BIZ-1070	343	344	1	1	3	4	1	0
BIZ-1070	344	345	1	1	4	1	0	0
BIZ-1070	344	477	133	0	4	1	0	0
BIZ-1070	344	477	133	0	4	4	0	0
BIZ-1070	346	477	131	0	4	4	0	0
BIZ-1070	346	454	108	1	4	1	3	0
BIZ-1070	346	477	131	0	4	1	1	0
BIZ-1070	347	348	1	1	3	1	1	1
BIZ-1070	347	348	1	1	4	4	1	0
BIZ-1071	347	477	130	0	4	4	1	0
BIZ-1071	347	348	1	1	3	1	1	0
BIZ-1071	347	351	4	1	3	1	1	2
BIZ-1071	348	355	7	1	5	1	2	0
BIZ-1071	348	477	129	0	3	4	0	0
BIZ-1071	349	350	1	1	3	5	1	1
BIZ-1071	350	447	97	1	3	4	1	0
BIZ-1071	350	351	1	1	4	4	1	0
BIZ-1071	350	477	127	0	3	4	1	0
BIZ-1071	350	477	127	0	4	4	1	1
BIZ-1072	350	477	127	0	3	1	0	0
BIZ-1072	351	355	4	1	4	3	2	1
BIZ-1072	351	477	126	0	4	1	1	0
BIZ-1072	352	425	73	1	4	4	1	0
BIZ-1072	353	355	2	1	4	5	1	0
BIZ-1072	354	477	123	0	4	4	0	0
BIZ-1072	354	359	5	1	4	5	1	0
BIZ-1072	355	432	77	1	3	1	3	0
BIZ-1072	355	364	9	1	4	5	1	0
BIZ-1072	355	477	122	0	3	4	0	0
BIZ-1073	355	376	21	1	3	4	1	0
BIZ-1073	355	477	122	0	3	1	0	0
BIZ-1073	355	359	4	1	4	5	1	0
BIZ-1073	355	477	122	0	3	1	0	0
BIZ-1073	355	477	122	0	3	1	0	0
BIZ-1073	355	477	122	0	3	1	1	0
BIZ-1073	355	356	1	1	3	1	1	0
BIZ-1073	355	432	77	1	4	4	0	0
BIZ-1073	355	432	77	1	3	1	2	1
BIZ-1073	355	477	122	0	4	4	0	0
BIZ-1074	355	477	122	0	5	1	0	0
BIZ-1074	355	378	23	1	3	1	3	1
BIZ-1074	355	477	122	0	3	1	1	0
BIZ-1074	355	453	98	1	3	1	3	0
BIZ-1074	355	359	4	1	3	1	1	1
BIZ-1074	355	357	2	1	4	5	1	0
BIZ-1074	355	477	122	0	3	1	0	0
BIZ-1074	355	376	21	1	3	4	1	0
BIZ-1074	355	477	122	0	2	1	0	0
BIZ-1074	355	477	122	0	3	1	0	0
BIZ-1075	359	477	118	0	4	4	1	4
BIZ-1075	361	477	116	0	3	5	0	0
BIZ-1075	361	362	1	1	3	3	1	0
BIZ-1075	361	448	87	1	3	4	0	0
INGO-121	2	477	475	0	3	1	0	0
INGO-122	2	3	1	1	2	1	0	0
INGO-122	3	477	474	0	3	1	0	0
INGO-122	16	477	461	0	3	1	0	0
INGO-122	18	477	459	0	4	5	0	0
INGO-122	22	30	8	1	3	1	0	0
INGO-122	28	477	449	0	3	5	0	0
INGO-122	30	108	78	1	4	2	0	1
INGO-122	30	31	1	1	1	1	0	0
INGO-122	31	32	1	1	3	1	0	0
INGO-122	31	38	7	1	4	4	0	0
INGO-123	32	214	182	1	3	1	1	0
INGO-123	32	51	19	1	3	1	0	0
INGO-123	36	38	2	1	3	1	0	0
INGO-123	36	477	441	0	2	2	0	0
INGO-123	39	477	438	0	3	1	0	0
INGO-123	45	477	432	0	3	4	0	0
INGO-123	49	477	428	0	4	1	0	0
INGO-123	51	52	1	1	4	1	1	0
INGO-123	56	71	15	1	3	1	0	0
INGO-123	57	477	420	0	3	1	0	1
INGO-124	58	477	419	0	3	1	0	0
INGO-124	58	477	419	0	1	5	0	0
INGO-124	58	477	419	0	3	1	0	0
INGO-124	59	477	418	0	3	1	0	0
INGO-124	63	98	35	1	3	1	0	0
INGO-124	67	214	147	1	3	1	1	0
INGO-124	70	134	64	1	3	1	0	0
INGO-124	71	477	406	0	3	1	0	0
INGO-124	77	100	23	1	3	1	0	0
INGO-124	78	109	31	1	4	1	0	0
INGO-125	78	477	399	0	3	1	0	0
INGO-125	79	477	398	0	2	4	0	0
INGO-125	81	94	13	1	1	1	1	0
INGO-125	91	98	7	1	3	2	1	0
INGO-125	92	140	48	1	2	1	0	0
INGO-125	99	100	1	1	4	1	0	0
INGO-125	100	101	1	1	4	4	1	0
INGO-125	100	477	377	0	3	1	0	0
INGO-125	107	108	1	1	4	1	1	0
INGO-125	107	112	5	1	4	1	0	0
INGO-126	111	477	366	0	2	1	0	0
INGO-126	115	477	362	0	3	1	0	0
INGO-126	115	140	25	1	3	1	0	0
INGO-126	130	477	347	0	3	1	0	0
INGO-126	141	477	336	0	1	5	0	0
INGO-126	143	477	334	0	4	1	0	0
INGO-126	144	477	333	0	3	1	0	0
INGO-126	149	477	328	0	3	5	1	0
INGO-126	150	477	327	0	3	5	1	0
INGO-126	155	477	322	0	4	1	0	0
INGO-127	162	477	315	0	2	1	0	0
INGO-127	171	172	1	1	3	4	1	0
INGO-127	175	477	302	0	3	1	0	0
INGO-127	176	189	13	1	3	2	0	0
INGO-127	182	192	10	1	1	1	0	0
INGO-127	184	477	293	0	3	1	0	0
INGO-127	192	477	285	0	1	1	1	0
INGO-127	193	477	284	0	3	1	0	0
INGO-127	196	477	281	0	3	1	0	0
INGO-127	206	207	1	1	4	1	0	0
INGO-128	206	207	1	1	4	1	0	0
INGO-128	210	477	267	0	3	5	0	0
INGO-128	212	477	265	0	3	5	0	0
INGO-128	217	218	1	1	4	1	1	0
INGO-128	217	344	127	1	3	3	1	0
INGO-128	219	477	258	0	4	1	0	0
INGO-128	221	477	256	0	3	1	0	0
INGO-128	228	229	1	1	3	2	0	0
INGO-128	231	477	246	0	4	4	0	0
INGO-128	238	477	239	0	3	1	0	0
INGO-129	262	477	215	0	1	1	0	0
INGO-129	262	477	215	0	3	1	0	0
INGO-129	263	266	3	1	3	1	1	0
INGO-129	263	266	3	1	3	1	1	0
INGO-129	263	266	3	1	3	1	1	0
INGO-129	266	477	211	0	4	4	0	0
INGO-129	268	269	1	1	4	1	1	0
INGO-129	268	269	1	1	4	1	1	0
INGO-129	268	269	1	1	4	1	1	0
INGO-129	268	273	5	1	3	1	0	0
INGO-130	269	477	208	0	3	2	0	0
INGO-130	271	288	17	1	3	1	1	0
INGO-130	273	375	102	1	2	1	0	0
INGO-130	274	477	203	0	1	5	0	0
INGO-130	275	276	1	1	4	1	1	0
INGO-130	276	477	201	0	1	1	0	0
INGO-130	280	477	197	0	3	1	1	1
INGO-130	281	477	196	0	1	1	1	0
INGO-130	287	477	190	0	4	2	0	1
INGO-130	291	337	46	1	2	1	0	0
INGO-131	294	477	183	0	3	5	0	0
INGO-131	295	296	1	1	3	1	1	2
INGO-131	296	477	181	0	3	1	0	0
INGO-131	298	337	39	1	3	5	0	0
INGO-131	298	477	179	0	3	1	0	0
INGO-131	322	323	1	1	4	4	1	0
INGO-131	322	323	1	1	3	1	1	0
INGO-131	323	477	154	0	3	1	0	0
INGO-131	323	324	1	1	3	3	1	0
INGO-131	336	463	127	1	2	1	0	0
INGO-132	345	477	132	0	3	1	0	0
INGO-132	346	347	1	1	4	4	1	0
INGO-132	346	347	1	1	4	4	1	0
INGO-132	346	347	1	1	4	4	1	0
INGO-132	347	477	130	0	3	1	0	0
INGO-132	352	477	125	0	3	1	0	0
INGO-132	353	477	124	0	3	2	0	0
TU-21	10	11	1	1	4	4	0	0
ID-10	144	294	150	1	3	5	1	0
ID-10	158	294	136	1	3	3	0	1
ID-10	165	294	129	1	3	5	1	0
ID-10	166	192	26	1	3	1	0	0
ID-10	166	477	311	0	3	1	0	0
ID-10	202	294	92	1	3	5	1	0
ID-10	202	294	92	1	3	5	1	0
ID-10	210	294	84	1	3	5	1	0
ID-10	210	294	84	1	3	5	1	0
ID-10	221	294	73	1	1	5	1	0
ID-11	237	294	57	1	3	5	1	0
ID-11	248	258	10	1	3	3	0	0
ID-11	269	294	25	1	3	5	1	0
ID-11	269	310	41	1	3	5	1	0
ID-11	270	310	40	1	3	5	1	0
ID-11	274	310	36	1	3	5	1	0
ID-11	274	285	11	1	3	5	1	0
ID-11	274	310	36	1	3	5	1	0
ID-11	291	294	3	1	3	5	1	0
ID-11	294	310	16	1	3	5	1	0
ID-12	302	477	175	0	3	4	0	0
ID-12	336	339	3	1	3	3	0	0
ID-12	359	477	118	0	4	5	0	1
ID-12	359	477	118	0	3	5	0	1
ID-12	360	443	83	1	2	5	1	1
ID-8	30	55	25	1	5	4	1	0
ID-8	31	55	24	1	2	1	1	0
ID-8	31	44	13	1	3	1	1	0
ID-8	32	55	23	1	4	1	1	0
ID-9	52	294	242	1	3	5	1	0
ID-9	66	158	92	1	3	3	0	1
ID-9	70	71	1	1	3	2	1	0
ID-9	70	294	224	1	3	5	1	0
ID-9	73	294	221	1	3	5	1	0
ID-9	84	92	8	1	3	2	1	0
ID-9	84	294	210	1	3	5	1	0
ID-9	113	118	5	1	3	1	1	0
ID-9	118	120	2	1	3	1	1	0
ID-9	141	294	153	1	3	5	1	0
DT-100	318	477	159	0	3	3	1	0
DT-100	327	477	150	0	4	4	0	1
DT-100	333	334	1	1	1	3	1	0
DT-100	334	477	143	0	3	4	1	0
DT-96	2	56	54	1	3	1	1	0
DT-96	9	57	48	1	1	5	1	0
DT-97	9	57	48	1	3	5	1	0
DT-97	53	477	424	0	3	1	1	2
DT-97	53	54	1	1	3	4	1	0
DT-97	93	95	2	1	4	1	1	0
DT-97	107	477	370	0	3	4	0	0
DT-97	113	271	158	1	4	4	1	0
DT-97	114	477	363	0	3	4	1	0
DT-97	122	477	355	0	4	2	0	0
DT-97	135	137	2	1	2	1	1	0
DT-97	144	145	1	1	3	1	1	0
DT-98	153	241	88	1	3	5	1	1
DT-98	153	241	88	1	3	5	1	1
DT-98	153	241	88	1	3	5	1	1
DT-98	153	477	324	0	3	5	1	0
DT-98	159	241	82	1	4	5	1	1
DT-98	160	232	72	1	1	1	1	1
DT-98	164	477	313	0	3	4	0	2
DT-98	180	241	61	1	4	5	1	1
DT-98	191	477	286	0	3	1	0	0
DT-98	217	218	1	1	1	1	1	0
DT-99	225	477	252	0	2	4	1	0
DT-99	228	477	249	0	3	1	0	0
DT-99	229	231	2	1	3	1	1	1
DT-99	236	271	35	1	3	4	1	0
DT-99	256	477	221	0	1	4	1	0
DT-99	277	477	200	0	3	1	1	0
DT-99	283	477	194	0	3	1	0	0
DT-99	287	477	190	0	3	1	0	0
DT-99	306	307	1	1	4	1	1	0
DT-99	306	367	61	1	3	1	1	0
ZIE-315	2	477	475	0	4	1	0	0
ZIE-315	2	8	6	1	1	1	2	3
ZIE-315	3	4	1	1	4	1	0	0
ZIE-315	7	8	1	1	3	5	1	0
ZIE-315	9	242	233	1	2	1	1	2
ZIE-315	10	210	200	1	3	1	1	0
ZIE-315	10	25	15	1	1	1	1	0
ZIE-315	11	477	466	0	3	4	0	0
ZIE-315	12	16	4	1	1	1	1	1
ZIE-316	13	275	262	1	3	1	1	4
ZIE-316	15	16	1	1	1	1	1	0
ZIE-316	15	17	2	1	3	1	1	0
ZIE-316	19	36	17	1	3	3	1	1
ZIE-316	19	259	240	1	3	3	1	3
ZIE-316	21	477	456	0	3	1	0	0
ZIE-316	22	23	1	1	4	1	1	0
ZIE-316	22	23	1	1	1	1	1	0
ZIE-316	23	35	12	1	3	1	1	0
ZIE-316	24	477	453	0	4	2	0	0
ZIE-317	25	477	452	0	3	1	0	0
ZIE-317	26	31	5	1	1	1	1	0
ZIE-317	28	44	16	1	3	4	1	1
ZIE-317	35	39	4	1	3	1	1	0
ZIE-317	36	252	216	1	3	4	0	2
ZIE-317	36	477	441	0	3	5	0	0
ZIE-317	37	85	48	1	1	1	1	1
ZIE-317	37	477	440	0	4	1	0	1
ZIE-317	37	214	177	1	1	1	1	3
ZIE-317	39	477	438	0	3	4	0	0
ZIE-318	40	477	437	0	3	4	0	0
ZIE-318	42	466	424	1	3	1	0	1
ZIE-318	43	60	17	1	3	1	1	1
ZIE-318	44	45	1	1	3	4	1	1
ZIE-318	52	70	18	1	3	1	0	1
ZIE-318	54	143	89	1	3	1	1	0
ZIE-318	58	368	310	1	2	1	2	0
ZIE-318	58	477	419	0	3	2	0	0
ZIE-318	59	127	68	1	3	4	0	1
ZIE-318	63	78	15	1	1	4	1	0
ZIE-319	64	70	6	1	3	1	0	1
ZIE-319	64	477	413	0	3	1	0	1
ZIE-319	65	98	33	1	3	1	1	1
ZIE-319	65	212	147	1	3	1	1	0
ZIE-319	66	367	301	1	2	1	1	0
ZIE-319	71	77	6	1	4	1	1	0
ZIE-319	72	477	405	0	3	2	1	3
ZIE-319	77	78	1	1	4	1	0	0
ZIE-319	77	477	400	0	3	5	1	0
ZIE-319	78	477	399	0	3	1	0	0
ZIE-320	81	477	396	0	1	4	1	1
ZIE-320	84	85	1	1	4	4	1	0
ZIE-320	86	477	391	0	3	1	0	0
ZIE-320	86	477	391	0	4	1	0	0
ZIE-320	86	459	373	1	2	1	0	0
ZIE-320	87	477	390	0	3	1	0	0
ZIE-320	87	477	390	0	5	1	1	0
ZIE-320	87	431	344	1	1	1	1	2
ZIE-320	87	190	103	1	2	1	1	1
ZIE-320	92	93	1	1	4	1	1	0
ZIE-321	92	240	148	1	3	1	1	0
ZIE-321	92	477	385	0	3	1	1	0
ZIE-321	94	95	1	1	4	1	1	0
ZIE-321	96	477	381	0	4	1	0	0
ZIE-321	99	477	378	0	3	2	0	1
ZIE-321	99	477	378	0	3	4	0	1
ZIE-321	99	477	378	0	3	4	0	1
ZIE-321	100	135	35	1	4	4	1	2
ZIE-321	101	368	267	1	3	1	0	1
ZIE-321	102	134	32	1	3	1	1	3
ZIE-322	102	126	24	1	3	1	0	0
ZIE-322	102	140	38	1	5	1	1	0
ZIE-322	105	107	2	1	4	4	1	0
ZIE-322	105	477	372	0	3	4	0	0
ZIE-322	107	164	57	1	3	3	1	0
ZIE-322	109	122	13	1	3	1	1	0
ZIE-322	109	135	26	1	3	5	1	1
ZIE-322	112	154	42	1	3	5	1	3
ZIE-322	113	147	34	1	3	1	1	3
ZIE-322	115	266	151	1	3	2	1	4
ZIE-323	116	134	18	1	3	1	0	0
ZIE-323	122	123	1	1	4	1	0	1
ZIE-323	123	127	4	1	3	4	1	1
ZIE-323	123	157	34	1	3	1	1	1
ZIE-323	123	477	354	0	4	4	0	1
ZIE-323	126	135	9	1	4	1	1	0
ZIE-323	127	135	8	1	3	5	1	1
ZIE-323	127	141	14	1	3	5	1	0
ZIE-323	127	143	16	1	3	5	1	1
ZIE-323	127	136	9	1	3	5	1	1
ZIE-324	127	135	8	1	3	5	1	1
ZIE-324	127	136	9	1	3	5	1	2
ZIE-324	127	135	8	1	3	5	1	0
ZIE-324	127	393	266	1	3	5	1	0
ZIE-324	127	477	350	0	3	5	0	0
ZIE-324	127	477	350	0	3	5	0	0
ZIE-324	127	135	8	1	3	5	1	0
ZIE-324	128	477	349	0	4	4	0	0
ZIE-324	128	477	349	0	3	2	0	0
ZIE-324	129	459	330	1	3	4	1	0
ZIE-325	129	135	6	1	3	4	1	1
ZIE-325	141	142	1	1	3	5	1	0
ZIE-325	141	477	336	0	3	5	0	1
ZIE-325	142	143	1	1	3	5	1	1
ZIE-325	142	477	335	0	3	1	0	1
ZIE-325	142	477	335	0	3	1	0	0
ZIE-325	143	477	334	0	4	4	0	1
ZIE-325	144	145	1	1	3	5	1	1
ZIE-325	144	147	3	1	3	1	1	0
ZIE-325	144	477	333	0	3	5	0	0
ZIE-326	144	162	18	1	3	1	1	4
ZIE-326	147	414	267	1	3	4	1	1
ZIE-326	147	477	330	0	3	4	0	1
ZIE-326	147	477	330	0	3	5	0	0
ZIE-326	147	234	87	1	3	5	1	0
ZIE-326	148	477	329	0	4	3	0	2
ZIE-326	148	477	329	0	3	2	1	0
ZIE-326	148	477	329	0	3	2	0	0
ZIE-326	148	477	329	0	3	5	0	0
ZIE-326	149	150	1	1	3	5	1	0
ZIE-327	150	169	19	1	3	4	1	0
ZIE-327	150	477	327	0	3	5	0	0
ZIE-327	151	178	27	1	3	1	0	0
ZIE-327	154	477	323	0	3	1	0	0
ZIE-327	155	477	322	0	3	1	1	0
ZIE-327	156	169	13	1	3	4	1	0
ZIE-327	156	477	321	0	3	4	0	1
ZIE-327	156	277	121	1	4	4	1	0
ZIE-327	158	164	6	1	3	1	1	1
ZIE-327	159	477	318	0	3	2	0	1
ZIE-328	162	477	315	0	3	5	0	3
ZIE-328	162	477	315	0	3	5	0	1
ZIE-328	162	477	315	0	3	5	0	1
ZIE-328	162	477	315	0	3	5	0	1
ZIE-328	162	164	2	1	4	4	1	0
ZIE-328	162	477	315	0	3	1	0	0
ZIE-328	163	477	314	0	3	2	0	0
ZIE-328	165	477	312	0	3	1	0	0
ZIE-328	165	477	312	0	3	5	0	0
ZIE-328	165	169	4	1	3	5	1	1
ZIE-329	165	477	312	0	3	1	0	0
ZIE-329	165	477	312	0	3	1	0	0
ZIE-329	169	170	1	1	3	5	1	1
ZIE-329	169	477	308	0	3	5	0	0
ZIE-329	170	178	8	1	3	1	0	0
ZIE-329	171	172	1	1	3	5	1	0
ZIE-329	172	477	305	0	3	5	0	0
ZIE-329	175	183	8	1	2	1	1	0
ZIE-329	176	253	77	1	1	1	1	0
ZIE-329	178	477	299	0	3	1	0	0
ZIE-330	182	187	5	1	2	1	0	0
ZIE-330	183	477	294	0	3	1	0	0
ZIE-330	183	413	230	1	3	1	0	0
ZIE-330	191	210	19	1	1	1	1	2
ZIE-330	197	220	23	1	2	1	1	0
ZIE-330	197	477	280	0	3	2	0	0
ZIE-330	197	199	2	1	4	4	1	0
ZIE-330	199	268	69	1	2	1	1	1
ZIE-330	202	477	275	0	4	1	0	1
ZIE-330	205	210	5	1	4	1	1	1
ZIE-331	206	211	5	1	4	1	1	1
ZIE-331	210	477	267	0	3	5	0	1
ZIE-331	213	434	221	1	3	1	1	0
ZIE-331	213	214	1	1	4	1	1	0
ZIE-331	213	219	6	1	3	1	1	1
ZIE-331	213	217	4	1	4	1	1	0
ZIE-331	213	240	27	1	3	1	1	1
ZIE-331	213	249	36	1	2	5	1	1
ZIE-331	213	235	22	1	1	5	1	1
ZIE-331	214	477	263	0	4	4	0	0
ZIE-332	216	477	261	0	3	4	0	1
ZIE-332	217	219	2	1	4	1	1	0
ZIE-332	217	477	260	0	4	4	0	1
ZIE-332	217	477	260	0	4	4	0	1
ZIE-332	220	226	6	1	2	1	1	1
ZIE-332	220	477	257	0	3	1	0	0
ZIE-332	221	417	196	1	3	1	1	0
ZIE-332	225	281	56	1	3	5	0	0
ZIE-332	225	477	252	0	3	3	0	0
ZIE-332	226	228	2	1	4	5	1	1
ZIE-333	228	233	5	1	3	1	1	1
ZIE-333	232	234	2	1	4	5	1	0
ZIE-333	232	235	3	1	5	4	1	0
ZIE-333	239	255	16	1	1	1	0	0
ZIE-333	241	242	1	1	3	1	1	0
ZIE-333	245	477	232	0	4	4	0	1
ZIE-333	246	477	231	0	3	4	1	0
ZIE-333	248	477	229	0	4	4	0	1
ZIE-333	252	315	63	1	4	4	2	1
ZIE-333	252	477	225	0	4	4	0	1
ZIE-334	252	268	16	1	3	4	1	0
ZIE-334	252	366	114	1	3	4	1	2
ZIE-334	252	263	11	1	3	4	1	0
ZIE-334	254	269	15	1	3	1	1	1
ZIE-334	254	262	8	1	3	1	0	0
ZIE-334	260	477	217	0	3	1	1	0
ZIE-334	260	266	6	1	3	4	1	0
ZIE-334	260	263	3	1	3	4	1	0
ZIE-334	260	275	15	1	3	4	1	2
ZIE-334	261	263	2	1	3	1	1	2
ZIE-335	263	477	214	0	3	1	1	0
ZIE-335	263	266	3	1	3	5	1	0
ZIE-335	266	267	1	1	3	5	1	1
ZIE-335	268	477	209	0	3	2	0	0
ZIE-335	269	270	1	1	3	1	1	2
ZIE-335	270	477	207	0	2	2	0	0
ZIE-335	273	477	204	0	3	4	0	0
ZIE-335	275	477	202	0	3	4	1	1
ZIE-335	275	276	1	1	2	1	1	1
ZIE-335	277	477	200	0	3	4	1	1
ZIE-336	280	477	197	0	3	4	0	0
ZIE-336	280	287	7	1	4	4	1	0
ZIE-336	281	477	196	0	3	4	0	0
ZIE-336	282	477	195	0	1	1	0	1
ZIE-336	283	477	194	0	3	1	0	0
ZIE-336	283	287	4	1	3	1	1	0
ZIE-336	283	477	194	0	3	1	0	0
ZIE-336	284	477	193	0	3	1	0	0
ZIE-336	285	287	2	1	4	1	1	0
ZIE-336	287	288	1	1	3	3	2	0
ZIE-337	289	297	8	1	3	1	1	0
ZIE-337	291	297	6	1	3	5	1	0
ZIE-337	291	477	186	0	4	4	0	0
ZIE-337	294	308	14	1	4	1	2	0
ZIE-337	295	477	182	0	3	1	0	0
ZIE-337	301	477	176	0	3	1	0	0
ZIE-337	303	308	5	1	3	1	1	0
ZIE-337	303	308	5	1	3	3	1	0
ZIE-337	308	309	1	1	3	4	2	0
ZIE-337	308	339	31	1	3	1	1	1
ZIE-338	308	317	9	1	3	1	1	0
ZIE-338	312	325	13	1	3	3	1	1
ZIE-338	315	334	19	1	3	4	1	1
ZIE-338	317	477	160	0	3	4	0	0
ZIE-338	317	331	14	1	3	5	1	0
ZIE-338	322	477	155	0	1	1	0	0
ZIE-338	323	331	8	1	3	1	2	0
ZIE-338	323	477	154	0	3	4	0	1
ZIE-338	325	344	19	1	3	1	1	1
ZIE-338	325	336	11	1	1	1	2	0
ZIE-339	325	336	11	1	1	1	1	0
ZIE-339	326	477	151	0	3	4	0	0
ZIE-339	329	477	148	0	3	4	1	1
ZIE-339	330	477	147	0	3	4	0	0
ZIE-339	331	477	146	0	3	4	0	0
ZIE-339	332	424	92	1	4	3	1	2
ZIE-339	336	477	141	0	3	1	0	1
ZIE-339	336	351	15	1	3	4	1	0
ZIE-339	338	340	2	1	4	4	1	0
ZIE-339	339	340	1	1	3	4	1	0
ZIE-340	344	366	22	1	3	5	1	1
ZIE-340	345	381	36	1	3	1	1	0
ZIE-340	346	477	131	0	4	1	0	0
ZIE-340	346	477	131	0	4	1	0	0
ZIE-340	351	477	126	0	3	1	0	0
ZIE-340	351	477	126	0	4	4	0	0
ZIE-340	352	477	125	0	3	4	0	0
ZIE-340	352	374	22	1	3	5	1	2
ZIE-340	352	477	125	0	3	5	0	0
ZIE-340	352	423	71	1	3	1	1	1
ZIE-341	353	364	11	1	3	4	2	0
ZIE-341	358	389	31	1	3	1	0	0
ZIE-341	360	366	6	1	3	3	0	0
ZIE-341	361	477	116	0	3	1	0	0
ENEJB-213	249	253	4	1	3	1	0	0
ENEJB-213	349	477	128	0	3	1	0	0
ENEJB-213	350	477	127	0	3	1	1	0
ENEJB-214	350	477	127	0	3	5	0	0
ENEJB-214	350	477	127	0	3	5	0	0
ENEJB-214	350	477	127	0	3	5	0	0
ENEJB-214	350	477	127	0	3	5	0	0
ENEJB-214	350	477	127	0	3	5	0	0
ENJPA-272	2	3	1	1	4	1	2	0
ENJPA-272	11	477	466	0	3	1	1	0
ENJPA-272	23	477	454	0	3	1	0	0
ENJPA-272	33	477	444	0	3	1	1	0
ENJPA-272	64	477	413	0	3	1	0	0
ENJPA-273	72	73	1	1	3	5	2	0
ENJPA-273	85	477	392	0	3	1	1	0
ENJPA-273	90	477	387	0	4	1	0	0
ENJPA-273	98	409	311	1	3	1	1	0
ENJPA-273	98	477	379	0	3	1	0	0
ENJPA-273	114	477	363	0	3	1	0	0
ENJPA-273	114	477	363	0	3	1	0	0
ENJPA-273	122	477	355	0	3	4	0	0
ENJPA-273	138	477	339	0	3	1	0	0
ENJPA-273	153	154	1	1	5	5	0	0
ENJPA-274	156	477	321	0	3	5	0	0
ENJPA-274	162	477	315	0	3	1	1	1
ENJPA-274	179	182	3	1	3	1	2	1
ENJPA-274	192	477	285	0	3	1	0	0
ENJPA-274	199	244	45	1	3	3	1	0
ENJPA-274	214	219	5	1	4	4	4	0
ENJPA-274	227	228	1	1	3	1	1	0
ENJPA-274	228	428	200	1	3	4	1	2
ENJPA-274	244	267	23	1	3	4	1	0
ENJPA-274	245	477	232	0	3	1	0	0
ENJPA-275	262	266	4	1	3	4	1	0
ENJPA-275	269	275	6	1	3	4	1	0
ENJPA-275	287	294	7	1	3	4	1	0
ENJPA-275	294	454	160	1	3	4	1	0
ENJPA-275	295	449	154	1	3	3	1	0
ENJPA-275	302	305	3	1	3	4	1	1
ENJPA-275	313	314	1	1	3	1	1	0
ENJPA-275	313	314	1	1	3	1	1	0
ENJPA-275	317	428	111	1	3	3	1	1
ENJPA-275	330	477	147	0	3	1	0	0
ENJPA-276	332	477	145	0	4	4	0	0
ENJPA-276	340	378	38	1	1	1	1	0
ENJPA-276	352	477	125	0	3	3	0	0
ENMEETINGS-181	1	5	4	1	3	1	0	1
ENMEETINGS-181	5	10	5	1	3	4	1	1
ENMEETINGS-181	6	7	1	1	3	1	0	0
ENMEETINGS-181	17	18	1	1	3	1	0	0
ENMEETINGS-181	25	40	15	1	4	2	1	0
ENMEETINGS-181	25	26	1	1	4	2	0	0
ENMEETINGS-181	25	28	3	1	3	1	1	0
ENMEETINGS-181	25	31	6	1	4	4	1	0
ENMEETINGS-181	26	27	1	1	3	1	0	0
ENMEETINGS-182	28	38	10	1	4	1	1	0
ENMEETINGS-182	28	29	1	1	5	4	1	0
ENMEETINGS-182	28	29	1	1	4	1	0	0
ENMEETINGS-182	28	29	1	1	3	1	0	0
ENMEETINGS-182	29	30	1	1	4	4	1	0
ENMEETINGS-182	30	32	2	1	3	4	1	2
ENMEETINGS-182	31	38	7	1	3	1	0	0
ENMEETINGS-182	34	36	2	1	3	1	1	0
ENMEETINGS-182	37	40	3	1	5	1	0	0
ENMEETINGS-182	38	39	1	1	1	1	1	0
ENMEETINGS-183	41	43	2	1	4	1	0	0
ENMEETINGS-183	43	44	1	1	3	1	0	0
ENMEETINGS-183	43	44	1	1	4	1	1	0
ENMEETINGS-183	51	52	1	1	3	1	0	1
ENMEETINGS-183	59	60	1	1	3	1	0	0
ENMEETINGS-183	61	63	2	1	3	1	0	0
ENMEETINGS-183	64	99	35	1	1	1	1	0
ENMEETINGS-183	64	66	2	1	3	1	1	0
ENMEETINGS-183	65	77	12	1	3	1	0	0
ENMEETINGS-183	66	67	1	1	3	1	0	0
ENMEETINGS-184	66	67	1	1	3	1	1	0
ENMEETINGS-184	66	67	1	1	3	1	1	0
ENMEETINGS-184	66	67	1	1	3	1	0	0
ENMEETINGS-184	66	67	1	1	3	1	0	0
ENMEETINGS-184	66	67	1	1	3	1	0	0
ENMEETINGS-184	66	67	1	1	2	1	0	0
ENMEETINGS-184	66	294	228	1	4	4	1	0
ENMEETINGS-184	67	68	1	1	2	1	0	0
ENMEETINGS-184	67	99	32	1	3	3	1	0
ENMEETINGS-184	70	71	1	1	3	1	1	1
ENMEETINGS-185	72	77	5	1	1	1	1	0
ENMEETINGS-185	72	331	259	1	3	4	1	0
ENMEETINGS-185	74	75	1	1	2	1	1	1
ENMEETINGS-185	74	75	1	1	4	1	1	0
ENMEETINGS-185	76	81	5	1	3	4	1	0
ENMEETINGS-185	79	445	366	1	3	4	1	0
ENMEETINGS-185	79	445	366	1	3	3	1	0
ENMEETINGS-185	79	80	1	1	3	1	2	1
ENMEETINGS-185	80	81	1	1	3	1	0	1
ENMEETINGS-185	81	452	371	1	3	3	1	0
ENMEETINGS-186	88	477	389	0	3	1	1	0
ENMEETINGS-186	88	89	1	1	2	1	0	1
ENMEETINGS-186	90	91	1	1	3	3	1	0
ENMEETINGS-186	93	94	1	1	3	4	1	0
ENMEETINGS-186	95	141	46	1	1	3	1	0
ENMEETINGS-186	95	477	382	0	3	4	0	0
ENMEETINGS-186	95	99	4	1	5	3	1	0
ENMEETINGS-186	100	445	345	1	3	4	1	0
ENMEETINGS-186	101	115	14	1	4	4	1	0
ENMEETINGS-186	101	105	4	1	3	1	0	0
ENMEETINGS-187	102	290	188	1	4	1	1	1
ENMEETINGS-187	103	111	8	1	3	4	1	0
ENMEETINGS-187	104	142	38	1	3	3	1	0
ENMEETINGS-187	105	106	1	1	3	1	0	0
ENMEETINGS-187	106	107	1	1	3	1	0	0
ENMEETINGS-187	106	107	1	1	3	4	0	0
ENMEETINGS-187	107	176	69	1	3	1	1	0
ENMEETINGS-187	113	114	1	1	1	1	1	0
ENMEETINGS-187	114	115	1	1	2	1	1	0
ENMEETINGS-187	115	141	26	1	4	1	0	0
ENMEETINGS-188	117	118	1	1	3	1	1	0
ENMEETINGS-188	122	290	168	1	3	4	0	0
ENMEETINGS-188	124	207	83	1	3	1	1	0
ENMEETINGS-188	126	128	2	1	3	1	0	0
ENMEETINGS-188	129	238	109	1	3	4	1	0
ENMEETINGS-188	129	130	1	1	4	1	1	0
ENMEETINGS-188	130	131	1	1	1	1	1	0
ENMEETINGS-188	130	133	3	1	3	1	0	0
ENMEETINGS-188	140	296	156	1	3	1	1	0
ENMEETINGS-188	143	391	248	1	2	1	1	1
ENMEETINGS-189	143	207	64	1	3	1	1	0
ENMEETINGS-189	144	206	62	1	4	4	1	0
ENMEETINGS-189	149	177	28	1	3	1	0	0
ENMEETINGS-189	149	150	1	1	2	1	0	0
ENMEETINGS-189	150	151	1	1	3	1	0	0
ENMEETINGS-189	150	151	1	1	4	1	1	0
ENMEETINGS-189	154	206	52	1	4	4	1	0
ENMEETINGS-189	157	241	84	1	3	3	1	0
ENMEETINGS-189	164	220	56	1	3	1	1	0
ENMEETINGS-189	166	171	5	1	3	1	0	0
ENMEETINGS-190	170	196	26	1	4	1	1	0
ENMEETINGS-190	188	198	10	1	3	1	0	0
ENMEETINGS-190	192	477	285	0	3	3	0	0
ENMEETINGS-190	195	196	1	1	3	4	1	0
ENMEETINGS-190	197	477	280	0	4	4	0	0
ENMEETINGS-190	197	198	1	1	3	1	1	0
ENMEETINGS-190	197	198	1	1	2	1	1	0
ENMEETINGS-190	203	204	1	1	2	4	1	0
ENMEETINGS-190	206	207	1	1	3	1	1	0
ENMEETINGS-190	206	207	1	1	3	1	1	0
ENMEETINGS-191	206	207	1	1	3	3	0	0
ENMEETINGS-191	207	208	1	1	3	1	1	0
ENMEETINGS-191	207	208	1	1	3	1	1	0
ENMEETINGS-191	207	208	1	1	3	1	0	0
ENMEETINGS-191	210	212	2	1	5	1	1	0
ENMEETINGS-191	212	213	1	1	4	3	0	0
ENMEETINGS-191	212	213	1	1	4	3	0	0
ENMEETINGS-191	212	223	11	1	3	3	0	1
ENMEETINGS-191	218	219	1	1	3	1	0	0
ENMEETINGS-191	219	220	1	1	3	1	1	0
ENMEETINGS-192	221	222	1	1	3	1	1	0
ENMEETINGS-192	226	237	11	1	3	4	1	0
ENMEETINGS-192	232	477	245	0	4	4	0	0
ENMEETINGS-192	235	238	3	1	4	1	1	0
ENMEETINGS-192	242	245	3	1	3	1	1	0
ENMEETINGS-192	242	245	3	1	3	1	1	0
ENMEETINGS-192	242	243	1	1	3	1	0	0
ENMEETINGS-192	247	248	1	1	3	1	1	0
ENMEETINGS-192	250	282	32	1	3	3	1	0
ENMEETINGS-192	250	259	9	1	3	4	1	0
ENMEETINGS-193	252	259	7	1	3	1	1	0
ENMEETINGS-193	260	323	63	1	3	5	1	1
ENMEETINGS-193	260	267	7	1	3	4	1	0
ENMEETINGS-193	261	477	216	0	3	4	0	0
ENMEETINGS-193	261	295	34	1	3	4	1	0
ENMEETINGS-193	261	288	27	1	4	1	0	0
ENMEETINGS-193	262	269	7	1	3	1	0	0
ENMEETINGS-193	263	271	8	1	4	4	1	0
ENMEETINGS-193	265	271	6	1	3	1	1	0
ENMEETINGS-193	270	280	10	1	1	1	0	1
ENMEETINGS-194	273	274	1	1	3	1	0	0
ENMEETINGS-194	273	280	7	1	4	1	0	0
ENMEETINGS-194	273	274	1	1	1	1	0	0
ENMEETINGS-194	273	274	1	1	1	1	1	0
ENMEETINGS-194	274	277	3	1	3	1	1	0
ENMEETINGS-194	277	299	22	1	4	1	1	0
ENMEETINGS-194	277	280	3	1	4	1	1	0
ENMEETINGS-194	278	279	1	1	3	4	1	1
ENMEETINGS-194	278	279	1	1	2	1	0	1
ENMEETINGS-194	279	280	1	1	1	1	1	1
ENMEETINGS-195	280	294	14	1	4	4	1	0
ENMEETINGS-195	280	281	1	1	3	1	0	0
ENMEETINGS-195	281	282	1	1	2	1	1	0
ENMEETINGS-195	281	282	1	1	3	1	1	0
ENMEETINGS-195	282	358	76	1	3	3	1	0
ENMEETINGS-195	283	426	143	1	3	4	1	1
ENMEETINGS-195	283	438	155	1	3	1	0	0
ENMEETINGS-195	286	290	4	1	1	1	1	2
ENMEETINGS-195	287	288	1	1	3	4	0	0
ENMEETINGS-195	288	289	1	1	1	2	0	1
ENMEETINGS-196	290	291	1	1	3	1	0	0
ENMEETINGS-196	300	301	1	1	4	1	0	0
ENMEETINGS-196	302	303	1	1	3	1	1	1
ENMEETINGS-196	317	322	5	1	3	1	1	0
ENMEETINGS-196	318	319	1	1	3	1	1	0
ENMEETINGS-196	320	322	2	1	4	1	0	0
ENMEETINGS-196	323	329	6	1	4	4	1	0
ENMEETINGS-196	338	351	13	1	3	4	1	0
ENMEETINGS-196	338	339	1	1	3	2	0	0
ENMEETINGS-196	340	347	7	1	3	1	0	0
ENMEETINGS-197	342	347	5	1	3	4	1	0
ENMEETINGS-197	342	345	3	1	3	4	1	0
ENMEETINGS-197	343	345	2	1	5	4	1	0
ENMEETINGS-197	359	360	1	1	1	1	0	0
ENMEETINGS-197	360	366	6	1	3	1	1	0
ENNLP-117	0	477	477	0	4	3	0	0
ENNLP-117	0	143	143	1	4	3	0	0
ENNLP-117	1	4	3	1	3	1	1	0
ENNLP-118	7	8	1	1	3	3	1	0
ENNLP-118	9	92	83	1	4	1	0	0
ENNLP-118	10	477	467	0	3	1	0	0
ENNLP-118	26	477	451	0	3	4	0	0
ENNLP-118	28	92	64	1	4	5	0	0
ENNLP-118	39	477	438	0	3	4	0	0
ENNLP-118	46	80	34	1	3	3	0	0
ENNLP-118	56	477	421	0	3	1	0	0
ENNLP-118	67	171	104	1	4	3	1	0
ENNLP-118	75	76	1	1	4	1	1	0
ENNLP-119	84	477	393	0	3	1	0	0
ENNLP-119	84	477	393	0	3	2	0	0
ENNLP-119	92	93	1	1	3	2	1	0
ENNLP-119	101	141	40	1	3	1	1	0
ENNLP-119	109	171	62	1	3	4	1	0
ENNLP-119	133	134	1	1	5	4	0	0
ENNLP-119	134	135	1	1	4	4	0	0
ENNLP-119	135	177	42	1	3	1	1	0
ENNLP-119	140	141	1	1	5	5	0	0
ENNLP-119	140	142	2	1	4	4	0	0
ENNLP-120	141	142	1	1	5	4	1	0
ENNLP-120	154	267	113	1	3	4	0	0
ENNLP-120	162	477	315	0	3	1	0	0
ENNLP-120	171	183	12	1	3	3	0	0
ENNLP-120	172	184	12	1	4	3	0	0
ENNLP-120	178	179	1	1	5	3	0	0
ENNLP-120	181	191	10	1	4	3	1	0
ENNLP-120	186	190	4	1	3	1	0	0
ENNLP-120	186	187	1	1	3	1	0	0
ENNLP-120	200	364	164	1	3	5	1	0
ENNLP-121	210	212	2	1	3	1	1	0
ENNLP-121	222	225	3	1	5	5	1	0
ENNLP-121	222	225	3	1	4	1	1	0
ENNLP-121	225	235	10	1	4	1	1	0
ENNLP-121	225	477	252	0	4	4	1	0
ENNLP-121	240	241	1	1	5	5	1	0
ENNLP-121	240	241	1	1	4	5	1	0
ENNLP-121	240	241	1	1	5	5	1	0
ENNLP-121	241	477	236	0	3	1	0	0
ENNLP-121	261	262	1	1	4	4	1	0
ENNLP-122	267	477	210	0	3	4	0	0
ENNLP-122	268	269	1	1	4	4	0	0
ENNLP-122	274	275	1	1	3	3	1	0
ENNLP-122	279	477	198	0	3	2	0	0
ENNLP-122	308	317	9	1	3	4	1	0
ENNLP-122	337	338	1	1	3	4	1	0
ENNLP-122	340	477	137	0	1	5	0	0
ENNLP-122	350	477	127	0	3	2	0	0
ENNLP-122	357	477	120	0	4	1	0	0
ENNLP-122	357	477	120	0	4	1	0	0
ENNLP-123	360	361	1	1	3	3	1	0
ENNLP-123	360	364	4	1	2	3	1	0
C-28	1	4	3	1	3	1	1	0
C-28	3	477	474	0	4	5	0	0
C-28	4	5	1	1	3	1	1	0
C-28	12	15	3	1	1	1	1	0
C-29	17	18	1	1	3	4	1	0
C-29	17	477	460	0	3	4	0	0
C-29	18	477	459	0	3	4	0	0
C-29	18	57	39	1	1	1	1	0
C-29	23	477	454	0	3	4	0	0
C-29	25	477	452	0	3	1	0	0
C-29	28	33	5	1	3	1	2	0
C-29	30	477	447	0	3	1	0	0
C-29	36	37	1	1	1	3	2	0
C-29	38	477	439	0	3	4	0	0
C-30	42	57	15	1	4	4	1	0
C-30	44	46	2	1	3	1	2	0
C-30	45	477	432	0	3	1	0	0
C-30	46	477	431	0	3	4	0	0
C-30	46	47	1	1	3	5	2	0
C-30	51	114	63	1	3	5	1	0
C-30	56	60	4	1	3	5	2	0
C-30	56	477	421	0	3	5	0	0
C-30	57	60	3	1	3	2	1	1
C-30	58	477	419	0	3	1	0	1
C-31	58	73	15	1	3	1	1	0
C-31	60	74	14	1	3	1	1	1
C-31	61	74	13	1	3	1	1	1
C-31	61	82	21	1	3	1	1	2
C-31	63	74	11	1	3	1	1	1
C-31	64	477	413	0	3	3	0	4
C-31	64	477	413	0	3	1	0	0
C-31	65	81	16	1	3	1	1	2
C-31	65	101	36	1	3	5	1	0
C-31	66	74	8	1	3	1	1	1
C-32	70	93	23	1	3	1	0	0
C-32	70	78	8	1	3	1	1	0
C-32	73	93	20	1	3	1	1	1
C-32	74	120	46	1	4	4	1	1
C-32	74	78	4	1	3	1	2	0
C-32	81	477	396	0	3	1	0	1
C-32	84	85	1	1	3	1	1	0
C-32	84	85	1	1	3	1	1	0
C-32	84	85	1	1	3	1	1	0
C-32	91	93	2	1	4	1	1	0
C-33	94	100	6	1	4	3	2	0
C-33	96	112	16	1	3	2	1	0
C-33	96	100	4	1	5	4	2	0
C-33	96	112	16	1	4	4	1	0
C-33	98	141	43	1	3	4	1	0
C-33	99	137	38	1	4	5	0	0
C-33	100	101	1	1	3	1	2	0
C-33	100	106	6	1	3	4	1	0
C-33	101	102	1	1	3	1	1	0
C-33	101	112	11	1	3	4	1	0
C-34	102	477	375	0	2	1	0	0
C-34	103	126	23	1	3	4	1	4
C-34	103	477	374	0	4	1	0	0
C-34	107	457	350	1	3	2	0	0
C-34	107	112	5	1	3	4	1	0
C-34	107	122	15	1	3	4	1	0
C-34	107	116	9	1	1	1	1	0
C-34	109	477	368	0	3	5	0	0
C-34	109	477	368	0	3	4	0	0
C-34	109	477	368	0	3	5	0	0
C-35	109	477	368	0	3	5	0	0
C-35	110	112	2	1	1	1	1	0
C-35	112	121	9	1	3	4	1	0
C-35	116	120	4	1	3	4	1	0
C-35	119	121	2	1	3	4	1	0
C-35	119	120	1	1	3	4	1	0
C-35	120	121	1	1	3	4	1	0
C-35	121	122	1	1	4	4	1	0
C-35	122	123	1	1	3	4	1	0
C-35	123	477	354	0	1	4	0	0
C-36	126	127	1	1	3	4	2	1
C-36	128	477	349	0	3	1	0	0
C-36	128	140	12	1	3	1	0	0
C-36	130	477	347	0	3	1	0	0
C-36	133	134	1	1	3	4	2	0
C-36	135	174	39	1	4	1	2	1
C-36	135	141	6	1	3	4	1	0
C-36	141	142	1	1	3	1	2	2
C-36	143	477	334	0	3	3	0	0
C-36	149	477	328	0	3	1	0	0
C-37	149	477	328	0	1	1	0	1
C-37	149	178	29	1	3	1	1	0
C-37	151	155	4	1	3	4	2	0
C-37	152	154	2	1	3	1	2	0
C-37	154	477	323	0	3	4	0	2
C-37	155	259	104	1	3	1	2	3
C-37	156	157	1	1	3	4	2	1
C-37	159	477	318	0	3	4	0	0
C-37	165	477	312	0	3	1	0	0
C-37	165	168	3	1	3	1	2	1
C-38	170	171	1	1	2	1	2	0
C-38	122	477	355	0	4	1	0	0
C-38	175	177	2	1	3	1	2	0
C-38	176	177	1	1	3	2	2	0
C-38	177	193	16	1	4	1	2	0
C-38	186	262	76	1	3	4	2	0
C-38	186	193	7	1	3	4	1	1
C-38	196	477	281	0	3	2	0	0
C-38	204	477	273	0	3	1	0	0
C-38	205	206	1	1	3	4	1	1
C-39	205	477	272	0	3	4	0	0
C-39	207	262	55	1	4	1	2	0
C-39	211	217	6	1	3	1	0	0
C-39	214	220	6	1	3	4	1	0
C-39	221	244	23	1	3	2	0	0
C-39	226	457	231	1	3	2	0	0
C-39	228	230	2	1	3	1	1	0
C-39	32	246	214	1	3	2	2	2
C-39	242	477	235	0	3	4	0	0
C-39	242	246	4	1	3	4	1	1
C-40	254	477	223	0	3	2	0	1
C-40	255	256	1	1	5	1	2	0
C-40	255	477	222	0	4	4	0	0
C-40	257	260	3	1	3	1	2	1
C-40	259	477	218	0	3	4	0	1
C-40	260	261	1	1	3	4	1	1
C-40	260	262	2	1	3	1	2	2
C-40	261	273	12	1	3	1	1	0
C-40	268	477	209	0	3	1	0	0
C-40	270	273	3	1	3	1	2	1
C-41	270	273	3	1	3	1	2	0
C-41	272	273	1	1	3	4	2	0
C-41	281	308	27	1	3	1	1	2
C-41	281	301	20	1	3	1	1	0
C-41	281	477	196	0	3	1	0	1
C-41	281	457	176	1	3	1	0	0
C-41	282	283	1	1	3	1	2	2
C-41	282	297	15	1	4	1	2	0
C-41	282	304	22	1	3	4	2	0
C-41	283	290	7	1	2	1	2	2
C-42	291	335	44	1	3	2	0	0
C-42	291	297	6	1	3	5	1	0
C-42	296	458	162	1	3	1	1	2
C-42	301	304	3	1	3	1	1	0
C-42	301	477	176	0	3	1	0	0
C-42	301	477	176	0	5	1	0	0
C-42	302	303	1	1	4	1	1	0
C-42	302	303	1	1	4	1	1	0
C-42	302	303	1	1	4	1	0	0
C-42	303	308	5	1	4	4	1	0
C-43	304	477	173	0	3	4	0	0
C-43	304	308	4	1	4	4	1	0
C-43	305	306	1	1	3	1	2	1
C-43	305	306	1	1	3	1	1	0
C-43	311	477	166	0	3	1	0	0
C-43	312	330	18	1	3	1	2	1
C-43	314	331	17	1	3	1	0	0
C-43	317	324	7	1	3	1	1	1
C-43	324	329	5	1	3	1	1	2
C-43	325	477	152	0	3	1	0	0
C-44	329	330	1	1	3	3	1	1
C-44	330	477	147	0	3	2	0	0
C-44	332	335	3	1	4	4	0	0
C-44	333	337	4	1	4	4	0	0
C-44	334	337	3	1	4	4	0	0
C-44	337	477	140	0	4	4	0	0
C-44	337	477	140	0	3	4	0	0
C-44	352	353	1	1	3	4	2	0
C-44	352	354	2	1	3	4	1	0
C-44	354	477	123	0	3	4	0	0
C-45	355	477	122	0	3	4	0	0
C-45	357	477	120	0	3	1	0	1
C-45	358	432	74	1	3	2	2	0
C-45	359	477	118	0	5	4	0	0
C-45	359	375	16	1	3	4	1	1
B-122	28	29	1	1	3	1	1	0
B-122	29	30	1	1	3	1	1	0
B-122	29	30	1	1	3	1	1	0
B-122	31	32	1	1	3	1	1	0
B-122	36	45	9	1	3	1	1	0
B-122	37	45	8	1	3	1	1	0
B-122	37	38	1	1	3	1	1	0
B-123	40	45	5	1	3	1	1	0
B-123	46	47	1	1	3	1	1	0
B-123	56	102	46	1	3	4	1	0
B-123	58	102	44	1	3	1	1	0
B-123	59	477	418	0	3	1	0	0
B-123	65	102	37	1	3	1	1	0
B-123	80	81	1	1	3	5	3	0
B-123	98	117	19	1	3	5	2	0
B-123	103	104	1	1	3	4	1	0
B-123	103	104	1	1	3	3	1	0
B-124	105	107	2	1	3	3	2	0
B-124	110	111	1	1	3	1	1	0
B-124	110	111	1	1	3	2	1	0
B-124	117	118	1	1	3	4	1	0
B-124	118	119	1	1	5	1	0	0
B-124	141	142	1	1	3	2	1	0
B-124	175	182	7	1	3	1	0	0
B-124	182	183	1	1	3	1	1	0
B-124	192	193	1	1	2	1	1	1
B-124	210	211	1	1	3	4	1	0
B-125	211	212	1	1	5	4	1	0
B-125	225	226	1	1	3	1	1	0
B-125	234	235	1	1	3	4	1	0
B-125	235	236	1	1	3	4	1	0
B-125	235	236	1	1	3	4	1	0
B-125	235	236	1	1	3	4	1	0
B-125	248	435	187	1	3	1	0	0
B-125	259	260	1	1	3	1	1	0
B-125	261	477	216	0	3	1	1	1
B-125	266	435	169	1	4	5	1	0
B-126	267	435	168	1	3	1	0	0
B-126	278	279	1	1	3	4	1	0
B-126	284	296	12	1	4	4	0	0
B-126	288	289	1	1	3	1	1	0
B-126	288	289	1	1	2	1	1	0
B-126	288	289	1	1	3	4	1	0
B-126	289	344	55	1	3	4	2	0
B-126	297	477	180	0	4	5	0	0
B-126	305	306	1	1	3	3	1	0
B-126	309	310	1	1	3	1	1	0
B-127	317	336	19	1	3	4	1	1
B-127	331	332	1	1	4	4	1	0
B-127	331	332	1	1	3	4	1	0
B-127	351	352	1	1	3	1	1	0
B-127	351	352	1	1	3	1	1	0
B-127	351	352	1	1	3	1	1	0
B-127	352	353	1	1	3	1	1	0
RQUET-118	2	3	1	1	4	1	1	0
RQUET-118	3	88	85	1	3	4	1	0
RQUET-118	3	88	85	1	3	4	0	0
RQUET-118	4	9	5	1	3	1	1	0
RQUET-118	6	314	308	1	3	2	1	0
RQUET-118	8	477	469	0	3	1	0	0
RQUET-118	8	109	101	1	3	3	1	4
RQUET-119	9	477	468	0	3	3	0	0
RQUET-119	9	18	9	1	3	1	1	1
RQUET-119	10	477	467	0	3	1	0	0
RQUET-119	11	23	12	1	3	1	1	0
RQUET-119	14	477	463	0	3	1	0	2
RQUET-119	14	147	133	1	3	1	0	1
RQUET-119	16	45	29	1	3	4	1	0
RQUET-119	17	18	1	1	4	4	2	0
RQUET-119	18	29	11	1	3	4	1	0
RQUET-119	18	477	459	0	3	2	1	0
RQUET-120	20	43	23	1	3	4	1	0
RQUET-120	21	290	269	1	3	2	2	4
RQUET-120	28	477	449	0	3	1	0	0
RQUET-120	35	36	1	1	3	1	0	0
RQUET-120	37	322	285	1	3	4	1	1
RQUET-120	38	40	2	1	3	1	1	0
RQUET-120	38	39	1	1	3	1	0	0
RQUET-120	41	42	1	1	3	2	0	2
RQUET-120	42	49	7	1	3	1	1	1
RQUET-120	42	70	28	1	3	1	1	0
RQUET-121	43	44	1	1	3	1	1	0
RQUET-121	43	147	104	1	3	5	0	3
RQUET-121	43	147	104	1	3	5	0	1
RQUET-121	43	147	104	1	3	5	0	1
RQUET-121	43	211	168	1	3	5	0	1
RQUET-121	44	45	1	1	3	4	1	1
RQUET-121	44	477	433	0	4	1	0	0
RQUET-121	45	57	12	1	3	1	2	2
RQUET-121	48	51	3	1	3	4	0	0
RQUET-121	48	50	2	1	3	4	1	0
RQUET-122	48	50	2	1	3	4	1	0
RQUET-122	48	50	2	1	3	3	1	0
RQUET-122	49	477	428	0	2	1	0	4
RQUET-122	49	477	428	0	3	3	0	1
RQUET-122	49	477	428	0	3	3	0	1
RQUET-122	49	54	5	1	3	3	1	0
RQUET-122	49	50	1	1	3	1	1	0
RQUET-122	50	211	161	1	3	5	2	0
RQUET-122	50	477	427	0	3	5	0	0
RQUET-122	50	477	427	0	3	5	0	0
RQUET-123	50	477	427	0	3	5	0	0
RQUET-123	50	431	381	1	1	1	0	0
RQUET-123	50	290	240	1	3	5	1	0
RQUET-123	50	51	1	1	3	1	1	0
RQUET-123	51	107	56	1	3	3	1	2
RQUET-123	51	477	426	0	3	1	0	0
RQUET-123	53	79	26	1	3	1	1	0
RQUET-123	56	477	421	0	3	1	0	0
RQUET-123	57	156	99	1	5	1	0	1
RQUET-124	63	477	414	0	3	1	0	0
RQUET-124	66	477	411	0	3	4	0	1
RQUET-124	67	81	14	1	3	1	1	1
RQUET-124	70	477	407	0	3	4	1	0
RQUET-124	70	149	79	1	4	1	0	1
RQUET-124	6	80	74	1	4	1	1	0
RQUET-124	71	77	6	1	3	1	2	3
RQUET-124	72	477	405	0	3	1	0	0
RQUET-124	72	477	405	0	3	1	0	0
RQUET-124	75	477	402	0	3	4	0	0
RQUET-125	77	477	400	0	4	4	0	0
RQUET-125	78	84	6	1	3	1	1	2
RQUET-125	80	477	397	0	3	1	1	1
RQUET-125	84	143	59	1	3	2	1	4
RQUET-125	84	477	393	0	3	1	0	0
RQUET-125	85	86	1	1	3	1	1	0
RQUET-125	85	228	143	1	5	4	1	0
RQUET-125	86	88	2	1	4	1	2	0
RQUET-125	86	93	7	1	3	2	0	0
RQUET-126	86	137	51	1	3	3	0	0
RQUET-126	87	326	239	1	3	1	0	0
RQUET-126	87	112	25	1	3	4	1	1
RQUET-126	88	89	1	1	3	4	1	0
RQUET-126	88	95	7	1	3	4	1	1
RQUET-126	93	101	8	1	3	1	0	0
RQUET-126	94	268	174	1	4	1	1	0
RQUET-126	95	106	11	1	5	4	1	0
RQUET-126	101	106	5	1	3	1	1	1
RQUET-126	102	112	10	1	3	1	0	0
RQUET-127	102	106	4	1	3	1	1	0
RQUET-127	102	322	220	1	4	5	1	0
RQUET-127	106	107	1	1	3	1	1	0
RQUET-127	32	107	75	1	3	1	1	1
RQUET-127	108	109	1	1	3	1	1	1
RQUET-127	108	231	123	1	3	4	1	0
RQUET-127	109	143	34	1	3	3	1	3
RQUET-127	112	375	263	1	3	1	0	1
RQUET-127	112	113	1	1	4	4	1	0
RQUET-128	113	378	265	1	4	4	1	1
RQUET-128	113	413	300	1	3	4	0	0
RQUET-128	114	115	1	1	3	1	0	0
RQUET-128	114	120	6	1	4	1	1	0
RQUET-128	116	147	31	1	3	4	0	2
RQUET-128	118	126	8	1	4	1	1	1
RQUET-128	120	477	357	0	3	5	0	0
RQUET-128	120	477	357	0	3	2	0	0
RQUET-128	120	178	58	1	3	2	0	0
RQUET-128	120	310	190	1	4	5	0	0
RQUET-129	120	126	6	1	3	4	1	0
RQUET-129	121	315	194	1	3	4	1	0
RQUET-129	122	477	355	0	4	4	0	0
RQUET-129	128	129	1	1	4	1	1	1
RQUET-129	128	143	15	1	3	3	1	0
RQUET-129	128	477	349	0	3	1	0	2
RQUET-129	130	147	17	1	3	1	1	0
RQUET-129	131	132	1	1	4	1	1	1
RQUET-129	133	477	344	0	3	3	0	0
RQUET-129	133	315	182	1	3	4	0	0
RQUET-130	134	477	343	0	3	2	0	1
RQUET-130	134	215	81	1	3	5	1	0
RQUET-130	136	477	341	0	3	1	0	1
RQUET-130	136	477	341	0	4	1	0	0
RQUET-130	137	150	13	1	3	1	1	1
RQUET-130	137	310	173	1	3	1	1	1
RQUET-130	140	315	175	1	3	4	1	0
RQUET-130	141	145	4	1	3	1	1	0
RQUET-130	141	228	87	1	3	3	1	0
RQUET-130	143	155	12	1	3	1	1	3
RQUET-131	147	228	81	1	3	5	0	1
RQUET-131	147	162	15	1	4	1	1	0
RQUET-131	147	175	28	1	3	4	0	0
RQUET-131	148	150	2	1	3	1	1	0
RQUET-131	148	477	329	0	3	1	0	0
RQUET-131	148	150	2	1	3	1	1	0
RQUET-131	150	154	4	1	3	1	0	0
RQUET-131	154	155	1	1	3	1	1	0
RQUET-131	154	155	1	1	3	1	0	1
RQUET-131	155	164	9	1	3	1	1	0
RQUET-132	158	420	262	1	3	4	0	1
RQUET-132	158	162	4	1	3	4	1	0
RQUET-132	160	477	317	0	4	1	0	1
RQUET-132	161	204	43	1	3	4	1	0
RQUET-132	163	231	68	1	3	2	0	1
RQUET-132	165	477	312	0	4	5	0	0
RQUET-132	165	477	312	0	4	5	0	0
RQUET-132	165	477	312	0	4	5	0	0
RQUET-132	165	477	312	0	3	5	0	0
RQUET-133	170	477	307	0	3	1	0	0
RQUET-133	170	287	117	1	4	4	0	1
RQUET-133	172	226	54	1	4	5	1	1
RQUET-133	172	178	6	1	3	1	1	0
RQUET-133	172	178	6	1	3	1	1	0
RQUET-133	172	175	3	1	4	4	1	0
RQUET-133	174	176	2	1	3	4	1	0
RQUET-133	175	477	302	0	3	4	0	0
RQUET-133	175	180	5	1	3	1	0	0
RQUET-133	177	178	1	1	3	1	0	0
RQUET-134	177	178	1	1	3	4	1	0
RQUET-134	178	213	35	1	3	1	1	0
RQUET-134	179	477	298	0	3	5	0	0
RQUET-134	179	477	298	0	4	1	0	0
RQUET-134	179	184	5	1	3	1	1	0
RQUET-134	189	477	288	0	3	1	0	0
RQUET-134	190	192	2	1	3	4	1	1
RQUET-134	192	477	285	0	4	1	0	0
RQUET-134	192	208	16	1	3	4	1	0
RQUET-134	194	195	1	1	3	1	1	0
RQUET-135	197	203	6	1	3	3	1	1
RQUET-135	198	204	6	1	3	1	1	0
RQUET-135	198	477	279	0	3	1	0	0
RQUET-135	203	477	274	0	4	1	0	0
RQUET-135	204	281	77	1	1	1	1	0
RQUET-135	204	477	273	0	3	4	0	0
RQUET-135	205	212	7	1	1	1	0	0
RQUET-135	206	212	6	1	3	1	1	0
RQUET-135	206	207	1	1	3	1	1	0
RQUET-135	206	477	271	0	3	1	0	0
RQUET-136	208	209	1	1	3	4	1	0
RQUET-136	209	477	268	0	3	1	1	0
RQUET-136	210	477	267	0	3	4	0	0
RQUET-136	211	214	3	1	3	5	1	1
RQUET-136	211	322	111	1	3	4	1	1
RQUET-136	212	213	1	1	4	3	1	0
RQUET-136	213	477	264	0	3	1	0	0
RQUET-136	214	274	60	1	3	1	1	0
RQUET-136	186	272	86	1	3	1	1	0
RQUET-137	214	477	263	0	3	4	1	0
RQUET-137	217	248	31	1	3	1	1	0
RQUET-137	218	236	18	1	3	3	1	0
RQUET-137	219	477	258	0	3	2	0	1
RQUET-137	220	409	189	1	4	1	1	1
RQUET-137	221	477	256	0	3	1	0	0
RQUET-137	221	477	256	0	3	2	0	1
RQUET-137	221	477	256	0	4	5	0	0
RQUET-137	224	226	2	1	3	4	1	0
RQUET-137	226	229	3	1	3	5	0	0
RQUET-138	226	315	89	1	4	5	1	0
RQUET-138	226	477	251	0	3	2	0	0
RQUET-138	227	228	1	1	3	3	1	1
RQUET-138	227	289	62	1	4	4	1	0
RQUET-138	227	228	1	1	3	1	1	0
RQUET-138	228	477	249	0	3	1	1	0
RQUET-138	228	234	6	1	3	5	0	0
RQUET-138	228	239	11	1	3	4	1	0
RQUET-138	228	276	48	1	3	2	1	1
RQUET-138	228	253	25	1	4	5	0	0
RQUET-139	229	230	1	1	4	4	1	1
RQUET-139	230	477	247	0	2	5	0	0
RQUET-139	230	234	4	1	3	2	1	1
RQUET-139	231	315	84	1	3	1	1	0
RQUET-139	231	315	84	1	3	1	1	0
RQUET-139	231	477	246	0	3	2	1	3
RQUET-139	231	477	246	0	3	5	1	3
RQUET-139	232	260	28	1	4	5	1	0
RQUET-139	233	266	33	1	3	4	1	1
RQUET-140	233	266	33	1	3	4	1	1
RQUET-140	233	260	27	1	3	5	1	0
RQUET-140	233	477	244	0	3	1	0	0
RQUET-140	234	477	243	0	3	1	0	0
RQUET-140	238	477	239	0	3	2	0	0
RQUET-140	239	477	238	0	3	1	1	0
RQUET-140	240	314	74	1	2	5	1	0
RQUET-140	240	322	82	1	2	1	1	0
RQUET-140	241	477	236	0	4	1	1	0
RQUET-140	242	477	235	0	3	1	0	1
RQUET-141	242	263	21	1	3	4	1	2
RQUET-141	242	477	235	0	3	4	0	2
RQUET-141	246	477	231	0	3	4	1	0
RQUET-141	246	477	231	0	3	4	1	0
RQUET-141	249	310	61	1	3	4	1	1
RQUET-141	249	477	228	0	4	4	0	2
RQUET-141	252	477	225	0	3	4	1	0
RQUET-141	256	262	6	1	3	1	1	0
RQUET-141	262	263	1	1	3	4	1	0
RQUET-141	262	477	215	0	3	5	1	0
RQUET-142	262	477	215	0	3	1	0	0
RQUET-142	262	263	1	1	3	1	1	0
RQUET-142	263	477	214	0	3	4	1	0
RQUET-142	267	274	7	1	3	3	0	0
RQUET-142	268	477	209	0	3	1	0	0
RQUET-142	268	280	12	1	3	1	1	0
RQUET-142	268	269	1	1	3	4	1	0
RQUET-142	269	274	5	1	3	3	0	0
RQUET-142	269	270	1	1	3	3	1	0
RQUET-143	269	477	208	0	3	4	1	0
RQUET-143	269	271	2	1	3	4	1	0
RQUET-143	273	477	204	0	3	2	0	0
RQUET-143	273	287	14	1	3	3	1	0
RQUET-143	275	477	202	0	3	3	1	4
RQUET-143	275	315	40	1	3	4	1	2
RQUET-143	275	287	12	1	3	3	1	0
RQUET-143	280	310	30	1	3	1	1	0
RQUET-143	281	412	131	1	3	1	1	0
RQUET-143	281	313	32	1	3	4	1	0
RQUET-144	281	282	1	1	3	1	1	0
RQUET-144	282	477	195	0	3	1	0	1
RQUET-144	289	402	113	1	4	4	0	1
RQUET-144	289	402	113	1	4	4	0	1
RQUET-144	289	477	188	0	4	4	0	2
RQUET-144	289	477	188	0	4	4	0	0
RQUET-144	290	477	187	0	4	4	0	0
RQUET-144	290	371	81	1	4	4	0	0
RQUET-144	290	477	187	0	4	4	0	0
RQUET-144	296	297	1	1	4	4	1	0
RQUET-145	297	382	85	1	3	5	0	0
RQUET-145	301	302	1	1	3	1	0	0
RQUET-145	301	310	9	1	3	3	1	0
RQUET-145	302	477	175	0	5	5	0	0
RQUET-145	303	402	99	1	4	1	0	0
RQUET-145	308	477	169	0	3	1	0	0
RQUET-145	312	322	10	1	1	1	1	0
RQUET-145	315	477	162	0	3	2	0	1
RQUET-145	317	318	1	1	5	1	1	0
RQUET-146	324	325	1	1	3	1	1	0
RQUET-146	325	373	48	1	3	1	1	0
RQUET-146	326	337	11	1	3	4	2	0
RQUET-146	328	331	3	1	3	4	1	0
RQUET-146	329	477	148	0	3	1	0	0
RQUET-146	332	333	1	1	3	2	2	1
RQUET-146	332	378	46	1	4	4	1	0
RQUET-146	335	336	1	1	3	4	1	0
RQUET-146	336	477	141	0	3	4	1	0
RQUET-146	336	337	1	1	3	1	1	0
RQUET-147	337	401	64	1	3	1	1	0
RQUET-147	339	340	1	1	3	1	1	0
RQUET-147	343	346	3	1	3	1	1	0
RQUET-147	343	346	3	1	5	4	1	0
RQUET-147	344	346	2	1	3	4	1	0
RQUET-147	345	378	33	1	3	1	1	0
RQUET-147	346	409	63	1	4	4	1	0
RQUET-147	347	448	101	1	3	5	1	0
RQUET-147	347	371	24	1	3	1	1	0
RQUET-147	348	477	129	0	3	2	0	0
RQUET-148	354	402	48	1	5	1	1	0
RQUET-148	354	357	3	1	3	1	1	0
RQUET-148	354	429	75	1	3	1	1	0
RQUET-148	356	477	121	0	4	1	0	0
RQUET-148	360	364	4	1	3	4	1	0
RQUET-152	339	477	138	0	4	4	0	0
FBOX-404	3	68	65	1	3	1	0	1
FBOX-405	3	4	1	1	4	3	2	0
FBOX-405	4	5	1	1	4	1	0	1
FBOX-405	4	23	19	1	3	1	1	0
FBOX-405	4	5	1	1	3	1	1	0
FBOX-405	4	367	363	1	2	4	0	0
FBOX-405	6	57	51	1	4	3	3	0
FBOX-405	7	13	6	1	3	1	0	0
FBOX-405	7	120	113	1	4	4	2	0
FBOX-405	7	9	2	1	3	1	2	1
FBOX-405	8	9	1	1	3	1	0	0
FBOX-406	8	16	8	1	3	1	2	0
FBOX-406	9	10	1	1	3	1	2	2
FBOX-406	10	11	1	1	1	1	0	0
FBOX-406	10	13	3	1	3	1	0	0
FBOX-406	11	12	1	1	3	1	3	3
FBOX-406	15	16	1	1	4	3	1	0
FBOX-406	15	32	17	1	3	1	2	0
FBOX-406	15	16	1	1	4	5	1	0
FBOX-406	15	477	462	0	3	3	0	0
FBOX-406	16	477	461	0	3	1	0	0
FBOX-407	16	17	1	1	3	5	1	0
FBOX-407	16	477	461	0	3	3	0	1
FBOX-407	16	17	1	1	3	5	1	0
FBOX-407	17	477	460	0	4	2	0	0
FBOX-407	18	28	10	1	4	5	1	0
FBOX-407	19	20	1	1	3	5	1	0
FBOX-407	19	477	458	0	3	1	0	0
FBOX-407	22	477	455	0	3	1	0	0
FBOX-407	23	54	31	1	3	1	0	0
FBOX-407	23	24	1	1	3	5	1	0
FBOX-408	24	477	453	0	3	4	0	0
FBOX-408	24	25	1	1	3	1	0	1
FBOX-408	25	26	1	1	3	1	0	0
FBOX-408	25	26	1	1	4	1	3	0
FBOX-408	26	69	43	1	3	1	2	0
FBOX-408	28	29	1	1	3	1	2	0
FBOX-408	28	477	449	0	3	1	0	1
FBOX-408	29	30	1	1	3	1	0	0
FBOX-408	29	30	1	1	3	1	3	0
FBOX-408	29	33	4	1	3	5	1	0
FBOX-409	30	31	1	1	3	1	0	0
FBOX-409	31	34	3	1	2	1	2	0
FBOX-409	31	32	1	1	3	5	1	0
FBOX-409	32	37	5	1	3	1	2	0
FBOX-409	32	46	14	1	4	5	2	0
FBOX-409	32	143	111	1	3	4	2	0
FBOX-409	33	34	1	1	4	5	1	0
FBOX-409	36	94	58	1	3	1	2	1
FBOX-409	36	56	20	1	3	3	1	0
FBOX-409	36	37	1	1	4	4	1	0
FBOX-410	36	477	441	0	3	1	0	0
FBOX-410	36	477	441	0	3	1	0	0
FBOX-410	39	93	54	1	3	1	0	0
FBOX-410	39	41	2	1	3	1	2	0
FBOX-410	42	43	1	1	4	1	0	0
FBOX-410	42	50	8	1	4	1	2	0
FBOX-410	42	130	88	1	3	2	2	2
FBOX-410	42	45	3	1	2	1	2	0
FBOX-410	43	44	1	1	4	1	2	0
FBOX-410	43	57	14	1	3	1	0	1
FBOX-411	44	45	1	1	1	1	0	0
FBOX-411	46	165	119	1	3	3	1	2
FBOX-411	47	48	1	1	4	1	2	0
FBOX-411	47	49	2	1	3	1	2	1
FBOX-411	48	49	1	1	3	1	2	0
FBOX-411	49	51	2	1	4	5	0	0
FBOX-411	49	54	5	1	3	2	2	0
FBOX-411	50	128	78	1	3	5	1	0
FBOX-411	51	52	1	1	3	4	2	0
FBOX-412	51	316	265	1	3	4	0	0
FBOX-412	52	55	3	1	3	4	2	0
FBOX-412	52	65	13	1	3	5	1	0
FBOX-412	53	55	2	1	3	1	0	1
FBOX-412	53	63	10	1	3	5	0	0
FBOX-412	53	63	10	1	3	1	2	0
FBOX-412	54	55	1	1	4	4	0	0
FBOX-412	56	57	1	1	3	1	0	1
FBOX-412	56	57	1	1	4	1	0	0
FBOX-412	56	57	1	1	3	1	2	0
FBOX-413	57	62	5	1	3	4	0	3
FBOX-413	57	107	50	1	3	1	2	0
FBOX-413	57	477	420	0	3	1	0	0
FBOX-413	57	58	1	1	3	1	0	0
FBOX-413	57	96	39	1	3	5	1	0
FBOX-413	57	58	1	1	3	3	2	0
FBOX-413	58	59	1	1	3	1	0	1
FBOX-413	59	66	7	1	4	4	2	1
FBOX-413	60	477	417	0	4	1	0	0
FBOX-413	62	63	1	1	4	4	2	0
FBOX-414	63	64	1	1	3	1	2	0
FBOX-414	63	73	10	1	4	4	0	0
FBOX-414	63	105	42	1	3	4	4	0
FBOX-414	64	65	1	1	4	3	2	0
FBOX-414	65	67	2	1	3	1	0	2
FBOX-414	65	477	412	0	4	4	0	0
FBOX-414	65	70	5	1	4	1	2	0
FBOX-414	66	477	411	0	3	1	0	0
FBOX-414	66	67	1	1	3	1	0	0
FBOX-414	69	401	332	1	3	1	2	0
FBOX-415	70	71	1	1	3	4	2	0
FBOX-415	71	82	11	1	3	1	2	1
FBOX-415	71	477	406	0	3	1	0	0
FBOX-415	71	73	2	1	3	1	2	0
FBOX-415	74	75	1	1	1	4	0	0
FBOX-415	76	477	401	0	4	1	0	2
FBOX-415	76	82	6	1	4	4	2	0
FBOX-415	76	91	15	1	4	1	2	2
FBOX-415	77	98	21	1	4	1	2	0
FBOX-415	77	79	2	1	3	4	2	0
FBOX-416	78	79	1	1	3	1	0	1
FBOX-416	78	82	4	1	4	4	2	0
FBOX-416	78	79	1	1	2	1	2	0
FBOX-416	79	292	213	1	3	1	2	0
FBOX-416	81	82	1	1	3	1	2	0
FBOX-416	82	84	2	1	4	4	2	0
FBOX-416	83	84	1	1	3	1	0	0
FBOX-416	84	85	1	1	3	1	2	0
FBOX-416	84	85	1	1	5	4	2	0
FBOX-416	86	87	1	1	4	1	2	1
FBOX-417	86	87	1	1	4	3	2	1
FBOX-417	86	87	1	1	4	4	2	0
FBOX-417	87	96	9	1	3	1	2	0
FBOX-417	87	88	1	1	3	3	1	1
FBOX-417	88	91	3	1	3	1	0	1
FBOX-417	89	90	1	1	3	4	2	0
FBOX-417	91	92	1	1	3	1	2	1
FBOX-417	91	92	1	1	3	1	0	0
FBOX-417	91	92	1	1	3	1	0	0
FBOX-417	92	93	1	1	4	1	2	0
FBOX-418	92	93	1	1	5	1	2	0
FBOX-418	92	93	1	1	3	1	2	0
FBOX-418	94	477	383	0	3	4	0	1
FBOX-418	95	477	382	0	3	2	0	0
FBOX-418	96	330	234	1	4	4	2	0
FBOX-418	96	103	7	1	3	1	2	0
FBOX-418	96	97	1	1	3	4	2	0
FBOX-418	99	100	1	1	4	4	2	0
FBOX-418	100	477	377	0	3	4	0	1
FBOX-418	103	477	374	0	3	2	0	1
FBOX-419	105	477	372	0	3	4	0	0
FBOX-419	105	477	372	0	3	1	0	0
FBOX-419	106	107	1	1	4	4	2	0
FBOX-419	106	401	295	1	3	1	2	0
FBOX-419	106	117	11	1	3	1	0	1
FBOX-419	107	112	5	1	4	1	2	0
FBOX-419	107	401	294	1	3	5	0	0
FBOX-419	107	108	1	1	3	1	3	0
FBOX-419	107	108	1	1	4	4	2	0
FBOX-419	108	109	1	1	3	1	0	0
FBOX-420	108	112	4	1	3	1	2	0
FBOX-420	108	137	29	1	3	1	0	0
FBOX-420	109	367	258	1	2	1	0	0
FBOX-420	109	117	8	1	3	1	0	0
FBOX-420	109	136	27	1	3	1	2	1
FBOX-420	109	477	368	0	4	1	0	0
FBOX-420	112	113	1	1	3	1	0	0
FBOX-420	117	118	1	1	3	1	2	1
FBOX-420	123	124	1	1	2	4	0	0
FBOX-420	126	127	1	1	3	1	0	1
FBOX-421	127	477	350	0	3	1	0	0
FBOX-421	127	128	1	1	3	1	1	0
FBOX-421	128	477	349	0	3	4	0	0
FBOX-421	128	477	349	0	3	1	0	0
FBOX-421	128	179	51	1	4	1	0	0
FBOX-421	128	129	1	1	4	5	0	0
FBOX-421	128	477	349	0	3	1	0	1
FBOX-421	129	477	348	0	4	1	0	0
FBOX-421	129	130	1	1	4	1	2	0
FBOX-421	130	237	107	1	3	1	2	0
FBOX-422	130	477	347	0	3	1	0	3
FBOX-422	134	135	1	1	3	1	0	3
FBOX-422	135	136	1	1	3	1	2	0
FBOX-422	135	136	1	1	3	1	2	1
FBOX-422	137	138	1	1	4	3	2	0
FBOX-422	139	400	261	1	3	1	0	1
FBOX-422	139	140	1	1	3	1	0	1
FBOX-422	141	145	4	1	3	1	2	0
FBOX-422	142	143	1	1	2	1	2	0
FBOX-422	143	477	334	0	3	4	0	0
FBOX-423	143	144	1	1	3	1	2	0
FBOX-423	143	415	272	1	3	4	2	0
FBOX-423	147	400	253	1	3	1	0	0
FBOX-423	148	403	255	1	3	1	2	0
FBOX-423	149	193	44	1	3	1	0	0
FBOX-423	150	151	1	1	3	1	2	0
FBOX-423	154	477	323	0	4	1	0	0
FBOX-423	154	155	1	1	3	4	1	0
FBOX-423	155	162	7	1	3	1	0	0
FBOX-423	155	400	245	1	3	5	0	1
FBOX-424	156	477	321	0	3	4	0	0
FBOX-424	156	265	109	1	3	1	2	1
FBOX-424	157	185	28	1	4	1	2	0
FBOX-424	158	161	3	1	3	1	0	0
FBOX-424	162	164	2	1	3	1	0	0
FBOX-424	163	222	59	1	3	1	2	0
FBOX-424	168	169	1	1	3	1	0	0
FBOX-424	169	171	2	1	3	1	0	0
FBOX-424	170	171	1	1	3	1	2	1
FBOX-424	172	175	3	1	3	1	0	1
FBOX-425	174	175	1	1	3	1	0	0
FBOX-425	175	179	4	1	3	4	3	0
FBOX-425	176	477	301	0	3	1	0	0
FBOX-425	176	177	1	1	3	4	2	1
FBOX-425	176	178	2	1	3	1	2	0
FBOX-425	179	294	115	1	4	1	0	0
FBOX-425	179	190	11	1	3	4	2	0
FBOX-425	182	408	226	1	3	1	0	1
FBOX-425	183	184	1	1	3	1	0	3
FBOX-425	183	184	1	1	3	4	2	0
FBOX-426	185	191	6	1	4	4	2	0
FBOX-426	185	191	6	1	3	1	1	1
FBOX-426	189	190	1	1	1	1	0	0
FBOX-426	189	190	1	1	4	4	2	1
FBOX-426	190	205	15	1	1	1	0	0
FBOX-426	193	194	1	1	2	1	0	0
FBOX-426	193	194	1	1	3	1	1	0
FBOX-426	197	229	32	1	3	1	2	0
FBOX-426	199	200	1	1	3	1	2	0
FBOX-426	200	201	1	1	4	2	0	0
FBOX-427	201	477	276	0	3	1	0	1
FBOX-427	202	204	2	1	2	4	2	0
FBOX-427	202	265	63	1	4	4	0	0
FBOX-427	202	203	1	1	4	4	0	0
FBOX-427	202	203	1	1	4	4	3	0
FBOX-427	203	213	10	1	3	1	0	0
FBOX-427	204	205	1	1	3	1	3	0
FBOX-427	205	208	3	1	3	1	0	0
FBOX-427	205	206	1	1	3	1	2	0
FBOX-427	206	207	1	1	3	1	2	0
FBOX-428	207	215	8	1	3	1	0	0
FBOX-428	208	209	1	1	3	3	2	0
FBOX-428	211	217	6	1	2	1	0	0
FBOX-428	212	215	3	1	4	1	3	0
FBOX-428	213	214	1	1	3	1	0	0
FBOX-428	213	218	5	1	3	4	2	0
FBOX-428	214	215	1	1	3	1	0	0
FBOX-428	214	215	1	1	3	1	0	0
FBOX-428	218	219	1	1	4	1	2	0
FBOX-428	219	220	1	1	4	4	2	0
FBOX-429	224	230	6	1	3	1	1	0
FBOX-429	225	226	1	1	5	1	2	0
FBOX-429	231	233	2	1	3	1	2	0
FBOX-429	231	241	10	1	1	1	0	0
FBOX-429	231	477	246	0	3	1	0	0
FBOX-429	231	232	1	1	3	4	2	1
FBOX-429	232	240	8	1	5	4	0	0
FBOX-429	233	477	244	0	3	4	0	0
FBOX-429	233	252	19	1	3	1	3	0
FBOX-429	238	239	1	1	3	1	2	0
FBOX-430	238	477	239	0	4	4	0	0
FBOX-430	238	239	1	1	4	1	2	0
FBOX-430	239	241	2	1	4	1	2	0
FBOX-430	240	339	99	1	3	1	2	3
FBOX-430	240	477	237	0	3	1	0	2
FBOX-430	241	242	1	1	3	1	2	0
FBOX-430	242	261	19	1	3	1	2	1
FBOX-430	242	243	1	1	4	1	2	0
FBOX-430	245	246	1	1	3	1	2	0
FBOX-430	246	477	231	0	4	4	0	0
FBOX-431	246	263	17	1	4	5	0	0
FBOX-431	246	247	1	1	3	1	0	0
FBOX-431	248	304	56	1	3	1	1	1
FBOX-431	248	477	229	0	3	1	0	0
FBOX-431	248	249	1	1	3	1	0	0
FBOX-431	249	250	1	1	3	1	2	0
FBOX-431	252	253	1	1	3	1	3	0
FBOX-431	255	269	14	1	3	1	0	0
FBOX-431	258	259	1	1	3	1	2	1
FBOX-431	262	263	1	1	3	1	2	0
FBOX-432	263	273	10	1	3	1	0	1
FBOX-432	265	477	212	0	3	1	1	1
FBOX-432	266	270	4	1	3	1	2	1
FBOX-432	267	268	1	1	3	1	0	0
FBOX-432	268	269	1	1	3	1	0	0
FBOX-432	269	477	208	0	3	1	0	0
FBOX-432	271	277	6	1	3	1	2	2
FBOX-432	272	277	5	1	3	1	2	0
FBOX-432	272	273	1	1	3	1	0	1
FBOX-432	274	275	1	1	4	1	0	0
FBOX-433	275	276	1	1	3	1	3	0
FBOX-433	275	276	1	1	3	1	2	0
FBOX-433	278	281	3	1	3	1	1	1
FBOX-433	279	280	1	1	4	1	2	0
FBOX-433	280	307	27	1	4	1	0	2
FBOX-433	280	281	1	1	3	4	2	0
FBOX-433	281	282	1	1	4	1	2	0
FBOX-433	282	283	1	1	3	5	0	0
FBOX-433	283	284	1	1	4	1	2	0
FBOX-433	283	284	1	1	4	1	2	0
FBOX-434	283	477	194	0	4	3	1	0
FBOX-434	286	477	191	0	4	4	0	0
FBOX-434	288	289	1	1	3	5	0	0
FBOX-434	288	291	3	1	3	1	2	0
FBOX-434	288	477	189	0	3	4	0	0
FBOX-434	289	292	3	1	3	1	2	1
FBOX-434	289	302	13	1	3	1	0	0
FBOX-434	289	293	4	1	4	1	2	0
FBOX-434	289	290	1	1	4	1	2	0
FBOX-434	289	293	4	1	4	1	2	0
FBOX-435	289	292	3	1	4	1	2	1
FBOX-435	289	293	4	1	4	1	2	0
FBOX-435	289	290	1	1	4	1	2	0
FBOX-435	289	293	4	1	4	1	2	0
FBOX-435	289	294	5	1	4	1	2	0
FBOX-435	290	291	1	1	4	1	2	0
FBOX-435	291	292	1	1	4	1	0	0
FBOX-435	292	293	1	1	3	1	2	1
FBOX-435	295	296	1	1	4	3	2	1
FBOX-435	296	297	1	1	3	1	2	0
FBOX-436	297	298	1	1	4	1	3	0
FBOX-436	297	298	1	1	4	1	2	0
FBOX-436	297	298	1	1	4	3	2	0
FBOX-436	300	307	7	1	4	4	2	0
FBOX-436	301	302	1	1	3	1	1	0
FBOX-436	302	303	1	1	3	1	1	0
FBOX-436	305	306	1	1	3	1	2	0
FBOX-436	305	311	6	1	4	1	2	0
FBOX-436	307	308	1	1	4	5	0	0
FBOX-436	308	327	19	1	4	1	1	0
FBOX-437	310	477	167	0	5	3	0	0
FBOX-437	311	312	1	1	3	4	2	2
FBOX-437	311	312	1	1	3	1	3	1
FBOX-437	312	316	4	1	4	5	2	0
FBOX-437	312	313	1	1	4	1	2	0
FBOX-437	312	315	3	1	4	4	2	0
FBOX-437	315	318	3	1	3	4	0	0
FBOX-437	316	317	1	1	4	1	2	0
FBOX-437	317	318	1	1	3	1	0	0
FBOX-437	318	320	2	1	3	1	0	0
FBOX-438	319	320	1	1	3	1	0	1
FBOX-438	319	320	1	1	3	1	2	0
FBOX-438	323	331	8	1	3	4	0	0
FBOX-438	324	325	1	1	3	1	2	1
FBOX-438	325	331	6	1	3	1	2	1
FBOX-438	326	341	15	1	3	1	0	2
FBOX-438	329	330	1	1	3	1	0	1
FBOX-438	329	330	1	1	3	1	0	1
FBOX-438	330	400	70	1	5	3	2	0
FBOX-438	332	333	1	1	3	1	0	0
FBOX-439	332	333	1	1	3	1	1	2
FBOX-439	336	337	1	1	3	1	1	0
FBOX-439	336	342	6	1	3	1	2	1
FBOX-439	337	345	8	1	3	1	2	2
FBOX-439	337	338	1	1	4	4	2	0
FBOX-439	337	338	1	1	3	1	2	0
FBOX-439	337	339	2	1	3	1	0	3
FBOX-439	338	339	1	1	4	4	2	0
FBOX-439	339	477	138	0	4	1	1	3
FBOX-439	339	380	41	1	3	1	2	1
FBOX-440	340	345	5	1	3	1	2	0
FBOX-440	340	341	1	1	4	3	2	0
FBOX-440	343	477	134	0	3	1	0	0
FBOX-440	345	346	1	1	3	5	0	0
FBOX-440	346	347	1	1	3	1	1	0
FBOX-440	348	477	129	0	3	3	0	0
FBOX-440	349	350	1	1	3	1	2	0
FBOX-440	350	354	4	1	3	1	2	1
FBOX-440	350	352	2	1	3	1	2	0
FBOX-440	351	352	1	1	2	1	0	0
FBOX-441	351	400	49	1	2	1	0	0
FBOX-441	351	401	50	1	3	4	2	0
FBOX-441	353	354	1	1	3	1	0	0
FBOX-441	354	367	13	1	3	4	2	1
FBOX-441	360	477	117	0	3	3	1	0
FBOX-441	360	361	1	1	3	1	2	0
FBOX-441	361	363	2	1	3	1	2	0
FBOX-441	361	363	2	1	3	1	2	0
OENIX-450	1	7	6	1	3	1	3	0
OENIX-450	1	2	1	1	5	1	2	0
OENIX-451	1	2	1	1	3	1	2	1
OENIX-451	1	2	1	1	5	1	2	0
OENIX-451	1	2	1	1	1	1	1	1
OENIX-451	2	477	475	0	3	1	1	0
OENIX-451	2	10	8	1	4	1	3	0
OENIX-451	3	477	474	0	1	1	1	0
OENIX-451	3	477	474	0	5	1	1	0
OENIX-451	3	29	26	1	3	3	1	0
OENIX-451	3	108	105	1	3	3	0	0
OENIX-451	4	274	270	1	3	1	3	0
OENIX-452	4	477	473	0	3	1	0	0
OENIX-452	5	477	472	0	3	4	0	0
OENIX-452	5	10	5	1	2	1	3	0
OENIX-452	7	11	4	1	3	1	3	0
OENIX-452	7	477	470	0	1	1	0	0
OENIX-452	9	11	2	1	3	1	0	0
OENIX-452	10	477	467	0	3	1	0	0
OENIX-452	10	11	1	1	3	5	1	0
OENIX-452	10	16	6	1	3	1	2	0
OENIX-452	10	477	467	0	3	1	0	1
OENIX-453	16	95	79	1	3	4	2	0
OENIX-453	16	50	34	1	3	1	2	0
OENIX-453	16	477	461	0	3	1	0	0
OENIX-453	17	43	26	1	4	4	2	0
OENIX-453	17	140	123	1	2	1	1	0
OENIX-453	17	477	460	0	3	1	0	0
OENIX-453	17	18	1	1	3	1	1	0
OENIX-453	17	98	81	1	2	1	2	0
OENIX-453	17	18	1	1	3	1	0	0
OENIX-453	18	137	119	1	3	1	1	1
OENIX-454	18	477	459	0	3	1	0	1
OENIX-454	18	19	1	1	1	1	2	0
OENIX-454	18	19	1	1	3	3	2	1
OENIX-454	18	477	459	0	3	1	0	0
OENIX-454	18	157	139	1	3	1	2	0
OENIX-454	20	477	457	0	3	1	0	0
OENIX-454	20	38	18	1	3	1	2	0
OENIX-454	21	22	1	1	3	3	1	0
OENIX-454	21	23	2	1	3	1	2	0
OENIX-454	21	42	21	1	3	4	1	0
OENIX-455	22	477	455	0	3	4	0	0
OENIX-455	22	23	1	1	3	1	2	0
OENIX-455	22	477	455	0	4	2	0	1
OENIX-455	23	68	45	1	4	1	0	0
OENIX-455	24	30	6	1	3	3	1	0
OENIX-455	24	477	453	0	3	5	0	0
OENIX-455	24	31	7	1	3	3	1	0
OENIX-455	24	477	453	0	3	4	0	0
OENIX-455	24	477	453	0	3	4	0	0
OENIX-455	24	477	453	0	3	4	0	0
OENIX-456	24	27	3	1	3	1	1	0
OENIX-456	25	172	147	1	3	3	1	2
OENIX-456	25	26	1	1	3	1	1	1
OENIX-456	27	477	450	0	3	5	0	0
OENIX-456	28	477	449	0	3	1	0	0
OENIX-456	28	477	449	0	2	1	0	1
OENIX-456	29	477	448	0	3	4	0	0
OENIX-456	29	150	121	1	3	3	1	2
OENIX-456	29	477	448	0	4	1	0	1
OENIX-456	29	477	448	0	4	4	0	0
OENIX-457	29	32	3	1	1	1	1	0
OENIX-457	29	36	7	1	2	1	2	0
OENIX-457	29	32	3	1	3	1	1	0
OENIX-457	30	32	2	1	3	3	1	1
OENIX-457	30	32	2	1	3	3	1	1
OENIX-457	30	102	72	1	3	2	2	1
OENIX-457	31	79	48	1	3	1	1	0
OENIX-457	31	32	1	1	2	1	2	0
OENIX-457	32	247	215	1	3	1	0	0
OENIX-457	32	102	70	1	3	2	2	2
OENIX-458	32	144	112	1	1	3	1	2
OENIX-458	33	477	444	0	3	1	0	0
OENIX-458	35	36	1	1	3	1	1	0
OENIX-458	35	36	1	1	3	1	0	1
OENIX-458	36	477	441	0	3	1	0	0
OENIX-458	36	46	10	1	3	4	1	0
OENIX-458	36	38	2	1	2	1	1	0
OENIX-458	36	191	155	1	3	4	0	1
OENIX-458	37	39	2	1	3	1	2	2
OENIX-458	38	129	91	1	3	4	0	0
OENIX-459	38	122	84	1	4	1	1	0
OENIX-459	38	42	4	1	3	1	2	0
OENIX-459	39	46	7	1	3	1	1	0
OENIX-459	39	477	438	0	3	4	0	0
OENIX-459	39	477	438	0	3	4	0	0
OENIX-459	40	333	293	1	3	4	0	1
OENIX-459	41	477	436	0	3	1	0	0
OENIX-459	42	215	173	1	3	4	0	0
OENIX-459	42	477	435	0	4	5	0	0
OENIX-459	42	477	435	0	3	4	0	0
OENIX-460	42	109	67	1	1	1	2	0
OENIX-460	42	109	67	1	3	1	2	0
OENIX-460	43	44	1	1	3	4	1	1
OENIX-460	43	44	1	1	3	1	2	0
OENIX-460	43	477	434	0	3	1	0	0
OENIX-460	43	102	59	1	3	1	2	0
OENIX-460	44	477	433	0	4	1	0	0
OENIX-460	44	60	16	1	3	2	2	0
OENIX-460	45	46	1	1	3	1	1	1
OENIX-460	45	202	157	1	1	1	0	1
OENIX-461	45	368	323	1	3	3	1	0
OENIX-461	45	477	432	0	3	1	0	0
OENIX-461	45	477	432	0	3	1	0	0
OENIX-461	45	109	64	1	3	1	2	0
OENIX-461	46	477	431	0	4	4	0	0
OENIX-461	46	477	431	0	4	1	0	0
OENIX-461	46	93	47	1	3	4	2	1
OENIX-461	46	93	47	1	3	1	2	1
OENIX-461	47	441	394	1	3	4	2	1
OENIX-461	49	81	32	1	3	1	2	0
OENIX-462	50	73	23	1	3	5	1	0
OENIX-462	51	52	1	1	3	1	0	0
OENIX-462	51	477	426	0	2	1	0	0
OENIX-462	51	128	77	1	3	1	2	0
OENIX-462	52	63	11	1	3	1	1	0
OENIX-462	52	53	1	1	3	1	2	0
OENIX-462	53	57	4	1	3	1	2	0
OENIX-462	53	477	424	0	3	1	0	0
OENIX-462	56	57	1	1	3	1	2	0
OENIX-462	57	70	13	1	3	1	1	0
OENIX-463	58	60	2	1	2	1	1	1
OENIX-463	58	64	6	1	3	1	0	1
OENIX-463	58	477	419	0	3	1	0	0
OENIX-463	58	64	6	1	3	1	2	0
OENIX-463	59	71	12	1	3	1	1	1
OENIX-463	59	60	1	1	3	1	2	0
OENIX-463	59	79	20	1	3	1	2	2
OENIX-463	63	477	414	0	3	4	1	0
OENIX-463	63	65	2	1	3	1	0	0
OENIX-463	63	477	414	0	3	1	0	0
OENIX-464	63	68	5	1	3	1	2	0
OENIX-464	64	477	413	0	3	1	0	0
OENIX-464	64	477	413	0	3	1	0	0
OENIX-464	64	81	17	1	4	2	2	1
OENIX-464	64	122	58	1	3	1	2	1
OENIX-464	66	113	47	1	3	1	1	0
OENIX-464	66	128	62	1	3	1	2	0
OENIX-464	67	219	152	1	3	1	2	0
OENIX-464	67	477	410	0	3	2	0	0
OENIX-464	68	477	409	0	3	1	1	0
OENIX-465	70	71	1	1	3	4	2	0
OENIX-465	71	477	406	0	2	2	0	1
OENIX-465	71	477	406	0	3	5	0	0
OENIX-465	72	100	28	1	3	1	2	0
OENIX-465	72	477	405	0	3	3	0	0
OENIX-465	73	80	7	1	3	1	2	0
OENIX-465	73	119	46	1	3	5	0	0
OENIX-465	73	477	404	0	3	2	0	0
OENIX-465	75	100	25	1	3	1	2	1
OENIX-465	75	81	6	1	3	1	2	0
OENIX-466	75	81	6	1	3	1	2	0
OENIX-466	77	80	3	1	3	1	2	1
OENIX-466	78	81	3	1	3	1	2	1
OENIX-466	79	477	398	0	3	4	0	0
OENIX-466	79	477	398	0	3	1	0	1
OENIX-466	79	108	29	1	3	3	2	1
OENIX-466	79	253	174	1	3	4	2	1
OENIX-466	79	232	153	1	4	1	1	1
OENIX-466	80	102	22	1	3	4	2	0
OENIX-466	80	99	19	1	3	1	1	0
OENIX-467	81	82	1	1	3	4	0	0
OENIX-467	82	122	40	1	4	1	2	0
OENIX-467	84	99	15	1	5	3	2	0
OENIX-467	85	477	392	0	4	1	0	0
OENIX-467	85	119	34	1	3	1	0	0
OENIX-467	85	86	1	1	3	1	2	1
OENIX-467	86	477	391	0	3	1	0	0
OENIX-467	86	87	1	1	1	1	2	0
OENIX-467	86	128	42	1	2	1	2	0
OENIX-467	87	477	390	0	4	4	0	0
OENIX-468	87	96	9	1	3	5	1	0
OENIX-468	87	477	390	0	4	1	0	0
OENIX-468	89	98	9	1	3	1	2	0
OENIX-468	91	98	7	1	3	1	2	0
OENIX-468	91	477	386	0	3	1	0	1
OENIX-468	98	168	70	1	1	1	2	0
OENIX-468	99	120	21	1	3	1	2	0
OENIX-468	99	100	1	1	2	1	0	1
OENIX-468	100	277	177	1	4	4	2	0
OENIX-468	102	477	375	0	3	1	0	0
OENIX-469	103	117	14	1	2	1	2	0
OENIX-469	103	106	3	1	3	1	2	0
OENIX-469	107	143	36	1	3	1	2	0
OENIX-469	107	108	1	1	1	1	1	1
OENIX-469	107	115	8	1	3	1	2	0
OENIX-469	107	108	1	1	4	4	0	0
OENIX-469	108	109	1	1	3	1	0	0
OENIX-469	108	121	13	1	3	1	2	0
OENIX-469	108	115	7	1	3	1	2	0
OENIX-470	109	115	6	1	3	1	2	0
OENIX-470	109	133	24	1	3	4	2	0
OENIX-470	112	477	365	0	3	4	0	0
OENIX-470	113	477	364	0	3	1	0	0
OENIX-470	114	151	37	1	3	4	2	1
OENIX-470	115	116	1	1	3	1	2	0
OENIX-470	115	140	25	1	3	1	1	0
OENIX-470	115	116	1	1	3	1	2	0
OENIX-470	115	116	1	1	3	1	2	0
OENIX-470	115	116	1	1	3	1	2	0
OENIX-471	115	116	1	1	3	1	2	0
OENIX-471	115	116	1	1	3	1	2	0
OENIX-471	116	121	5	1	3	1	2	0
OENIX-471	116	477	361	0	3	1	0	1
OENIX-471	116	117	1	1	4	5	1	0
OENIX-471	116	477	361	0	3	1	0	0
OENIX-471	116	117	1	1	3	5	2	0
OENIX-471	119	477	358	0	3	3	0	0
OENIX-471	119	120	1	1	3	1	2	0
OENIX-471	120	121	1	1	3	1	2	0
OENIX-472	120	121	1	1	3	1	2	0
OENIX-472	120	121	1	1	3	1	2	0
OENIX-472	120	477	357	0	3	4	0	0
OENIX-472	120	143	23	1	3	1	1	0
OENIX-472	123	151	28	1	3	5	2	1
OENIX-472	123	477	354	0	3	1	0	0
OENIX-472	124	133	9	1	4	4	2	0
OENIX-472	127	128	1	1	3	5	2	0
OENIX-472	127	144	17	1	3	1	2	0
OENIX-472	127	128	1	1	3	4	0	0
OENIX-473	127	128	1	1	3	4	1	0
OENIX-473	127	277	150	1	3	4	1	0
OENIX-473	127	128	1	1	3	4	2	0
OENIX-473	128	129	1	1	3	1	2	0
OENIX-473	129	130	1	1	3	1	2	0
OENIX-473	129	477	348	0	3	4	0	0
OENIX-473	129	477	348	0	3	4	0	0
OENIX-473	132	134	2	1	3	4	2	0
OENIX-473	133	477	344	0	3	1	0	0
OENIX-473	136	140	4	1	3	1	1	0
OENIX-474	136	477	341	0	3	1	0	0
OENIX-474	136	477	341	0	3	1	0	0
OENIX-474	136	138	2	1	3	1	2	0
OENIX-474	137	477	340	0	3	1	0	0
OENIX-474	137	138	1	1	3	5	1	0
OENIX-474	137	144	7	1	3	5	1	0
OENIX-474	137	477	340	0	3	4	0	2
OENIX-474	140	477	337	0	3	1	0	0
OENIX-474	141	477	336	0	3	1	0	0
OENIX-474	142	144	2	1	3	4	2	0
OENIX-475	142	227	85	1	3	4	2	0
OENIX-475	142	214	72	1	3	4	2	0
OENIX-475	142	477	335	0	3	4	0	0
OENIX-475	143	477	334	0	3	1	0	0
OENIX-475	145	477	332	0	4	1	0	0
OENIX-475	145	232	87	1	3	4	2	0
OENIX-475	147	150	3	1	2	1	1	0
OENIX-475	147	477	330	0	3	4	1	0
OENIX-475	148	154	6	1	4	4	2	0
OENIX-475	149	150	1	1	1	1	2	0
OENIX-476	150	477	327	0	3	1	0	0
OENIX-476	150	151	1	1	3	1	0	0
OENIX-476	150	151	1	1	3	1	2	0
OENIX-476	151	343	192	1	3	5	0	1
OENIX-476	151	323	172	1	1	5	2	0
OENIX-476	151	330	179	1	1	5	2	1
OENIX-476	151	323	172	1	3	5	0	1
OENIX-476	151	275	124	1	3	5	0	1
OENIX-476	151	477	326	0	3	1	1	0
OENIX-476	151	152	1	1	5	1	2	0
OENIX-477	151	152	1	1	3	1	1	0
OENIX-477	154	155	1	1	3	1	0	1
OENIX-477	154	157	3	1	3	1	2	0
OENIX-477	155	156	1	1	3	1	2	0
OENIX-477	155	156	1	1	3	4	1	0
OENIX-477	159	161	2	1	3	4	0	1
OENIX-477	159	161	2	1	3	4	2	0
OENIX-477	159	161	2	1	3	4	1	0
OENIX-477	161	162	1	1	3	1	1	0
OENIX-477	161	477	316	0	3	2	0	0
OENIX-478	162	163	1	1	4	1	0	0
OENIX-478	164	337	173	1	3	4	2	1
OENIX-478	164	477	313	0	4	1	0	0
OENIX-478	164	220	56	1	3	5	0	0
OENIX-478	164	331	167	1	1	3	0	0
OENIX-478	164	171	7	1	1	1	2	1
OENIX-478	165	166	1	1	3	1	2	0
OENIX-478	167	172	5	1	3	4	1	0
OENIX-478	167	172	5	1	3	1	1	0
OENIX-478	168	169	1	1	3	1	2	0
OENIX-479	169	193	24	1	4	1	2	0
OENIX-479	170	248	78	1	3	1	2	1
OENIX-479	172	477	305	0	3	1	0	0
OENIX-479	172	477	305	0	3	1	1	0
OENIX-479	175	477	302	0	2	1	1	0
OENIX-479	176	177	1	1	1	1	1	0
OENIX-479	176	477	301	0	3	1	0	0
OENIX-479	177	205	28	1	3	1	2	0
OENIX-479	179	239	60	1	3	5	2	0
OENIX-479	179	217	38	1	3	5	2	1
OENIX-480	179	477	298	0	3	1	0	1
OENIX-480	179	180	1	1	3	1	0	1
OENIX-480	183	477	294	0	3	1	0	0
OENIX-480	183	477	294	0	3	1	0	0
OENIX-480	185	477	292	0	2	1	1	0
OENIX-480	186	219	33	1	3	4	1	0
OENIX-480	189	477	288	0	3	1	0	1
OENIX-480	190	191	1	1	3	3	0	0
OENIX-480	191	477	286	0	3	4	0	0
OENIX-480	191	192	1	1	3	1	2	0
OENIX-481	191	330	139	1	3	5	0	0
OENIX-481	192	193	1	1	3	1	0	0
OENIX-481	192	193	1	1	2	1	0	0
OENIX-481	193	477	284	0	3	3	0	0
OENIX-481	193	204	11	1	3	1	0	1
OENIX-481	196	477	281	0	3	4	0	1
OENIX-481	197	198	1	1	1	1	1	0
OENIX-481	198	205	7	1	4	1	2	1
OENIX-481	202	203	1	1	4	1	2	0
OENIX-481	203	204	1	1	4	4	0	1
OENIX-482	204	369	165	1	3	4	1	2
OENIX-482	204	205	1	1	3	3	0	1
OENIX-482	205	219	14	1	3	1	2	1
OENIX-482	206	368	162	1	3	1	1	0
OENIX-482	208	213	5	1	3	1	0	0
OENIX-482	210	277	67	1	1	3	1	1
OENIX-482	210	268	58	1	3	3	1	0
OENIX-482	210	273	63	1	3	5	0	0
OENIX-482	210	477	267	0	3	3	0	0
OENIX-482	211	212	1	1	5	4	2	0
OENIX-483	212	477	265	0	3	1	2	0
OENIX-483	212	477	265	0	3	4	0	1
OENIX-483	212	341	129	1	4	4	2	0
OENIX-483	213	477	264	0	3	1	0	0
OENIX-483	217	218	1	1	3	4	2	0
OENIX-483	217	231	14	1	3	4	2	0
OENIX-483	218	219	1	1	3	1	0	0
OENIX-483	218	477	259	0	4	4	0	0
OENIX-483	218	477	259	0	4	3	0	0
OENIX-483	219	256	37	1	1	1	1	1
OENIX-484	219	477	258	0	4	1	0	0
OENIX-484	219	318	99	1	3	1	2	3
OENIX-484	220	221	1	1	5	3	0	0
OENIX-484	221	224	3	1	3	1	2	0
OENIX-484	221	477	256	0	4	4	1	0
OENIX-484	221	477	256	0	3	2	0	0
OENIX-484	222	477	255	0	3	1	2	1
OENIX-484	224	477	253	0	2	1	0	0
OENIX-484	225	228	3	1	3	1	1	0
OENIX-484	225	268	43	1	2	1	2	4
OENIX-485	226	477	251	0	3	4	1	0
OENIX-485	226	270	44	1	3	4	1	0
OENIX-485	227	477	250	0	3	1	0	1
OENIX-485	228	231	3	1	3	4	2	0
OENIX-485	228	231	3	1	3	4	2	0
OENIX-485	228	289	61	1	3	5	2	2
OENIX-485	231	477	246	0	3	4	0	0
OENIX-485	231	477	246	0	3	4	0	1
OENIX-485	231	253	22	1	3	4	2	0
OENIX-485	232	281	49	1	3	1	2	0
OENIX-486	232	477	245	0	3	1	0	0
OENIX-486	232	477	245	0	3	5	0	0
OENIX-486	233	234	1	1	3	5	0	0
OENIX-486	234	477	243	0	3	5	0	0
OENIX-486	234	236	2	1	4	1	0	0
OENIX-486	235	477	242	0	3	1	0	0
OENIX-486	235	477	242	0	1	1	1	0
OENIX-486	235	477	242	0	4	1	0	0
OENIX-486	235	477	242	0	4	5	0	0
OENIX-486	236	477	241	0	3	1	0	0
OENIX-487	238	249	11	1	3	1	2	0
OENIX-487	239	477	238	0	3	1	0	0
OENIX-487	239	302	63	1	2	1	2	0
OENIX-487	239	240	1	1	3	3	0	1
OENIX-487	239	295	56	1	1	3	2	1
OENIX-487	239	273	34	1	3	5	2	0
OENIX-487	239	477	238	0	4	1	0	0
OENIX-487	239	477	238	0	4	4	0	0
OENIX-487	240	477	237	0	3	4	0	0
OENIX-487	240	242	2	1	3	5	0	1
OENIX-488	241	255	14	1	3	1	1	1
OENIX-488	241	477	236	0	3	2	0	0
OENIX-488	242	248	6	1	3	4	2	1
OENIX-488	242	477	235	0	2	1	0	0
OENIX-488	242	253	11	1	3	1	2	0
OENIX-488	242	266	24	1	3	1	3	2
OENIX-488	245	477	232	0	1	1	0	0
OENIX-488	245	477	232	0	2	1	0	0
OENIX-488	246	309	63	1	3	5	0	0
OENIX-488	246	477	231	0	3	1	0	0
OENIX-489	246	274	28	1	3	5	1	0
OENIX-489	248	302	54	1	4	1	2	1
OENIX-489	248	260	12	1	4	1	2	0
OENIX-489	249	477	228	0	3	5	0	1
OENIX-489	249	250	1	1	1	1	0	0
OENIX-489	253	254	1	1	3	1	1	1
OENIX-489	253	477	224	0	1	1	0	0
OENIX-489	253	254	1	1	3	2	0	0
OENIX-489	253	477	224	0	3	1	0	0
OENIX-489	253	477	224	0	2	1	0	0
OENIX-490	253	441	188	1	3	4	3	0
OENIX-490	254	477	223	0	3	2	0	0
OENIX-490	255	477	222	0	4	1	0	0
OENIX-490	255	260	5	1	3	4	2	0
OENIX-490	255	477	222	0	3	1	0	0
OENIX-490	256	477	221	0	3	4	0	0
OENIX-490	259	477	218	0	2	1	0	0
OENIX-490	259	260	1	1	3	4	3	0
OENIX-490	260	262	2	1	3	1	2	0
OENIX-490	260	303	43	1	5	1	2	0
OENIX-491	261	477	216	0	3	1	2	0
OENIX-491	262	477	215	0	3	1	0	0
OENIX-491	262	477	215	0	3	4	0	0
OENIX-491	262	477	215	0	3	1	0	0
OENIX-491	262	477	215	0	3	1	0	0
OENIX-491	263	367	104	1	3	1	0	0
OENIX-491	263	477	214	0	3	1	0	0
OENIX-491	264	276	12	1	1	1	1	2
OENIX-491	265	477	212	0	5	1	0	0
OENIX-491	266	477	211	0	3	1	0	0
OENIX-492	266	267	1	1	3	5	1	0
OENIX-492	266	270	4	1	3	1	0	1
OENIX-492	267	477	210	0	3	1	0	0
OENIX-492	267	477	210	0	3	5	0	0
OENIX-492	267	477	210	0	3	4	0	0
OENIX-492	267	477	210	0	3	4	0	1
OENIX-492	267	477	210	0	3	4	0	0
OENIX-492	267	477	210	0	3	4	0	1
OENIX-492	268	304	36	1	3	1	0	0
OENIX-492	268	429	161	1	3	1	1	0
OENIX-493	268	270	2	1	3	5	2	1
OENIX-493	269	430	161	1	4	4	0	0
OENIX-493	269	477	208	0	3	4	0	1
OENIX-493	270	273	3	1	3	1	3	0
OENIX-493	271	272	1	1	3	5	2	0
OENIX-493	271	274	3	1	3	1	3	0
OENIX-493	271	407	136	1	1	1	0	0
OENIX-493	271	274	3	1	3	5	0	0
OENIX-493	273	477	204	0	3	4	0	0
OENIX-493	273	277	4	1	4	4	0	0
OENIX-494	273	406	133	1	3	4	2	0
OENIX-494	273	274	1	1	3	1	2	0
OENIX-494	274	288	14	1	3	5	0	0
OENIX-494	274	276	2	1	3	5	0	0
OENIX-494	274	330	56	1	3	5	0	1
OENIX-494	275	277	2	1	3	1	2	0
OENIX-494	275	477	202	0	3	4	0	0
OENIX-494	275	477	202	0	3	5	0	1
OENIX-494	275	276	1	1	4	1	2	1
OENIX-495	275	477	202	0	3	4	0	0
OENIX-495	276	343	67	1	3	4	0	1
OENIX-495	276	477	201	0	3	1	0	0
OENIX-495	277	477	200	0	3	1	0	0
OENIX-495	277	477	200	0	3	1	0	0
OENIX-495	277	319	42	1	4	1	2	0
OENIX-495	277	477	200	0	4	3	0	4
OENIX-495	277	280	3	1	3	1	1	0
OENIX-495	278	477	199	0	3	1	0	0
OENIX-495	279	477	198	0	4	4	0	0
OENIX-496	280	294	14	1	2	1	1	0
OENIX-496	281	330	49	1	3	5	0	0
OENIX-496	282	477	195	0	3	1	0	1
OENIX-496	282	288	6	1	2	1	1	0
OENIX-496	282	284	2	1	4	4	3	1
OENIX-496	283	284	1	1	4	4	0	0
OENIX-496	283	284	1	1	3	4	2	0
OENIX-496	284	285	1	1	3	4	3	0
OENIX-496	284	477	193	0	3	3	1	0
OENIX-496	284	477	193	0	4	4	0	0
OENIX-497	286	477	191	0	3	1	0	0
OENIX-497	286	329	43	1	3	1	2	0
OENIX-497	287	477	190	0	4	4	0	1
OENIX-497	287	477	190	0	4	4	0	0
OENIX-497	288	477	189	0	1	4	0	0
OENIX-497	288	289	1	1	3	5	1	0
OENIX-497	288	294	6	1	3	1	0	2
OENIX-497	288	297	9	1	3	1	1	0
OENIX-497	288	477	189	0	3	1	0	0
OENIX-497	289	290	1	1	4	1	1	0
OENIX-498	289	294	5	1	2	1	1	2
OENIX-498	289	309	20	1	3	5	2	0
OENIX-498	290	295	5	1	3	1	0	0
OENIX-498	290	350	60	1	3	2	2	1
OENIX-498	291	292	1	1	3	1	0	1
OENIX-498	291	477	186	0	3	1	0	0
OENIX-498	291	292	1	1	3	5	1	0
OENIX-498	291	292	1	1	3	5	1	0
OENIX-498	292	294	2	1	2	1	1	1
OENIX-498	295	305	10	1	3	1	1	0
OENIX-499	295	301	6	1	3	1	0	0
OENIX-499	296	477	181	0	4	1	0	0
OENIX-499	296	477	181	0	3	1	0	0
OENIX-499	297	396	99	1	3	1	2	0
OENIX-499	297	477	180	0	3	4	1	0
OENIX-499	298	477	179	0	4	1	0	0
OENIX-499	298	309	11	1	3	4	2	1
OENIX-499	298	305	7	1	3	1	2	1
OENIX-499	300	477	177	0	3	1	0	0
OENIX-499	302	477	175	0	3	1	0	0
OENIX-500	302	322	20	1	3	1	2	0
OENIX-500	303	477	174	0	3	1	0	0
OENIX-500	303	308	5	1	3	4	0	0
OENIX-500	305	477	172	0	3	1	0	0
OENIX-500	309	350	41	1	3	5	1	0
OENIX-500	310	320	10	1	3	1	1	0
OENIX-500	310	477	167	0	4	1	0	0
OENIX-500	311	477	166	0	3	1	0	1
OENIX-500	312	322	10	1	3	1	2	0
OENIX-500	312	477	165	0	3	1	0	0
OENIX-501	312	316	4	1	3	1	2	0
OENIX-501	313	477	164	0	3	1	0	0
OENIX-501	313	314	1	1	3	5	1	0
OENIX-501	313	319	6	1	3	5	2	0
OENIX-501	315	477	162	0	3	1	0	0
OENIX-501	316	380	64	1	3	4	0	1
OENIX-501	316	318	2	1	3	4	0	1
OENIX-501	316	317	1	1	3	1	2	0
OENIX-501	317	415	98	1	3	1	2	1
OENIX-501	317	417	100	1	3	1	0	1
OENIX-502	317	477	160	0	1	4	2	0
OENIX-502	318	319	1	1	3	1	2	0
OENIX-502	318	368	50	1	1	1	1	1
OENIX-502	318	477	159	0	4	4	0	0
OENIX-502	318	319	1	1	4	5	2	0
OENIX-502	319	354	35	1	3	2	1	0
OENIX-502	319	325	6	1	3	4	2	3
OENIX-502	319	477	158	0	3	1	0	0
OENIX-502	320	321	1	1	3	5	1	0
OENIX-502	320	321	1	1	3	5	1	0
OENIX-503	321	477	156	0	3	1	0	0
OENIX-503	322	329	7	1	3	1	0	0
OENIX-503	323	477	154	0	3	3	0	0
OENIX-503	323	477	154	0	4	1	0	0
OENIX-503	324	477	153	0	4	4	0	0
OENIX-503	324	477	153	0	2	1	0	0
OENIX-503	324	331	7	1	4	4	2	0
OENIX-503	324	331	7	1	4	4	2	0
OENIX-503	324	331	7	1	4	4	2	0
OENIX-503	324	477	153	0	4	4	0	0
OENIX-504	324	477	153	0	4	4	0	0
OENIX-504	325	477	152	0	3	1	0	0
OENIX-504	326	477	151	0	4	4	0	0
OENIX-504	329	477	148	0	3	1	1	0
OENIX-504	330	477	147	0	3	3	0	1
OENIX-504	330	477	147	0	3	3	0	0
OENIX-504	330	331	1	1	3	1	0	0
OENIX-504	331	332	1	1	3	1	0	0
OENIX-504	331	350	19	1	3	4	2	0
OENIX-504	331	477	146	0	3	1	1	0
OENIX-505	333	334	1	1	3	1	0	0
OENIX-505	333	338	5	1	3	1	2	0
OENIX-505	333	477	144	0	4	3	0	0
OENIX-505	333	477	144	0	3	1	0	1
OENIX-505	333	477	144	0	3	2	0	1
OENIX-505	336	369	33	1	2	1	1	0
OENIX-505	336	337	1	1	1	1	1	1
OENIX-505	336	477	141	0	1	1	1	2
OENIX-505	337	477	140	0	3	1	0	4
OENIX-505	337	372	35	1	3	2	1	0
OENIX-506	337	477	140	0	3	1	0	0
OENIX-506	337	340	3	1	3	1	0	0
OENIX-506	338	441	103	1	3	2	2	1
OENIX-506	338	429	91	1	3	2	2	1
OENIX-506	338	477	139	0	4	1	0	0
OENIX-506	340	477	137	0	3	1	0	0
OENIX-506	343	477	134	0	2	1	2	2
OENIX-506	345	477	132	0	4	4	0	0
OENIX-506	346	414	68	1	4	1	0	1
OENIX-506	346	409	63	1	3	4	2	1
OENIX-507	347	352	5	1	1	1	1	1
OENIX-507	350	477	127	0	3	4	0	0
OENIX-507	351	477	126	0	3	1	0	0
OENIX-507	352	374	22	1	3	1	3	0
OENIX-507	353	354	1	1	3	5	2	0
OENIX-507	353	477	124	0	3	2	0	0
OENIX-507	354	477	123	0	3	1	0	0
OENIX-507	354	477	123	0	3	1	0	0
OENIX-507	354	477	123	0	3	1	0	0
OENIX-507	355	381	26	1	4	1	0	1
OENIX-508	355	400	45	1	1	1	2	1
OENIX-508	357	477	120	0	4	1	1	0
OENIX-508	359	477	118	0	3	3	0	4
OENIX-508	360	477	117	0	3	1	0	0
OENIX-508	360	366	6	1	1	1	2	1
G-532	2	8	6	1	3	1	1	0
G-532	2	477	475	0	3	1	0	0
G-532	5	8	3	1	3	1	1	0
G-532	16	26	10	1	3	1	1	0
G-532	18	24	6	1	5	1	1	0
G-533	30	477	447	0	3	1	0	0
G-533	53	81	28	1	3	1	0	0
G-533	73	477	404	0	3	5	0	0
G-533	94	95	1	1	3	1	1	0
G-533	98	100	2	1	4	4	1	0
G-533	99	134	35	1	3	1	1	0
G-533	100	162	62	1	5	4	1	0
G-533	100	477	377	0	5	4	0	0
G-533	101	477	376	0	3	4	0	0
G-533	106	477	371	0	3	1	0	0
G-534	153	245	92	1	3	1	0	0
G-534	154	155	1	1	2	1	1	0
G-534	163	275	112	1	3	5	1	0
G-534	170	249	79	1	3	4	1	1
G-534	179	182	3	1	3	4	1	0
G-534	185	477	292	0	3	4	0	0
G-534	186	187	1	1	5	3	0	0
G-534	186	187	1	1	3	1	0	0
G-534	190	477	287	0	3	1	0	0
G-534	192	193	1	1	5	4	1	0
G-535	206	226	20	1	3	1	0	1
G-535	207	208	1	1	4	5	0	0
G-535	210	477	267	0	3	2	0	0
G-535	220	226	6	1	3	1	0	1
G-535	221	277	56	1	5	4	1	0
G-535	240	269	29	1	3	1	1	1
G-535	241	477	236	0	4	5	0	0
G-535	252	280	28	1	4	4	1	0
G-535	256	260	4	1	4	4	1	1
G-535	259	281	22	1	3	4	1	0
G-536	269	477	208	0	4	1	1	0
G-536	273	477	204	0	3	2	0	1
G-536	276	477	201	0	4	1	1	0
G-536	276	477	201	0	3	4	0	1
G-536	284	477	193	0	3	2	0	0
G-536	292	298	6	1	3	1	1	0
G-536	295	477	182	0	1	1	0	0
G-536	310	323	13	1	3	1	1	0
G-536	311	477	166	0	3	1	0	0
G-537	324	333	9	1	3	1	1	1
G-537	326	477	151	0	3	1	0	0
G-537	345	389	44	1	3	1	1	0
G-537	353	367	14	1	3	1	1	1
O-14	9	477	468	0	3	5	0	0
O-14	18	59	41	1	3	4	1	0
O-14	42	43	1	1	3	1	1	0
O-14	42	59	17	1	3	3	1	0
O-14	51	72	21	1	3	1	0	0
O-15	57	59	2	1	3	4	1	0
O-15	59	60	1	1	4	4	1	0
O-15	62	70	8	1	3	1	1	0
O-15	70	269	199	1	4	1	1	0
O-15	70	477	407	0	3	2	0	0
O-15	71	116	45	1	4	1	2	0
O-15	72	248	176	1	3	1	2	0
O-15	204	259	55	1	3	1	1	1
O-15	228	248	20	1	3	3	1	0
O-15	238	239	1	1	3	4	1	1
O-16	238	252	14	1	3	1	1	0
O-16	241	247	6	1	3	2	1	0
O-16	248	253	5	1	3	4	1	1
O-16	253	255	2	1	3	4	1	0
O-16	254	259	5	1	3	1	1	0
O-16	259	260	1	1	4	4	1	0
O-16	262	477	215	0	4	1	0	0
O-16	263	269	6	1	4	4	1	0
O-16	263	415	152	1	3	2	1	1
O-16	264	477	213	0	3	1	0	0
O-17	264	270	6	1	3	3	1	0
O-17	264	268	4	1	2	3	1	0
O-17	266	415	149	1	3	2	1	1
O-17	267	477	210	0	4	1	0	0
O-17	267	477	210	0	4	4	0	0
O-17	267	415	148	1	3	3	1	0
O-17	268	276	8	1	4	4	1	0
O-17	269	477	208	0	4	4	0	0
O-17	269	477	208	0	4	3	0	0
O-17	274	276	2	1	4	4	1	0
O-18	282	283	1	1	5	4	1	0
O-18	283	477	194	0	3	3	0	0
O-18	284	301	17	1	3	4	1	0
O-18	287	305	18	1	3	2	1	0
O-18	288	292	4	1	5	1	1	0
O-18	288	298	10	1	4	1	2	0
O-18	289	416	127	1	3	4	0	0
O-18	290	434	144	1	4	4	1	0
O-18	294	298	4	1	3	4	1	0
O-18	296	298	2	1	3	5	1	0
O-19	298	477	179	0	3	3	0	0
O-19	299	306	7	1	2	1	1	0
O-19	305	343	38	1	3	4	1	0
O-19	309	477	168	0	3	4	0	0
O-19	315	342	27	1	3	4	1	0
O-19	318	415	97	1	3	4	1	0
O-19	330	346	16	1	4	4	1	0
O-19	331	477	146	0	4	1	0	0
O-19	333	477	144	0	3	4	0	0
O-19	346	415	69	1	3	4	1	0
O-20	353	477	124	0	4	4	0	0
VOT-102	1	37	36	1	4	4	1	0
VOT-102	4	23	19	1	4	1	0	0
VOT-102	10	11	1	1	4	4	1	0
VOT-102	10	477	467	0	4	4	1	0
VOT-102	17	32	15	1	4	1	1	1
VOT-102	17	32	15	1	4	1	1	1
VOT-102	17	477	460	0	3	1	1	0
VOT-102	32	435	403	1	4	4	0	0
VOT-102	38	39	1	1	4	1	1	0
VOT-102	45	477	432	0	4	5	0	0
VOT-103	46	47	1	1	4	4	0	0
VOT-103	50	58	8	1	4	2	0	0
VOT-103	59	477	418	0	4	4	0	0
VOT-103	112	477	365	0	4	4	0	0
VOT-103	157	253	96	1	4	4	1	0
VOT-103	168	224	56	1	4	4	0	0
VOT-103	168	213	45	1	4	4	0	1
VOT-103	170	171	1	1	4	1	1	0
VOT-103	171	172	1	1	4	4	0	1
VOT-103	213	253	40	1	4	4	1	1
VOT-104	224	253	29	1	5	4	1	0
VOT-104	234	477	243	0	4	4	0	0
VOT-104	290	477	187	0	3	1	1	0
VOT-104	291	477	186	0	3	1	1	1
VOT-104	308	477	169	0	4	4	1	0
C4X-2	3	24	21	1	3	1	1	0
C4X-2	3	4	1	1	3	1	1	0
C4X-2	4	5	1	1	3	4	1	0
C4X-2	4	64	60	1	3	3	1	0
C4X-2	12	32	20	1	3	4	1	0
C4X-2	12	32	20	1	4	4	1	0
C4X-2	12	32	20	1	2	4	1	0
C4X-2	12	32	20	1	3	4	1	0
C4X-2	25	46	21	1	3	2	1	0
C4X-2	37	149	112	1	3	4	1	0
C4X-3	37	477	440	0	3	4	0	0
C4X-3	42	64	22	1	3	5	1	0
C4X-3	57	58	1	1	3	3	1	0
C4X-3	57	477	420	0	3	4	0	0
C4X-3	72	73	1	1	3	3	1	0
C4X-3	175	477	302	0	3	2	0	0
C4X-3	176	477	301	0	3	2	0	0
C4X-3	178	477	299	0	3	4	0	0
C4X-3	179	477	298	0	3	2	0	0
C4X-3	183	184	1	1	3	4	1	0
C4X-4	186	191	5	1	3	3	1	0
C4X-4	189	477	288	0	3	4	0	0
C4X-4	212	333	121	1	4	1	0	0
C4X-4	222	297	75	1	3	4	0	0
C4X-4	241	477	236	0	3	4	0	0
C4X-4	241	477	236	0	3	4	0	0
C4X-4	249	250	1	1	5	4	1	0
C4X-4	253	256	3	1	3	1	1	0
C4X-4	253	256	3	1	3	1	1	0
C4X-4	256	477	221	0	3	4	0	0
C4X-5	256	435	179	1	3	2	1	0
C4X-5	260	477	217	0	3	2	0	0
C4X-5	260	297	37	1	3	1	0	0
C4X-5	262	477	215	0	3	2	0	0
C4X-5	266	268	2	1	3	1	0	0
C4X-5	266	273	7	1	3	1	0	0
C4X-5	267	268	1	1	3	1	1	0
C4X-5	267	269	2	1	3	1	1	0
C4X-5	267	333	66	1	3	1	0	0
C4X-5	267	333	66	1	3	1	0	0
C4X-6	268	269	1	1	3	3	1	0
C4X-6	273	297	24	1	3	1	1	0
C4X-6	278	279	1	1	3	1	1	0
C4X-6	278	477	199	0	3	4	0	0
C4X-6	278	477	199	0	2	4	0	0
C4X-6	280	477	197	0	3	5	0	0
C4X-6	281	477	196	0	4	1	0	0
C4X-6	297	428	131	1	3	1	0	0
C4X-6	297	421	124	1	3	3	0	0
C4X-6	297	477	180	0	2	1	0	0
C4X-7	297	327	30	1	3	2	1	0
C4X-7	311	415	104	1	5	1	1	0
C4X-7	329	477	148	0	3	4	0	0
C4X-7	329	477	148	0	3	4	0	0
C4X-7	329	477	148	0	3	4	0	0
C4X-7	329	333	4	1	4	1	0	0
C4X-7	331	333	2	1	3	1	0	0
C4X-7	333	334	1	1	3	1	0	0
C4X-7	339	477	138	0	3	1	0	0
UTO-67	2	3	1	1	3	1	1	0
UTO-67	2	3	1	1	3	1	1	0
UTO-67	3	4	1	1	3	1	1	0
UTO-67	4	5	1	1	3	1	1	0
UTO-67	4	5	1	1	3	1	1	0
UTO-67	9	32	23	1	3	1	1	0
UTO-67	9	10	1	1	3	1	1	0
UTO-68	11	122	111	1	3	1	1	0
UTO-68	19	36	17	1	3	1	1	0
UTO-68	21	477	456	0	3	3	0	0
UTO-68	21	477	456	0	3	1	0	0
UTO-68	24	38	14	1	4	1	1	0
UTO-68	43	46	3	1	3	1	1	0
UTO-68	45	46	1	1	3	1	1	0
UTO-68	58	59	1	1	3	1	1	0
UTO-69	58	477	419	0	3	1	0	0
UTO-69	61	62	1	1	3	1	1	0
UTO-69	61	477	416	0	3	1	0	0
UTO-69	61	100	39	1	3	1	1	0
UTO-69	61	62	1	1	3	1	1	0
UTO-69	64	84	20	1	3	1	1	0
UTO-69	64	82	18	1	3	1	1	1
UTO-69	64	477	413	0	3	1	0	1
UTO-69	66	67	1	1	4	1	1	0
UTO-69	93	477	384	0	3	1	0	0
UTO-70	98	477	379	0	3	1	0	0
UTO-70	100	101	1	1	3	1	1	0
UTO-70	107	112	5	1	3	1	1	0
UTO-70	108	109	1	1	3	4	1	0
UTO-70	109	110	1	1	3	4	1	0
UTO-70	118	119	1	1	3	4	1	0
UTO-70	118	119	1	1	4	1	1	0
UTO-70	118	119	1	1	4	1	1	0
UTO-70	118	119	1	1	4	4	1	0
UTO-70	118	119	1	1	4	4	1	0
UTO-71	119	120	1	1	4	4	1	0
UTO-71	126	127	1	1	3	1	1	0
UTO-71	126	127	1	1	3	1	1	0
UTO-71	127	128	1	1	3	1	1	0
UTO-71	129	464	335	1	3	1	1	0
UTO-71	129	130	1	1	3	1	1	0
UTO-71	130	131	1	1	3	1	1	1
UTO-71	136	477	341	0	3	1	0	0
UTO-71	168	477	309	0	4	4	0	0
UTO-71	204	205	1	1	3	1	1	0
UTO-72	207	464	257	1	3	3	1	0
UTO-72	207	208	1	1	3	1	1	0
UTO-72	207	464	257	1	3	1	1	0
UTO-72	215	216	1	1	3	1	1	0
UTO-72	215	464	249	1	3	1	1	0
UTO-72	215	216	1	1	3	1	1	0
UTO-72	215	464	249	1	3	1	1	0
UTO-72	232	233	1	1	3	1	1	0
UTO-72	232	464	232	1	3	1	1	0
UTO-72	233	464	231	1	3	1	1	0
UTO-73	233	464	231	1	3	1	1	0
UTO-73	240	464	224	1	3	1	1	0
UTO-73	249	477	228	0	3	1	0	0
UTO-73	254	297	43	1	3	5	1	0
UTO-73	259	464	205	1	3	5	1	0
UTO-73	262	464	202	1	3	3	1	0
UTO-73	274	464	190	1	3	3	1	0
UTO-73	278	464	186	1	4	4	1	0
UTO-73	279	464	185	1	4	4	1	0
UTO-73	280	464	184	1	3	3	0	0
UTO-74	280	464	184	1	3	3	1	0
UTO-74	287	464	177	1	3	3	1	0
UTO-74	287	288	1	1	3	3	1	0
UTO-74	287	288	1	1	3	3	1	0
UTO-74	294	464	170	1	3	4	1	0
LYGENE-29	84	477	393	0	3	1	0	0
LYGENE-29	85	477	392	0	3	1	0	0
LYGENE-29	92	93	1	1	3	1	1	0
LYGENE-29	92	93	1	1	3	3	1	0
LYGENE-29	105	108	3	1	3	3	1	0
LYGENE-30	105	477	372	0	3	3	0	0
LYGENE-30	108	477	369	0	3	4	1	0
LYGENE-30	108	477	369	0	3	4	0	0
LYGENE-30	114	117	3	1	3	4	0	0
LYGENE-30	115	116	1	1	3	2	0	0
LYGENE-30	115	117	2	1	3	2	0	0
LYGENE-30	115	477	362	0	3	2	0	0
LYGENE-30	117	118	1	1	3	2	0	1
LYGENE-30	121	122	1	1	3	1	1	0
LYGENE-30	231	232	1	1	3	2	0	0
LYGENE-31	231	232	1	1	3	2	0	0
LYGENE-31	272	477	205	0	3	2	0	0
OL-33	29	140	111	1	3	1	0	1
OL-33	93	146	53	1	3	1	1	0
OL-33	94	95	1	1	3	4	1	0
OL-34	107	299	192	1	2	1	1	1
OL-34	142	143	1	1	3	4	1	0
OL-34	145	146	1	1	3	4	1	0
OL-34	157	162	5	1	1	1	0	0
OL-34	159	160	1	1	3	4	1	0
OL-34	186	316	130	1	3	4	1	0
OL-34	196	197	1	1	3	4	1	0
OL-34	200	202	2	1	2	1	1	2
OL-34	219	456	237	1	3	1	1	0
OL-34	227	316	89	1	3	4	1	0
OL-35	253	477	224	0	2	2	0	0
OL-35	288	477	189	0	3	2	0	0
OL-35	289	477	188	0	3	1	0	0
OL-35	295	477	182	0	4	4	2	0
OL-35	295	302	7	1	4	4	0	0
OL-35	296	297	1	1	3	1	1	2
OL-35	300	301	1	1	3	4	1	0
OL-35	300	301	1	1	3	4	0	0
OL-35	319	325	6	1	3	1	1	0
OTOCOLS-11	133	477	344	0	3	1	0	0
OTOCOLS-11	206	477	271	0	3	4	0	0
OTON-173	1	11	10	1	4	5	1	0
OTON-173	2	52	50	1	3	1	0	0
OTON-173	3	11	8	1	4	5	1	0
OTON-173	3	7	4	1	3	4	1	0
OTON-173	3	52	49	1	3	1	1	1
OTON-173	4	477	473	0	3	2	0	0
OTON-173	7	8	1	1	3	4	1	1
OTON-173	8	9	1	1	4	4	1	0
OTON-173	8	44	36	1	3	1	1	1
OTON-173	9	10	1	1	4	4	1	1
OTON-174	10	477	467	0	4	1	0	0
OTON-174	11	12	1	1	3	1	1	0
OTON-174	11	12	1	1	4	4	1	0
OTON-174	14	477	463	0	3	1	0	0
OTON-174	15	477	462	0	4	1	0	0
OTON-174	16	22	6	1	3	1	1	1
OTON-174	16	477	461	0	3	4	0	0
OTON-174	17	18	1	1	3	1	1	0
OTON-174	19	20	1	1	3	4	0	0
OTON-174	21	22	1	1	4	4	1	1
OTON-175	22	477	455	0	4	4	0	0
OTON-175	22	42	20	1	3	4	1	1
OTON-175	24	63	39	1	3	3	1	2
OTON-175	24	455	431	1	4	4	1	2
OTON-175	24	59	35	1	3	4	1	2
OTON-175	26	32	6	1	3	1	0	0
OTON-175	28	29	1	1	5	4	1	0
OTON-175	31	32	1	1	3	1	1	0
OTON-175	32	33	1	1	4	1	1	0
OTON-175	37	477	440	0	3	1	0	1
OTON-176	38	80	42	1	5	5	0	0
OTON-176	41	44	3	1	4	1	1	1
OTON-176	42	45	3	1	3	4	1	0
OTON-176	42	477	435	0	3	4	0	1
OTON-176	46	268	222	1	3	1	0	2
OTON-176	46	477	431	0	5	4	0	0
OTON-176	50	52	2	1	3	1	1	1
OTON-176	51	52	1	1	4	4	1	0
OTON-176	52	53	1	1	3	4	1	0
OTON-176	52	53	1	1	3	1	1	1
OTON-177	52	477	425	0	3	1	0	1
OTON-177	53	145	92	1	3	5	1	0
OTON-177	53	54	1	1	3	1	1	0
OTON-177	53	56	3	1	1	1	1	1
OTON-177	56	57	1	1	4	4	1	0
OTON-177	56	65	9	1	3	1	1	1
OTON-177	56	57	1	1	3	1	1	0
OTON-177	57	93	36	1	3	3	1	2
OTON-177	58	81	23	1	3	4	1	0
OTON-177	59	477	418	0	3	4	0	0
OTON-178	59	477	418	0	3	4	0	0
OTON-178	60	64	4	1	3	4	1	0
OTON-178	63	74	11	1	3	4	1	1
OTON-178	63	477	414	0	3	1	0	1
OTON-178	64	65	1	1	3	1	1	0
OTON-178	64	477	413	0	3	3	1	0
OTON-178	65	477	412	0	3	3	0	0
OTON-178	65	72	7	1	3	3	0	0
OTON-178	66	67	1	1	4	5	0	0
OTON-178	68	86	18	1	3	1	1	0
OTON-179	70	79	9	1	3	1	1	0
OTON-179	71	74	3	1	3	1	1	0
OTON-179	71	92	21	1	3	3	0	1
OTON-179	72	86	14	1	3	1	0	1
OTON-179	72	73	1	1	3	4	1	0
OTON-179	74	477	403	0	3	1	0	0
OTON-179	74	477	403	0	3	4	0	0
OTON-179	77	78	1	1	4	1	0	0
OTON-179	77	253	176	1	3	5	1	2
OTON-179	78	79	1	1	3	3	1	0
OTON-180	78	477	399	0	3	1	1	0
OTON-180	78	477	399	0	3	3	0	0
OTON-180	79	477	398	0	3	1	0	0
OTON-180	79	81	2	1	3	2	1	0
OTON-180	80	81	1	1	3	1	1	0
OTON-180	80	344	264	1	3	1	1	1
OTON-180	80	92	12	1	3	5	1	0
OTON-180	80	81	1	1	3	5	1	1
OTON-180	80	81	1	1	4	4	1	0
OTON-180	81	148	67	1	4	1	1	2
OTON-181	81	82	1	1	3	5	1	0
OTON-181	81	82	1	1	3	4	1	0
OTON-181	84	145	61	1	3	3	1	2
OTON-181	84	477	393	0	3	1	0	0
OTON-181	85	86	1	1	3	1	1	0
OTON-181	86	94	8	1	3	1	1	0
OTON-181	86	217	131	1	4	4	1	0
OTON-181	86	87	1	1	3	1	1	0
OTON-181	87	94	7	1	3	1	1	0
OTON-181	87	477	390	0	3	1	0	1
OTON-182	87	94	7	1	3	1	1	0
OTON-182	87	91	4	1	3	1	1	0
OTON-182	94	95	1	1	3	1	1	0
OTON-182	95	99	4	1	4	4	1	0
OTON-182	98	477	379	0	3	1	1	0
OTON-182	99	100	1	1	3	1	1	1
OTON-182	100	101	1	1	3	4	1	0
OTON-182	101	148	47	1	3	5	0	0
OTON-182	102	103	1	1	3	2	1	0
OTON-182	102	103	1	1	3	4	1	0
OTON-183	102	103	1	1	3	1	1	0
OTON-183	107	121	14	1	3	1	0	2
OTON-183	109	115	6	1	3	1	1	4
OTON-183	113	477	364	0	2	1	0	0
OTON-183	114	477	363	0	3	1	0	0
OTON-183	114	477	363	0	3	1	0	0
OTON-183	114	115	1	1	3	1	1	2
OTON-183	115	477	362	0	4	1	0	1
OTON-183	116	477	361	0	3	1	1	0
OTON-183	120	477	357	0	3	1	0	0
OTON-184	121	477	356	0	3	1	0	1
OTON-184	121	127	6	1	3	1	1	0
OTON-184	121	226	105	1	3	1	1	0
OTON-184	131	477	346	0	3	1	0	0
OTON-184	132	134	2	1	3	1	1	0
OTON-184	134	135	1	1	3	1	1	2
OTON-184	135	477	342	0	3	1	0	1
OTON-184	136	137	1	1	3	1	1	0
OTON-184	136	155	19	1	3	4	1	0
OTON-184	137	176	39	1	4	1	0	2
OTON-185	137	155	18	1	3	4	1	1
OTON-185	142	143	1	1	3	1	0	0
OTON-185	142	180	38	1	3	3	1	2
OTON-185	155	156	1	1	3	4	0	0
OTON-185	156	157	1	1	3	1	1	1
OTON-185	157	163	6	1	3	1	1	0
OTON-185	157	163	6	1	3	1	1	1
OTON-185	157	158	1	1	3	1	1	0
OTON-185	162	176	14	1	3	4	1	0
OTON-185	163	164	1	1	3	1	1	1
OTON-186	163	164	1	1	3	1	1	0
OTON-186	163	164	1	1	3	1	1	0
OTON-186	164	450	286	1	2	1	0	0
OTON-186	164	165	1	1	3	1	1	0
OTON-186	165	477	312	0	3	1	0	1
OTON-186	169	171	2	1	3	4	1	0
OTON-186	169	175	6	1	3	1	1	0
OTON-186	171	175	4	1	3	1	1	0
OTON-186	176	177	1	1	3	1	1	0
OTON-186	176	177	1	1	3	4	1	0
OTON-187	176	477	301	0	3	4	0	0
OTON-187	176	477	301	0	3	1	0	0
OTON-187	176	248	72	1	3	3	1	2
OTON-187	176	177	1	1	4	1	1	0
OTON-187	176	245	69	1	3	1	1	0
OTON-187	177	193	16	1	4	4	1	0
OTON-187	178	179	1	1	4	1	1	1
OTON-187	179	180	1	1	3	4	1	0
OTON-187	179	245	66	1	3	4	1	1
OTON-188	179	180	1	1	3	1	1	0
OTON-188	179	198	19	1	3	1	1	0
OTON-188	179	183	4	1	3	1	1	0
OTON-188	184	477	293	0	3	1	0	1
OTON-188	184	211	27	1	3	1	1	3
OTON-188	185	186	1	1	3	4	1	0
OTON-188	186	245	59	1	3	4	1	0
OTON-188	186	322	136	1	3	4	1	0
OTON-188	189	268	79	1	3	4	1	1
OTON-188	189	190	1	1	3	1	2	0
OTON-189	190	193	3	1	3	1	0	1
OTON-189	190	191	1	1	4	1	2	0
OTON-189	190	191	1	1	2	1	2	3
OTON-189	193	477	284	0	3	1	1	0
OTON-189	193	194	1	1	4	4	1	0
OTON-189	193	194	1	1	4	4	1	0
OTON-189	197	198	1	1	3	1	1	0
OTON-189	198	254	56	1	3	1	0	1
OTON-189	199	477	278	0	3	1	0	1
OTON-189	200	477	277	0	3	4	0	0
OTON-190	200	477	277	0	4	4	0	1
OTON-190	207	211	4	1	2	1	2	2
OTON-190	210	211	1	1	3	1	2	0
OTON-190	210	211	1	1	3	1	1	0
OTON-190	211	477	266	0	3	4	0	1
OTON-190	213	218	5	1	3	1	0	1
OTON-190	213	214	1	1	3	1	2	1
OTON-190	213	477	264	0	3	1	0	1
OTON-190	213	477	264	0	4	4	0	0
OTON-190	213	214	1	1	4	4	0	1
OTON-191	217	283	66	1	3	1	1	2
OTON-191	218	221	3	1	3	4	1	0
OTON-191	220	221	1	1	3	1	1	0
OTON-191	221	222	1	1	3	3	1	0
OTON-191	221	477	256	0	3	1	0	2
OTON-191	225	477	252	0	3	1	0	0
OTON-191	232	309	77	1	5	5	1	0
OTON-191	233	396	163	1	3	1	0	0
OTON-191	235	236	1	1	4	4	1	1
OTON-191	237	245	8	1	3	4	1	0
OTON-192	238	239	1	1	3	3	1	0
OTON-192	239	245	6	1	3	4	1	0
OTON-192	239	245	6	1	3	4	1	0
OTON-192	240	477	237	0	3	1	0	0
OTON-192	240	241	1	1	3	1	0	0
OTON-192	241	242	1	1	5	4	1	0
OTON-192	245	280	35	1	3	3	1	2
OTON-192	247	477	230	0	3	1	0	1
OTON-192	249	250	1	1	3	1	1	1
OTON-192	252	253	1	1	3	1	1	0
OTON-193	252	253	1	1	3	5	1	1
OTON-193	253	477	224	0	4	5	0	1
OTON-193	253	477	224	0	4	5	0	1
OTON-193	254	283	29	1	3	1	1	0
OTON-193	254	255	1	1	3	1	1	1
OTON-193	255	270	15	1	3	4	1	1
OTON-193	259	477	218	0	4	4	0	0
OTON-193	262	477	215	0	3	1	0	0
OTON-193	262	302	40	1	4	1	1	0
OTON-193	263	477	214	0	3	1	0	0
OTON-194	266	270	4	1	3	4	1	0
OTON-194	268	269	1	1	4	4	1	0
OTON-194	269	270	1	1	4	1	1	0
OTON-194	270	477	207	0	3	3	0	1
OTON-194	273	425	152	1	3	3	1	2
OTON-194	273	477	204	0	2	1	0	0
OTON-194	274	275	1	1	3	5	0	0
OTON-194	274	276	2	1	3	5	0	0
OTON-194	275	276	1	1	4	4	1	0
OTON-194	276	277	1	1	3	1	0	0
OTON-195	277	477	200	0	3	1	0	0
OTON-195	277	283	6	1	3	1	1	0
OTON-195	283	477	194	0	2	1	0	0
OTON-195	283	284	1	1	3	1	1	0
OTON-195	283	284	1	1	4	1	1	0
OTON-195	283	284	1	1	3	1	1	0
OTON-195	283	284	1	1	3	1	0	0
OTON-195	287	477	190	0	4	3	0	0
OTON-195	288	309	21	1	3	1	1	0
OTON-195	296	401	105	1	3	4	1	0
OTON-196	301	305	4	1	3	1	1	0
OTON-196	304	309	5	1	4	4	1	0
OTON-196	309	315	6	1	3	1	1	0
OTON-196	316	326	10	1	4	4	1	0
OTON-196	317	477	160	0	3	1	1	1
OTON-196	320	323	3	1	4	4	1	0
OTON-196	322	323	1	1	3	1	1	0
OTON-196	322	323	1	1	4	4	1	0
OTON-196	324	325	1	1	4	1	1	0
OTON-196	324	325	1	1	3	1	1	0
OTON-197	325	326	1	1	4	1	1	0
OTON-197	325	326	1	1	3	3	1	0
OTON-197	325	326	1	1	3	1	1	0
OTON-197	330	331	1	1	3	4	1	0
OTON-197	330	332	2	1	3	1	1	0
OTON-197	337	477	140	0	3	3	1	1
OTON-197	337	477	140	0	3	4	1	1
OTON-197	338	477	139	0	1	1	0	0
OTON-197	339	340	1	1	3	1	1	0
OTON-197	339	340	1	1	3	1	1	0
OTON-198	340	341	1	1	4	4	1	0
OTON-198	343	345	2	1	3	1	0	0
OTON-198	343	345	2	1	3	1	1	0
OTON-198	344	345	1	1	3	4	1	0
OTON-198	344	345	1	1	3	1	1	0
OTON-198	353	372	19	1	3	1	1	0
OTON-198	353	372	19	1	3	1	1	0
OXY-2	171	172	1	1	2	1	0	0
OXY-2	210	211	1	1	3	2	0	1
LUCENE-4	42	477	435	0	4	4	0	0
LUCENE-4	77	287	210	1	3	1	0	0
LUCENE-4	157	158	1	1	3	1	0	0
LUCENE-4	261	262	1	1	3	1	0	0
LUCENE-4	285	286	1	1	3	1	0	0
LUCENE-4	288	289	1	1	3	1	0	0
ID-806	2	8	6	1	3	1	0	1
ID-806	3	8	5	1	3	1	0	0
ID-807	4	15	11	1	3	1	2	0
ID-807	8	15	7	1	3	1	0	0
ID-807	8	78	70	1	3	3	1	1
ID-807	8	79	71	1	3	4	1	0
ID-807	9	25	16	1	3	3	1	0
ID-807	11	23	12	1	1	1	1	0
ID-807	14	16	2	1	3	1	1	0
ID-807	15	16	1	1	5	4	1	0
ID-807	15	477	462	0	4	1	0	0
ID-807	15	16	1	1	4	1	1	0
ID-808	15	477	462	0	3	1	0	0
ID-808	18	32	14	1	4	1	2	0
ID-808	18	22	4	1	3	1	1	0
ID-808	20	71	51	1	3	4	1	0
ID-808	21	46	25	1	3	1	1	0
ID-808	23	30	7	1	3	4	1	0
ID-808	23	29	6	1	3	4	2	2
ID-808	28	31	3	1	4	1	1	0
ID-808	28	29	1	1	4	4	1	0
ID-808	28	51	23	1	4	4	1	0
ID-809	30	31	1	1	4	4	1	0
ID-809	31	50	19	1	3	4	2	0
ID-809	31	32	1	1	4	1	1	1
ID-809	32	477	445	0	4	1	1	1
ID-809	32	38	6	1	3	3	1	0
ID-809	35	477	442	0	4	1	1	0
ID-809	35	50	15	1	4	1	1	0
ID-809	36	477	441	0	3	1	0	0
ID-809	44	50	6	1	3	1	2	0
ID-809	45	50	5	1	4	1	2	0
ID-810	45	50	5	1	3	1	2	0
ID-810	46	52	6	1	4	4	2	0
ID-810	48	53	5	1	4	4	2	0
ID-810	49	62	13	1	4	4	1	0
ID-810	50	56	6	1	4	1	1	0
ID-810	51	477	426	0	3	1	0	0
ID-810	51	52	1	1	3	1	2	0
ID-810	51	58	7	1	3	1	0	0
ID-810	52	477	425	0	4	1	0	0
ID-810	52	53	1	1	3	1	0	0
ID-811	53	56	3	1	3	4	2	1
ID-811	53	477	424	0	3	4	1	1
ID-811	57	62	5	1	3	3	1	0
ID-811	58	73	15	1	3	1	1	0
ID-811	58	352	294	1	3	1	1	0
ID-811	58	73	15	1	3	1	1	0
ID-811	63	64	1	1	3	1	0	1
ID-811	64	67	3	1	4	1	1	0
ID-811	65	66	1	1	3	1	1	0
ID-811	66	477	411	0	4	4	0	0
ID-812	66	477	411	0	4	1	0	0
ID-812	66	72	6	1	4	1	1	0
ID-812	67	477	410	0	3	1	0	0
ID-812	70	85	15	1	3	4	1	0
ID-812	70	78	8	1	3	1	1	0
ID-812	70	477	407	0	3	1	0	0
ID-812	70	477	407	0	5	1	0	0
ID-812	70	477	407	0	3	4	0	0
ID-812	70	72	2	1	3	3	1	0
ID-812	70	78	8	1	3	3	1	1
ID-813	72	77	5	1	4	1	2	0
ID-813	72	73	1	1	4	1	1	0
ID-813	73	302	229	1	4	4	1	0
ID-813	73	105	32	1	4	4	1	0
ID-813	73	477	404	0	3	1	0	0
ID-813	74	108	34	1	3	1	1	0
ID-813	77	78	1	1	3	4	3	1
ID-813	77	80	3	1	4	1	2	0
ID-813	78	477	399	0	3	4	0	0
ID-813	81	477	396	0	3	1	1	0
ID-814	85	87	2	1	4	1	1	0
ID-814	85	123	38	1	3	1	1	0
ID-814	86	477	391	0	3	1	0	0
ID-814	87	340	253	1	3	4	1	0
ID-814	87	88	1	1	1	1	3	0
ID-814	87	477	390	0	4	1	0	0
ID-814	87	477	390	0	4	1	0	0
ID-814	88	89	1	1	5	4	2	0
ID-814	88	98	10	1	3	3	1	0
ID-814	88	98	10	1	3	3	1	0
ID-815	88	163	75	1	3	4	1	0
ID-815	90	248	158	1	3	4	1	0
ID-815	92	93	1	1	4	1	0	0
ID-815	92	105	13	1	5	4	1	0
ID-815	92	477	385	0	3	3	0	1
ID-815	93	110	17	1	3	1	1	1
ID-815	98	336	238	1	3	1	1	0
ID-815	98	352	254	1	3	1	1	0
ID-815	98	302	204	1	3	4	1	0
ID-815	100	101	1	1	3	4	0	1
ID-816	100	106	6	1	4	1	2	0
ID-816	101	477	376	0	3	1	0	0
ID-816	101	477	376	0	3	4	1	0
ID-816	101	105	4	1	4	4	2	0
ID-816	101	112	11	1	3	1	2	0
ID-816	102	141	39	1	3	1	2	0
ID-816	104	123	19	1	4	4	1	0
ID-816	105	134	29	1	4	1	1	1
ID-816	109	477	368	0	3	1	1	0
ID-816	109	110	1	1	3	1	1	0
ID-817	110	111	1	1	3	3	0	0
ID-817	113	114	1	1	4	1	2	0
ID-817	113	134	21	1	3	1	1	0
ID-817	113	477	364	0	3	4	0	0
ID-817	113	114	1	1	3	1	0	0
ID-817	115	477	362	0	3	1	0	0
ID-817	116	120	4	1	3	1	1	0
ID-817	119	477	358	0	3	1	0	0
ID-817	121	477	356	0	4	4	1	0
ID-817	122	123	1	1	3	1	0	0
ID-818	123	124	1	1	4	4	1	0
ID-818	123	142	19	1	4	4	2	0
ID-818	126	130	4	1	3	1	2	0
ID-818	126	293	167	1	3	3	1	0
ID-818	126	134	8	1	3	1	0	0
ID-818	127	133	6	1	3	1	1	0
ID-818	129	132	3	1	3	1	1	0
ID-818	129	293	164	1	3	1	1	0
ID-818	129	132	3	1	3	1	1	0
ID-818	129	152	23	1	3	3	1	0
ID-819	129	139	10	1	3	3	1	0
ID-819	133	352	219	1	3	1	1	0
ID-819	135	323	188	1	3	1	1	0
ID-819	136	352	216	1	3	4	1	0
ID-819	136	188	52	1	4	1	1	0
ID-819	136	154	18	1	4	4	1	0
ID-819	137	302	165	1	3	1	1	0
ID-819	142	477	335	0	3	3	0	0
ID-819	144	147	3	1	3	1	2	0
ID-819	144	152	8	1	3	1	2	0
ID-820	144	477	333	0	3	1	0	0
ID-820	155	323	168	1	3	1	2	0
ID-820	155	166	11	1	2	1	3	0
ID-820	155	156	1	1	2	1	2	0
ID-820	156	157	1	1	4	4	2	0
ID-820	157	166	9	1	3	3	1	0
ID-820	157	477	320	0	3	1	0	0
ID-820	158	161	3	1	2	1	2	0
ID-820	161	169	8	1	2	4	0	0
ID-820	164	290	126	1	3	1	1	0
ID-821	165	170	5	1	2	1	1	0
ID-821	170	477	307	0	3	1	0	0
ID-821	172	199	27	1	1	1	1	0
ID-821	177	178	1	1	4	1	1	0
ID-821	177	323	146	1	3	4	1	0
ID-821	182	238	56	1	3	1	1	0
ID-821	185	302	117	1	3	1	2	0
ID-821	185	186	1	1	5	1	0	0
ID-821	186	199	13	1	3	3	1	0
ID-821	197	238	41	1	3	1	3	0
ID-822	204	477	273	0	3	1	0	0
ID-822	204	219	15	1	3	1	1	0
ID-822	213	221	8	1	1	1	1	0
ID-822	216	218	2	1	3	1	2	0
ID-822	216	218	2	1	3	4	2	0
ID-822	217	218	1	1	2	1	2	0
ID-822	218	219	1	1	3	1	1	0
ID-822	219	352	133	1	3	4	1	0
ID-822	224	231	7	1	3	3	1	0
ID-822	231	241	10	1	2	1	1	1
ID-823	231	352	121	1	3	1	1	0
ID-823	232	252	20	1	3	1	2	0
ID-823	233	352	119	1	3	4	2	0
ID-823	234	252	18	1	3	1	2	1
ID-823	234	235	1	1	3	1	0	1
ID-823	234	477	243	0	3	1	0	0
ID-823	238	241	3	1	3	1	3	0
ID-823	239	245	6	1	3	3	1	0
ID-823	242	352	110	1	3	4	2	1
ID-823	248	424	176	1	3	3	1	0
ID-824	256	340	84	1	4	4	1	0
ID-824	260	280	20	1	3	4	1	1
ID-824	260	323	63	1	3	4	1	0
ID-824	261	352	91	1	4	4	2	0
ID-824	261	352	91	1	3	4	2	0
ID-824	267	352	85	1	3	4	1	1
ID-824	277	477	200	0	3	1	0	0
ID-824	280	323	43	1	3	4	1	0
ID-824	282	283	1	1	3	1	1	0
ID-824	288	289	1	1	4	1	0	0
ID-825	293	477	184	0	3	3	1	1
ID-825	296	477	181	0	4	4	0	1
ID-825	298	399	101	1	3	1	2	1
ID-825	302	352	50	1	3	1	1	0
ID-825	302	340	38	1	3	1	2	0
ID-825	302	477	175	0	3	1	0	0
ID-825	305	340	35	1	3	4	3	0
ID-825	308	311	3	1	3	1	1	0
ID-825	308	340	32	1	3	4	1	0
ID-825	312	340	28	1	3	4	2	0
ID-826	326	352	26	1	3	4	2	0
ID-826	336	352	16	1	3	4	1	0
ID-826	336	369	33	1	3	3	1	0
ID-826	338	477	139	0	3	4	1	1
ID-826	340	352	12	1	3	4	2	0
ID-826	352	477	125	0	3	4	1	1
ID-826	352	477	125	0	3	4	1	1
ID-826	352	477	125	0	3	4	1	1
ID-826	359	477	118	0	3	1	0	0
IDIT-10	11	14	3	1	3	3	1	1
IDIT-10	11	477	466	0	3	3	0	0
IDIT-10	15	19	4	1	3	4	1	0
IDIT-11	19	31	12	1	3	4	1	0
IDIT-11	19	477	458	0	3	4	0	0
IDIT-11	31	32	1	1	4	4	1	0
IDIT-11	58	59	1	1	3	1	1	0
IDIT-11	58	78	20	1	3	1	1	0
IDIT-11	58	122	64	1	3	4	1	0
IDIT-11	58	477	419	0	3	4	0	0
IDIT-11	59	477	418	0	3	4	0	0
IDIT-11	73	477	404	0	5	4	0	0
IDIT-11	78	119	41	1	3	3	1	0
IDIT-12	87	477	390	0	3	1	0	0
IDIT-12	102	477	375	0	4	3	0	0
IDIT-12	114	477	363	0	4	3	0	0
IDIT-12	114	477	363	0	3	3	0	0
IDIT-12	114	477	363	0	3	3	0	0
IDIT-12	176	337	161	1	3	3	1	0
IDIT-12	179	477	298	0	3	3	0	0
IDIT-12	183	189	6	1	4	4	1	0
IDIT-12	183	196	13	1	2	1	1	0
IDIT-12	183	191	8	1	1	1	1	0
IDIT-13	183	189	6	1	1	1	1	0
IDIT-13	183	189	6	1	3	3	1	0
IDIT-13	191	477	286	0	3	3	0	0
IDIT-13	196	477	281	0	3	3	0	0
IDIT-13	196	477	281	0	3	3	0	0
IDIT-13	214	477	263	0	3	1	0	0
IDIT-13	221	337	116	1	3	1	1	0
IDJMS-35	10	64	54	1	3	4	0	0
IDJMS-35	14	15	1	1	4	4	1	0
IDJMS-35	15	16	1	1	4	4	1	0
IDJMS-35	16	17	1	1	4	2	1	0
IDJMS-35	16	18	2	1	4	2	1	0
IDJMS-35	18	19	1	1	2	1	0	0
IDJMS-35	23	24	1	1	4	1	0	0
IDJMS-36	23	24	1	1	4	1	1	0
IDJMS-36	23	24	1	1	3	4	1	0
IDJMS-36	45	46	1	1	3	3	1	0
IDJMS-36	56	57	1	1	3	4	1	0
IDJMS-36	58	59	1	1	4	4	1	1
IDJMS-36	71	74	3	1	3	1	1	0
IDJMS-36	71	79	8	1	3	1	1	0
IDJMS-36	72	73	1	1	3	4	1	1
IDJMS-36	74	75	1	1	3	1	1	0
IDJMS-36	79	80	1	1	3	1	1	0
IDJMS-37	80	477	397	0	4	4	0	0
IDJMS-37	81	82	1	1	3	1	0	0
IDJMS-37	84	85	1	1	3	1	1	1
IDJMS-37	86	127	41	1	3	2	1	2
IDJMS-37	87	94	7	1	3	1	1	0
IDJMS-37	95	114	19	1	3	2	1	2
IDJMS-37	99	154	55	1	3	1	1	2
IDJMS-37	100	101	1	1	5	3	1	0
IDJMS-37	102	114	12	1	4	3	1	0
IDJMS-37	106	127	21	1	3	4	1	0
IDJMS-38	108	114	6	1	3	4	1	0
IDJMS-38	112	119	7	1	3	3	1	3
IDJMS-38	112	113	1	1	3	4	1	1
IDJMS-38	112	113	1	1	3	4	1	2
IDJMS-38	114	115	1	1	3	4	1	2
IDJMS-38	136	137	1	1	3	1	0	0
IDJMS-38	154	161	7	1	3	1	1	1
IDJMS-38	154	155	1	1	5	3	1	0
IDJMS-38	154	477	323	0	4	1	0	0
IDJMS-38	157	158	1	1	3	1	1	0
IDJMS-39	158	159	1	1	3	4	1	0
IDJMS-39	158	226	68	1	4	2	1	0
IDJMS-39	162	477	315	0	3	1	0	0
IDJMS-39	162	163	1	1	3	1	1	0
IDJMS-39	162	163	1	1	3	1	1	0
IDJMS-39	168	175	7	1	3	1	1	0
IDJMS-39	175	176	1	1	3	4	1	0
IDJMS-39	176	177	1	1	3	3	1	0
IDJMS-39	176	177	1	1	3	3	1	0
IDJMS-39	178	179	1	1	3	4	1	0
IDJMS-40	183	477	294	0	3	1	0	0
IDJMS-40	191	198	7	1	3	4	1	0
IDJMS-40	193	199	6	1	2	1	0	2
IDJMS-40	197	198	1	1	4	1	1	0
IDJMS-40	198	199	1	1	3	1	1	2
IDJMS-40	198	199	1	1	4	3	1	1
IDJMS-40	199	200	1	1	4	3	1	0
IDJMS-40	214	219	5	1	2	1	1	0
IDJMS-40	218	225	7	1	3	4	1	0
IDJMS-40	226	231	5	1	3	1	0	0
IDJMS-41	226	227	1	1	4	3	1	0
IDJMS-41	227	228	1	1	4	4	1	0
IDJMS-41	242	243	1	1	4	1	1	0
IDJMS-41	266	267	1	1	5	1	1	0
IDJMS-41	274	275	1	1	3	3	0	1
IDJMS-41	274	275	1	1	3	3	1	0
IDJMS-41	281	283	2	1	3	4	1	0
IDJMS-41	282	477	195	0	5	4	0	0
IDJMS-41	288	289	1	1	3	4	1	0
IDJMS-41	289	290	1	1	3	1	1	0
IDJMS-42	289	305	16	1	4	4	1	1
IDJMS-42	291	292	1	1	3	4	1	0
IDJMS-42	294	477	183	0	4	2	0	0
IDJMS-42	301	302	1	1	4	4	1	0
IDJMS-42	310	311	1	1	4	3	1	1
IDJMS-42	311	477	166	0	4	1	0	0
IDJMS-42	315	316	1	1	4	3	0	0
IDJMS-42	315	316	1	1	3	3	1	0
IDJMS-42	315	477	162	0	3	5	0	0
IDJMS-42	315	316	1	1	4	4	1	0
IDJMS-43	317	477	160	0	4	4	0	0
IDJMS-43	317	330	13	1	3	4	1	0
IDJMS-43	318	325	7	1	4	3	1	0
IDJMS-43	319	320	1	1	3	1	0	0
IDJMS-43	323	324	1	1	3	1	1	1
IDJMS-43	326	330	4	1	3	1	0	0
IDJMS-43	326	327	1	1	3	3	1	0
IDJMS-43	330	331	1	1	3	3	1	0
IDJMS-43	345	346	1	1	3	1	1	0
IDJMS-43	345	346	1	1	4	4	1	0
IDJMS-44	347	348	1	1	3	3	1	0
ICKSTEP-11	24	477	453	0	4	2	0	0
ICKSTEP-11	29	95	66	1	3	3	0	0
ICKSTEP-11	76	477	401	0	3	3	0	0
ICKSTEP-11	110	477	367	0	4	4	0	0
ICKSTEP-11	110	115	5	1	3	4	0	0
ICKSTEP-12	111	477	366	0	4	4	0	0
ICKSTEP-12	112	128	16	1	3	4	0	0
ICKSTEP-12	114	477	363	0	4	5	0	0
ICKSTEP-12	116	117	1	1	3	1	0	0
ICKSTEP-12	117	118	1	1	4	2	0	0
ICKSTEP-12	124	126	2	1	3	1	0	0
ICKSTEP-12	128	477	349	0	3	2	0	0
ICKSTEP-12	137	155	18	1	3	2	0	1
ICKSTEP-12	155	477	322	0	3	4	0	0
MPART-44	309	310	1	1	3	1	1	0
NGER-194	3	477	474	0	3	1	0	0
NGER-194	3	4	1	1	4	1	0	0
NGER-194	8	477	469	0	3	1	0	0
NGER-194	8	73	65	1	3	1	1	0
NGER-194	8	477	469	0	3	1	0	0
NGER-195	8	477	469	0	3	1	0	0
NGER-195	9	207	198	1	3	1	2	0
NGER-195	11	16	5	1	4	1	2	0
NGER-195	11	24	13	1	3	4	2	0
NGER-195	11	12	1	1	5	4	1	0
NGER-195	15	477	462	0	4	1	1	0
NGER-195	16	21	5	1	3	1	2	0
NGER-195	16	19	3	1	3	1	2	0
NGER-195	20	282	262	1	3	1	2	0
NGER-195	21	477	456	0	3	2	0	0
NGER-196	21	22	1	1	3	1	2	0
NGER-196	22	59	37	1	5	1	1	0
NGER-196	22	23	1	1	3	1	2	0
NGER-196	23	67	44	1	3	2	1	0
NGER-196	28	477	449	0	5	5	1	0
NGER-196	28	29	1	1	4	1	1	0
NGER-196	29	30	1	1	3	1	2	0
NGER-196	29	60	31	1	3	2	1	0
NGER-196	29	477	448	0	3	2	0	0
NGER-196	32	35	3	1	3	4	1	0
NGER-197	32	35	3	1	3	1	1	0
NGER-197	32	35	3	1	4	4	1	0
NGER-197	37	57	20	1	3	2	1	0
NGER-197	37	477	440	0	1	2	0	0
NGER-197	37	477	440	0	1	2	0	0
NGER-197	37	38	1	1	3	1	1	0
NGER-197	42	43	1	1	3	4	1	0
NGER-197	42	43	1	1	3	4	1	0
NGER-197	42	429	387	1	3	4	1	0
NGER-197	42	43	1	1	3	4	1	0
NGER-198	42	43	1	1	3	1	2	1
NGER-198	43	56	13	1	2	1	1	0
NGER-198	43	57	14	1	3	1	1	1
NGER-198	44	67	23	1	3	1	2	0
NGER-198	44	45	1	1	3	1	1	0
NGER-198	44	134	90	1	3	2	1	0
NGER-198	49	477	428	0	3	1	0	0
NGER-198	49	56	7	1	3	4	1	0
NGER-198	50	51	1	1	3	1	1	0
NGER-198	51	114	63	1	3	1	1	1
NGER-199	52	56	4	1	3	4	1	1
NGER-199	54	71	17	1	1	1	1	1
NGER-199	56	477	421	0	3	1	0	0
NGER-199	57	64	7	1	3	1	1	0
NGER-199	57	81	24	1	3	1	1	0
NGER-199	57	78	21	1	1	3	1	0
NGER-199	58	59	1	1	3	1	2	0
NGER-199	58	59	1	1	3	1	2	0
NGER-199	58	65	7	1	3	1	1	0
NGER-199	59	60	1	1	3	4	1	0
NGER-200	59	63	4	1	3	2	2	1
NGER-200	59	60	1	1	3	4	2	0
NGER-200	59	182	123	1	3	2	1	0
NGER-200	59	65	6	1	3	1	1	0
NGER-200	59	60	1	1	3	4	1	1
NGER-200	60	64	4	1	2	4	2	0
NGER-200	60	72	12	1	4	1	2	0
NGER-200	63	64	1	1	3	1	2	0
NGER-200	64	65	1	1	3	1	1	0
NGER-200	64	66	2	1	3	1	1	0
NGER-201	64	73	9	1	3	4	1	1
NGER-201	64	65	1	1	3	1	1	0
NGER-201	64	65	1	1	5	4	1	0
NGER-201	65	73	8	1	3	1	1	0
NGER-201	68	70	2	1	3	1	1	0
NGER-201	70	73	3	1	3	1	1	0
NGER-201	71	84	13	1	3	1	1	2
NGER-201	71	185	114	1	2	1	1	1
NGER-201	71	80	9	1	4	4	1	1
NGER-201	72	78	6	1	3	4	1	1
NGER-202	72	73	1	1	3	1	1	0
NGER-202	72	108	36	1	3	1	1	2
NGER-202	72	73	1	1	4	4	1	0
NGER-202	73	81	8	1	3	1	2	1
NGER-202	73	76	3	1	3	1	2	0
NGER-202	73	76	3	1	3	1	2	0
NGER-202	73	76	3	1	3	1	2	0
NGER-202	73	76	3	1	3	1	2	0
NGER-202	74	80	6	1	3	1	2	1
NGER-202	77	96	19	1	3	4	1	0
NGER-203	77	108	31	1	3	5	1	1
NGER-203	78	79	1	1	3	1	1	0
NGER-203	78	85	7	1	3	4	1	4
NGER-203	80	87	7	1	3	1	2	0
NGER-203	80	477	397	0	4	1	0	0
NGER-203	81	86	5	1	3	1	3	0
NGER-203	81	93	12	1	3	1	1	0
NGER-203	81	82	1	1	3	1	2	0
NGER-203	84	85	1	1	3	1	1	0
NGER-203	84	93	9	1	3	1	2	0
NGER-204	84	93	9	1	3	1	2	1
NGER-204	84	121	37	1	3	1	1	0
NGER-204	85	87	2	1	3	1	3	0
NGER-204	85	107	22	1	3	4	1	0
NGER-204	85	87	2	1	3	1	2	0
NGER-204	86	87	1	1	3	1	2	0
NGER-204	86	477	391	0	3	4	0	0
NGER-204	86	477	391	0	3	4	0	0
NGER-204	86	477	391	0	3	4	0	0
NGER-204	86	319	233	1	3	4	1	1
NGER-205	86	477	391	0	3	4	0	0
NGER-205	87	88	1	1	3	1	2	1
NGER-205	87	477	390	0	3	2	0	0
NGER-205	87	93	6	1	2	1	2	1
NGER-205	91	92	1	1	4	1	2	0
NGER-205	92	93	1	1	3	1	1	0
NGER-205	93	96	3	1	3	4	1	0
NGER-205	94	99	5	1	3	1	2	0
NGER-205	94	101	7	1	3	4	1	0
NGER-205	94	107	13	1	3	4	1	0
NGER-206	96	100	4	1	3	1	2	0
NGER-206	96	98	2	1	3	1	2	0
NGER-206	98	102	4	1	3	1	1	0
NGER-206	98	99	1	1	3	1	2	0
NGER-206	100	108	8	1	3	4	1	1
NGER-206	100	136	36	1	3	1	1	0
NGER-206	100	102	2	1	3	1	4	0
NGER-206	101	105	4	1	4	3	2	0
NGER-206	102	107	5	1	3	1	3	0
NGER-206	107	108	1	1	2	1	1	0
NGER-207	107	109	2	1	3	1	1	0
NGER-207	107	108	1	1	3	1	1	0
NGER-207	107	121	14	1	3	4	1	0
NGER-207	107	108	1	1	3	1	1	0
NGER-207	108	112	4	1	3	1	1	0
NGER-207	109	110	1	1	3	1	1	0
NGER-207	112	134	22	1	3	1	1	0
NGER-207	112	477	365	0	3	1	0	0
NGER-207	112	477	365	0	3	1	0	0
NGER-207	113	134	21	1	2	1	1	0
NGER-208	113	116	3	1	3	1	1	0
NGER-208	113	114	1	1	3	1	0	0
NGER-208	113	114	1	1	3	1	1	1
NGER-208	114	128	14	1	3	1	1	0
NGER-208	114	115	1	1	3	1	1	0
NGER-208	114	135	21	1	3	1	1	0
NGER-208	114	115	1	1	3	1	2	0
NGER-208	115	116	1	1	3	1	1	0
NGER-208	118	477	359	0	3	1	1	0
NGER-208	119	120	1	1	3	1	1	0
NGER-209	119	120	1	1	3	1	4	0
NGER-209	121	124	3	1	3	1	1	0
NGER-209	121	122	1	1	3	1	1	0
NGER-209	122	450	328	1	3	1	1	0
NGER-209	123	124	1	1	3	1	1	0
NGER-209	123	172	49	1	2	4	1	0
NGER-209	123	129	6	1	3	1	1	0
NGER-209	126	477	351	0	3	1	0	0
NGER-209	126	129	3	1	3	1	1	0
NGER-209	128	183	55	1	3	3	1	0
NGER-210	129	183	54	1	3	1	1	1
NGER-210	133	134	1	1	3	1	1	0
NGER-210	135	143	8	1	4	1	1	0
NGER-210	135	137	2	1	3	1	1	0
NGER-210	135	136	1	1	3	1	3	0
NGER-210	136	140	4	1	3	1	2	0
NGER-210	136	141	5	1	3	1	1	0
NGER-210	136	143	7	1	3	1	1	0
NGER-210	137	149	12	1	3	1	2	0
NGER-210	137	477	340	0	3	1	0	0
NGER-211	138	151	13	1	3	1	1	0
NGER-211	140	477	337	0	2	1	1	0
NGER-211	141	206	65	1	3	1	0	0
NGER-211	144	154	10	1	3	1	1	0
NGER-211	144	268	124	1	3	1	2	0
NGER-211	148	149	1	1	3	4	1	0
NGER-211	149	150	1	1	3	1	1	0
NGER-211	150	155	5	1	3	1	3	1
NGER-211	150	151	1	1	3	1	1	0
NGER-211	151	155	4	1	3	1	1	0
NGER-212	153	154	1	1	3	1	2	0
NGER-212	154	183	29	1	3	1	1	0
NGER-212	156	157	1	1	3	1	1	0
NGER-212	156	183	27	1	5	1	1	0
NGER-212	157	158	1	1	3	1	1	0
NGER-212	158	183	25	1	3	5	1	0
NGER-212	158	183	25	1	3	5	1	0
NGER-212	158	477	319	0	3	4	0	0
NGER-212	159	477	318	0	3	2	1	0
NGER-212	159	477	318	0	3	4	1	0
NGER-213	159	246	87	1	3	1	0	0
NGER-213	160	168	8	1	3	1	1	0
NGER-213	162	183	21	1	2	4	1	0
NGER-213	162	165	3	1	3	1	1	0
NGER-213	165	172	7	1	3	1	2	0
NGER-213	166	477	311	0	3	1	0	0
NGER-213	168	170	2	1	4	3	1	0
NGER-213	169	172	3	1	3	1	1	0
NGER-213	171	183	12	1	3	1	1	0
NGER-213	171	477	306	0	2	1	1	0
NGER-214	172	281	109	1	3	4	3	0
NGER-214	172	183	11	1	3	1	1	1
NGER-214	176	477	301	0	3	4	0	0
NGER-214	178	179	1	1	3	4	1	0
NGER-214	179	477	298	0	3	4	0	0
NGER-214	180	181	1	1	3	1	1	0
NGER-214	182	183	1	1	3	1	2	0
NGER-214	182	190	8	1	3	3	1	0
NGER-214	183	423	240	1	2	1	1	1
NGER-214	184	206	22	1	3	1	0	0
NGER-215	185	203	18	1	3	5	2	0
NGER-215	190	423	233	1	2	1	1	0
NGER-215	194	207	13	1	5	1	2	0
NGER-215	194	214	20	1	3	2	2	0
NGER-215	196	477	281	0	3	4	1	0
NGER-215	197	212	15	1	3	1	1	0
NGER-215	197	477	280	0	3	2	0	0
NGER-215	200	267	67	1	3	4	2	0
NGER-215	200	203	3	1	2	1	2	0
NGER-215	204	477	273	0	3	1	0	0
NGER-216	204	210	6	1	3	1	2	0
NGER-216	205	241	36	1	3	1	2	0
NGER-216	206	207	1	1	3	4	4	0
NGER-216	206	346	140	1	4	1	2	0
NGER-216	206	207	1	1	3	1	2	0
NGER-216	206	211	5	1	2	1	2	0
NGER-216	207	212	5	1	3	1	2	0
NGER-216	207	226	19	1	4	3	2	0
NGER-216	209	214	5	1	3	4	4	1
NGER-216	209	212	3	1	3	4	4	0
NGER-217	210	366	156	1	3	2	2	0
NGER-217	210	219	9	1	3	5	4	1
NGER-217	210	214	4	1	3	1	2	0
NGER-217	211	212	1	1	3	4	2	0
NGER-217	211	477	266	0	3	5	0	0
NGER-217	211	366	155	1	3	5	2	0
NGER-217	211	212	1	1	1	1	0	0
NGER-217	211	218	7	1	4	4	2	0
NGER-217	212	477	265	0	3	1	0	0
NGER-217	212	477	265	0	3	2	0	0
NGER-218	212	213	1	1	3	1	2	0
NGER-218	214	219	5	1	3	1	2	0
NGER-218	214	220	6	1	2	1	2	0
NGER-218	215	221	6	1	3	1	2	1
NGER-218	218	266	48	1	3	1	2	0
NGER-218	220	477	257	0	3	1	0	1
NGER-218	221	227	6	1	3	1	2	0
NGER-218	221	268	47	1	3	1	2	0
NGER-218	225	226	1	1	3	1	2	0
NGER-218	226	227	1	1	2	1	2	0
NGER-219	227	477	250	0	2	4	0	0
NGER-219	228	229	1	1	3	1	2	0
NGER-219	229	477	248	0	3	2	0	1
NGER-219	229	269	40	1	4	1	2	0
NGER-219	231	477	246	0	3	2	0	1
NGER-219	233	268	35	1	2	1	2	0
NGER-219	233	234	1	1	3	1	2	0
NGER-219	234	235	1	1	3	1	2	0
NGER-219	235	253	18	1	3	3	2	0
NGER-219	238	241	3	1	3	4	0	0
NGER-220	238	477	239	0	3	1	1	1
NGER-220	238	240	2	1	3	1	2	0
NGER-220	240	477	237	0	3	4	0	0
NGER-220	240	291	51	1	3	4	2	0
NGER-220	241	266	25	1	4	1	3	0
NGER-220	242	477	235	0	3	1	0	0
NGER-220	246	477	231	0	3	1	1	0
NGER-220	246	285	39	1	3	4	4	1
NGER-220	247	477	230	0	3	1	4	0
NGER-220	247	288	41	1	3	2	4	0
NGER-221	249	268	19	1	2	1	1	0
NGER-221	251	477	226	0	3	1	0	0
NGER-221	252	264	12	1	4	4	2	0
NGER-221	253	267	14	1	3	1	2	0
NGER-221	253	263	10	1	4	4	2	0
NGER-221	253	261	8	1	3	1	2	0
NGER-221	253	367	114	1	3	1	1	0
NGER-221	254	256	2	1	1	1	1	0
NGER-221	254	269	15	1	3	4	4	0
NGER-221	254	291	37	1	3	5	2	0
NGER-222	255	284	29	1	4	1	1	0
NGER-222	255	281	26	1	3	1	0	1
NGER-222	255	281	26	1	3	1	0	1
NGER-222	255	477	222	0	3	1	0	0
NGER-222	256	477	221	0	3	1	1	0
NGER-222	256	477	221	0	3	1	0	0
NGER-222	256	259	3	1	3	3	2	0
NGER-222	256	477	221	0	2	1	0	0
NGER-222	260	276	16	1	3	3	1	0
NGER-222	261	330	69	1	3	1	0	0
NGER-223	261	266	5	1	3	1	1	0
NGER-223	263	270	7	1	3	3	1	0
NGER-223	265	391	126	1	3	2	0	3
NGER-223	266	477	211	0	3	2	0	0
NGER-223	268	387	119	1	3	1	1	0
NGER-223	268	280	12	1	4	1	1	0
NGER-223	269	477	208	0	3	4	0	0
NGER-223	269	283	14	1	3	3	1	0
NGER-223	270	284	14	1	4	1	3	0
NGER-223	274	275	1	1	3	3	1	0
NGER-224	274	477	203	0	3	2	0	0
NGER-224	276	277	1	1	3	1	4	1
NGER-224	277	283	6	1	3	1	4	0
NGER-224	277	291	14	1	3	1	2	0
NGER-224	280	329	49	1	3	1	1	0
NGER-224	282	284	2	1	3	1	4	0
NGER-224	282	294	12	1	3	5	1	0
NGER-224	282	290	8	1	3	1	4	0
NGER-224	283	298	15	1	4	1	1	0
NGER-224	284	285	1	1	3	1	1	0
NGER-225	287	289	2	1	3	1	4	1
NGER-225	288	295	7	1	3	1	1	0
NGER-225	288	477	189	0	3	1	1	0
NGER-225	288	289	1	1	1	1	1	0
NGER-225	289	318	29	1	3	1	1	0
NGER-225	289	380	91	1	4	5	1	1
NGER-225	289	290	1	1	5	3	1	0
NGER-225	291	298	7	1	4	4	1	0
NGER-225	291	297	6	1	4	4	1	0
NGER-225	294	295	1	1	3	1	1	0
NGER-226	294	295	1	1	3	5	1	0
NGER-226	294	477	183	0	3	1	0	0
NGER-226	294	295	1	1	3	1	4	0
NGER-226	294	295	1	1	3	1	3	0
NGER-226	296	298	2	1	2	1	1	0
NGER-226	296	303	7	1	3	4	1	0
NGER-226	297	304	7	1	4	4	1	1
NGER-226	297	316	19	1	4	4	1	0
NGER-226	298	299	1	1	3	1	3	0
NGER-226	298	301	3	1	3	1	3	0
NGER-227	301	304	3	1	3	1	4	0
NGER-227	301	477	176	0	3	1	0	0
NGER-227	301	302	1	1	3	1	4	0
NGER-227	302	308	6	1	3	1	2	0
NGER-227	304	308	4	1	3	5	2	0
NGER-227	305	306	1	1	3	1	4	0
NGER-227	305	322	17	1	3	1	1	1
NGER-227	308	316	8	1	3	1	1	0
NGER-227	308	309	1	1	3	1	4	0
NGER-227	309	317	8	1	3	4	4	0
NGER-228	311	316	5	1	4	1	2	0
NGER-228	312	313	1	1	3	1	1	1
NGER-228	316	324	8	1	4	1	1	0
NGER-228	316	323	7	1	3	1	0	0
NGER-228	317	322	5	1	3	1	0	0
NGER-228	318	477	159	0	4	1	1	0
NGER-228	318	324	6	1	3	4	4	0
NGER-228	318	389	71	1	3	4	1	0
NGER-228	319	323	4	1	3	1	1	0
NGER-228	323	325	2	1	3	1	1	1
NGER-229	326	477	151	0	3	1	0	0
NGER-229	329	346	17	1	3	4	4	0
NGER-229	329	330	1	1	3	1	0	1
NGER-229	329	393	64	1	3	5	0	1
NGER-229	331	345	14	1	3	1	1	0
NGER-229	331	350	19	1	3	4	4	0
NGER-229	331	448	117	1	3	1	0	0
NGER-229	331	332	1	1	3	1	3	0
NGER-229	333	344	11	1	4	1	1	0
NGER-229	333	345	12	1	4	1	1	0
NGER-230	333	477	144	0	3	1	0	0
NGER-230	333	477	144	0	3	1	0	0
NGER-230	335	477	142	0	3	1	0	0
NGER-230	338	344	6	1	3	4	2	0
NGER-230	338	346	8	1	3	1	2	0
NGER-230	339	345	6	1	3	1	4	0
NGER-230	340	345	5	1	3	1	2	1
NGER-230	340	347	7	1	3	1	1	0
NGER-230	340	346	6	1	4	4	3	0
NGER-230	345	366	21	1	3	1	4	0
NGER-231	347	393	46	1	3	5	0	1
NGER-231	354	362	8	1	4	1	1	0
NGER-231	355	477	122	0	4	1	1	0
NGER-231	357	362	5	1	3	1	1	0
NGER-231	360	362	2	1	4	4	1	0
NGER-231	360	477	117	0	3	4	0	1
NGER-231	361	362	1	1	3	1	2	0
T-24	37	38	1	1	3	4	1	1
T-24	39	477	438	0	4	1	0	1
T-24	46	47	1	1	3	1	0	0
T-24	66	477	411	0	3	1	0	0
T-24	169	477	308	0	4	4	0	0
TIS-18	0	6	6	1	3	1	0	0
TIS-18	3	7	4	1	3	1	1	0
TIS-18	4	28	24	1	3	3	1	0
TIS-18	4	6	2	1	3	1	1	0
TIS-18	5	6	1	1	3	4	1	0
TIS-18	8	477	469	0	3	2	0	0
TIS-18	8	477	469	0	3	2	0	0
TIS-18	9	11	2	1	3	1	1	0
TIS-19	10	49	39	1	3	2	1	0
TIS-19	10	477	467	0	3	1	0	0
TIS-19	14	18	4	1	3	1	1	0
TIS-19	15	17	2	1	3	1	1	0
TIS-19	18	200	182	1	3	1	0	0
TIS-19	18	268	250	1	4	5	0	0
TIS-19	20	21	1	1	3	1	1	0
TIS-19	22	37	15	1	3	1	1	1
TIS-19	22	477	455	0	3	1	0	0
TIS-19	22	477	455	0	4	5	0	0
TIS-20	22	477	455	0	4	5	0	0
TIS-20	23	36	13	1	4	1	1	0
TIS-20	23	477	454	0	3	4	0	0
TIS-20	24	35	11	1	3	1	1	0
TIS-20	26	31	5	1	3	5	1	1
TIS-20	29	45	16	1	3	5	1	2
TIS-20	30	35	5	1	3	5	1	2
TIS-20	32	48	16	1	3	5	1	1
TIS-20	37	99	62	1	3	2	1	0
TIS-20	43	85	42	1	3	1	1	1
TIS-21	53	74	21	1	3	4	1	0
TIS-21	57	87	30	1	3	1	1	0
TIS-21	67	477	410	0	5	4	0	0
TIS-21	71	80	9	1	3	1	1	0
TIS-21	73	79	6	1	3	3	1	0
TIS-21	79	81	2	1	3	2	1	0
TIS-21	80	82	2	1	3	1	0	1
TIS-21	80	96	16	1	3	2	1	0
TIS-21	82	121	39	1	3	1	0	1
TIS-21	86	102	16	1	3	4	1	0
TIS-22	93	477	384	0	3	4	0	0
TIS-22	93	477	384	0	3	2	0	0
TIS-22	93	477	384	0	3	1	0	0
TIS-22	93	110	17	1	3	2	1	0
TIS-22	96	100	4	1	4	4	1	0
TIS-22	98	102	4	1	3	4	1	0
TIS-22	99	115	16	1	3	4	1	2
TIS-22	102	120	18	1	1	1	0	1
TIS-22	109	113	4	1	1	1	1	0
TIS-22	109	119	10	1	3	1	0	1
TIS-23	110	114	4	1	4	4	1	0
TIS-23	113	119	6	1	1	1	1	4
TIS-23	114	477	363	0	3	1	0	1
TIS-23	119	164	45	1	3	2	1	0
TIS-23	119	282	163	1	3	2	1	4
TIS-23	121	122	1	1	4	5	1	0
TIS-23	122	123	1	1	3	4	1	0
TIS-23	126	130	4	1	3	1	0	0
TIS-23	130	133	3	1	4	1	0	0
TIS-23	133	150	17	1	3	1	1	2
TIS-24	134	157	23	1	3	5	1	0
TIS-24	136	137	1	1	4	4	1	0
TIS-24	137	198	61	1	3	1	0	1
TIS-24	142	477	335	0	3	4	0	0
TIS-24	142	477	335	0	4	1	0	0
TIS-24	142	143	1	1	3	3	0	0
TIS-24	142	348	206	1	3	2	1	4
TIS-24	143	156	13	1	4	5	1	0
TIS-24	145	170	25	1	1	1	0	0
TIS-24	145	178	33	1	1	1	1	0
TIS-25	145	157	12	1	4	1	0	0
TIS-25	149	477	328	0	5	4	0	0
TIS-25	155	198	43	1	3	2	1	0
TIS-25	162	253	91	1	3	1	1	1
TIS-25	163	164	1	1	4	4	1	0
TIS-25	164	477	313	0	3	4	0	0
TIS-25	165	318	153	1	3	2	0	1
TIS-25	172	308	136	1	3	4	0	0
TIS-25	178	179	1	1	1	1	1	0
TIS-25	179	242	63	1	3	4	0	2
TIS-26	183	224	41	1	3	1	0	1
TIS-26	185	477	292	0	3	1	0	0
TIS-26	185	304	119	1	4	1	1	0
TIS-26	186	200	14	1	2	1	1	2
TIS-26	186	238	52	1	3	4	0	0
TIS-26	186	477	291	0	1	1	0	0
TIS-26	186	189	3	1	4	4	1	0
TIS-26	188	333	145	1	3	4	0	0
TIS-26	189	190	1	1	3	1	0	0
TIS-26	202	205	3	1	3	1	1	0
TIS-27	206	222	16	1	3	1	1	1
TIS-27	206	477	271	0	3	2	0	2
TIS-27	206	249	43	1	3	5	1	1
TIS-27	206	268	62	1	3	5	0	1
TIS-27	206	290	84	1	3	5	1	0
TIS-27	206	276	70	1	3	5	0	0
TIS-27	206	477	271	0	3	5	0	0
TIS-27	206	477	271	0	3	5	0	0
TIS-27	206	477	271	0	3	5	0	0
TIS-27	206	282	76	1	3	5	1	0
TIS-28	206	477	271	0	3	5	0	0
TIS-28	206	210	4	1	3	1	1	0
TIS-28	206	477	271	0	3	5	0	0
TIS-28	206	477	271	0	3	4	0	1
TIS-28	207	211	4	1	3	1	1	0
TIS-28	207	217	10	1	3	1	1	0
TIS-28	209	212	3	1	3	1	1	0
TIS-28	211	252	41	1	3	1	0	1
TIS-28	212	218	6	1	4	4	1	0
TIS-28	213	214	1	1	3	1	1	0
TIS-29	215	224	9	1	3	1	1	0
TIS-29	215	234	19	1	3	1	1	0
TIS-29	217	218	1	1	3	1	1	0
TIS-29	217	218	1	1	3	1	1	0
TIS-29	218	270	52	1	1	4	1	0
TIS-29	219	228	9	1	3	4	1	0
TIS-29	219	477	258	0	3	1	1	0
TIS-29	219	477	258	0	3	4	0	0
TIS-29	221	222	1	1	3	1	1	0
TIS-29	225	226	1	1	4	1	1	0
TIS-30	225	245	20	1	3	5	0	0
TIS-30	228	242	14	1	3	1	1	1
TIS-30	233	235	2	1	3	4	0	1
TIS-30	235	252	17	1	3	1	1	0
TIS-30	235	269	34	1	3	4	1	1
TIS-30	240	252	12	1	3	5	1	1
TIS-30	240	280	40	1	3	5	1	0
TIS-30	241	477	236	0	4	4	0	0
TIS-30	242	477	235	0	3	1	0	0
TIS-30	245	319	74	1	3	1	0	0
TIS-31	245	253	8	1	3	1	1	0
TIS-31	249	281	32	1	2	1	0	2
TIS-31	249	252	3	1	3	1	0	1
TIS-31	252	253	1	1	3	1	0	1
TIS-31	252	253	1	1	3	4	1	1
TIS-31	254	259	5	1	3	5	1	0
TIS-31	254	266	12	1	3	4	1	1
TIS-31	255	262	7	1	3	5	1	1
TIS-31	255	268	13	1	3	1	0	0
TIS-31	255	260	5	1	5	3	0	0
TIS-32	256	477	221	0	3	5	0	0
TIS-32	259	267	8	1	4	4	1	0
TIS-32	259	260	1	1	3	4	0	0
TIS-32	259	260	1	1	3	4	0	0
TIS-32	259	262	3	1	3	4	0	0
TIS-32	260	261	1	1	4	4	0	0
TIS-32	261	347	86	1	3	4	1	0
TIS-32	262	274	12	1	4	1	0	0
TIS-32	265	477	212	0	3	1	1	0
TIS-32	266	477	211	0	3	1	1	0
TIS-33	266	270	4	1	3	3	0	1
TIS-33	267	294	27	1	3	1	1	1
TIS-33	267	269	2	1	3	5	0	1
TIS-33	267	333	66	1	3	2	0	0
TIS-33	268	296	28	1	3	5	1	0
TIS-33	269	276	7	1	3	3	1	0
TIS-33	269	277	8	1	3	1	1	1
TIS-33	274	280	6	1	3	1	1	2
TIS-33	275	294	19	1	3	5	1	0
TIS-33	276	477	201	0	4	4	0	0
TIS-34	277	278	1	1	3	1	1	0
TIS-34	277	278	1	1	3	1	1	1
TIS-34	277	305	28	1	3	5	1	0
TIS-34	280	477	197	0	3	4	0	0
TIS-34	280	318	38	1	3	4	0	0
TIS-34	282	434	152	1	3	1	1	2
TIS-34	282	477	195	0	3	1	0	0
TIS-34	283	284	1	1	3	4	1	0
TIS-34	283	284	1	1	3	1	1	1
TIS-34	283	303	20	1	3	3	0	0
TIS-35	284	477	193	0	4	4	0	0
TIS-35	284	477	193	0	5	1	0	0
TIS-35	287	324	37	1	3	4	1	1
TIS-35	288	293	5	1	3	4	1	0
TIS-35	288	290	2	1	4	5	1	0
TIS-35	289	290	1	1	3	1	1	3
TIS-35	289	291	2	1	3	4	1	0
TIS-35	290	292	2	1	3	5	1	0
TIS-35	290	477	187	0	4	3	0	0
TIS-35	291	338	47	1	3	4	1	1
TIS-36	291	375	84	1	3	1	0	0
TIS-36	291	294	3	1	3	1	1	0
TIS-36	291	308	17	1	3	4	1	0
TIS-36	291	294	3	1	1	4	1	1
TIS-36	294	295	1	1	3	4	1	1
TIS-36	294	320	26	1	3	4	1	0
TIS-36	294	295	1	1	3	1	1	1
TIS-36	295	477	182	0	3	1	0	0
TIS-36	295	296	1	1	3	1	1	1
TIS-36	295	298	3	1	3	5	1	0
TIS-37	296	324	28	1	3	1	0	0
TIS-37	296	297	1	1	3	4	1	1
TIS-37	297	367	70	1	3	3	1	1
TIS-37	297	298	1	1	3	4	1	1
TIS-37	297	298	1	1	3	5	1	1
TIS-37	297	316	19	1	3	5	1	1
TIS-37	297	477	180	0	3	5	0	0
TIS-37	298	301	3	1	1	1	1	0
TIS-37	298	338	40	1	3	4	1	1
TIS-37	301	302	1	1	3	4	1	0
TIS-38	301	477	176	0	4	4	0	0
TIS-38	302	306	4	1	4	4	1	0
TIS-38	303	332	29	1	3	1	1	2
TIS-38	303	477	174	0	4	5	0	0
TIS-38	304	319	15	1	3	4	1	0
TIS-38	304	364	60	1	3	5	1	1
TIS-38	305	477	172	0	4	4	0	0
TIS-38	305	477	172	0	3	1	0	0
TIS-39	305	477	172	0	5	3	0	0
TIS-39	305	332	27	1	5	3	0	0
TIS-39	308	311	3	1	3	1	0	1
TIS-39	309	318	9	1	4	1	0	0
TIS-39	309	310	1	1	3	1	1	0
TIS-39	309	310	1	1	3	4	1	0
TIS-39	310	311	1	1	3	4	1	1
TIS-39	310	397	87	1	4	4	1	0
TIS-39	310	312	2	1	3	1	1	0
TIS-39	311	316	5	1	3	4	1	0
TIS-40	311	477	166	0	3	5	0	0
TIS-40	311	312	1	1	3	1	1	0
TIS-40	311	340	29	1	3	4	1	1
TIS-40	312	324	12	1	3	1	0	1
TIS-40	312	313	1	1	3	1	1	1
TIS-40	312	313	1	1	2	4	1	2
TIS-40	312	318	6	1	3	4	1	1
TIS-40	315	477	162	0	3	1	0	1
TIS-40	315	477	162	0	3	1	0	0
TIS-40	315	320	5	1	3	1	1	0
TIS-41	316	324	8	1	3	1	1	0
TIS-41	316	411	95	1	5	4	1	0
TIS-41	316	388	72	1	3	4	0	0
TIS-41	318	477	159	0	3	4	0	0
TIS-41	318	389	71	1	3	5	1	0
TIS-41	318	319	1	1	3	5	1	0
TIS-41	318	389	71	1	3	5	1	0
TIS-41	318	389	71	1	3	5	1	0
TIS-41	318	477	159	0	3	1	1	0
TIS-41	318	319	1	1	3	1	0	0
TIS-42	318	477	159	0	3	1	0	0
TIS-42	318	320	2	1	1	3	1	0
TIS-42	318	319	1	1	3	5	1	0
TIS-42	318	364	46	1	3	3	0	0
TIS-42	318	449	131	1	3	3	0	0
TIS-42	318	393	75	1	5	4	0	0
TIS-42	319	406	87	1	3	1	0	0
TIS-42	319	330	11	1	3	4	1	0
TIS-42	319	477	158	0	3	4	0	0
TIS-42	322	323	1	1	3	1	0	0
TIS-43	322	325	3	1	3	1	1	0
TIS-43	322	340	18	1	3	1	0	0
TIS-43	322	323	1	1	1	1	0	2
TIS-43	324	333	9	1	3	4	0	1
TIS-43	330	477	147	0	3	1	0	0
TIS-43	330	477	147	0	3	1	0	0
TIS-43	330	340	10	1	3	1	0	0
TIS-43	330	477	147	0	3	2	0	0
TIS-43	330	334	4	1	4	1	1	0
TIS-43	331	333	2	1	3	1	1	0
TIS-44	332	333	1	1	3	4	0	0
TIS-44	332	366	34	1	3	5	1	0
TIS-44	332	333	1	1	3	4	1	1
TIS-44	332	336	4	1	3	1	1	0
TIS-44	333	337	4	1	4	4	1	0
TIS-44	333	346	13	1	3	3	1	0
TIS-44	333	334	1	1	3	3	2	0
TIS-44	336	339	3	1	3	1	1	1
TIS-44	337	338	1	1	2	1	1	0
TIS-44	338	339	1	1	4	4	1	0
TIS-45	338	339	1	1	4	4	1	0
TIS-45	340	477	137	0	5	3	0	0
TIS-45	340	347	7	1	4	1	1	0
TIS-45	341	344	3	1	3	1	1	0
TIS-45	346	353	7	1	3	1	1	2
TIS-45	347	477	130	0	3	4	0	0
TIS-45	350	353	3	1	1	1	1	0
TIS-45	351	477	126	0	3	1	0	0
TIS-45	351	477	126	0	3	1	0	0
TIS-45	352	437	85	1	3	4	1	1
TIS-46	353	394	41	1	3	1	0	0
TIS-46	353	375	22	1	3	1	0	1
TIS-46	353	361	8	1	3	1	0	0
TIS-46	354	434	80	1	5	4	1	0
TIS-46	354	361	7	1	3	1	1	0
TIS-46	360	477	117	0	3	1	1	0
TIS-46	360	477	117	0	4	1	0	0
EF-196	1	4	3	1	5	3	1	0
EF-197	4	93	89	1	3	5	0	0
EF-197	8	10	2	1	4	1	0	0
EF-197	10	11	1	1	3	1	0	0
EF-197	16	27	11	1	1	3	1	0
EF-197	24	93	69	1	3	5	0	0
EF-197	24	162	138	1	1	3	1	0
EF-197	24	162	138	1	1	3	0	0
EF-197	31	45	14	1	4	1	0	0
EF-197	32	477	445	0	3	2	0	1
EF-197	43	477	434	0	1	4	0	0
EF-198	44	477	433	0	2	1	0	0
EF-198	58	477	419	0	3	1	0	0
EF-198	66	72	6	1	4	5	1	0
EF-198	66	72	6	1	4	5	0	0
EF-198	66	72	6	1	4	5	0	0
EF-198	66	72	6	1	4	5	1	0
EF-198	70	72	2	1	5	5	1	0
EF-198	71	72	1	1	5	3	1	0
EF-198	71	477	406	0	3	1	0	0
EF-198	71	93	22	1	3	5	0	0
EF-199	71	85	14	1	5	5	0	0
EF-199	71	149	78	1	3	5	1	0
EF-199	74	114	40	1	1	3	1	0
EF-199	74	75	1	1	5	5	0	0
EF-199	74	75	1	1	5	5	0	0
EF-199	74	75	1	1	5	5	0	0
EF-199	77	116	39	1	5	5	1	0
EF-199	84	86	2	1	5	5	1	0
EF-199	84	110	26	1	1	3	1	0
EF-199	93	115	22	1	3	5	1	1
EF-200	93	115	22	1	3	5	1	1
EF-200	93	99	6	1	4	3	1	0
EF-200	95	105	10	1	3	5	1	0
EF-200	106	477	371	0	3	5	1	0
EF-200	106	477	371	0	4	1	0	0
EF-200	109	112	3	1	5	5	1	0
EF-200	109	477	368	0	5	5	0	1
EF-200	110	477	367	0	3	5	0	0
EF-200	110	477	367	0	3	5	0	0
EF-200	113	114	1	1	5	5	1	0
EF-201	113	116	3	1	5	5	1	0
EF-201	114	477	363	0	3	4	0	0
EF-201	115	477	362	0	4	4	1	0
EF-201	117	118	1	1	5	1	1	0
EF-201	117	118	1	1	3	1	1	1
EF-201	121	477	356	0	3	5	0	0
EF-201	123	156	33	1	3	1	1	0
EF-201	131	477	346	0	1	1	1	0
EF-201	136	149	13	1	3	1	1	0
EF-201	137	477	340	0	3	1	0	0
EF-202	140	477	337	0	3	4	0	0
EF-202	140	169	29	1	3	4	0	0
EF-202	141	477	336	0	3	1	0	0
EF-202	142	477	335	0	3	2	1	2
EF-202	142	477	335	0	3	5	1	1
EF-202	142	477	335	0	3	5	1	1
EF-202	143	477	334	0	3	5	1	0
EF-202	144	477	333	0	3	1	0	0
EF-202	150	477	327	0	3	5	1	0
EF-202	150	477	327	0	4	1	0	0
EF-203	151	169	18	1	3	1	0	0
EF-203	154	177	23	1	3	4	0	0
EF-203	155	477	322	0	3	1	0	0
EF-203	155	477	322	0	3	2	0	0
EF-203	155	477	322	0	3	1	0	0
EF-203	158	477	319	0	3	1	0	0
EF-203	159	477	318	0	3	2	0	0
EF-203	161	477	316	0	3	1	0	0
EF-203	170	477	307	0	3	1	0	0
EF-203	171	477	306	0	3	4	0	0
EF-204	172	477	305	0	3	1	0	0
EF-204	189	218	29	1	4	1	0	0
EF-204	194	477	283	0	4	4	0	0
EF-204	226	477	251	0	3	2	1	0
EF-204	249	477	228	0	4	1	0	0
EF-204	267	477	210	0	4	1	0	0
EF-204	273	477	204	0	3	3	0	0
EF-204	275	281	6	1	3	3	0	0
EF-204	278	477	199	0	4	1	0	0
EF-204	283	477	194	0	3	3	0	1
EF-205	283	477	194	0	3	5	0	0
EF-205	283	477	194	0	3	5	0	0
EF-205	289	477	188	0	3	3	0	1
EF-205	289	477	188	0	3	3	0	1
VER-45	41	477	436	0	4	5	0	0
VER-45	41	477	436	0	4	5	0	0
VER-45	45	477	432	0	4	5	0	0
VER-45	45	477	432	0	4	5	0	0
VER-45	45	477	432	0	4	5	0	0
VER-45	45	477	432	0	4	5	0	0
VER-45	45	477	432	0	4	5	0	0
VER-45	45	477	432	0	4	5	0	0
VER-45	45	477	432	0	4	5	0	0
VER-45	45	477	432	0	4	5	0	0
VER-46	45	477	432	0	4	5	0	0
VER-46	45	477	432	0	4	5	0	0
VER-46	45	477	432	0	4	5	0	0
VER-46	45	477	432	0	4	5	0	0
VER-46	45	477	432	0	4	5	0	0
VER-46	79	477	398	0	3	1	0	0
VER-46	132	477	345	0	4	1	0	0
VER-46	307	477	170	0	4	1	0	0
G-4	6	10	4	1	5	2	0	1
G-4	6	11	5	1	5	4	1	0
G-4	9	10	1	1	5	4	1	1
G-4	9	477	468	0	4	1	0	0
G-4	10	25	15	1	5	5	1	0
G-4	10	25	15	1	1	5	1	0
G-4	12	25	13	1	4	5	1	0
G-4	22	225	203	1	4	3	1	0
G-4	205	477	272	0	4	5	0	0
G-5	206	219	13	1	4	4	1	1
G-5	218	264	46	1	4	4	1	1
G-5	218	318	100	1	3	1	1	0
G-5	221	222	1	1	3	5	1	0
G-5	226	477	251	0	4	4	0	0
G-5	226	227	1	1	5	1	1	0
G-5	227	235	8	1	3	1	1	0
G-5	266	330	64	1	4	4	1	2
G-5	276	312	36	1	3	5	1	1
G-5	278	297	19	1	3	4	1	0
G-6	319	320	1	1	4	3	1	0
G-6	319	323	4	1	5	4	1	0
G-6	319	331	12	1	4	2	1	0
G-6	323	330	7	1	5	3	1	0
G-6	326	327	1	1	4	4	1	0
G-6	326	332	6	1	1	3	0	0
CKETMQ-35	0	477	477	0	3	4	0	0
CKETMQ-35	4	477	473	0	4	4	1	0
CKETMQ-35	9	56	47	1	3	3	0	0
CKETMQ-35	10	477	467	0	3	2	1	0
CKETMQ-35	14	477	463	0	3	1	1	0
CKETMQ-35	15	477	462	0	3	1	0	0
CKETMQ-35	21	64	43	1	3	4	0	0
CKETMQ-35	21	477	456	0	3	2	0	0
CKETMQ-35	21	477	456	0	3	2	0	0
CKETMQ-35	22	477	455	0	3	4	1	0
CKETMQ-36	23	477	454	0	3	1	0	0
CKETMQ-36	24	477	453	0	3	2	0	0
CKETMQ-36	25	477	452	0	3	1	0	0
CKETMQ-36	28	477	449	0	4	4	0	0
CKETMQ-36	32	33	1	1	3	1	0	0
CKETMQ-36	36	477	441	0	3	4	0	0
CKETMQ-36	37	41	4	1	3	1	0	0
CKETMQ-36	39	477	438	0	3	2	1	0
CKETMQ-36	41	477	436	0	3	1	0	0
CKETMQ-36	42	477	435	0	3	1	0	0
CKETMQ-37	43	477	434	0	4	4	0	0
CKETMQ-37	55	56	1	1	5	1	0	0
CKETMQ-37	56	477	421	0	4	4	0	0
CKETMQ-37	57	59	2	1	4	1	1	0
CKETMQ-37	58	477	419	0	3	1	0	0
CKETMQ-37	59	477	418	0	3	1	0	0
CKETMQ-37	59	477	418	0	3	2	0	0
CKETMQ-37	59	477	418	0	3	2	0	0
CKETMQ-37	59	60	1	1	3	2	0	0
CKETMQ-37	60	477	417	0	3	2	0	0
CKETMQ-38	60	477	417	0	3	2	0	0
CKETMQ-38	62	477	415	0	3	2	1	0
CKETMQ-38	62	477	415	0	3	2	1	0
CKETMQ-38	69	477	408	0	3	2	0	0
CKETMQ-38	69	477	408	0	3	4	0	0
CKETMQ-38	75	477	402	0	3	2	0	0
CKETMQ-38	75	477	402	0	3	2	0	0
CKETMQ-38	78	477	399	0	1	4	0	0
L-211	48	55	7	1	1	1	0	0
L-211	168	169	1	1	2	5	0	0
L-211	168	169	1	1	3	5	0	0
L-212	207	208	1	1	3	3	0	0
L-212	286	287	1	1	3	1	1	0
L-212	293	477	184	0	3	4	0	0
L-212	342	343	1	1	3	1	1	0
L-212	342	348	6	1	3	4	1	0
A-41	2	477	475	0	3	3	0	0
A-41	3	477	474	0	4	1	0	0
A-42	3	477	474	0	3	1	0	0
A-42	4	7	3	1	5	4	1	1
A-42	4	7	3	1	5	1	1	1
A-42	7	477	470	0	3	3	0	0
A-42	7	477	470	0	3	5	0	0
A-42	7	477	470	0	3	5	0	0
A-42	7	477	470	0	3	3	0	0
A-42	7	15	8	1	3	1	1	0
A-42	7	15	8	1	3	1	1	0
A-42	8	477	469	0	4	4	0	0
A-43	9	477	468	0	3	1	0	0
A-43	9	477	468	0	3	2	0	0
A-43	9	477	468	0	3	2	0	1
A-43	10	477	467	0	3	5	0	0
A-43	10	477	467	0	3	5	0	0
A-43	10	477	467	0	3	5	0	0
A-43	10	477	467	0	3	5	0	0
A-43	10	477	467	0	3	5	0	0
A-43	10	477	467	0	3	5	0	0
A-43	10	477	467	0	3	5	0	0
A-44	10	29	19	1	3	3	1	0
A-44	10	477	467	0	3	4	0	0
A-44	11	17	6	1	3	3	1	0
A-44	11	106	95	1	3	3	0	0
A-44	11	12	1	1	3	5	0	0
A-44	11	12	1	1	3	5	0	0
A-44	15	38	23	1	3	5	0	0
A-44	15	32	17	1	3	1	1	0
A-44	17	22	5	1	3	5	0	0
A-44	17	18	1	1	3	5	0	2
A-45	17	23	6	1	3	5	0	2
A-45	17	29	12	1	3	5	0	3
A-45	17	22	5	1	3	5	0	1
A-45	17	29	12	1	3	5	0	2
A-45	17	21	4	1	3	5	0	0
A-45	22	23	1	1	3	5	0	0
A-45	22	29	7	1	3	5	0	0
A-45	22	477	455	0	3	1	1	0
A-45	24	29	5	1	3	5	0	0
A-45	24	32	8	1	3	1	1	0
A-46	31	477	446	0	3	2	0	1
A-46	32	38	6	1	4	1	1	0
A-46	38	39	1	1	3	5	0	0
A-46	38	39	1	1	3	5	0	0
A-46	38	39	1	1	3	5	0	0
A-46	43	477	434	0	3	4	0	0
A-46	45	106	61	1	3	4	0	0
A-46	45	106	61	1	3	1	0	0
A-46	46	49	3	1	3	4	1	0
A-46	46	106	60	1	3	1	0	0
A-47	53	477	424	0	3	1	0	0
A-47	53	477	424	0	4	4	0	0
A-47	56	106	50	1	4	1	0	1
A-47	70	71	1	1	3	1	0	0
A-47	70	73	3	1	3	3	0	0
A-47	72	477	405	0	3	5	0	1
A-47	73	106	33	1	1	5	0	0
A-47	79	477	398	0	4	4	1	1
A-47	79	477	398	0	3	5	1	0
A-47	79	477	398	0	3	5	1	0
A-48	79	477	398	0	3	5	1	0
A-48	79	477	398	0	3	5	1	0
A-48	79	477	398	0	3	5	1	0
A-48	81	477	396	0	4	4	0	1
A-48	95	477	382	0	3	4	0	0
A-48	100	106	6	1	3	1	2	1
A-48	105	113	8	1	3	3	0	0
A-48	106	135	29	1	3	2	1	1
A-48	106	120	14	1	3	1	1	0
A-48	107	120	13	1	3	4	1	1
A-49	108	477	369	0	3	4	0	0
A-49	113	120	7	1	3	4	1	0
A-49	113	135	22	1	3	1	1	0
A-49	120	477	357	0	3	4	0	0
A-49	127	135	8	1	3	1	0	0
A-49	134	477	343	0	3	1	0	0
A-49	135	477	342	0	3	4	1	0
A-49	141	340	199	1	3	1	1	0
A-49	151	477	326	0	3	2	1	0
A-49	182	477	295	0	4	4	0	0
A-50	184	477	293	0	5	4	0	0
A-50	256	477	221	0	5	4	0	0
A-50	260	477	217	0	3	3	0	0
A-50	260	328	68	1	3	5	0	0
A-50	261	477	216	0	3	5	0	0
A-50	261	477	216	0	3	5	0	0
A-50	261	477	216	0	3	5	0	0
A-50	261	477	216	0	3	5	0	0
A-50	261	477	216	0	3	5	0	0
A-50	277	477	200	0	3	3	0	0
A-51	310	477	167	0	3	1	0	0
A-51	310	477	167	0	3	4	0	0
A-51	310	477	167	0	5	4	0	0
A-51	311	477	166	0	3	2	0	0
GRAPH-17	23	42	19	1	4	2	0	0
GRAPH-17	43	44	1	1	5	1	0	0
GRAPH-17	52	57	5	1	3	2	0	0
GRAPH-17	56	65	9	1	3	1	0	0
GRAPH-17	56	57	1	1	4	1	0	0
GRAPH-18	56	88	32	1	4	5	0	0
GRAPH-18	56	79	23	1	3	1	0	0
GRAPH-18	63	72	9	1	3	4	0	0
GRAPH-18	73	91	18	1	3	2	0	0
GRAPH-18	78	477	399	0	4	1	0	0
GRAPH-18	79	477	398	0	3	2	0	0
GRAPH-18	79	80	1	1	4	1	0	0
GRAPH-18	80	477	397	0	5	4	0	0
GRAPH-18	81	86	5	1	3	1	0	0
GRAPH-18	86	87	1	1	4	1	0	0
GRAPH-19	86	88	2	1	5	3	0	0
GRAPH-19	87	88	1	1	4	4	0	0
GRAPH-19	87	88	1	1	3	1	0	0
GRAPH-19	88	113	25	1	3	4	0	0
GRAPH-19	88	477	389	0	4	1	0	0
GRAPH-19	88	89	1	1	3	1	0	0
GRAPH-19	88	100	12	1	3	4	0	0
GRAPH-19	88	99	11	1	3	5	0	0
GRAPH-19	90	98	8	1	4	4	0	0
GRAPH-19	91	94	3	1	3	4	0	0
GRAPH-20	92	477	385	0	4	4	0	0
GRAPH-20	93	112	19	1	3	5	0	0
GRAPH-20	95	168	73	1	4	2	0	0
GRAPH-20	99	190	91	1	4	4	0	0
GRAPH-20	99	107	8	1	4	4	0	0
GRAPH-20	99	112	13	1	4	5	0	0
GRAPH-20	100	133	33	1	3	2	0	0
GRAPH-20	106	112	6	1	4	4	0	0
GRAPH-20	106	477	371	0	4	4	0	0
GRAPH-20	109	113	4	1	4	4	0	0
GRAPH-21	114	115	1	1	4	4	0	0
GRAPH-21	116	122	6	1	4	4	0	0
GRAPH-21	121	122	1	1	5	3	0	0
GRAPH-21	127	130	3	1	3	4	0	0
GRAPH-21	134	154	20	1	5	5	0	0
GRAPH-21	142	154	12	1	4	4	0	0
GRAPH-21	149	168	19	1	4	4	0	0
GRAPH-21	151	477	326	0	4	4	0	0
GRAPH-21	157	168	11	1	4	5	0	0
GRAPH-21	158	168	10	1	4	2	0	0
GRAPH-22	161	165	4	1	4	1	0	0
GRAPH-22	164	171	7	1	4	4	0	0
GRAPH-22	165	168	3	1	4	2	0	0
GRAPH-22	165	171	6	1	3	2	0	0
GRAPH-22	168	477	309	0	4	3	0	0
GRAPH-22	168	477	309	0	4	5	0	0
GRAPH-22	169	339	170	1	4	2	0	0
GRAPH-22	171	172	1	1	5	1	0	0
GRAPH-22	171	172	1	1	5	1	0	0
GRAPH-22	178	190	12	1	4	3	0	0
GRAPH-23	182	193	11	1	4	1	0	0
GRAPH-23	186	193	7	1	4	4	0	0
GRAPH-23	186	477	291	0	4	4	0	0
GRAPH-23	189	477	288	0	3	5	0	0
GRAPH-23	212	477	265	0	4	4	0	0
GRAPH-23	214	316	102	1	5	4	0	0
GRAPH-23	224	238	14	1	5	4	0	0
GRAPH-23	240	477	237	0	4	1	0	0
GRAPH-23	241	477	236	0	3	5	0	0
GRAPH-23	241	477	236	0	3	4	0	0
GRAPH-24	248	477	229	0	3	4	0	0
GRAPH-24	261	477	216	0	4	2	0	0
GRAPH-24	272	477	205	0	4	5	0	0
GRAPH-24	290	477	187	0	4	1	0	0
GRAPH-24	294	477	183	0	2	1	0	0
GRAPH-24	305	477	172	0	4	3	0	0
GRAPH-24	316	477	161	0	4	3	0	0
GRAPH-24	316	477	161	0	3	2	0	0
GRAPH-24	325	477	152	0	4	3	0	0
GRAPH-24	326	477	151	0	4	5	0	0
GRAPH-25	346	477	131	0	3	4	1	0
GRAPH-25	353	477	124	0	4	5	0	0
GRAPH-25	360	477	117	0	3	4	0	0
MOA-7	277	477	200	0	4	3	0	0
MZA-154	1	29	28	1	3	1	1	0
MZA-154	1	477	476	0	2	1	0	2
MZA-155	1	74	73	1	3	1	1	0
MZA-155	4	477	473	0	3	1	1	0
MZA-155	5	74	69	1	3	5	0	0
MZA-155	8	74	66	1	3	1	0	0
MZA-155	10	463	453	1	3	2	0	2
MZA-155	10	46	36	1	3	4	0	0
MZA-155	11	16	5	1	3	1	1	1
MZA-155	15	53	38	1	3	1	1	0
MZA-155	16	17	1	1	3	1	1	0
MZA-155	16	477	461	0	3	5	0	0
MZA-156	16	74	58	1	3	1	0	0
MZA-156	17	74	57	1	3	1	0	0
MZA-156	22	477	455	0	3	1	0	0
MZA-156	22	127	105	1	3	4	1	0
MZA-156	22	46	24	1	3	1	0	1
MZA-156	23	477	454	0	3	1	0	0
MZA-156	23	477	454	0	3	1	0	0
MZA-156	23	25	2	1	3	1	1	0
MZA-156	24	74	50	1	3	1	0	0
MZA-156	24	30	6	1	3	1	1	0
MZA-157	24	477	453	0	3	4	1	0
MZA-157	24	134	110	1	3	1	0	0
MZA-157	24	43	19	1	3	1	1	0
MZA-157	24	477	453	0	3	4	0	0
MZA-157	24	477	453	0	3	5	0	0
MZA-157	24	477	453	0	3	5	0	0
MZA-157	24	477	453	0	3	5	0	0
MZA-157	25	477	452	0	3	1	0	0
MZA-157	25	30	5	1	3	1	1	0
MZA-157	29	32	3	1	3	1	0	0
MZA-158	30	477	447	0	3	1	0	0
MZA-158	32	477	445	0	3	1	0	0
MZA-158	42	116	74	1	3	1	1	0
MZA-158	43	477	434	0	3	1	0	0
MZA-158	43	101	58	1	3	1	0	0
MZA-158	43	477	434	0	3	1	0	0
MZA-158	43	477	434	0	4	1	0	0
MZA-158	43	477	434	0	3	1	0	0
MZA-158	45	63	18	1	4	4	0	0
MZA-158	46	74	28	1	3	4	0	0
MZA-159	50	477	427	0	3	1	1	0
MZA-159	51	477	426	0	3	1	0	0
MZA-159	52	63	11	1	3	4	0	0
MZA-159	52	64	12	1	3	4	0	0
MZA-159	53	63	10	1	3	4	0	0
MZA-159	53	63	10	1	3	1	1	0
MZA-159	57	477	420	0	3	1	0	0
MZA-159	60	63	3	1	4	1	0	0
MZA-159	63	87	24	1	3	1	1	0
MZA-160	63	64	1	1	3	1	0	0
MZA-160	64	477	413	0	3	3	0	4
MZA-160	65	66	1	1	4	3	1	0
MZA-160	65	477	412	0	3	1	0	1
MZA-160	65	477	412	0	3	1	0	1
MZA-160	65	477	412	0	3	1	0	1
MZA-160	65	477	412	0	3	1	0	1
MZA-160	65	74	9	1	3	1	0	0
MZA-160	66	74	8	1	3	1	0	1
MZA-160	67	112	45	1	3	5	0	0
MZA-161	67	136	69	1	3	4	0	0
MZA-161	69	72	3	1	3	1	0	0
MZA-161	69	283	214	1	3	1	1	1
MZA-161	69	477	408	0	3	1	0	1
MZA-161	69	477	408	0	3	1	0	1
MZA-161	70	74	4	1	3	1	0	0
MZA-161	70	477	407	0	3	1	0	1
MZA-161	70	477	407	0	3	1	0	1
MZA-161	71	72	1	1	3	1	0	0
MZA-161	71	109	38	1	3	1	0	1
MZA-162	71	477	406	0	3	1	0	1
MZA-162	73	141	68	1	3	1	0	0
MZA-162	73	74	1	1	3	1	0	0
MZA-162	79	80	1	1	3	3	0	0
MZA-162	79	109	30	1	3	1	1	0
MZA-162	79	113	34	1	3	5	1	0
MZA-162	79	477	398	0	3	1	0	0
MZA-162	80	134	54	1	3	1	2	0
MZA-162	80	477	397	0	3	1	0	0
MZA-162	85	350	265	1	3	2	1	0
MZA-163	86	87	1	1	3	4	0	0
MZA-163	86	87	1	1	3	1	0	0
MZA-163	87	134	47	1	4	1	1	0
MZA-163	88	477	389	0	3	1	0	0
MZA-163	92	477	385	0	3	1	0	0
MZA-163	93	477	384	0	3	1	0	0
MZA-163	93	477	384	0	4	1	0	0
MZA-163	93	477	384	0	3	4	0	0
MZA-163	93	338	245	1	3	1	1	0
MZA-163	95	477	382	0	3	1	0	0
MZA-164	95	134	39	1	3	1	1	0
MZA-164	98	477	379	0	3	1	0	1
MZA-164	98	477	379	0	3	1	0	0
MZA-164	99	134	35	1	3	1	0	0
MZA-164	99	477	378	0	3	1	0	1
MZA-164	100	119	19	1	3	1	1	0
MZA-164	100	477	377	0	3	1	0	0
MZA-164	100	119	19	1	3	1	1	0
MZA-164	101	175	74	1	3	2	1	0
MZA-164	101	119	18	1	3	5	1	0
MZA-165	101	119	18	1	3	1	1	1
MZA-165	101	109	8	1	3	1	1	4
MZA-165	101	477	376	0	3	1	0	1
MZA-165	101	127	26	1	3	1	1	0
MZA-165	101	477	376	0	4	4	0	0
MZA-165	101	477	376	0	3	1	0	0
MZA-165	102	112	10	1	3	1	1	0
MZA-165	102	442	340	1	3	1	0	0
MZA-165	104	477	373	0	3	4	1	0
MZA-165	105	144	39	1	3	4	1	0
MZA-166	105	477	372	0	4	1	0	1
MZA-166	105	442	337	1	3	1	0	1
MZA-166	105	442	337	1	3	4	0	0
MZA-166	105	477	372	0	3	1	0	0
MZA-166	106	119	13	1	3	1	1	0
MZA-166	106	198	92	1	3	1	1	0
MZA-166	106	107	1	1	3	1	0	0
MZA-166	107	112	5	1	3	1	1	0
MZA-166	107	477	370	0	3	1	0	0
MZA-166	108	142	34	1	3	1	0	0
MZA-167	109	163	54	1	3	4	1	0
MZA-167	109	119	10	1	3	4	1	0
MZA-167	109	477	368	0	3	1	0	0
MZA-167	109	113	4	1	3	5	1	0
MZA-167	109	113	4	1	3	5	1	0
MZA-167	109	113	4	1	3	5	1	0
MZA-167	109	113	4	1	3	4	1	0
MZA-167	109	205	96	1	4	4	1	0
MZA-167	109	477	368	0	3	4	0	0
MZA-167	112	477	365	0	3	1	0	1
MZA-168	112	113	1	1	3	1	0	1
MZA-168	112	119	7	1	3	1	1	1
MZA-168	112	477	365	0	4	1	1	1
MZA-168	112	477	365	0	4	4	1	0
MZA-168	112	442	330	1	3	1	0	0
MZA-168	113	114	1	1	3	1	1	0
MZA-168	113	114	1	1	3	1	1	0
MZA-168	114	134	20	1	3	5	1	0
MZA-168	114	116	2	1	3	4	1	0
MZA-168	116	119	3	1	3	1	1	0
MZA-169	116	477	361	0	4	4	0	0
MZA-169	116	127	11	1	3	1	1	0
MZA-169	119	134	15	1	3	1	2	0
MZA-169	119	120	1	1	3	1	0	1
MZA-169	120	477	357	0	3	1	0	0
MZA-169	120	127	7	1	3	1	1	0
MZA-169	121	133	12	1	3	1	1	1
MZA-169	121	477	356	0	4	1	0	0
MZA-169	123	124	1	1	3	1	0	0
MZA-169	123	124	1	1	3	5	2	0
MZA-170	124	134	10	1	3	4	1	0
MZA-170	126	477	351	0	3	3	0	0
MZA-170	126	134	8	1	3	3	1	0
MZA-170	126	127	1	1	3	3	1	0
MZA-170	127	134	7	1	3	3	1	0
MZA-170	127	134	7	1	3	3	1	0
MZA-170	127	128	1	1	3	4	0	0
MZA-170	128	442	314	1	4	1	0	0
MZA-170	128	477	349	0	3	4	0	0
MZA-170	128	163	35	1	3	4	1	0
MZA-171	128	477	349	0	3	1	0	1
MZA-171	129	134	5	1	3	1	0	0
MZA-171	130	140	10	1	3	1	0	0
MZA-171	131	477	346	0	3	1	1	0
MZA-171	133	352	219	1	3	4	1	0
MZA-171	134	136	2	1	3	4	1	0
MZA-171	134	477	343	0	3	4	0	0
MZA-171	135	477	342	0	3	1	0	0
MZA-171	136	173	37	1	3	1	1	0
MZA-171	136	442	306	1	3	4	0	0
MZA-172	136	442	306	1	3	1	0	0
MZA-172	139	477	338	0	3	1	1	0
MZA-172	140	141	1	1	3	2	0	0
MZA-172	140	141	1	1	3	1	0	0
MZA-172	140	477	337	0	3	1	0	0
MZA-172	141	143	2	1	3	1	0	0
MZA-172	142	175	33	1	3	4	1	0
MZA-172	142	143	1	1	3	1	0	0
MZA-172	143	207	64	1	3	1	1	0
MZA-172	143	477	334	0	3	1	0	0
MZA-173	144	198	54	1	3	1	1	0
MZA-173	145	442	297	1	3	1	0	0
MZA-173	145	442	297	1	3	1	0	0
MZA-173	149	207	58	1	3	4	1	0
MZA-173	149	477	328	0	3	5	0	0
MZA-173	149	179	30	1	3	5	0	0
MZA-173	149	151	2	1	3	1	1	0
MZA-173	149	477	328	0	3	1	0	0
MZA-173	149	178	29	1	3	3	1	0
MZA-173	150	477	327	0	3	1	0	0
MZA-174	155	477	322	0	3	1	0	0
MZA-174	156	158	2	1	3	1	1	0
MZA-174	157	163	6	1	3	4	1	0
MZA-174	158	477	319	0	4	4	0	0
MZA-174	158	159	1	1	3	1	1	0
MZA-174	161	213	52	1	3	4	1	0
MZA-174	162	477	315	0	3	1	0	0
MZA-174	164	166	2	1	3	5	0	0
MZA-174	164	442	278	1	3	2	0	0
MZA-174	164	442	278	1	3	2	0	0
MZA-175	165	442	277	1	3	1	0	0
MZA-175	165	166	1	1	3	4	1	0
MZA-175	165	221	56	1	3	1	1	0
MZA-175	171	246	75	1	3	1	1	0
MZA-175	171	274	103	1	3	1	1	0
MZA-175	172	477	305	0	3	1	0	0
MZA-175	172	173	1	1	3	1	1	0
MZA-175	173	477	304	0	3	5	0	0
MZA-175	175	191	16	1	3	4	1	0
MZA-175	175	213	38	1	3	2	1	0
MZA-176	176	477	301	0	3	1	1	0
MZA-176	176	442	266	1	3	2	0	0
MZA-176	176	442	266	1	3	3	0	0
MZA-176	176	221	45	1	3	4	1	1
MZA-176	176	284	108	1	4	2	1	0
MZA-176	178	189	11	1	1	1	1	0
MZA-176	178	477	299	0	3	1	0	0
MZA-176	179	477	298	0	4	1	0	0
MZA-176	179	231	52	1	3	1	1	1
MZA-176	192	442	250	1	3	1	0	0
MZA-177	196	442	246	1	4	3	0	0
MZA-177	196	284	88	1	2	2	1	0
MZA-177	198	477	279	0	3	1	0	0
MZA-177	199	442	243	1	3	3	0	0
MZA-177	199	442	243	1	3	1	0	0
MZA-177	199	200	1	1	3	1	1	0
MZA-177	200	283	83	1	3	4	1	1
MZA-177	200	442	242	1	3	1	0	1
MZA-177	200	442	242	1	3	1	0	0
MZA-177	203	477	274	0	3	1	0	0
MZA-178	203	477	274	0	3	2	0	0
MZA-178	204	477	273	0	3	1	0	1
MZA-178	204	252	48	1	3	1	1	0
MZA-178	204	442	238	1	3	2	0	0
MZA-178	205	206	1	1	3	4	1	0
MZA-178	205	210	5	1	3	1	1	0
MZA-178	206	477	271	0	3	2	0	1
MZA-178	206	438	232	1	3	4	0	0
MZA-178	206	442	236	1	3	3	0	1
MZA-178	207	262	55	1	3	4	1	4
MZA-179	207	213	6	1	3	1	1	0
MZA-179	207	442	235	1	3	3	0	0
MZA-179	210	477	267	0	3	4	0	0
MZA-179	210	443	233	1	3	2	0	4
MZA-179	211	212	1	1	3	4	1	0
MZA-179	212	281	69	1	3	4	1	0
MZA-179	212	442	230	1	3	4	0	0
MZA-179	212	477	265	0	3	1	0	0
MZA-179	213	477	264	0	3	1	0	0
MZA-179	213	477	264	0	3	1	0	0
MZA-180	213	477	264	0	5	1	0	0
MZA-180	216	477	261	0	3	2	0	0
MZA-180	217	218	1	1	3	4	1	0
MZA-180	217	252	35	1	3	1	1	0
MZA-180	217	252	35	1	3	1	1	4
MZA-180	220	224	4	1	3	1	0	0
MZA-180	220	252	32	1	4	1	1	0
MZA-180	221	477	256	0	4	4	0	0
MZA-180	221	477	256	0	3	1	0	0
MZA-180	224	226	2	1	3	1	1	0
MZA-181	227	477	250	0	3	4	0	0
MZA-181	228	477	249	0	3	4	0	3
MZA-181	231	234	3	1	3	4	1	0
MZA-181	231	242	11	1	3	1	1	1
MZA-181	232	274	42	1	3	4	1	2
MZA-181	232	477	245	0	3	4	0	1
MZA-181	232	477	245	0	3	1	0	0
MZA-181	233	253	20	1	3	1	1	0
MZA-181	234	270	36	1	3	4	1	2
MZA-181	234	477	243	0	3	4	0	1
MZA-182	234	235	1	1	3	1	1	0
MZA-182	235	246	11	1	3	1	1	0
MZA-182	235	238	3	1	3	1	1	0
MZA-182	235	442	207	1	3	1	0	0
MZA-182	235	442	207	1	3	1	0	0
MZA-182	235	236	1	1	3	1	1	0
MZA-182	235	238	3	1	3	1	1	0
MZA-182	236	477	241	0	3	1	0	0
MZA-182	240	477	237	0	3	1	1	0
MZA-182	240	477	237	0	3	1	1	0
MZA-183	240	477	237	0	3	1	1	1
MZA-183	240	477	237	0	3	1	0	0
MZA-183	240	442	202	1	3	1	1	1
MZA-183	241	477	236	0	3	4	0	1
MZA-183	241	477	236	0	3	4	0	1
MZA-183	242	366	124	1	3	4	1	1
MZA-183	242	284	42	1	3	4	1	1
MZA-183	243	253	10	1	3	1	1	0
MZA-183	247	256	9	1	3	1	1	0
MZA-183	247	477	230	0	3	4	0	1
MZA-184	247	262	15	1	3	4	1	0
MZA-184	248	477	229	0	3	4	1	1
MZA-184	248	477	229	0	3	4	0	3
MZA-184	248	249	1	1	3	4	1	0
MZA-184	248	477	229	0	4	4	0	0
MZA-184	248	442	194	1	3	1	1	1
MZA-184	248	442	194	1	3	3	0	0
MZA-184	248	442	194	1	3	3	0	0
MZA-184	248	442	194	1	3	3	0	0
MZA-184	248	262	14	1	3	3	1	0
MZA-185	248	477	229	0	3	2	0	0
MZA-185	248	442	194	1	3	1	0	0
MZA-185	249	274	25	1	3	1	1	0
MZA-185	249	477	228	0	3	1	0	0
MZA-185	249	262	13	1	3	1	1	0
MZA-185	249	442	193	1	3	1	0	0
MZA-185	249	283	34	1	3	1	1	0
MZA-185	249	346	97	1	3	1	1	1
MZA-185	249	352	103	1	3	4	1	0
MZA-185	249	442	193	1	3	2	0	0
MZA-186	249	283	34	1	3	1	1	0
MZA-186	249	346	97	1	3	1	1	1
MZA-186	250	477	227	0	3	1	0	1
MZA-186	250	477	227	0	3	1	0	1
MZA-186	250	477	227	0	3	1	0	1
MZA-186	250	477	227	0	3	1	0	1
MZA-186	252	253	1	1	3	1	0	1
MZA-186	252	477	225	0	3	1	0	0
MZA-186	252	301	49	1	3	5	0	1
MZA-186	252	443	191	1	3	5	0	0
MZA-187	253	254	1	1	3	1	1	0
MZA-187	253	477	224	0	3	1	0	1
MZA-187	253	442	189	1	3	1	0	0
MZA-187	253	477	224	0	3	1	0	1
MZA-187	253	269	16	1	3	4	1	0
MZA-187	254	255	1	1	3	4	1	0
MZA-187	254	477	223	0	3	1	0	0
MZA-187	255	477	222	0	3	1	0	1
MZA-187	255	477	222	0	1	1	0	0
MZA-187	255	269	14	1	3	4	1	0
MZA-188	255	268	13	1	3	4	1	0
MZA-188	256	477	221	0	3	1	0	1
MZA-188	256	477	221	0	3	1	0	1
MZA-188	256	477	221	0	3	1	0	1
MZA-188	256	477	221	0	3	1	0	1
MZA-188	257	442	185	1	3	2	0	0
MZA-188	259	261	2	1	3	1	1	0
MZA-188	259	477	218	0	3	1	0	1
MZA-188	260	442	182	1	3	1	0	1
MZA-188	261	283	22	1	3	1	1	2
MZA-189	261	262	1	1	3	1	1	0
MZA-189	262	283	21	1	3	1	1	0
MZA-189	262	477	215	0	3	1	0	0
MZA-189	262	477	215	0	3	4	0	1
MZA-189	262	477	215	0	3	4	0	0
MZA-189	262	477	215	0	3	4	0	0
MZA-189	263	442	179	1	3	5	0	0
MZA-189	263	477	214	0	3	1	0	0
MZA-189	263	442	179	1	3	5	0	0
MZA-189	263	442	179	1	3	1	0	1
MZA-190	264	283	19	1	3	1	1	0
MZA-190	266	477	211	0	3	2	1	1
MZA-190	266	477	211	0	3	5	0	0
MZA-190	266	477	211	0	3	1	0	0
MZA-190	266	267	1	1	3	4	1	0
MZA-190	266	281	15	1	3	2	1	0
MZA-190	266	477	211	0	3	1	0	1
MZA-190	267	442	175	1	3	4	0	0
MZA-190	267	284	17	1	3	5	1	0
MZA-190	267	477	210	0	3	5	0	0
MZA-191	267	442	175	1	3	5	0	0
MZA-191	268	442	174	1	3	4	0	0
MZA-191	268	477	209	0	3	1	0	1
MZA-191	268	269	1	1	3	4	1	0
MZA-191	268	269	1	1	3	1	1	0
MZA-191	268	271	3	1	3	2	1	0
MZA-191	268	442	174	1	3	4	0	0
MZA-191	269	477	208	0	3	1	0	0
MZA-191	269	442	173	1	3	3	0	0
MZA-191	269	272	3	1	3	4	0	0
MZA-192	269	442	173	1	3	2	0	0
MZA-192	269	442	173	1	3	1	0	1
MZA-192	269	303	34	1	3	1	1	2
MZA-192	269	477	208	0	3	3	0	0
MZA-192	270	378	108	1	3	3	1	0
MZA-192	270	442	172	1	3	1	0	0
MZA-192	270	442	172	1	3	2	0	0
MZA-192	271	477	206	0	3	1	0	0
MZA-192	273	442	169	1	3	4	0	0
MZA-192	273	277	4	1	3	2	1	0
MZA-193	274	289	15	1	3	5	1	0
MZA-193	274	477	203	0	3	1	0	1
MZA-193	274	477	203	0	3	1	0	1
MZA-193	274	442	168	1	3	1	0	0
MZA-193	274	442	168	1	3	1	0	0
MZA-193	274	442	168	1	3	4	0	0
MZA-193	275	477	202	0	3	1	0	0
MZA-193	276	288	12	1	3	1	1	0
MZA-193	277	442	165	1	3	1	1	0
MZA-193	280	477	197	0	3	4	0	0
MZA-194	281	477	196	0	3	4	0	0
MZA-194	281	477	196	0	3	1	1	0
MZA-194	281	477	196	0	4	4	0	0
MZA-194	281	442	161	1	3	1	0	1
MZA-194	281	477	196	0	3	1	0	1
MZA-194	281	477	196	0	3	1	0	1
MZA-194	282	338	56	1	3	1	1	0
MZA-194	282	442	160	1	4	2	0	0
MZA-194	283	284	1	1	3	1	1	0
MZA-194	283	477	194	0	3	2	0	0
MZA-195	284	379	95	1	3	5	1	0
MZA-195	284	294	10	1	3	5	1	0
MZA-195	287	442	155	1	3	2	1	0
MZA-195	287	442	155	1	3	1	0	0
MZA-195	287	442	155	1	3	1	0	0
MZA-195	288	477	189	0	4	1	0	0
MZA-195	288	289	1	1	3	1	1	0
MZA-195	288	477	189	0	3	5	0	0
MZA-195	288	289	1	1	3	5	1	0
MZA-195	288	289	1	1	3	2	1	0
MZA-196	289	477	188	0	3	1	1	0
MZA-196	289	379	90	1	3	5	1	0
MZA-196	290	477	187	0	3	4	0	0
MZA-196	291	292	1	1	3	2	1	0
MZA-196	291	292	1	1	3	1	1	0
MZA-196	294	350	56	1	3	5	1	0
MZA-196	295	477	182	0	3	1	0	0
MZA-196	297	350	53	1	3	1	1	0
MZA-196	297	477	180	0	3	1	0	0
MZA-196	298	379	81	1	3	4	1	0
MZA-197	302	350	48	1	3	4	1	0
MZA-197	302	442	140	1	3	1	1	0
MZA-197	304	442	138	1	3	4	0	0
MZA-197	304	442	138	1	3	2	1	0
MZA-197	305	477	172	0	3	4	0	0
MZA-197	305	477	172	0	3	1	0	0
MZA-197	305	442	137	1	3	2	0	0
MZA-197	308	309	1	1	4	1	0	0
MZA-197	309	442	133	1	3	1	0	0
MZA-197	309	310	1	1	3	1	1	0
MZA-198	310	311	1	1	3	4	1	0
MZA-198	310	311	1	1	3	4	1	0
MZA-198	310	477	167	0	3	4	1	0
MZA-198	310	477	167	0	3	2	1	4
MZA-198	310	477	167	0	3	4	0	0
MZA-198	311	430	119	1	3	2	1	1
MZA-198	312	477	165	0	3	1	0	0
MZA-198	312	477	165	0	3	1	0	0
MZA-198	312	315	3	1	3	1	1	0
MZA-198	315	442	127	1	3	2	0	0
MZA-199	315	434	119	1	3	1	0	0
MZA-199	316	477	161	0	3	1	0	1
MZA-199	316	477	161	0	3	4	0	0
MZA-199	317	477	160	0	3	1	0	0
MZA-199	318	442	124	1	3	1	0	0
MZA-199	318	477	159	0	3	4	0	0
MZA-199	318	477	159	0	3	4	0	2
MZA-199	318	324	6	1	2	5	0	0
MZA-199	318	324	6	1	3	4	1	0
MZA-199	319	477	158	0	3	1	0	0
MZA-200	319	320	1	1	5	3	1	0
MZA-200	322	477	155	0	3	1	0	0
MZA-200	324	339	15	1	3	5	0	0
MZA-200	329	477	148	0	3	1	0	1
MZA-200	329	330	1	1	3	4	1	0
MZA-200	329	477	148	0	3	5	0	0
MZA-200	329	330	1	1	3	4	1	0
MZA-200	330	477	147	0	3	1	0	0
MZA-200	331	477	146	0	3	4	1	0
MZA-200	331	332	1	1	3	4	0	0
MZA-201	332	333	1	1	3	4	1	0
MZA-201	332	333	1	1	3	4	0	0
MZA-201	332	352	20	1	3	4	1	0
MZA-201	333	334	1	1	3	1	1	0
MZA-201	333	477	144	0	3	1	0	0
MZA-201	333	334	1	1	3	4	1	0
MZA-201	333	477	144	0	3	4	0	0
MZA-201	334	442	108	1	3	1	0	0
MZA-201	334	442	108	1	3	4	1	0
MZA-201	334	442	108	1	3	1	0	0
MZA-202	336	477	141	0	3	4	0	0
MZA-202	336	477	141	0	3	1	0	0
MZA-202	337	430	93	1	3	2	1	1
MZA-202	337	477	140	0	3	2	1	1
MZA-202	337	477	140	0	3	2	1	1
MZA-202	337	442	105	1	3	4	0	0
MZA-202	337	338	1	1	3	4	1	0
MZA-202	338	477	139	0	3	5	0	0
MZA-202	338	343	5	1	3	5	0	0
MZA-202	338	395	57	1	3	5	0	0
MZA-203	339	442	103	1	3	1	0	0
MZA-203	339	477	138	0	3	4	0	1
MZA-203	339	477	138	0	4	4	0	0
MZA-203	340	373	33	1	3	1	1	0
MZA-203	340	477	137	0	3	1	0	0
MZA-203	344	442	98	1	3	1	0	0
MZA-203	344	345	1	1	3	1	1	0
MZA-203	344	477	133	0	3	4	0	0
MZA-203	344	477	133	0	3	2	0	1
MZA-203	344	477	133	0	3	4	0	0
MZA-204	345	477	132	0	3	4	0	0
MZA-204	345	347	2	1	4	3	1	2
MZA-204	345	442	97	1	3	4	0	0
MZA-204	346	350	4	1	3	4	1	0
MZA-204	347	477	130	0	3	1	0	0
MZA-204	348	477	129	0	3	2	0	1
MZA-204	350	477	127	0	3	2	0	1
MZA-204	353	477	124	0	3	1	0	0
MZA-204	353	442	89	1	3	4	0	0
MZA-204	354	477	123	0	3	3	1	1
MZA-205	354	477	123	0	3	4	0	0
MZA-205	354	442	88	1	3	4	0	0
MZA-205	354	442	88	1	3	3	0	0
MZA-205	357	442	85	1	3	3	0	0
MZA-205	357	442	85	1	3	3	0	0
NDBOX-50	242	477	235	0	3	4	0	0
NTUARIO-48	58	106	48	1	3	4	1	3
NTUARIO-48	93	94	1	1	3	1	2	0
NTUARIO-48	120	121	1	1	3	4	1	2
NTUARIO-48	128	137	9	1	3	4	1	1
NTUARIO-48	134	135	1	1	3	4	1	0
NTUARIO-48	134	135	1	1	3	4	1	0
NTUARIO-48	161	162	1	1	3	3	1	1
NTUARIO-48	172	175	3	1	3	1	2	0
NTUARIO-49	207	225	18	1	3	4	1	0
NTUARIO-49	212	213	1	1	2	1	1	0
NTUARIO-49	226	227	1	1	3	2	0	0
NTUARIO-49	241	242	1	1	3	3	1	0
NTUARIO-49	262	263	1	1	3	4	0	1
NTUARIO-49	267	477	210	0	3	1	0	0
NTUARIO-49	283	305	22	1	3	1	1	0
NTUARIO-49	305	477	172	0	3	1	0	0
NTUARIO-49	329	477	148	0	3	1	0	0
B-100	304	477	173	0	3	4	0	0
B-100	304	305	1	1	3	5	1	1
B-100	304	477	173	0	3	5	0	0
B-100	304	477	173	0	3	4	0	0
B-100	304	477	173	0	3	4	0	0
B-100	304	477	173	0	3	4	0	0
B-100	304	477	173	0	3	4	0	0
B-100	304	322	18	1	3	1	1	0
B-100	305	477	172	0	3	4	0	0
B-100	308	315	7	1	3	2	1	0
B-101	308	477	169	0	3	4	0	0
B-101	309	477	168	0	3	4	1	0
B-101	310	311	1	1	3	1	1	0
B-101	310	329	19	1	3	4	1	0
B-101	311	318	7	1	3	1	1	0
B-101	312	317	5	1	3	4	1	0
B-101	312	314	2	1	3	3	1	0
B-101	313	322	9	1	3	5	0	0
B-101	314	316	2	1	3	4	1	0
B-101	314	322	8	1	3	3	0	0
B-102	315	326	11	1	3	4	1	0
B-102	315	327	12	1	3	5	1	1
B-102	315	322	7	1	3	5	1	1
B-102	315	329	14	1	3	3	1	0
B-102	317	477	160	0	3	4	0	0
B-102	318	319	1	1	3	4	0	0
B-102	318	477	159	0	3	3	1	0
B-102	318	319	1	1	3	1	1	0
B-102	319	323	4	1	3	3	1	0
B-102	322	357	35	1	3	4	1	0
B-103	322	477	155	0	3	3	0	0
B-103	324	329	5	1	3	4	1	0
B-103	324	330	6	1	3	2	0	0
B-103	324	329	5	1	3	3	1	0
B-103	325	327	2	1	3	5	1	0
B-103	325	328	3	1	3	3	1	0
B-103	326	327	1	1	3	4	1	0
B-103	326	464	138	1	2	4	1	0
B-103	326	330	4	1	3	4	1	0
B-103	326	329	3	1	3	4	0	1
B-104	326	330	4	1	3	2	1	1
B-104	326	327	1	1	3	1	0	0
B-104	327	477	150	0	3	4	0	0
B-104	327	329	2	1	3	1	1	0
B-104	328	464	136	1	3	4	1	0
B-104	329	330	1	1	3	1	1	0
B-104	329	464	135	1	3	3	1	0
B-104	330	464	134	1	3	4	1	0
B-104	330	338	8	1	3	2	1	0
B-104	330	359	29	1	3	2	1	0
B-105	330	331	1	1	3	1	1	0
B-105	330	464	134	1	3	4	1	0
B-105	331	332	1	1	3	4	1	0
B-105	331	350	19	1	3	4	1	0
B-105	331	464	133	1	2	1	1	0
B-105	331	333	2	1	3	1	0	0
B-105	332	338	6	1	3	4	1	0
B-105	333	477	144	0	3	4	1	0
B-105	333	477	144	0	4	3	0	0
B-105	336	462	126	1	3	1	1	0
B-106	336	338	2	1	3	1	0	0
B-106	336	338	2	1	3	2	1	0
B-106	337	339	2	1	4	3	1	0
B-106	337	338	1	1	3	4	1	0
B-106	337	477	140	0	3	4	0	0
B-106	337	343	6	1	3	1	1	0
B-106	337	464	127	1	3	1	1	0
B-106	337	477	140	0	3	5	0	0
B-106	338	464	126	1	3	4	1	0
B-106	338	477	139	0	3	1	0	0
B-107	338	339	1	1	3	4	1	0
B-107	339	378	39	1	3	5	1	1
B-107	340	344	4	1	3	4	1	0
B-107	344	366	22	1	4	1	1	0
B-107	344	353	9	1	3	4	1	0
B-107	345	353	8	1	3	4	1	0
B-107	345	353	8	1	3	4	1	0
B-107	345	353	8	1	3	4	1	0
B-107	345	357	12	1	3	3	1	0
B-107	346	353	7	1	3	4	1	0
B-108	346	477	131	0	3	3	0	0
B-108	350	357	7	1	3	1	1	0
B-108	351	357	6	1	3	4	1	0
B-108	351	414	63	1	3	3	1	0
B-108	352	477	125	0	3	1	0	0
B-108	352	477	125	0	3	1	0	0
B-108	354	357	3	1	3	4	1	0
B-108	357	477	120	0	3	2	1	0
B-108	357	378	21	1	3	1	1	0
B-108	358	361	3	1	3	1	1	0
B-109	358	359	1	1	3	4	1	0
B-109	358	360	2	1	3	4	1	0
B-109	359	462	103	1	3	4	1	0
B-109	360	361	1	1	3	4	1	0
B-109	361	375	14	1	3	1	1	0
B-109	361	369	8	1	3	1	1	0
B-109	361	464	103	1	3	1	1	0
B-109	362	363	1	1	3	3	1	0
B-109	362	363	1	1	3	1	1	0
B-15	0	23	23	1	3	5	1	0
B-15	1	23	22	1	3	2	1	1
B-15	1	2	1	1	3	2	1	0
B-15	1	117	116	1	3	5	1	2
B-15	1	3	2	1	3	3	1	0
B-15	1	2	1	1	3	1	1	0
B-15	2	12	10	1	3	4	1	0
B-15	2	7	5	1	3	3	1	1
B-15	2	3	1	1	3	1	1	0
B-15	2	11	9	1	3	1	1	0
B-16	3	9	6	1	3	2	1	0
B-16	3	4	1	1	3	4	1	1
B-16	3	4	1	1	3	2	1	1
B-16	3	477	474	0	3	4	0	1
B-16	3	10	7	1	3	4	1	1
B-16	3	15	12	1	3	1	1	0
B-16	3	10	7	1	3	5	1	0
B-16	3	4	1	1	3	4	1	1
B-16	3	9	6	1	3	4	1	1
B-16	3	8	5	1	3	4	1	1
B-17	3	477	474	0	3	4	1	0
B-17	4	15	11	1	3	4	1	0
B-17	4	10	6	1	3	4	1	1
B-17	4	9	5	1	3	4	1	0
B-17	4	7	3	1	3	4	1	0
B-17	4	477	473	0	4	2	0	0
B-17	4	10	6	1	4	5	1	0
B-17	4	93	89	1	4	5	1	0
B-17	4	477	473	0	4	5	0	0
B-17	4	11	7	1	3	1	1	0
B-18	4	15	11	1	3	1	1	0
B-18	4	5	1	1	3	1	1	0
B-18	4	5	1	1	3	1	1	0
B-18	4	7	3	1	3	4	1	0
B-18	4	105	101	1	3	4	1	0
B-18	6	7	1	1	3	5	1	1
B-18	6	7	1	1	3	5	1	1
B-18	6	7	1	1	3	5	1	1
B-18	6	9	3	1	3	5	1	1
B-18	6	100	94	1	3	5	1	1
B-19	6	25	19	1	3	5	1	1
B-19	6	477	471	0	3	5	0	0
B-19	6	33	27	1	3	5	1	0
B-19	7	12	5	1	3	3	2	0
B-19	7	171	164	1	3	4	1	0
B-19	7	12	5	1	3	4	1	0
B-19	7	109	102	1	3	5	1	0
B-19	7	121	114	1	4	5	0	0
B-19	7	8	1	1	3	1	1	0
B-19	7	8	1	1	3	1	1	0
B-20	7	8	1	1	3	1	1	0
B-20	7	161	154	1	3	2	1	2
B-20	7	8	1	1	3	5	1	1
B-20	7	161	154	1	3	5	1	1
B-20	7	8	1	1	3	2	1	0
B-20	7	8	1	1	3	1	1	0
B-20	7	245	238	1	5	4	1	0
B-20	8	334	326	1	3	4	1	0
B-20	8	24	16	1	4	5	1	0
B-20	8	87	79	1	3	4	1	0
B-21	8	67	59	1	3	5	0	0
B-21	8	14	6	1	3	4	1	0
B-21	9	13	4	1	3	2	1	0
B-21	9	10	1	1	3	4	1	0
B-21	9	87	78	1	3	1	1	0
B-21	9	262	253	1	3	2	1	0
B-21	10	11	1	1	3	1	1	0
B-21	10	11	1	1	3	1	1	0
B-21	10	21	11	1	3	4	1	0
B-21	10	32	22	1	3	4	0	0
B-22	10	15	5	1	3	4	1	0
B-22	10	11	1	1	3	3	1	0
B-22	10	12	2	1	3	1	1	0
B-22	10	57	47	1	3	4	1	0
B-22	11	121	110	1	3	2	1	0
B-22	11	23	12	1	3	4	1	0
B-22	11	16	5	1	3	5	0	0
B-22	11	15	4	1	3	2	1	0
B-22	11	13	2	1	3	4	1	1
B-22	12	477	465	0	3	5	0	0
B-23	12	14	2	1	3	3	1	0
B-23	13	14	1	1	3	3	1	1
B-23	13	14	1	1	3	4	1	1
B-23	13	14	1	1	3	4	1	1
B-23	14	15	1	1	3	4	1	1
B-23	14	15	1	1	3	4	1	0
B-23	14	15	1	1	3	1	0	1
B-23	15	24	9	1	3	5	1	1
B-23	15	23	8	1	3	4	2	1
B-23	16	43	27	1	3	4	1	0
B-24	16	477	461	0	3	3	1	0
B-24	16	477	461	0	3	4	1	1
B-24	16	136	120	1	4	4	0	0
B-24	16	43	27	1	4	4	1	0
B-24	16	206	190	1	4	4	1	0
B-24	16	147	131	1	4	4	1	0
B-24	16	144	128	1	4	4	1	1
B-24	16	477	461	0	4	4	0	0
B-24	16	141	125	1	3	1	0	0
B-24	16	18	2	1	3	3	1	1
B-25	16	18	2	1	3	3	1	0
B-25	16	17	1	1	3	2	1	0
B-25	17	109	92	1	4	5	1	0
B-25	17	20	3	1	3	2	1	0
B-25	17	18	1	1	3	3	1	0
B-25	17	21	4	1	3	4	1	0
B-25	17	20	3	1	3	1	1	0
B-25	17	161	144	1	3	2	1	4
B-25	18	477	459	0	3	2	0	0
B-25	18	19	1	1	3	1	1	0
B-26	18	23	5	1	3	3	2	0
B-26	18	21	3	1	3	2	1	0
B-26	18	135	117	1	3	1	0	0
B-26	18	24	6	1	3	5	0	0
B-26	18	32	14	1	3	1	0	0
B-26	18	477	459	0	3	2	0	1
B-26	18	20	2	1	3	5	1	1
B-26	18	477	459	0	3	5	0	0
B-26	21	477	456	0	3	4	1	0
B-26	21	22	1	1	3	4	1	0
B-27	21	22	1	1	3	4	1	0
B-27	21	477	456	0	3	5	0	0
B-27	21	22	1	1	3	1	1	0
B-27	21	477	456	0	3	1	0	0
B-27	21	135	114	1	3	3	1	0
B-27	21	477	456	0	3	2	1	0
B-27	21	22	1	1	3	4	1	0
B-27	22	477	455	0	4	4	1	0
B-27	22	26	4	1	3	5	1	0
B-27	22	477	455	0	3	2	0	1
B-28	22	417	395	1	3	5	0	0
B-28	22	477	455	0	3	5	0	0
B-28	22	477	455	0	3	5	0	0
B-28	22	477	455	0	3	5	0	0
B-28	22	144	122	1	3	5	0	1
B-28	22	172	150	1	3	2	1	0
B-28	22	334	312	1	3	2	0	0
B-28	22	334	312	1	3	5	0	0
B-28	22	334	312	1	3	5	0	0
B-28	22	477	455	0	3	2	0	0
B-29	22	477	455	0	3	2	0	0
B-29	22	392	370	1	3	3	1	0
B-29	22	111	89	1	3	2	1	0
B-29	22	85	63	1	3	1	1	0
B-29	22	60	38	1	3	1	1	0
B-29	22	23	1	1	3	4	1	0
B-29	23	28	5	1	3	1	1	0
B-29	23	24	1	1	3	1	1	0
B-29	23	28	5	1	3	1	1	0
B-29	23	25	2	1	3	1	1	0
B-30	24	210	186	1	3	5	1	3
B-30	24	477	453	0	3	5	1	0
B-30	24	477	453	0	3	5	1	0
B-30	24	477	453	0	3	5	1	0
B-30	24	93	69	1	3	4	1	0
B-30	24	79	55	1	3	4	1	2
B-30	24	477	453	0	3	5	1	1
B-30	25	33	8	1	3	4	1	0
B-30	25	43	18	1	3	1	1	0
B-30	25	26	1	1	3	4	1	0
B-31	25	33	8	1	3	4	1	0
B-31	25	28	3	1	3	5	1	0
B-31	25	477	452	0	3	3	0	0
B-31	25	31	6	1	3	5	0	0
B-31	26	93	67	1	3	2	1	0
B-31	26	93	67	1	3	2	1	0
B-31	28	477	449	0	3	2	0	0
B-31	28	57	29	1	3	5	1	0
B-31	28	29	1	1	3	2	1	0
B-31	28	141	113	1	3	4	1	0
B-32	28	39	11	1	3	5	1	0
B-32	29	31	2	1	3	2	1	0
B-32	30	32	2	1	3	3	1	0
B-32	30	36	6	1	3	1	1	0
B-32	31	85	54	1	4	3	1	0
B-32	32	163	131	1	3	4	1	0
B-32	33	39	6	1	3	5	1	0
B-32	33	57	24	1	3	5	1	0
B-32	36	37	1	1	3	1	1	0
B-32	36	37	1	1	3	4	1	0
B-33	36	43	7	1	3	4	1	0
B-33	37	141	104	1	3	3	1	0
B-33	37	38	1	1	3	1	1	0
B-33	38	445	407	1	3	2	0	0
B-33	38	477	439	0	3	4	0	0
B-33	38	477	439	0	3	1	0	0
B-33	38	58	20	1	3	1	1	0
B-33	39	43	4	1	3	4	1	0
B-33	41	52	11	1	3	3	0	0
B-33	42	58	16	1	3	1	1	1
B-34	42	477	435	0	3	2	0	0
B-34	42	477	435	0	3	2	0	0
B-34	42	136	94	1	3	2	1	0
B-34	42	43	1	1	3	1	1	0
B-34	43	44	1	1	3	3	1	0
B-34	43	87	44	1	3	2	1	0
B-34	43	66	23	1	3	3	1	0
B-34	43	44	1	1	3	3	0	0
B-34	43	477	434	0	3	4	0	0
B-34	56	60	4	1	3	3	0	0
B-35	56	163	107	1	3	4	1	0
B-35	56	60	4	1	3	3	1	0
B-35	56	87	31	1	3	3	1	0
B-35	57	464	407	1	3	5	1	1
B-35	57	60	3	1	3	3	1	0
B-35	58	143	85	1	3	4	1	0
B-35	58	64	6	1	3	5	1	0
B-35	58	59	1	1	3	1	1	1
B-35	58	64	6	1	3	5	1	0
B-35	59	477	418	0	3	3	0	4
B-36	59	74	15	1	3	5	1	1
B-36	59	60	1	1	3	3	0	0
B-36	59	60	1	1	3	1	1	0
B-36	59	71	12	1	3	3	1	0
B-36	60	66	6	1	3	3	1	0
B-36	60	93	33	1	3	1	1	0
B-36	61	477	416	0	3	3	0	0
B-36	62	136	74	1	3	3	1	0
B-36	63	66	3	1	3	2	1	0
B-36	64	74	10	1	3	5	1	1
B-37	64	109	45	1	3	5	1	0
B-37	64	477	413	0	3	5	0	0
B-37	65	66	1	1	3	5	1	0
B-37	65	87	22	1	3	4	1	0
B-37	66	74	8	1	3	5	1	1
B-37	66	135	69	1	4	1	0	0
B-37	66	78	12	1	4	4	0	0
B-37	66	147	81	1	3	3	1	0
B-37	67	72	5	1	3	3	2	0
B-37	67	93	26	1	3	2	0	0
B-38	67	70	3	1	3	3	3	0
B-38	68	232	164	1	3	1	1	0
B-38	68	72	4	1	3	1	1	0
B-38	70	86	16	1	3	5	1	1
B-38	70	89	19	1	3	5	1	1
B-38	70	92	22	1	3	5	1	1
B-38	70	72	2	1	3	1	1	0
B-38	70	71	1	1	3	1	1	0
B-38	70	71	1	1	4	4	1	0
B-38	70	74	4	1	3	1	1	0
B-39	70	79	9	1	3	3	1	1
B-39	70	74	4	1	3	1	1	0
B-39	70	71	1	1	3	1	1	0
B-39	70	148	78	1	3	1	1	0
B-39	70	74	4	1	3	4	1	0
B-39	70	72	2	1	4	4	1	0
B-39	71	74	3	1	3	3	1	0
B-39	71	72	1	1	3	3	1	0
B-39	72	217	145	1	3	1	1	0
B-39	73	74	1	1	3	1	1	0
B-40	73	74	1	1	3	4	1	0
B-40	73	74	1	1	3	3	1	0
B-40	73	74	1	1	3	1	1	0
B-40	73	74	1	1	3	1	1	0
B-40	73	74	1	1	3	1	2	0
B-40	73	74	1	1	3	4	1	0
B-40	73	85	12	1	3	2	1	0
B-40	74	75	1	1	3	1	1	1
B-40	74	135	61	1	4	1	0	0
B-40	74	336	262	1	3	4	0	1
B-41	74	106	32	1	3	4	1	2
B-41	74	78	4	1	3	1	1	0
B-41	77	100	23	1	3	4	1	0
B-41	77	78	1	1	3	1	1	0
B-41	77	78	1	1	4	3	1	0
B-41	77	78	1	1	3	1	1	0
B-41	77	217	140	1	3	4	1	0
B-41	77	78	1	1	3	3	1	0
B-41	78	297	219	1	3	4	1	0
B-41	79	322	243	1	3	5	0	1
B-42	79	80	1	1	3	3	1	0
B-42	79	84	5	1	3	1	0	0
B-42	80	98	18	1	3	5	1	1
B-42	80	477	397	0	3	5	0	0
B-42	80	87	7	1	3	3	1	0
B-42	80	398	318	1	3	2	0	0
B-42	80	82	2	1	3	1	1	0
B-42	82	83	1	1	3	4	1	0
B-42	82	83	1	1	3	4	1	0
B-42	83	84	1	1	3	4	1	0
B-43	84	87	3	1	3	1	1	0
B-43	84	97	13	1	3	4	1	0
B-43	84	85	1	1	3	4	1	0
B-43	84	85	1	1	4	4	1	0
B-43	84	85	1	1	3	1	1	0
B-43	84	212	128	1	3	4	1	0
B-43	84	85	1	1	4	4	1	0
B-43	85	86	1	1	4	3	1	0
B-43	85	477	392	0	3	4	0	0
B-43	85	127	42	1	3	2	1	0
B-44	85	117	32	1	3	5	1	0
B-44	85	99	14	1	3	5	1	0
B-44	85	112	27	1	3	5	1	0
B-44	86	91	5	1	4	3	1	0
B-44	87	123	36	1	4	4	1	0
B-44	87	101	14	1	3	5	1	1
B-44	87	99	12	1	3	5	1	1
B-44	87	88	1	1	3	4	1	0
B-44	87	89	2	1	3	1	1	0
B-44	87	136	49	1	4	1	1	0
B-45	89	99	10	1	3	5	1	1
B-45	89	99	10	1	4	1	0	0
B-45	90	136	46	1	4	3	1	0
B-45	91	110	19	1	3	3	1	0
B-45	91	108	17	1	3	4	0	0
B-45	91	116	25	1	4	1	1	0
B-45	91	142	51	1	3	3	1	0
B-45	91	141	50	1	3	3	1	0
B-45	93	94	1	1	3	3	0	0
B-45	93	99	6	1	3	3	1	0
B-46	93	94	1	1	3	2	0	0
B-46	93	94	1	1	3	3	0	0
B-46	93	98	5	1	3	5	1	1
B-46	95	106	11	1	3	4	1	1
B-46	95	98	3	1	4	4	1	0
B-46	96	98	2	1	3	4	1	0
B-46	98	99	1	1	3	4	0	0
B-46	98	141	43	1	4	4	1	0
B-46	98	414	316	1	4	4	0	0
B-46	99	100	1	1	4	4	1	0
B-47	99	117	18	1	3	5	1	0
B-47	99	154	55	1	3	3	1	0
B-47	99	105	6	1	3	1	1	0
B-47	99	101	2	1	3	1	1	0
B-47	100	115	15	1	3	1	1	0
B-47	100	163	63	1	3	5	0	0
B-47	100	127	27	1	3	1	1	0
B-47	101	106	5	1	3	4	1	0
B-47	101	108	7	1	3	3	1	0
B-47	101	113	12	1	3	4	1	0
B-48	101	102	1	1	3	1	1	1
B-48	101	105	4	1	3	1	1	0
B-48	102	141	39	1	3	2	1	0
B-48	102	109	7	1	3	5	1	1
B-48	102	161	59	1	3	5	1	1
B-48	102	123	21	1	3	5	1	1
B-48	102	111	9	1	3	5	1	1
B-48	102	112	10	1	3	5	1	1
B-48	102	217	115	1	3	4	1	0
B-48	102	477	375	0	3	4	0	0
B-49	102	180	78	1	3	1	2	0
B-49	102	134	32	1	3	1	1	1
B-49	102	477	375	0	4	4	0	0
B-49	105	322	217	1	3	5	1	1
B-49	105	109	4	1	3	5	1	1
B-49	105	128	23	1	3	1	1	0
B-49	105	477	372	0	3	4	0	0
B-49	106	107	1	1	4	4	1	0
B-49	106	163	57	1	3	4	1	1
B-49	106	107	1	1	3	1	1	0
B-50	107	477	370	0	4	5	0	0
B-50	107	114	7	1	3	5	1	1
B-50	107	148	41	1	3	1	1	0
B-50	107	116	9	1	3	1	1	0
B-50	107	127	20	1	3	5	1	0
B-50	107	108	1	1	3	1	1	2
B-50	108	178	70	1	3	3	1	0
B-50	108	109	1	1	3	1	1	0
B-50	108	122	14	1	3	1	1	0
B-50	109	110	1	1	3	3	1	0
B-51	109	113	4	1	3	1	1	0
B-51	110	211	101	1	4	4	1	0
B-51	110	113	3	1	3	1	1	1
B-51	110	113	3	1	3	4	1	0
B-51	111	121	10	1	3	4	1	0
B-51	112	116	4	1	3	5	1	0
B-51	112	116	4	1	3	1	1	0
B-51	112	116	4	1	3	4	1	0
B-51	115	121	6	1	3	4	1	1
B-51	115	116	1	1	3	1	0	0
B-52	115	128	13	1	3	1	1	0
B-52	115	121	6	1	3	1	1	0
B-52	115	136	21	1	3	1	0	0
B-52	116	117	1	1	3	4	1	0
B-52	116	117	1	1	4	1	0	0
B-52	116	117	1	1	4	5	0	0
B-52	116	134	18	1	3	4	1	0
B-52	116	122	6	1	3	5	1	0
B-52	116	136	20	1	4	4	0	0
B-52	117	128	11	1	3	5	1	1
B-53	117	477	360	0	3	3	1	4
B-53	117	137	20	1	3	5	1	1
B-53	117	133	16	1	3	5	1	1
B-53	117	130	13	1	3	5	1	1
B-53	117	135	18	1	3	5	1	1
B-53	118	477	359	0	3	3	0	0
B-53	118	477	359	0	3	5	0	0
B-53	118	477	359	0	3	5	0	0
B-53	118	129	11	1	3	5	1	1
B-53	121	196	75	1	4	5	0	1
B-54	122	127	5	1	3	5	1	0
B-54	122	123	1	1	3	1	1	0
B-54	122	136	14	1	3	3	1	0
B-54	123	141	18	1	3	4	1	0
B-54	123	126	3	1	3	2	1	0
B-54	123	124	1	1	3	4	1	0
B-54	124	137	13	1	3	4	1	0
B-54	126	127	1	1	3	4	1	0
B-54	126	140	14	1	3	4	1	0
B-54	126	127	1	1	3	4	1	0
B-55	127	128	1	1	3	3	0	0
B-55	127	128	1	1	3	5	0	0
B-55	127	128	1	1	3	5	0	0
B-55	127	128	1	1	3	5	0	0
B-55	127	128	1	1	3	5	0	0
B-55	127	148	21	1	3	3	1	1
B-55	127	477	350	0	3	5	1	0
B-55	127	477	350	0	3	2	0	0
B-55	127	477	350	0	3	2	1	0
B-55	127	128	1	1	3	4	1	0
B-56	127	128	1	1	4	5	0	0
B-56	127	128	1	1	3	2	1	0
B-56	128	151	23	1	3	1	1	0
B-56	128	129	1	1	3	1	1	0
B-56	128	129	1	1	3	3	1	0
B-56	128	129	1	1	3	1	1	0
B-56	128	147	19	1	3	1	1	0
B-56	128	163	35	1	3	1	1	0
B-56	129	150	21	1	4	4	1	0
B-56	129	133	4	1	3	4	1	0
B-57	129	141	12	1	4	4	1	0
B-57	129	136	7	1	3	4	1	0
B-57	129	130	1	1	3	1	1	0
B-57	130	136	6	1	4	4	1	0
B-57	130	477	347	0	3	4	0	0
B-57	130	477	347	0	3	4	1	0
B-57	131	150	19	1	4	4	1	0
B-57	132	477	345	0	3	4	0	0
B-57	132	477	345	0	3	5	0	0
B-57	133	140	7	1	3	1	1	0
B-58	133	140	7	1	3	1	1	0
B-58	134	142	8	1	4	2	1	0
B-58	134	141	7	1	3	2	1	0
B-58	134	136	2	1	4	4	1	0
B-58	135	151	16	1	4	1	1	0
B-58	135	217	82	1	3	4	1	0
B-58	135	136	1	1	3	1	1	0
B-58	135	140	5	1	3	1	1	0
B-58	136	140	4	1	3	1	1	0
B-58	136	147	11	1	3	3	1	0
B-59	136	147	11	1	4	3	1	0
B-59	136	163	27	1	3	1	1	0
B-59	137	207	70	1	3	1	0	0
B-59	137	140	3	1	3	1	1	0
B-59	137	361	224	1	3	3	1	0
B-59	137	193	56	1	3	3	0	0
B-59	137	140	3	1	3	1	1	0
B-59	140	141	1	1	3	1	1	0
B-59	140	141	1	1	3	3	0	0
B-59	141	143	2	1	3	3	1	0
B-60	142	150	8	1	3	1	1	0
B-60	142	144	2	1	4	3	1	0
B-60	142	477	335	0	3	2	0	0
B-60	142	199	57	1	3	2	1	0
B-60	142	151	9	1	3	4	1	0
B-60	142	217	75	1	3	2	1	0
B-60	142	143	1	1	4	5	0	0
B-60	143	147	4	1	3	2	1	0
B-60	143	477	334	0	4	5	0	0
B-60	143	189	46	1	4	1	0	0
B-61	143	477	334	0	3	5	0	0
B-61	143	144	1	1	3	2	1	0
B-61	144	232	88	1	3	3	1	0
B-61	144	477	333	0	3	3	0	0
B-61	144	477	333	0	3	3	0	0
B-61	144	145	1	1	4	1	1	0
B-61	145	155	10	1	3	2	1	0
B-61	145	154	9	1	3	1	1	0
B-61	147	151	4	1	3	4	1	0
B-61	147	148	1	1	3	1	1	0
B-62	147	148	1	1	3	4	1	0
B-62	148	149	1	1	3	1	1	0
B-62	148	149	1	1	3	4	1	0
B-62	148	477	329	0	3	1	0	0
B-62	148	477	329	0	3	4	0	0
B-62	149	165	16	1	3	4	1	0
B-62	150	189	39	1	3	1	1	0
B-62	150	155	5	1	3	4	1	0
B-62	150	151	1	1	4	4	1	0
B-62	151	206	55	1	3	1	0	0
B-63	151	165	14	1	3	4	1	0
B-63	151	477	326	0	3	4	0	0
B-63	151	152	1	1	4	4	1	0
B-63	151	155	4	1	4	4	1	0
B-63	151	152	1	1	3	3	1	0
B-63	151	172	21	1	3	3	1	0
B-63	152	163	11	1	3	4	1	0
B-63	153	154	1	1	3	3	1	0
B-63	154	408	254	1	3	3	1	0
B-63	154	157	3	1	3	4	1	0
B-64	154	197	43	1	3	2	1	0
B-64	154	155	1	1	3	4	1	0
B-64	154	155	1	1	3	4	1	0
B-64	154	477	323	0	3	1	0	0
B-64	155	170	15	1	3	4	0	0
B-64	155	477	322	0	4	1	0	0
B-64	155	163	8	1	3	4	1	0
B-64	156	171	15	1	3	3	3	0
B-64	156	234	78	1	3	3	1	0
B-64	156	163	7	1	3	4	1	0
B-65	157	158	1	1	3	4	0	0
B-65	157	169	12	1	3	1	1	0
B-65	157	163	6	1	3	1	1	0
B-65	157	161	4	1	3	1	1	0
B-65	157	161	4	1	3	1	1	0
B-65	158	379	221	1	3	4	0	0
B-65	158	161	3	1	3	1	1	0
B-65	158	159	1	1	3	2	0	0
B-65	158	161	3	1	3	1	1	0
B-65	162	163	1	1	3	1	1	0
B-66	162	163	1	1	4	4	1	0
B-66	162	217	55	1	3	4	1	0
B-66	163	197	34	1	3	1	1	0
B-66	163	164	1	1	3	1	0	0
B-66	163	197	34	1	3	4	0	0
B-66	163	329	166	1	3	2	1	0
B-66	163	200	37	1	4	1	1	0
B-66	164	165	1	1	3	1	1	0
B-66	164	477	313	0	3	4	1	0
B-66	164	170	6	1	3	1	1	0
B-67	164	165	1	1	3	4	0	0
B-67	164	183	19	1	3	4	1	0
B-67	165	166	1	1	3	5	1	0
B-67	165	334	169	1	3	5	0	0
B-67	169	380	211	1	3	4	1	4
B-67	169	291	122	1	3	5	1	1
B-67	169	477	308	0	3	3	0	4
B-67	169	170	1	1	1	5	0	0
B-67	170	171	1	1	3	4	0	0
B-67	170	172	2	1	3	2	1	0
B-68	171	191	20	1	3	4	0	0
B-68	172	259	87	1	3	5	1	1
B-68	172	477	305	0	3	1	0	0
B-68	172	477	305	0	3	4	0	0
B-68	172	175	3	1	3	4	1	0
B-68	172	175	3	1	3	4	1	0
B-68	172	477	305	0	3	3	0	1
B-68	172	212	40	1	3	5	1	0
B-68	172	219	47	1	3	5	0	0
B-68	172	378	206	1	3	5	0	1
B-69	172	477	305	0	3	5	0	0
B-69	172	322	150	1	3	5	1	1
B-69	172	207	35	1	3	4	1	0
B-69	175	180	5	1	3	3	1	0
B-69	175	176	1	1	3	4	0	0
B-69	175	176	1	1	4	1	1	0
B-69	176	180	4	1	3	1	1	0
B-69	176	217	41	1	3	4	1	0
B-69	176	182	6	1	3	1	1	0
B-69	176	180	4	1	3	1	1	0
B-70	176	197	21	1	3	4	1	0
B-70	176	183	7	1	3	4	1	0
B-70	177	180	3	1	3	4	1	0
B-70	177	183	6	1	3	1	1	0
B-70	178	477	299	0	3	4	0	0
B-70	179	183	4	1	3	1	1	0
B-70	179	197	18	1	3	4	1	0
B-70	183	184	1	1	3	1	0	0
B-70	183	200	17	1	3	2	1	0
B-70	183	217	34	1	3	2	0	0
B-71	183	263	80	1	3	3	0	0
B-71	183	245	62	1	3	4	1	0
B-71	183	197	14	1	3	4	1	0
B-71	183	185	2	1	3	4	1	0
B-71	184	191	7	1	3	2	0	0
B-71	184	197	13	1	3	4	1	0
B-71	185	190	5	1	3	4	1	0
B-71	185	358	173	1	3	4	0	0
B-71	186	477	291	0	3	3	0	0
B-71	186	477	291	0	3	3	0	2
B-72	189	217	28	1	3	3	1	0
B-72	189	477	288	0	2	4	0	0
B-72	189	190	1	1	3	3	1	0
B-72	189	477	288	0	3	3	0	0
B-72	189	199	10	1	3	3	1	0
B-72	190	191	1	1	3	3	1	0
B-72	190	196	6	1	3	3	1	0
B-72	190	217	27	1	3	4	1	0
B-72	190	198	8	1	3	3	1	0
B-72	191	199	8	1	3	3	1	0
B-73	191	318	127	1	3	2	2	0
B-73	191	318	127	1	3	2	1	0
B-73	191	220	29	1	3	2	2	0
B-73	191	192	1	1	3	3	1	0
B-73	191	477	286	0	3	2	0	0
B-73	191	206	15	1	3	2	0	0
B-73	192	234	42	1	3	3	1	0
B-73	192	477	285	0	3	3	0	0
B-73	192	196	4	1	3	3	1	0
B-73	193	234	41	1	3	1	1	1
B-74	193	194	1	1	4	2	0	0
B-74	193	318	125	1	3	1	2	0
B-74	193	206	13	1	3	1	1	0
B-74	193	358	165	1	3	1	1	1
B-74	194	196	2	1	3	5	1	0
B-74	194	219	25	1	3	4	1	0
B-74	196	477	281	0	3	3	0	0
B-74	197	477	280	0	3	3	0	0
B-75	197	200	3	1	4	4	2	0
B-75	197	477	280	0	3	4	1	1
B-75	197	198	1	1	4	2	1	0
B-75	197	198	1	1	3	1	1	0
B-75	198	199	1	1	3	1	1	0
B-75	198	199	1	1	4	4	1	0
B-75	198	477	279	0	3	3	0	0
B-75	198	477	279	0	3	3	0	0
B-75	199	477	278	0	3	3	0	0
B-75	199	200	1	1	3	1	1	0
B-76	199	200	1	1	3	2	1	0
B-76	199	203	4	1	3	3	1	0
B-76	200	201	1	1	3	3	1	0
B-76	200	204	4	1	3	4	1	0
B-76	200	253	53	1	1	5	0	0
B-76	200	322	122	1	3	5	0	0
B-76	200	218	18	1	4	3	1	0
B-76	200	205	5	1	3	1	0	0
B-76	201	477	276	0	3	3	0	0
B-76	202	205	3	1	3	1	1	0
B-77	203	262	59	1	3	3	0	0
B-77	204	207	3	1	3	4	1	0
B-77	204	205	1	1	2	1	1	0
B-77	204	205	1	1	3	1	1	0
B-77	205	210	5	1	3	1	1	0
B-77	205	208	3	1	3	2	1	0
B-77	206	207	1	1	3	4	0	0
B-77	206	213	7	1	4	2	1	0
B-77	206	208	2	1	3	2	1	0
B-77	206	207	1	1	3	4	0	0
B-78	207	208	1	1	3	1	1	0
B-78	207	392	185	1	3	1	1	0
B-78	207	224	17	1	3	4	0	0
B-78	207	358	151	1	3	3	1	0
B-78	209	318	109	1	3	3	2	1
B-78	209	318	109	1	4	4	2	0
B-78	210	213	3	1	3	2	1	0
B-78	210	221	11	1	3	1	1	0
B-78	210	219	9	1	3	2	1	0
B-78	211	220	9	1	3	5	1	0
B-79	211	213	2	1	3	5	1	1
B-79	211	220	9	1	3	5	1	0
B-79	211	212	1	1	3	4	1	0
B-79	212	223	11	1	3	5	1	1
B-79	212	213	1	1	3	1	1	0
B-79	212	219	7	1	3	4	1	0
B-79	212	213	1	1	3	4	1	0
B-79	213	231	18	1	3	4	1	0
B-79	214	477	263	0	3	4	1	0
B-79	214	219	5	1	3	1	1	0
B-80	214	220	6	1	3	1	1	0
B-80	214	477	263	0	3	3	0	0
B-80	214	225	11	1	3	1	1	0
B-80	215	477	262	0	3	2	0	0
B-80	216	318	102	1	4	4	2	0
B-80	216	318	102	1	4	4	2	0
B-80	217	241	24	1	4	4	1	0
B-80	217	241	24	1	4	4	1	0
B-80	217	241	24	1	4	4	1	0
B-81	217	232	15	1	3	1	1	0
B-81	217	477	260	0	3	3	0	0
B-81	217	241	24	1	4	4	0	0
B-81	217	218	1	1	3	4	1	0
B-81	218	219	1	1	3	3	0	0
B-81	218	219	1	1	3	2	1	0
B-81	218	219	1	1	3	4	1	0
B-81	218	255	37	1	3	5	1	0
B-81	218	255	37	1	3	5	1	0
B-81	218	254	36	1	3	5	1	0
B-82	218	255	37	1	3	5	1	0
B-82	219	318	99	1	3	1	2	0
B-82	219	220	1	1	3	1	1	0
B-82	219	234	15	1	4	5	1	0
B-82	220	221	1	1	4	1	1	0
B-82	220	477	257	0	3	5	0	0
B-82	220	221	1	1	3	1	1	0
B-82	220	226	6	1	3	4	1	0
B-82	220	221	1	1	3	1	1	0
B-82	220	221	1	1	4	4	1	0
B-83	221	231	10	1	3	1	1	0
B-83	221	328	107	1	3	1	1	0
B-83	221	252	31	1	3	4	1	0
B-83	221	225	4	1	3	4	1	0
B-83	223	230	7	1	3	4	1	0
B-83	224	477	253	0	3	4	1	0
B-83	224	477	253	0	3	4	0	0
B-83	224	390	166	1	3	5	1	1
B-83	224	477	253	0	3	1	0	0
B-83	224	252	28	1	4	4	0	0
B-84	225	227	2	1	3	4	1	0
B-84	225	252	27	1	4	4	0	0
B-84	226	259	33	1	3	5	1	1
B-84	226	322	96	1	3	5	1	1
B-84	226	227	1	1	3	4	1	0
B-84	226	231	5	1	3	1	1	0
B-84	226	246	20	1	3	4	0	0
B-84	226	231	5	1	3	2	1	0
B-84	226	229	3	1	3	4	1	0
B-84	227	256	29	1	3	1	1	0
B-85	227	248	21	1	3	2	1	0
B-85	229	230	1	1	3	1	1	0
B-85	230	231	1	1	3	4	1	0
B-85	230	231	1	1	3	4	1	0
B-85	231	232	1	1	3	3	1	0
B-85	231	232	1	1	3	4	1	0
B-85	231	255	24	1	3	5	1	0
B-85	231	232	1	1	3	1	1	0
B-85	232	477	245	0	3	1	0	0
B-85	232	247	15	1	3	3	1	0
B-86	232	245	13	1	4	4	0	0
B-86	232	235	3	1	3	1	1	0
B-86	233	234	1	1	3	4	1	0
B-86	233	234	1	1	3	1	1	0
B-86	233	246	13	1	3	2	1	0
B-86	234	240	6	1	3	4	1	0
B-86	234	238	4	1	3	5	1	0
B-86	234	238	4	1	3	5	1	0
B-86	234	246	12	1	3	4	1	0
B-86	234	243	9	1	3	2	1	0
B-87	235	241	6	1	3	4	1	0
B-87	236	477	241	0	3	2	0	0
B-87	236	477	241	0	3	4	0	0
B-87	239	252	13	1	3	4	1	0
B-87	239	241	2	1	4	4	1	0
B-87	240	241	1	1	3	4	1	0
B-87	240	255	15	1	3	5	1	0
B-87	240	329	89	1	3	5	1	0
B-87	240	477	237	0	3	3	0	0
B-87	240	241	1	1	3	4	1	0
B-88	241	248	7	1	3	2	1	0
B-88	241	254	13	1	3	5	1	1
B-88	241	249	8	1	3	3	1	0
B-88	242	477	235	0	3	1	0	0
B-88	245	263	18	1	3	3	0	0
B-88	245	246	1	1	4	4	1	0
B-88	245	249	4	1	3	1	1	0
B-88	245	248	3	1	3	4	1	0
B-88	246	248	2	1	3	1	1	0
B-88	246	248	2	1	3	4	1	0
B-89	246	247	1	1	3	1	1	0
B-89	246	358	112	1	3	4	0	0
B-89	246	247	1	1	3	4	1	0
B-89	247	327	80	1	3	3	1	3
B-89	247	249	2	1	3	5	1	1
B-89	248	250	2	1	3	1	1	0
B-89	248	477	229	0	3	4	1	0
B-89	248	249	1	1	3	4	1	0
B-89	249	252	3	1	3	1	1	0
B-89	249	253	4	1	3	4	1	0
B-90	250	253	3	1	3	2	0	0
B-90	251	252	1	1	3	4	1	0
B-90	253	263	10	1	3	2	1	0
B-90	253	263	10	1	3	2	1	0
B-90	253	310	57	1	3	1	1	0
B-90	253	261	8	1	3	1	1	0
B-90	254	259	5	1	3	3	1	0
B-90	255	477	222	0	3	4	0	0
B-90	255	477	222	0	3	2	1	0
B-90	255	358	103	1	3	2	1	0
B-91	256	269	13	1	3	1	1	0
B-91	256	263	7	1	3	4	1	0
B-91	256	257	1	1	3	1	1	0
B-91	257	258	1	1	4	4	1	0
B-91	257	263	6	1	3	2	1	0
B-91	259	477	218	0	3	4	0	0
B-91	259	260	1	1	3	4	1	0
B-91	259	262	3	1	3	5	1	1
B-91	259	282	23	1	3	5	1	1
B-91	259	262	3	1	3	3	1	0
B-92	259	263	4	1	3	3	1	0
B-92	259	477	218	0	3	3	0	0
B-92	260	270	10	1	3	5	1	1
B-92	260	329	69	1	3	5	1	0
B-92	260	263	3	1	3	1	1	0
B-92	260	343	83	1	3	1	0	0
B-92	261	280	19	1	3	2	1	0
B-92	262	268	6	1	3	1	1	0
B-92	262	289	27	1	3	3	1	0
B-92	262	263	1	1	3	1	1	0
B-93	262	297	35	1	3	1	1	0
B-93	262	269	7	1	3	4	1	0
B-93	263	269	6	1	3	3	0	0
B-93	263	269	6	1	3	4	1	0
B-93	263	264	1	1	3	1	1	0
B-93	263	477	214	0	3	2	0	0
B-93	263	280	17	1	3	2	1	0
B-93	267	268	1	1	3	4	1	0
B-93	267	268	1	1	3	1	1	0
B-93	268	270	2	1	4	4	0	0
B-94	269	282	13	1	4	4	0	0
B-94	269	272	3	1	3	2	1	0
B-94	269	477	208	0	3	3	0	0
B-94	269	288	19	1	3	4	1	0
B-94	270	271	1	1	3	3	1	0
B-94	271	380	109	1	3	5	1	1
B-94	271	343	72	1	3	5	1	1
B-94	271	282	11	1	3	5	1	0
B-94	272	287	15	1	3	5	1	1
B-94	272	284	12	1	3	2	1	0
B-95	279	282	3	1	3	4	0	0
B-95	280	281	1	1	4	1	1	0
B-95	282	477	195	0	3	2	0	0
B-95	282	294	12	1	3	4	1	0
B-95	282	283	1	1	3	4	1	0
B-95	282	477	195	0	3	1	0	0
B-95	282	283	1	1	3	1	1	0
B-95	283	287	4	1	3	3	1	0
B-95	283	284	1	1	2	1	1	0
B-95	283	310	27	1	3	1	1	0
B-96	285	287	2	1	3	1	1	0
B-96	288	299	11	1	3	4	1	0
B-96	288	298	10	1	3	4	1	0
B-96	288	318	30	1	3	1	2	0
B-96	288	291	3	1	3	1	1	0
B-96	289	295	6	1	3	1	1	0
B-96	289	477	188	0	3	4	0	0
B-96	289	310	21	1	3	2	1	0
B-96	293	464	171	1	3	1	1	0
B-96	293	477	184	0	3	1	0	0
B-97	293	477	184	0	4	1	0	0
B-97	294	295	1	1	3	1	0	0
B-97	294	295	1	1	3	1	1	0
B-97	295	329	34	1	3	3	3	1
B-97	295	477	182	0	3	4	0	0
B-97	295	298	3	1	3	4	1	0
B-97	296	350	54	1	3	3	2	0
B-97	296	297	1	1	3	1	1	0
B-97	296	297	1	1	3	4	1	0
B-97	297	310	13	1	3	4	1	0
B-98	297	298	1	1	3	1	1	0
B-98	297	298	1	1	3	1	1	0
B-98	298	299	1	1	3	4	1	0
B-98	298	299	1	1	3	4	1	0
B-98	298	299	1	1	3	4	1	0
B-98	298	301	3	1	3	4	1	0
B-98	298	323	25	1	4	4	1	0
B-98	298	299	1	1	3	4	1	0
B-98	298	312	14	1	3	2	0	0
B-98	299	302	3	1	3	4	1	0
B-99	301	477	176	0	3	4	1	0
B-99	301	302	1	1	3	1	1	0
B-99	301	322	21	1	3	3	1	0
B-99	302	323	21	1	3	1	1	0
B-99	302	312	10	1	3	1	1	0
B-99	302	318	16	1	3	5	0	0
B-99	302	308	6	1	3	4	1	0
B-99	302	477	175	0	3	1	0	1
B-99	303	477	174	0	1	1	0	0
B-99	304	477	173	0	3	4	0	0
M-85	4	75	71	1	3	4	0	2
M-85	37	251	214	1	4	1	1	0
M-86	39	457	418	1	3	1	0	1
M-86	45	51	6	1	3	1	0	0
M-86	46	61	15	1	3	1	1	0
M-86	46	61	15	1	4	1	1	0
M-86	48	61	13	1	3	1	0	2
M-86	48	61	13	1	3	1	1	0
M-86	48	61	13	1	3	1	1	1
M-86	48	76	28	1	3	1	1	2
M-86	51	137	86	1	3	1	1	1
M-86	51	123	72	1	3	1	1	0
M-87	52	477	425	0	3	2	0	0
M-87	57	222	165	1	3	1	0	0
M-87	66	477	411	0	3	2	0	0
M-87	68	75	7	1	3	4	1	1
M-87	75	76	1	1	3	1	1	1
M-87	76	81	5	1	3	1	1	1
M-87	76	77	1	1	3	3	1	1
M-87	88	477	389	0	3	1	0	1
M-87	90	91	1	1	3	1	1	0
M-87	90	91	1	1	3	1	1	1
M-88	90	370	280	1	3	1	0	1
M-88	100	102	2	1	3	1	1	3
M-88	100	102	2	1	3	1	1	2
M-88	107	477	370	0	4	1	0	0
M-88	121	122	1	1	4	4	1	0
M-88	122	142	20	1	3	4	1	0
M-88	122	134	12	1	3	1	1	1
M-88	129	130	1	1	3	1	1	0
M-88	133	134	1	1	3	1	1	0
M-88	159	439	280	1	3	1	1	0
M-89	162	163	1	1	3	1	0	0
M-89	222	223	1	1	5	4	1	0
M-89	224	229	5	1	3	1	1	0
M-89	224	225	1	1	3	5	1	0
M-89	224	225	1	1	3	3	1	0
M-89	226	227	1	1	3	1	1	0
M-89	229	230	1	1	3	1	1	0
M-89	231	477	246	0	3	1	0	0
M-89	243	244	1	1	3	5	1	0
M-89	243	244	1	1	3	5	1	0
M-90	243	244	1	1	3	5	1	0
M-90	243	244	1	1	3	5	1	0
M-90	243	244	1	1	3	5	1	0
M-90	243	244	1	1	3	5	1	0
M-90	243	244	1	1	3	5	1	0
M-90	250	251	1	1	3	1	1	1
M-90	250	251	1	1	3	1	1	0
M-90	250	477	227	0	3	1	0	0
M-90	250	251	1	1	3	5	1	1
M-90	250	477	227	0	3	1	0	0
M-91	250	251	1	1	3	5	1	1
M-91	251	252	1	1	3	1	1	0
M-91	252	253	1	1	3	4	1	0
M-91	284	477	193	0	3	1	1	0
M-91	343	477	134	0	4	1	0	0
OUT-13	320	344	24	1	4	1	1	0
OUT-13	320	327	7	1	3	1	1	1
OUT-13	322	327	5	1	3	1	1	0
OUT-13	322	327	5	1	3	1	1	1
OUT-13	322	477	155	0	5	1	0	0
XML-27	3	20	17	1	3	1	0	1
XML-27	6	7	1	1	4	4	1	1
XML-27	20	21	1	1	3	4	1	1
XML-28	93	477	384	0	3	2	1	0
XML-28	94	477	383	0	3	2	0	0
XML-28	94	477	383	0	3	2	0	0
XML-28	276	280	4	1	3	4	1	0
XML-28	282	283	1	1	4	4	1	0
XML-28	289	290	1	1	3	1	1	0
AP-1	10	16	6	1	3	5	1	0
AP-10	142	477	335	0	4	5	0	0
AP-10	142	477	335	0	3	4	0	0
AP-10	142	477	335	0	3	3	0	0
AP-10	142	179	37	1	3	3	0	0
AP-10	142	477	335	0	3	2	0	0
AP-10	142	477	335	0	3	2	0	0
AP-10	142	477	335	0	3	1	0	0
AP-10	156	164	8	1	3	1	0	0
AP-10	161	477	316	0	3	4	1	0
AP-10	162	248	86	1	3	4	0	0
AP-1	10	16	6	1	3	5	1	0
AP-11	162	477	315	0	3	1	0	1
AP-11	164	255	91	1	3	2	0	0
AP-11	164	477	313	0	4	2	0	0
AP-11	164	477	313	0	3	2	1	0
AP-11	165	477	312	0	3	2	0	0
AP-11	168	169	1	1	3	3	0	0
AP-11	169	189	20	1	2	1	0	0
AP-11	178	477	299	0	4	2	0	0
AP-11	179	477	298	0	3	5	1	0
AP-11	183	193	10	1	2	4	0	0
AP-1	10	16	6	1	1	3	1	0
AP-12	189	233	44	1	1	1	1	0
AP-12	191	477	286	0	2	1	0	0
AP-12	191	192	1	1	3	5	0	0
AP-12	193	259	66	1	3	4	0	0
AP-12	197	259	62	1	2	2	0	1
AP-12	197	198	1	1	3	1	0	1
AP-12	198	302	104	1	3	3	0	0
AP-12	204	477	273	0	3	4	0	0
AP-12	217	477	260	0	3	4	1	0
AP-12	227	231	4	1	3	1	0	1
AP-1	15	477	462	0	2	2	1	0
AP-13	233	234	1	1	5	3	0	0
AP-13	234	289	55	1	3	1	0	0
AP-13	234	240	6	1	3	5	0	0
AP-13	236	240	4	1	3	5	0	0
AP-13	239	477	238	0	3	4	0	0
AP-13	246	477	231	0	3	1	0	0
AP-13	247	477	230	0	4	1	0	0
AP-13	248	310	62	1	3	4	1	0
AP-13	252	253	1	1	3	1	0	0
AP-13	252	253	1	1	3	4	0	0
AP-1	16	17	1	1	4	4	1	0
AP-14	253	254	1	1	3	1	0	0
AP-14	253	477	224	0	4	4	0	0
AP-14	254	477	223	0	3	4	0	0
AP-14	255	477	222	0	3	4	0	0
AP-14	255	477	222	0	3	2	0	0
AP-14	259	260	1	1	3	1	0	0
AP-14	260	477	217	0	3	5	1	0
AP-14	261	477	216	0	3	4	0	0
AP-14	261	282	21	1	3	1	0	0
AP-14	262	477	215	0	3	2	0	0
AP-1	16	477	461	0	3	3	1	0
AP-15	262	263	1	1	3	1	0	0
AP-15	262	380	118	1	3	4	0	0
AP-15	264	282	18	1	2	2	0	0
AP-15	267	477	210	0	4	4	0	0
AP-15	282	477	195	0	4	5	0	0
AP-15	284	296	12	1	3	3	0	0
AP-15	289	477	188	0	3	4	0	0
AP-15	289	290	1	1	3	3	0	0
AP-15	294	477	183	0	3	5	0	0
AP-15	295	477	182	0	4	5	0	0
AP-1	16	477	461	0	3	4	1	0
AP-16	302	477	175	0	4	3	1	0
AP-16	303	477	174	0	3	4	0	0
AP-16	309	477	168	0	3	5	0	0
AP-16	309	477	168	0	3	5	0	0
AP-16	310	316	6	1	3	3	1	0
AP-16	310	317	7	1	3	1	0	0
AP-16	317	387	70	1	3	4	1	0
AP-16	318	477	159	0	4	4	1	0
AP-16	346	477	131	0	4	4	0	0
AP-16	353	477	124	0	4	1	0	0
AP-1	16	29	13	1	3	4	1	0
AP-1	17	65	48	1	3	2	1	0
AP-1	21	93	72	1	4	3	1	0
AP-2	21	92	71	1	4	3	1	0
AP-2	29	477	448	0	3	3	1	1
AP-2	37	477	440	0	3	3	1	0
AP-2	37	477	440	0	3	3	1	0
AP-2	51	477	426	0	3	4	1	0
AP-2	51	65	14	1	2	4	1	0
AP-2	58	59	1	1	3	4	1	0
AP-2	59	72	13	1	3	3	1	1
AP-2	63	85	22	1	3	3	1	1
AP-2	64	72	8	1	3	4	1	0
AP-3	64	71	7	1	1	5	1	1
AP-3	64	71	7	1	3	5	1	1
AP-3	64	71	7	1	3	5	1	1
AP-3	64	71	7	1	3	5	1	0
AP-3	64	71	7	1	3	5	0	0
AP-3	65	71	6	1	3	3	1	0
AP-3	65	477	412	0	3	3	1	0
AP-3	65	70	5	1	3	2	1	1
AP-3	65	477	412	0	3	2	1	1
AP-3	65	477	412	0	3	4	1	2
AP-4	65	477	412	0	3	4	1	0
AP-4	67	73	6	1	3	1	1	0
AP-4	70	71	1	1	3	1	1	0
AP-4	70	71	1	1	3	4	1	0
AP-4	71	477	406	0	3	3	1	0
AP-4	71	477	406	0	3	4	1	0
AP-4	71	72	1	1	3	1	1	1
AP-4	71	82	11	1	3	2	1	0
AP-4	72	477	405	0	4	5	1	0
AP-4	72	73	1	1	3	4	1	0
AP-5	73	259	186	1	3	1	1	1
AP-5	80	82	2	1	3	4	1	0
AP-5	81	93	12	1	4	4	1	0
AP-5	85	477	392	0	4	5	1	0
AP-5	87	106	19	1	3	1	1	0
AP-5	91	132	41	1	3	4	1	0
AP-5	91	477	386	0	3	4	1	0
AP-5	92	179	87	1	3	3	1	0
AP-5	93	477	384	0	3	4	1	0
AP-5	100	477	377	0	3	4	1	0
AP-6	106	107	1	1	3	3	1	0
AP-6	106	107	1	1	5	3	1	0
AP-6	107	108	1	1	3	1	1	0
AP-6	112	113	1	1	3	3	1	0
AP-6	113	477	364	0	4	4	1	1
AP-6	114	116	2	1	3	1	0	0
AP-6	119	131	12	1	3	3	1	0
AP-6	123	477	354	0	3	4	0	0
AP-6	129	477	348	0	4	4	0	0
AP-6	129	130	1	1	3	4	0	0
AP-7	129	477	348	0	3	4	0	0
AP-7	133	134	1	1	3	1	1	0
AP-7	136	161	25	1	3	1	1	0
AP-7	136	155	19	1	3	1	1	0
AP-7	136	477	341	0	3	1	1	0
AP-7	136	155	19	1	3	1	1	0
AP-7	136	477	341	0	3	1	1	0
AP-7	136	477	341	0	3	1	1	0
AP-7	136	477	341	0	3	1	1	0
AP-7	140	477	337	0	3	1	1	0
AP-	9	16	7	1	3	3	1	0
AP-8	140	477	337	0	3	1	1	0
AP-8	140	155	15	1	3	1	1	0
AP-8	140	477	337	0	3	1	1	0
AP-8	140	477	337	0	3	1	1	0
AP-8	140	477	337	0	3	1	1	0
AP-8	140	155	15	1	3	1	1	0
AP-8	140	477	337	0	3	1	1	0
AP-8	142	477	335	0	4	2	0	0
AP-8	142	477	335	0	3	2	0	0
AP-8	142	477	335	0	3	4	0	2
AP-	9	16	7	1	3	5	1	0
AP-9	142	477	335	0	4	5	0	0
AP-9	142	477	335	0	4	5	0	0
AP-9	142	477	335	0	4	5	0	0
AP-9	142	302	160	1	4	5	0	0
AP-9	142	477	335	0	4	5	0	0
AP-9	142	302	160	1	4	5	0	0
AP-9	142	302	160	1	4	5	0	0
AP-9	142	477	335	0	4	5	0	0
AP-9	142	302	160	1	4	5	0	0
AP-9	142	477	335	0	4	5	0	0
NTRY-211	1	477	476	0	3	1	0	1
NTRY-211	2	477	475	0	3	1	0	1
NTRY-211	2	52	50	1	2	1	1	2
NTRY-211	3	477	474	0	3	1	0	0
NTRY-211	3	477	474	0	3	1	0	0
NTRY-211	4	8	4	1	3	3	1	0
NTRY-211	7	477	470	0	3	1	0	2
NTRY-212	8	11	3	1	3	1	1	0
NTRY-212	9	10	1	1	3	1	0	1
NTRY-212	16	477	461	0	3	5	0	0
NTRY-212	16	18	2	1	3	1	1	0
NTRY-212	17	28	11	1	4	1	1	2
NTRY-212	18	477	459	0	3	1	0	0
NTRY-212	18	477	459	0	3	1	0	1
NTRY-212	23	25	2	1	3	1	1	0
NTRY-212	24	477	453	0	3	2	0	0
NTRY-212	24	477	453	0	3	2	0	1
NTRY-213	24	477	453	0	3	5	0	0
NTRY-213	24	477	453	0	3	5	0	0
NTRY-213	24	477	453	0	3	5	0	0
NTRY-213	24	477	453	0	3	5	0	0
NTRY-213	28	477	449	0	3	4	0	0
NTRY-213	29	477	448	0	4	1	0	0
NTRY-213	32	38	6	1	4	1	1	0
NTRY-213	32	477	445	0	4	2	0	0
NTRY-213	32	477	445	0	3	2	0	0
NTRY-213	32	477	445	0	4	3	0	0
NTRY-214	32	477	445	0	3	2	0	1
NTRY-214	44	50	6	1	3	1	0	0
NTRY-214	44	477	433	0	3	1	0	0
NTRY-214	46	154	108	1	3	1	0	1
NTRY-214	53	137	84	1	3	1	0	1
NTRY-214	57	86	29	1	5	4	1	0
NTRY-214	58	405	347	1	3	1	0	0
NTRY-214	59	64	5	1	5	4	1	0
NTRY-214	60	477	417	0	3	1	0	0
NTRY-214	61	477	416	0	3	2	0	0
NTRY-215	64	65	1	1	5	4	1	0
NTRY-215	64	246	182	1	3	2	1	1
NTRY-215	64	123	59	1	3	5	1	0
NTRY-215	64	123	59	1	3	5	1	3
NTRY-215	64	127	63	1	3	5	1	0
NTRY-215	64	128	64	1	3	5	1	0
NTRY-215	64	148	84	1	3	5	1	0
NTRY-215	64	220	156	1	3	5	1	0
NTRY-215	64	477	413	0	4	2	0	0
NTRY-215	64	190	126	1	3	5	1	0
NTRY-216	64	130	66	1	3	5	1	0
NTRY-216	64	154	90	1	3	5	0	0
NTRY-216	64	156	92	1	3	5	1	0
NTRY-216	64	477	413	0	4	4	0	0
NTRY-216	65	66	1	1	3	1	1	0
NTRY-216	65	85	20	1	3	4	1	0
NTRY-216	65	477	412	0	3	1	0	0
NTRY-216	66	106	40	1	3	1	1	0
NTRY-216	66	88	22	1	3	1	0	0
NTRY-216	66	226	160	1	3	5	1	0
NTRY-217	66	124	58	1	3	5	0	0
NTRY-217	66	130	64	1	3	5	0	0
NTRY-217	66	143	77	1	3	5	0	0
NTRY-217	66	129	63	1	3	5	0	0
NTRY-217	66	136	70	1	3	5	1	0
NTRY-217	66	477	411	0	3	3	0	0
NTRY-217	67	68	1	1	3	4	0	2
NTRY-217	67	477	410	0	3	4	0	0
NTRY-217	68	72	4	1	2	1	1	0
NTRY-217	68	477	409	0	3	1	0	0
NTRY-218	71	329	258	1	3	4	0	1
NTRY-218	71	130	59	1	3	5	0	2
NTRY-218	71	150	79	1	3	5	0	1
NTRY-218	73	127	54	1	3	4	1	0
NTRY-218	77	79	2	1	2	1	1	0
NTRY-218	78	477	399	0	3	1	0	1
NTRY-218	79	80	1	1	3	5	0	0
NTRY-218	80	95	15	1	3	1	0	0
NTRY-218	84	477	393	0	4	1	0	0
NTRY-218	84	477	393	0	3	5	0	0
NTRY-219	85	196	111	1	3	1	1	0
NTRY-219	85	477	392	0	3	1	0	0
NTRY-219	86	99	13	1	3	1	1	0
NTRY-219	87	99	12	1	3	1	1	0
NTRY-219	88	98	10	1	3	4	0	0
NTRY-219	91	477	386	0	3	1	0	0
NTRY-219	91	477	386	0	3	5	0	0
NTRY-219	91	477	386	0	3	5	0	0
NTRY-219	93	94	1	1	3	4	1	0
NTRY-219	98	171	73	1	3	3	1	0
NTRY-220	101	109	8	1	3	1	1	0
NTRY-220	101	477	376	0	3	5	0	0
NTRY-220	102	477	375	0	3	1	0	0
NTRY-220	106	109	3	1	2	1	0	0
NTRY-220	107	121	14	1	3	2	0	0
NTRY-220	107	401	294	1	3	1	1	0
NTRY-220	107	129	22	1	3	5	1	2
NTRY-220	107	119	12	1	3	5	1	2
NTRY-220	107	148	41	1	3	5	1	3
NTRY-220	109	171	62	1	4	1	1	0
NTRY-221	110	119	9	1	3	4	0	0
NTRY-221	112	477	365	0	3	3	0	0
NTRY-221	112	119	7	1	3	1	1	0
NTRY-221	115	116	1	1	3	1	0	0
NTRY-221	120	127	7	1	3	1	1	0
NTRY-221	121	127	6	1	4	3	1	0
NTRY-221	121	143	22	1	3	5	0	0
NTRY-221	121	168	47	1	3	5	0	0
NTRY-221	122	134	12	1	3	5	0	0
NTRY-221	123	128	5	1	3	4	0	0
NTRY-222	127	206	79	1	3	2	1	0
NTRY-222	127	477	350	0	3	4	0	0
NTRY-222	128	206	78	1	3	5	0	1
NTRY-222	128	206	78	1	3	5	0	0
NTRY-222	128	169	41	1	3	5	1	1
NTRY-222	128	477	349	0	3	5	0	0
NTRY-222	129	130	1	1	3	1	2	0
NTRY-222	129	200	71	1	3	5	0	0
NTRY-222	129	477	348	0	3	4	0	0
NTRY-222	129	143	14	1	3	5	0	0
NTRY-223	130	206	76	1	3	5	0	2
NTRY-223	133	171	38	1	3	1	1	1
NTRY-223	133	477	344	0	3	4	0	0
NTRY-223	133	235	102	1	3	5	1	0
NTRY-223	134	477	343	0	3	1	0	0
NTRY-223	135	477	342	0	3	1	0	0
NTRY-223	136	137	1	1	3	1	1	0
NTRY-223	137	477	340	0	3	1	0	0
NTRY-223	137	176	39	1	3	1	1	0
NTRY-223	137	477	340	0	3	1	0	0
NTRY-224	138	477	339	0	3	1	0	1
NTRY-224	143	175	32	1	3	5	1	4
NTRY-224	143	179	36	1	3	5	0	0
NTRY-224	143	150	7	1	3	5	0	2
NTRY-224	143	156	13	1	3	5	0	0
NTRY-224	143	156	13	1	3	5	0	0
NTRY-224	144	150	6	1	3	5	1	1
NTRY-224	144	186	42	1	3	5	1	3
NTRY-224	144	477	333	0	3	1	0	0
NTRY-224	148	347	199	1	3	4	1	4
NTRY-225	148	477	329	0	3	4	0	0
NTRY-225	149	172	23	1	3	5	1	1
NTRY-225	149	158	9	1	3	5	1	1
NTRY-225	149	477	328	0	3	4	0	0
NTRY-225	150	157	7	1	1	1	0	0
NTRY-225	150	219	69	1	3	5	0	3
NTRY-225	151	155	4	1	3	5	1	0
NTRY-225	154	175	21	1	3	1	1	1
NTRY-225	154	156	2	1	3	5	0	0
NTRY-225	156	179	23	1	3	1	0	0
NTRY-226	156	168	12	1	3	5	1	0
NTRY-226	157	477	320	0	3	4	0	0
NTRY-226	161	162	1	1	3	1	1	0
NTRY-226	161	171	10	1	3	1	1	0
NTRY-226	161	176	15	1	3	5	1	0
NTRY-226	161	169	8	1	3	5	1	0
NTRY-226	162	477	315	0	3	1	0	0
NTRY-226	162	163	1	1	3	1	1	0
NTRY-226	162	477	315	0	3	3	0	0
NTRY-226	163	176	13	1	3	4	1	0
NTRY-227	163	165	2	1	3	1	1	0
NTRY-227	165	170	5	1	3	1	1	0
NTRY-227	168	177	9	1	3	5	1	0
NTRY-227	169	177	8	1	3	5	1	2
NTRY-227	169	183	14	1	3	5	1	2
NTRY-227	169	170	1	1	3	5	1	1
NTRY-227	171	477	306	0	4	1	0	0
NTRY-227	171	179	8	1	3	3	1	1
NTRY-227	171	172	1	1	3	1	1	0
NTRY-227	175	477	302	0	3	4	0	1
NTRY-228	176	178	2	1	2	5	1	0
NTRY-228	176	177	1	1	3	5	1	0
NTRY-228	176	177	1	1	3	1	1	0
NTRY-228	176	190	14	1	3	1	1	0
NTRY-228	177	178	1	1	3	4	1	0
NTRY-228	178	179	1	1	3	4	1	0
NTRY-228	178	477	299	0	3	5	0	1
NTRY-228	178	477	299	0	3	5	0	0
NTRY-228	178	477	299	0	3	4	0	0
NTRY-228	178	477	299	0	3	1	0	0
NTRY-229	179	273	94	1	3	5	1	1
NTRY-229	179	190	11	1	3	5	0	1
NTRY-229	179	373	194	1	3	4	0	0
NTRY-229	179	183	4	1	3	1	0	0
NTRY-229	179	182	3	1	3	5	1	0
NTRY-229	182	183	1	1	3	5	1	0
NTRY-229	182	228	46	1	3	5	1	0
NTRY-229	186	477	291	0	3	1	0	0
NTRY-229	186	477	291	0	4	3	0	0
NTRY-229	186	193	7	1	2	1	0	0
NTRY-230	189	477	288	0	3	1	0	1
NTRY-230	190	401	211	1	3	5	1	0
NTRY-230	190	477	287	0	3	3	1	0
NTRY-230	190	477	287	0	3	5	0	0
NTRY-230	190	477	287	0	3	5	0	0
NTRY-230	190	477	287	0	3	5	0	2
NTRY-230	190	477	287	0	3	5	0	1
NTRY-230	190	233	43	1	3	5	1	0
NTRY-230	190	228	38	1	3	1	1	0
NTRY-230	190	205	15	1	3	4	1	2
NTRY-231	192	196	4	1	3	1	1	0
NTRY-231	193	249	56	1	3	4	1	0
NTRY-231	193	228	35	1	3	5	1	0
NTRY-231	196	220	24	1	3	5	0	3
NTRY-231	198	477	279	0	3	5	0	0
NTRY-231	198	247	49	1	3	1	1	0
NTRY-231	199	217	18	1	3	1	0	1
NTRY-231	199	477	278	0	4	1	0	0
NTRY-231	199	246	47	1	3	5	0	0
NTRY-231	199	200	1	1	3	5	1	0
NTRY-232	200	477	277	0	3	5	0	0
NTRY-232	200	477	277	0	3	5	0	0
NTRY-232	200	477	277	0	3	5	0	0
NTRY-232	200	477	277	0	3	5	0	0
NTRY-232	203	213	10	1	3	4	0	0
NTRY-232	203	204	1	1	3	1	0	0
NTRY-232	203	234	31	1	3	5	0	0
NTRY-232	204	477	273	0	3	4	0	0
NTRY-232	205	477	272	0	3	5	0	0
NTRY-232	205	308	103	1	3	4	1	0
NTRY-233	210	220	10	1	4	1	1	1
NTRY-233	210	219	9	1	3	5	0	1
NTRY-233	213	214	1	1	3	1	0	0
NTRY-233	214	222	8	1	3	5	0	0
NTRY-233	217	477	260	0	3	4	0	1
NTRY-233	218	220	2	1	4	4	1	0
NTRY-233	218	246	28	1	3	3	1	0
NTRY-233	219	220	1	1	3	1	1	0
NTRY-233	219	477	258	0	3	3	0	2
NTRY-233	220	228	8	1	3	5	1	1
NTRY-234	220	477	257	0	3	3	0	1
NTRY-234	220	240	20	1	3	1	0	0
NTRY-234	220	477	257	0	2	2	0	0
NTRY-234	221	222	1	1	3	5	1	0
NTRY-234	221	228	7	1	3	5	1	0
NTRY-234	221	228	7	1	3	5	1	0
NTRY-234	221	228	7	1	3	5	1	0
NTRY-234	221	228	7	1	3	5	1	0
NTRY-234	221	228	7	1	3	5	1	0
NTRY-234	221	228	7	1	3	5	1	0
NTRY-235	221	232	11	1	3	5	1	0
NTRY-235	221	228	7	1	3	5	1	0
NTRY-235	224	225	1	1	3	1	1	0
NTRY-235	224	477	253	0	3	1	0	0
NTRY-235	225	232	7	1	3	1	0	1
NTRY-235	226	231	5	1	3	5	1	0
NTRY-235	228	232	4	1	3	5	0	0
NTRY-235	228	477	249	0	3	1	0	0
NTRY-235	228	231	3	1	3	5	1	0
NTRY-235	232	233	1	1	3	1	1	0
NTRY-236	232	233	1	1	3	5	1	0
NTRY-236	232	477	245	0	3	3	0	1
NTRY-236	232	233	1	1	3	5	1	1
NTRY-236	232	233	1	1	3	5	1	0
NTRY-236	232	233	1	1	3	5	1	1
NTRY-236	233	477	244	0	3	4	0	0
NTRY-236	233	238	5	1	4	4	1	0
NTRY-236	234	249	15	1	3	5	1	1
NTRY-236	235	238	3	1	3	1	0	1
NTRY-236	239	240	1	1	3	1	1	0
NTRY-237	239	477	238	0	3	5	0	0
NTRY-237	239	268	29	1	3	4	1	0
NTRY-237	240	299	59	1	3	4	1	0
NTRY-237	241	242	1	1	3	1	0	0
NTRY-237	242	246	4	1	4	5	1	1
NTRY-237	242	248	6	1	3	1	1	0
NTRY-237	246	247	1	1	3	4	1	0
NTRY-237	246	283	37	1	3	3	0	0
NTRY-237	246	256	10	1	3	5	1	0
NTRY-237	246	256	10	1	3	5	1	0
NTRY-238	246	256	10	1	3	5	1	0
NTRY-238	246	256	10	1	3	5	1	0
NTRY-238	246	282	36	1	3	5	0	0
NTRY-238	246	282	36	1	3	5	0	0
NTRY-238	246	256	10	1	3	5	0	0
NTRY-238	246	282	36	1	3	5	0	0
NTRY-238	246	282	36	1	3	5	0	0
NTRY-238	246	282	36	1	3	5	0	0
NTRY-238	246	256	10	1	3	5	0	0
NTRY-238	246	282	36	1	3	5	0	0
NTRY-239	246	282	36	1	3	5	0	0
NTRY-239	247	477	230	0	3	1	0	0
NTRY-239	248	249	1	1	3	4	1	0
NTRY-239	248	477	229	0	3	4	0	0
NTRY-239	248	249	1	1	4	1	1	0
NTRY-239	249	252	3	1	3	1	1	0
NTRY-239	249	477	228	0	3	5	0	2
NTRY-239	252	477	225	0	3	1	0	1
NTRY-239	253	255	2	1	3	4	1	0
NTRY-239	254	477	223	0	3	2	0	0
NTRY-240	254	477	223	0	3	1	0	0
NTRY-240	255	373	118	1	3	2	0	0
NTRY-240	255	477	222	0	3	1	0	0
NTRY-240	256	260	4	1	3	1	1	0
NTRY-240	256	477	221	0	3	4	0	0
NTRY-240	259	477	218	0	3	4	0	0
NTRY-240	259	268	9	1	3	1	0	0
NTRY-240	260	262	2	1	1	5	0	0
NTRY-240	261	477	216	0	3	1	0	0
NTRY-240	261	274	13	1	3	1	1	0
NTRY-241	262	477	215	0	3	1	0	0
NTRY-241	262	477	215	0	3	4	1	0
NTRY-241	262	373	111	1	3	1	0	0
NTRY-241	262	267	5	1	3	4	1	0
NTRY-241	263	350	87	1	3	1	0	0
NTRY-241	263	477	214	0	5	1	1	0
NTRY-241	266	477	211	0	3	1	0	0
NTRY-241	266	268	2	1	3	1	1	0
NTRY-241	266	477	211	0	3	4	0	0
NTRY-241	267	289	22	1	3	5	0	1
NTRY-242	267	477	210	0	3	1	0	0
NTRY-242	267	268	1	1	3	5	0	0
NTRY-242	274	477	203	0	3	4	0	0
NTRY-242	274	281	7	1	3	5	1	1
NTRY-242	277	477	200	0	3	1	0	0
NTRY-242	280	477	197	0	3	1	1	0
NTRY-242	282	283	1	1	3	5	0	0
NTRY-242	287	289	2	1	3	2	0	0
NTRY-242	288	291	3	1	3	1	1	0
NTRY-242	288	291	3	1	3	1	1	0
NTRY-243	290	477	187	0	3	5	0	1
NTRY-243	291	297	6	1	3	4	1	0
NTRY-243	294	296	2	1	3	1	1	0
NTRY-243	295	302	7	1	3	1	0	0
NTRY-243	297	477	180	0	3	1	0	0
NTRY-243	297	477	180	0	3	1	1	0
NTRY-243	298	310	12	1	4	3	1	0
NTRY-243	301	302	1	1	3	1	0	0
NTRY-243	301	371	70	1	3	5	0	1
NTRY-243	302	477	175	0	3	1	0	0
NTRY-244	303	408	105	1	3	4	1	0
NTRY-244	304	310	6	1	3	1	1	0
NTRY-244	308	346	38	1	3	1	1	0
NTRY-244	308	477	169	0	3	4	0	0
NTRY-244	310	336	26	1	4	4	1	0
NTRY-244	311	477	166	0	3	2	1	0
NTRY-244	311	477	166	0	3	5	0	4
NTRY-244	311	477	166	0	3	5	0	4
NTRY-244	311	340	29	1	3	5	1	1
NTRY-244	311	477	166	0	3	5	0	2
NTRY-245	311	477	166	0	3	5	0	0
NTRY-245	311	477	166	0	3	4	0	2
NTRY-245	311	343	32	1	3	4	1	4
NTRY-245	311	351	40	1	3	4	0	3
NTRY-245	311	382	71	1	3	4	1	1
NTRY-245	317	477	160	0	3	4	0	0
NTRY-245	318	477	159	0	3	4	0	0
NTRY-245	318	319	1	1	4	5	1	0
NTRY-245	318	337	19	1	3	4	1	1
NTRY-245	318	477	159	0	3	4	0	2
NTRY-246	318	340	22	1	3	4	1	1
NTRY-246	322	477	155	0	3	4	0	0
NTRY-246	322	477	155	0	3	4	1	1
NTRY-246	323	477	154	0	5	2	0	1
NTRY-246	329	331	2	1	3	1	0	0
NTRY-246	330	477	147	0	3	4	1	0
NTRY-246	331	345	14	1	3	4	0	0
NTRY-246	331	477	146	0	3	4	0	0
NTRY-246	332	340	8	1	3	5	0	0
NTRY-246	333	383	50	1	3	1	0	0
NTRY-247	333	477	144	0	3	4	0	1
NTRY-247	336	408	72	1	3	1	1	0
NTRY-247	337	477	140	0	3	4	0	1
NTRY-247	337	477	140	0	3	4	0	3
NTRY-247	337	477	140	0	3	4	0	2
NTRY-247	337	477	140	0	3	4	0	2
NTRY-247	337	345	8	1	3	1	0	1
NTRY-247	338	401	63	1	3	1	0	0
NTRY-247	340	477	137	0	3	4	0	1
NTRY-247	340	477	137	0	3	4	0	3
NTRY-248	345	350	5	1	4	1	0	0
NTRY-248	351	354	3	1	3	2	1	0
NTRY-248	353	464	111	1	3	4	1	0
NTRY-248	354	394	40	1	3	4	0	0
NTRY-248	362	477	115	0	4	5	0	0
IRO-64	8	477	469	0	4	4	0	0
IRO-64	37	477	440	0	3	1	0	0
IRO-64	67	196	129	1	3	1	0	1
IRO-64	98	477	379	0	3	1	0	0
IRO-64	138	477	339	0	4	1	0	0
IRO-64	156	477	321	0	3	1	0	0
IRO-64	192	477	285	0	3	1	0	0
IRO-65	217	386	169	1	3	1	1	0
IRO-65	287	449	162	1	3	4	1	3
IRO-65	312	387	75	1	3	1	1	0
IRO-65	327	477	150	0	3	1	1	1
IRO-65	327	384	57	1	3	1	1	0
IRO-65	363	477	114	0	3	1	0	0
NGA-34	63	189	126	1	3	4	0	0
NGA-34	63	477	414	0	3	2	0	0
NGA-34	63	477	414	0	3	2	0	0
NGA-34	64	477	413	0	3	2	0	0
NGA-34	94	129	35	1	3	1	0	0
NGA-34	98	477	379	0	4	4	0	0
NGA-34	101	477	376	0	3	2	0	0
NGA-34	101	129	28	1	3	2	0	0
NGA-34	108	477	369	0	3	2	0	0
NGA-35	114	129	15	1	3	1	0	0
NGA-35	116	477	361	0	3	4	0	0
NGA-35	122	477	355	0	3	4	0	0
NGA-35	123	129	6	1	3	1	0	0
NGA-35	124	129	5	1	3	4	0	0
NGA-35	124	189	65	1	3	4	0	0
NGA-35	127	477	350	0	3	1	0	0
NGA-35	128	477	349	0	3	4	0	0
NGA-35	128	183	55	1	5	4	0	0
NGA-35	130	189	59	1	3	4	0	0
NGA-36	130	477	347	0	4	4	0	0
NGA-36	131	477	346	0	3	4	0	0
NGA-36	131	189	58	1	3	4	0	0
NGA-36	133	178	45	1	4	2	0	0
NGA-36	133	477	344	0	3	3	0	0
NGA-36	133	477	344	0	3	4	0	0
NGA-36	134	477	343	0	4	4	0	0
NGA-36	134	477	343	0	3	4	0	0
NGA-36	135	136	1	1	3	1	0	0
NGA-36	135	189	54	1	3	1	0	0
NGA-37	149	477	328	0	3	4	0	0
NGA-37	150	477	327	0	3	2	0	0
NGA-37	153	460	307	1	3	4	0	0
NGA-37	154	477	323	0	3	4	0	0
NGA-37	155	477	322	0	3	4	0	0
NGA-37	155	477	322	0	3	4	0	0
NGA-37	166	189	23	1	3	4	0	0
NGA-37	179	477	298	0	3	1	0	0
NGA-37	190	477	287	0	3	2	0	0
NGA-37	190	477	287	0	3	2	0	0
NGA-38	191	477	286	0	3	4	0	0
NGA-38	191	477	286	0	3	4	0	0
NGA-38	192	477	285	0	3	2	0	0
NGA-38	193	477	284	0	3	2	0	0
NGA-38	196	477	281	0	3	2	0	0
NGA-38	196	477	281	0	3	2	0	0
NGA-38	196	477	281	0	3	2	0	0
NGA-38	224	477	253	0	3	4	0	0
NGA-38	224	477	253	0	3	2	0	0
NGA-38	226	477	251	0	3	1	0	0
NGA-39	228	477	249	0	3	2	0	0
NGA-39	231	234	3	1	3	2	0	0
NGA-39	266	477	211	0	3	4	0	0
NGA-39	277	477	200	0	3	2	0	0
NGA-39	277	477	200	0	3	2	0	0
NGA-39	278	477	199	0	3	2	0	0
NGA-39	280	477	197	0	4	4	0	0
NGA-39	293	477	184	0	3	5	0	0
NGA-39	296	302	6	1	3	4	0	0
NGA-39	299	477	178	0	3	1	0	0
NGA-40	301	302	1	1	4	4	0	0
NGA-40	308	477	169	0	3	1	0	0
NGA-40	311	477	166	0	3	4	0	0
NGA-40	312	332	20	1	3	2	0	0
NGA-40	315	477	162	0	3	4	0	0
NGA-40	316	477	161	0	3	4	0	4
NGA-40	321	332	11	1	3	2	0	0
NGA-40	322	477	155	0	3	1	0	0
NGA-40	323	477	154	0	3	1	0	0
NGA-40	323	477	154	0	3	1	0	0
NGA-41	329	477	148	0	3	2	0	0
NGA-41	330	339	9	1	3	1	0	0
NGA-41	332	477	145	0	3	4	0	0
NGA-41	332	477	145	0	3	4	0	0
NGA-41	332	477	145	0	3	1	0	0
NGA-41	333	477	144	0	4	3	0	0
NGA-41	341	477	136	0	4	4	0	0
NGA-41	341	345	4	1	1	2	0	1
NGA-41	345	477	132	0	3	1	0	0
NGA-41	345	351	6	1	3	2	0	0
NGA-42	350	455	105	1	3	4	0	2
NGA-42	351	352	1	1	3	4	0	0
S-38	5	124	119	1	4	3	1	0
S-38	6	477	471	0	4	4	1	1
S-38	14	477	463	0	3	1	1	2
S-38	14	477	463	0	3	1	1	2
S-38	21	477	456	0	4	3	0	2
S-38	25	26	1	1	3	3	1	1
S-38	26	477	451	0	3	3	1	0
S-39	27	28	1	1	3	4	1	0
S-39	27	477	450	0	3	2	0	2
S-39	30	477	447	0	3	3	0	4
S-39	30	477	447	0	3	3	1	2
S-39	32	477	445	0	3	3	0	3
S-39	36	477	441	0	3	4	1	1
S-39	37	232	195	1	3	4	1	1
S-39	39	477	438	0	3	4	0	1
S-39	46	477	431	0	4	3	0	0
S-39	49	104	55	1	3	5	1	0
S-40	49	477	428	0	3	5	0	1
S-40	49	477	428	0	3	5	0	2
S-40	49	477	428	0	3	5	1	0
S-40	49	477	428	0	3	5	0	2
S-40	49	281	232	1	3	5	1	0
S-40	50	477	427	0	3	5	0	1
S-40	57	112	55	1	3	3	1	0
S-40	58	64	6	1	3	1	1	1
S-40	58	63	5	1	3	2	1	2
S-40	58	477	419	0	3	2	0	1
S-41	63	64	1	1	4	2	1	0
S-41	66	477	411	0	3	2	1	0
S-41	89	90	1	1	3	2	1	0
S-41	93	199	106	1	3	2	1	4
S-41	94	210	116	1	3	1	1	3
S-41	95	98	3	1	5	3	1	0
S-41	109	477	368	0	3	3	0	0
S-41	133	477	344	0	5	2	0	2
S-41	140	477	337	0	3	4	0	2
S-41	143	477	334	0	4	2	0	2
S-42	145	477	332	0	3	4	0	1
S-42	154	477	323	0	3	4	1	0
S-42	163	232	69	1	3	4	1	2
S-42	191	477	286	0	3	4	0	1
S-42	199	200	1	1	3	2	1	1
S-42	200	201	1	1	3	2	1	1
S-42	208	209	1	1	4	5	1	2
S-42	208	477	269	0	3	4	0	1
S-42	208	477	269	0	3	4	0	1
S-42	209	210	1	1	3	4	1	0
S-43	241	313	72	1	3	3	1	1
S-43	244	477	233	0	3	3	1	1
S-43	281	287	6	1	3	1	1	0
S-43	288	477	189	0	4	3	0	3
S-43	288	477	189	0	3	3	0	1
S-43	290	477	187	0	3	5	0	0
S-43	290	477	187	0	3	5	0	0
S-43	290	477	187	0	3	5	0	0
S-43	307	477	170	0	1	3	1	2
S-43	309	311	2	1	3	1	1	0
S-44	329	477	148	0	4	3	1	0
S-44	329	330	1	1	3	1	1	0
S-44	347	477	130	0	3	3	1	2
IDER-125	8	477	469	0	2	1	0	0
IDER-125	24	477	453	0	3	1	0	0
IDER-125	24	477	453	0	3	5	0	0
IDER-125	27	72	45	1	4	1	1	0
IDER-126	44	45	1	1	3	1	1	0
IDER-126	47	52	5	1	3	1	1	0
IDER-126	59	63	4	1	3	1	1	0
IDER-126	60	477	417	0	3	4	0	0
IDER-126	77	82	5	1	2	1	1	0
IDER-126	151	477	326	0	3	2	0	0
ING-734	1	2	1	1	3	2	1	0
ING-734	1	2	1	1	3	2	1	0
ING-734	1	2	1	1	3	2	1	0
ING-734	1	3	2	1	3	4	1	0
ING-734	1	29	28	1	3	1	1	0
ING-734	2	3	1	1	3	4	1	0
ING-734	2	17	15	1	3	1	1	0
ING-734	2	8	6	1	3	4	1	2
ING-734	2	3	1	1	3	3	1	0
ING-734	2	3	1	1	3	1	1	0
ING-735	2	46	44	1	3	1	0	1
ING-735	2	16	14	1	3	4	1	1
ING-735	3	4	1	1	3	1	1	0
ING-735	3	38	35	1	3	3	4	1
ING-735	3	4	1	1	3	4	0	1
ING-735	3	4	1	1	3	4	0	1
ING-735	3	4	1	1	5	1	0	0
ING-735	5	477	472	0	4	4	1	1
ING-735	6	8	2	1	4	1	1	0
ING-735	6	8	2	1	3	1	1	0
ING-736	6	477	471	0	4	4	1	0
ING-736	7	8	1	1	3	1	1	0
ING-736	7	8	1	1	3	4	1	1
ING-736	7	8	1	1	3	1	1	0
ING-736	7	477	470	0	4	4	0	0
ING-736	7	14	7	1	3	1	1	2
ING-736	7	9	2	1	2	1	1	1
ING-736	8	12	4	1	3	2	1	0
ING-736	8	9	1	1	3	1	1	1
ING-737	8	9	1	1	4	1	1	0
ING-737	8	9	1	1	3	1	1	0
ING-737	10	11	1	1	3	4	1	0
ING-737	10	11	1	1	4	3	1	0
ING-737	11	477	466	0	3	1	0	0
ING-737	11	12	1	1	2	1	1	1
ING-737	11	14	3	1	3	1	1	0
ING-737	11	477	466	0	3	4	0	1
ING-737	13	14	1	1	3	4	2	0
ING-737	13	14	1	1	3	1	1	1
ING-738	14	15	1	1	3	1	2	0
ING-738	14	15	1	1	3	4	1	0
ING-738	14	477	463	0	4	4	0	1
ING-738	14	15	1	1	3	1	1	0
ING-738	15	16	1	1	3	4	1	0
ING-738	15	16	1	1	2	1	1	0
ING-738	15	16	1	1	3	4	1	0
ING-738	15	16	1	1	3	4	4	0
ING-738	15	16	1	1	3	4	4	0
ING-738	15	16	1	1	3	4	1	0
ING-739	15	16	1	1	3	4	1	0
ING-739	15	477	462	0	3	4	1	0
ING-739	15	16	1	1	3	4	1	0
ING-739	16	17	1	1	3	4	1	0
ING-739	16	17	1	1	3	4	1	0
ING-739	16	17	1	1	3	4	1	0
ING-739	16	17	1	1	3	4	1	0
ING-739	16	17	1	1	3	4	1	0
ING-739	16	17	1	1	3	4	1	0
ING-739	17	19	2	1	3	4	1	0
ING-740	17	477	460	0	5	4	0	0
ING-740	17	19	2	1	3	4	2	0
ING-740	17	18	1	1	3	1	1	0
ING-740	17	18	1	1	3	4	1	0
ING-740	17	18	1	1	3	1	3	1
ING-740	18	19	1	1	3	1	1	0
ING-740	18	22	4	1	3	4	4	1
ING-740	18	21	3	1	3	1	1	0
ING-740	18	33	15	1	3	5	0	0
ING-740	18	36	18	1	3	5	0	0
ING-741	18	36	18	1	3	5	0	0
ING-741	18	36	18	1	3	5	0	2
ING-741	18	33	15	1	3	5	0	0
ING-741	18	36	18	1	3	5	0	0
ING-741	18	287	269	1	2	1	1	1
ING-741	18	477	459	0	3	1	1	0
ING-741	19	20	1	1	3	4	1	0
ING-741	20	21	1	1	3	4	2	0
ING-741	20	21	1	1	3	4	1	0
ING-741	20	477	457	0	3	4	0	0
ING-742	21	22	1	1	3	4	1	0
ING-742	21	22	1	1	2	1	1	1
ING-742	21	22	1	1	3	4	1	0
ING-742	21	62	41	1	3	5	1	0
ING-742	21	22	1	1	3	4	1	0
ING-742	21	477	456	0	3	4	0	1
ING-742	21	22	1	1	3	4	1	0
ING-742	21	22	1	1	3	1	1	0
ING-742	22	23	1	1	3	1	1	0
ING-742	22	477	455	0	3	4	0	1
ING-743	22	477	455	0	3	1	0	1
ING-743	22	23	1	1	3	4	1	1
ING-743	22	24	2	1	1	1	1	2
ING-743	22	23	1	1	3	4	1	0
ING-743	22	26	4	1	3	1	0	1
ING-743	22	23	1	1	3	1	1	1
ING-743	23	312	289	1	3	1	0	0
ING-743	23	217	194	1	3	5	1	0
ING-743	23	62	39	1	3	5	1	1
ING-743	23	24	1	1	3	3	1	0
ING-744	23	24	1	1	3	3	1	0
ING-744	23	24	1	1	3	3	1	0
ING-744	23	62	39	1	3	5	2	1
ING-744	23	477	454	0	3	1	0	0
ING-744	23	24	1	1	5	4	1	0
ING-744	24	372	348	1	3	1	1	0
ING-744	24	219	195	1	3	3	0	2
ING-744	24	25	1	1	1	1	1	1
ING-744	25	30	5	1	3	4	1	0
ING-744	25	26	1	1	3	4	2	0
ING-745	28	29	1	1	3	4	1	0
ING-745	28	29	1	1	3	3	1	0
ING-745	28	29	1	1	3	1	0	1
ING-745	29	477	448	0	3	3	1	0
ING-745	29	30	1	1	4	3	1	1
ING-745	30	477	447	0	2	2	0	0
ING-745	30	32	2	1	4	1	1	0
ING-745	30	477	447	0	3	1	0	0
ING-745	30	31	1	1	4	1	1	0
ING-745	31	32	1	1	3	1	1	1
ING-746	31	477	446	0	2	4	1	0
ING-746	31	32	1	1	3	1	1	1
ING-746	31	32	1	1	3	1	1	0
ING-746	31	32	1	1	3	1	1	0
ING-746	31	32	1	1	3	1	1	0
ING-746	32	42	10	1	4	3	1	1
ING-746	32	35	3	1	3	1	1	0
ING-746	32	53	21	1	3	1	1	0
ING-746	32	35	3	1	3	4	1	1
ING-746	32	33	1	1	3	3	1	2
ING-747	33	34	1	1	2	1	1	1
ING-747	34	35	1	1	3	1	0	0
ING-747	35	477	442	0	3	4	0	1
ING-747	36	477	441	0	4	3	0	0
ING-747	36	37	1	1	3	1	0	0
ING-747	36	477	441	0	3	4	0	0
ING-747	37	65	28	1	3	1	1	1
ING-747	37	100	63	1	3	3	0	0
ING-747	37	138	101	1	3	4	1	1
ING-747	37	38	1	1	3	4	1	1
ING-748	37	38	1	1	3	4	0	0
ING-748	38	39	1	1	4	4	0	0
ING-748	38	44	6	1	4	1	1	0
ING-748	38	337	299	1	3	4	0	0
ING-748	38	44	6	1	3	4	1	2
ING-748	39	40	1	1	3	4	4	0
ING-748	39	477	438	0	3	3	0	1
ING-748	39	40	1	1	3	4	2	0
ING-748	39	40	1	1	3	4	1	0
ING-748	41	42	1	1	3	3	2	0
ING-749	41	42	1	1	3	3	1	0
ING-749	41	62	21	1	3	3	1	0
ING-749	42	477	435	0	3	1	0	0
ING-749	42	477	435	0	3	4	0	0
ING-749	42	477	435	0	2	4	0	0
ING-749	42	477	435	0	2	4	0	0
ING-749	42	49	7	1	3	1	1	0
ING-749	42	209	167	1	3	3	1	0
ING-749	44	45	1	1	3	3	1	0
ING-749	44	45	1	1	3	1	1	0
ING-750	44	45	1	1	3	4	1	0
ING-750	45	49	4	1	2	1	1	3
ING-750	46	47	1	1	3	1	1	0
ING-750	48	49	1	1	3	1	1	1
ING-750	48	477	429	0	3	4	1	0
ING-750	48	49	1	1	3	4	1	1
ING-750	49	121	72	1	3	3	0	0
ING-750	51	52	1	1	3	1	1	0
ING-750	51	56	5	1	3	1	1	0
ING-750	51	64	13	1	3	2	1	1
ING-751	51	477	426	0	3	4	1	0
ING-751	52	64	12	1	3	4	1	1
ING-751	52	56	4	1	3	4	0	0
ING-751	56	477	421	0	3	1	0	0
ING-751	56	57	1	1	3	3	1	0
ING-751	56	477	421	0	3	4	0	2
ING-751	56	77	21	1	3	1	1	1
ING-751	56	57	1	1	2	1	1	1
ING-751	56	57	1	1	2	1	1	0
ING-751	57	62	5	1	3	4	1	1
ING-752	57	58	1	1	5	4	1	0
ING-752	57	477	420	0	3	4	0	0
ING-752	58	59	1	1	3	1	0	0
ING-752	59	65	6	1	3	1	2	0
ING-752	59	73	14	1	3	4	1	0
ING-752	60	72	12	1	3	1	1	0
ING-752	60	163	103	1	3	1	1	0
ING-752	60	477	417	0	3	3	1	0
ING-752	60	81	21	1	3	1	1	0
ING-752	60	70	10	1	3	1	1	0
ING-753	61	62	1	1	3	3	1	0
ING-753	62	63	1	1	3	3	1	0
ING-753	62	63	1	1	3	3	3	0
ING-753	63	64	1	1	3	1	1	0
ING-753	63	477	414	0	3	3	1	3
ING-753	64	128	64	1	3	4	1	0
ING-753	65	80	15	1	3	4	1	0
ING-753	66	67	1	1	3	2	2	0
ING-753	66	78	12	1	3	1	0	1
ING-753	67	477	410	0	4	4	0	0
ING-754	67	73	6	1	3	4	1	0
ING-754	72	73	1	1	3	4	1	1
ING-754	74	75	1	1	3	1	1	0
ING-754	74	75	1	1	3	4	1	0
ING-754	74	477	403	0	3	4	1	0
ING-754	75	78	3	1	3	1	1	2
ING-754	76	125	49	1	3	4	3	4
ING-754	77	78	1	1	3	1	1	0
ING-754	77	477	400	0	3	1	0	2
ING-754	78	168	90	1	3	1	1	0
ING-755	78	79	1	1	3	1	1	0
ING-755	78	477	399	0	3	3	0	0
ING-755	78	477	399	0	3	4	0	0
ING-755	80	82	2	1	4	5	1	0
ING-755	81	83	2	1	1	1	3	2
ING-755	84	143	59	1	3	4	1	1
ING-755	86	91	5	1	3	4	1	0
ING-755	86	91	5	1	3	4	1	1
ING-755	87	477	390	0	3	4	0	1
ING-755	87	477	390	0	3	4	0	1
ING-756	87	88	1	1	3	1	1	0
ING-756	87	477	390	0	3	4	1	0
ING-756	87	477	390	0	3	4	1	0
ING-756	87	477	390	0	3	4	0	0
ING-756	87	88	1	1	4	1	0	0
ING-756	88	98	10	1	3	1	2	1
ING-756	89	91	2	1	4	1	0	0
ING-756	91	166	75	1	3	1	0	0
ING-756	91	92	1	1	2	1	0	0
ING-756	94	95	1	1	3	4	1	2
ING-757	94	95	1	1	3	4	1	1
ING-757	94	101	7	1	3	3	1	0
ING-757	94	101	7	1	3	3	1	0
ING-757	94	95	1	1	3	4	1	1
ING-757	98	131	33	1	3	4	1	0
ING-757	98	99	1	1	3	3	2	1
ING-757	100	107	7	1	3	4	1	0
ING-757	100	107	7	1	3	4	1	0
ING-757	101	102	1	1	3	3	0	0
ING-758	102	477	375	0	3	1	0	0
ING-758	102	214	112	1	3	1	2	1
ING-758	105	477	372	0	3	4	0	0
ING-758	105	107	2	1	4	1	1	0
ING-758	105	289	184	1	3	1	1	1
ING-758	105	106	1	1	3	3	1	0
ING-758	106	289	183	1	3	1	1	1
ING-758	106	108	2	1	3	4	1	0
ING-758	106	112	6	1	4	4	1	0
ING-758	106	113	7	1	3	1	3	0
ING-759	106	116	10	1	3	4	2	0
ING-759	106	113	7	1	3	1	1	0
ING-759	107	108	1	1	3	4	1	1
ING-759	108	113	5	1	1	1	2	3
ING-759	108	477	369	0	3	3	1	0
ING-759	108	477	369	0	3	3	1	0
ING-759	108	477	369	0	3	3	1	0
ING-759	108	423	315	1	3	3	1	0
ING-759	108	477	369	0	3	3	1	0
ING-759	108	477	369	0	3	4	1	0
ING-760	108	109	1	1	3	4	1	2
ING-760	108	109	1	1	3	4	1	1
ING-760	108	109	1	1	3	4	1	1
ING-760	108	109	1	1	3	4	1	1
ING-760	108	109	1	1	3	4	1	1
ING-760	108	420	312	1	3	5	1	0
ING-760	110	111	1	1	3	4	1	1
ING-760	110	111	1	1	3	4	1	0
ING-760	111	112	1	1	3	4	1	1
ING-760	111	112	1	1	3	4	1	1
ING-761	111	112	1	1	3	4	1	1
ING-761	112	113	1	1	3	4	1	0
ING-761	112	177	65	1	4	4	1	0
ING-761	113	210	97	1	3	2	0	0
ING-761	113	124	11	1	3	4	1	0
ING-761	113	114	1	1	3	1	1	1
ING-761	113	114	1	1	5	4	1	0
ING-761	113	114	1	1	3	1	1	1
ING-761	113	287	174	1	3	1	1	1
ING-761	114	134	20	1	3	4	1	0
ING-762	115	116	1	1	3	1	0	1
ING-762	115	122	7	1	3	2	1	0
ING-762	116	117	1	1	3	3	0	0
ING-762	116	117	1	1	2	1	1	0
ING-762	116	164	48	1	3	2	1	2
ING-762	116	134	18	1	3	4	1	0
ING-762	116	477	361	0	1	3	0	0
ING-762	116	117	1	1	3	1	1	0
ING-762	118	124	6	1	2	1	1	1
ING-762	118	119	1	1	3	4	1	0
ING-763	119	477	358	0	3	1	0	0
ING-763	121	122	1	1	4	1	1	0
ING-763	121	143	22	1	3	4	1	0
ING-763	121	477	356	0	3	4	0	2
ING-763	121	122	1	1	3	1	1	0
ING-763	121	126	5	1	3	1	0	0
ING-763	121	123	2	1	3	1	0	2
ING-763	121	122	1	1	3	1	0	1
ING-763	121	133	12	1	3	4	1	0
ING-763	121	124	3	1	4	4	1	0
ING-764	121	163	42	1	3	4	1	0
ING-764	121	122	1	1	3	1	1	0
ING-764	121	122	1	1	3	4	1	0
ING-764	121	122	1	1	3	4	1	0
ING-764	122	123	1	1	1	1	1	1
ING-764	122	123	1	1	4	4	1	0
ING-764	122	123	1	1	4	4	1	1
ING-764	122	123	1	1	3	1	0	3
ING-764	122	123	1	1	3	4	1	0
ING-764	122	123	1	1	4	1	2	0
ING-765	123	124	1	1	3	4	1	0
ING-765	123	124	1	1	3	1	0	1
ING-765	124	217	93	1	3	4	1	0
ING-765	125	126	1	1	3	4	1	1
ING-765	125	126	1	1	3	4	1	1
ING-765	126	127	1	1	3	1	0	0
ING-765	126	134	8	1	3	4	1	0
ING-765	126	127	1	1	3	4	1	0
ING-765	128	152	24	1	3	1	0	1
ING-765	128	138	10	1	4	4	1	0
ING-766	129	139	10	1	4	4	1	1
ING-766	129	133	4	1	4	4	0	1
ING-766	130	142	12	1	3	1	1	1
ING-766	130	477	347	0	4	4	0	2
ING-766	130	165	35	1	3	3	1	0
ING-766	131	220	89	1	3	4	1	1
ING-766	133	477	344	0	4	4	0	1
ING-766	134	477	343	0	3	4	0	0
ING-766	134	135	1	1	3	4	1	0
ING-766	134	157	23	1	3	1	1	0
ING-767	134	135	1	1	3	4	1	0
ING-767	135	137	2	1	4	3	1	0
ING-767	135	136	1	1	3	1	1	0
ING-767	136	137	1	1	4	1	1	0
ING-767	138	165	27	1	3	4	1	1
ING-767	138	139	1	1	3	3	1	1
ING-767	139	477	338	0	3	4	0	1
ING-767	142	143	1	1	3	1	1	0
ING-767	142	246	104	1	3	4	1	0
ING-767	143	477	334	0	3	4	0	1
ING-768	144	145	1	1	3	4	1	1
ING-768	144	168	24	1	3	2	4	0
ING-768	144	168	24	1	3	5	4	1
ING-768	144	145	1	1	3	4	1	0
ING-768	144	178	34	1	4	3	0	0
ING-768	146	168	22	1	3	1	3	0
ING-768	147	316	169	1	3	5	1	0
ING-768	148	211	63	1	3	1	1	0
ING-768	148	168	20	1	3	5	4	0
ING-768	148	158	10	1	3	1	1	0
ING-769	148	149	1	1	3	4	1	0
ING-769	148	149	1	1	3	4	1	0
ING-769	149	164	15	1	3	4	2	0
ING-769	149	150	1	1	3	1	1	0
ING-769	149	150	1	1	3	4	1	0
ING-769	149	154	5	1	4	4	1	0
ING-769	149	150	1	1	3	1	1	0
ING-769	149	150	1	1	3	4	1	0
ING-769	149	150	1	1	3	4	1	0
ING-769	149	211	62	1	3	4	1	0
ING-770	150	168	18	1	3	5	3	0
ING-770	151	168	17	1	3	5	4	0
ING-770	151	165	14	1	3	2	1	1
ING-770	152	477	325	0	3	1	0	1
ING-770	154	162	8	1	3	4	1	0
ING-770	154	155	1	1	3	1	1	0
ING-770	155	477	322	0	3	3	1	0
ING-770	155	254	99	1	3	4	1	0
ING-770	155	280	125	1	3	4	1	0
ING-770	156	168	12	1	3	5	3	0
ING-771	156	168	12	1	3	4	1	0
ING-771	156	157	1	1	3	3	0	0
ING-771	157	211	54	1	3	4	1	1
ING-771	157	168	11	1	3	5	3	0
ING-771	157	163	6	1	3	1	1	4
ING-771	157	158	1	1	3	4	1	0
ING-771	158	159	1	1	3	4	1	1
ING-771	158	165	7	1	3	4	1	1
ING-771	158	159	1	1	3	4	1	0
ING-771	158	159	1	1	3	4	1	0
ING-772	160	165	5	1	3	1	0	1
ING-772	161	162	1	1	3	1	1	1
ING-772	161	162	1	1	3	1	1	0
ING-772	161	477	316	0	3	4	0	0
ING-772	162	163	1	1	3	1	1	0
ING-772	162	163	1	1	3	1	0	0
ING-772	162	477	315	0	4	1	0	0
ING-772	162	163	1	1	3	4	1	0
ING-772	162	477	315	0	3	4	0	0
ING-772	163	477	314	0	3	4	0	0
ING-773	163	171	8	1	3	1	1	0
ING-773	163	477	314	0	3	1	0	0
ING-773	164	165	1	1	3	1	1	1
ING-773	164	477	313	0	3	4	0	0
ING-773	164	165	1	1	3	1	1	1
ING-773	164	177	13	1	3	1	1	1
ING-773	165	477	312	0	3	1	0	3
ING-773	165	166	1	1	3	2	4	0
ING-773	165	166	1	1	3	4	1	0
ING-773	165	166	1	1	3	4	3	0
ING-774	165	168	3	1	3	5	3	0
ING-774	165	179	14	1	3	1	1	2
ING-774	165	211	46	1	4	1	1	0
ING-774	165	166	1	1	3	3	1	0
ING-774	168	211	43	1	4	4	1	1
ING-774	168	169	1	1	3	5	1	0
ING-774	168	169	1	1	3	4	1	0
ING-774	169	170	1	1	3	1	1	0
ING-774	169	178	9	1	3	1	0	0
ING-774	169	170	1	1	3	4	1	0
ING-775	169	170	1	1	3	4	1	0
ING-775	171	175	4	1	4	4	1	0
ING-775	172	303	131	1	3	1	2	0
ING-775	173	174	1	1	3	4	1	1
ING-775	175	287	112	1	3	4	1	0
ING-775	177	238	61	1	3	1	3	0
ING-775	177	375	198	1	3	4	1	0
ING-775	178	477	299	0	3	4	0	2
ING-775	179	180	1	1	3	1	1	0
ING-775	179	192	13	1	3	4	2	0
ING-776	179	477	298	0	3	4	0	0
ING-776	182	183	1	1	3	4	1	1
ING-776	184	196	12	1	3	1	0	1
ING-776	184	477	293	0	3	1	1	0
ING-776	184	190	6	1	4	4	1	0
ING-776	186	197	11	1	3	1	2	0
ING-776	186	187	1	1	3	4	1	0
ING-776	186	196	10	1	3	4	1	0
ING-776	186	477	291	0	3	4	0	0
ING-776	188	189	1	1	5	4	1	0
ING-777	188	189	1	1	3	1	1	1
ING-777	188	189	1	1	3	1	1	0
ING-777	189	477	288	0	3	4	0	0
ING-777	190	191	1	1	3	1	1	0
ING-777	190	477	287	0	3	1	0	0
ING-777	190	477	287	0	3	4	0	0
ING-777	192	477	285	0	3	4	0	3
ING-777	192	213	21	1	3	1	1	0
ING-777	192	197	5	1	3	1	1	2
ING-777	193	326	133	1	3	2	0	0
ING-778	193	195	2	1	3	4	0	1
ING-778	197	477	280	0	4	1	0	0
ING-778	203	217	14	1	3	4	1	0
ING-778	205	206	1	1	3	1	1	0
ING-778	205	206	1	1	3	1	1	0
ING-778	205	219	14	1	3	4	1	0
ING-778	207	233	26	1	3	4	2	1
ING-778	207	222	15	1	3	4	2	1
ING-778	207	211	4	1	3	1	1	0
ING-778	207	210	3	1	3	1	0	0
ING-779	207	477	270	0	3	2	1	1
ING-779	210	477	267	0	3	1	0	0
ING-779	210	228	18	1	3	1	2	1
ING-779	210	253	43	1	3	4	1	0
ING-779	211	212	1	1	3	4	1	0
ING-779	211	212	1	1	3	1	1	1
ING-779	212	477	265	0	4	3	0	0
ING-779	212	213	1	1	3	1	1	0
ING-779	213	224	11	1	3	4	4	2
ING-779	213	232	19	1	4	3	1	1
ING-780	213	477	264	0	3	4	0	0
ING-780	214	215	1	1	3	1	1	1
ING-780	214	224	10	1	3	4	4	0
ING-780	214	224	10	1	3	2	4	0
ING-780	214	215	1	1	3	1	1	1
ING-780	214	219	5	1	3	1	1	2
ING-780	217	218	1	1	3	4	1	0
ING-780	217	218	1	1	3	1	1	0
ING-780	217	218	1	1	3	4	1	0
ING-780	217	218	1	1	3	1	1	0
ING-781	217	477	260	0	3	4	0	0
ING-781	217	477	260	0	3	1	2	1
ING-781	218	219	1	1	3	4	1	0
ING-781	218	219	1	1	4	4	1	0
ING-781	219	220	1	1	3	1	1	1
ING-781	219	417	198	1	3	4	1	1
ING-781	219	220	1	1	3	1	1	0
ING-781	220	221	1	1	3	4	1	0
ING-781	220	221	1	1	4	1	1	0
ING-781	220	248	28	1	4	2	1	0
ING-782	220	477	257	0	3	1	1	0
ING-782	224	477	253	0	3	3	1	0
ING-782	224	225	1	1	4	4	1	0
ING-782	225	226	1	1	3	4	1	0
ING-782	225	316	91	1	3	4	1	0
ING-782	225	270	45	1	3	4	0	0
ING-782	225	226	1	1	3	4	1	0
ING-782	225	226	1	1	3	3	4	0
ING-782	225	226	1	1	3	1	1	0
ING-782	226	262	36	1	3	3	2	0
ING-783	226	239	13	1	3	4	1	0
ING-783	227	230	3	1	3	1	3	0
ING-783	228	229	1	1	3	1	2	1
ING-783	228	229	1	1	3	1	1	1
ING-783	228	229	1	1	4	3	2	1
ING-783	230	231	1	1	3	1	2	0
ING-783	230	477	247	0	3	4	0	0
ING-783	231	232	1	1	3	1	1	1
ING-783	231	232	1	1	3	1	1	1
ING-783	231	232	1	1	3	4	1	0
ING-784	231	237	6	1	2	1	0	1
ING-784	231	232	1	1	3	4	1	0
ING-784	231	232	1	1	3	4	1	0
ING-784	232	477	245	0	3	4	0	0
ING-784	233	234	1	1	3	1	1	0
ING-784	233	234	1	1	1	2	1	0
ING-784	233	477	244	0	3	2	1	0
ING-784	233	477	244	0	3	5	1	0
ING-784	233	477	244	0	3	5	1	0
ING-784	233	477	244	0	3	5	1	0
ING-785	233	477	244	0	3	5	1	0
ING-785	233	477	244	0	3	2	1	0
ING-785	234	235	1	1	3	4	1	0
ING-785	234	235	1	1	3	4	1	0
ING-785	234	235	1	1	3	4	1	0
ING-785	234	235	1	1	3	4	1	0
ING-785	235	477	242	0	3	1	0	0
ING-785	235	238	3	1	4	1	0	3
ING-785	237	249	12	1	4	4	1	0
ING-785	239	240	1	1	3	1	1	1
ING-786	239	240	1	1	3	2	0	0
ING-786	239	240	1	1	3	1	1	0
ING-786	239	240	1	1	3	1	1	0
ING-786	240	241	1	1	3	4	1	0
ING-786	240	241	1	1	4	4	1	0
ING-786	240	241	1	1	4	4	1	0
ING-786	240	241	1	1	3	2	0	0
ING-786	240	241	1	1	3	4	1	0
ING-786	241	242	1	1	4	4	1	0
ING-786	241	242	1	1	3	1	1	0
ING-787	241	248	7	1	3	4	0	1
ING-787	241	248	7	1	3	4	0	2
ING-787	241	242	1	1	3	4	1	0
ING-787	241	242	1	1	3	3	4	0
ING-787	241	242	1	1	3	3	4	0
ING-787	241	242	1	1	3	3	2	0
ING-787	242	243	1	1	3	1	1	0
ING-787	243	244	1	1	3	2	1	1
ING-787	243	244	1	1	3	3	3	0
ING-787	243	244	1	1	3	3	4	0
ING-788	244	245	1	1	3	1	1	0
ING-788	246	247	1	1	3	1	1	0
ING-788	247	477	230	0	3	1	0	0
ING-788	248	249	1	1	3	1	0	1
ING-788	248	249	1	1	4	1	1	0
ING-788	248	249	1	1	3	1	1	0
ING-788	249	250	1	1	3	1	1	0
ING-788	249	250	1	1	3	1	1	0
ING-788	249	477	228	0	3	4	0	0
ING-788	249	250	1	1	3	4	1	0
ING-789	249	261	12	1	3	1	2	1
ING-789	249	250	1	1	3	4	1	0
ING-789	249	250	1	1	3	3	1	0
ING-789	249	250	1	1	3	3	1	0
ING-789	249	250	1	1	3	3	1	0
ING-789	249	250	1	1	3	3	1	0
ING-789	249	250	1	1	3	3	1	0
ING-789	249	250	1	1	3	4	1	0
ING-789	250	251	1	1	3	3	1	0
ING-789	250	251	1	1	3	4	1	0
ING-790	250	477	227	0	3	4	0	0
ING-790	250	251	1	1	3	1	1	0
ING-790	252	255	3	1	3	1	1	0
ING-790	253	296	43	1	3	3	0	1
ING-790	253	259	6	1	3	5	0	0
ING-790	253	266	13	1	3	5	0	1
ING-790	253	295	42	1	3	5	0	0
ING-790	253	291	38	1	3	5	0	0
ING-790	253	295	42	1	3	5	0	0
ING-790	253	295	42	1	3	5	0	0
ING-791	253	288	35	1	3	5	0	0
ING-791	253	296	43	1	3	5	0	0
ING-791	253	254	1	1	3	5	0	1
ING-791	253	477	224	0	3	1	1	0
ING-791	254	477	223	0	4	5	0	0
ING-791	254	255	1	1	3	2	1	0
ING-791	254	255	1	1	3	3	1	1
ING-791	254	255	1	1	3	1	1	2
ING-791	254	255	1	1	3	4	1	0
ING-791	255	256	1	1	4	1	1	1
ING-792	255	315	60	1	4	1	1	1
ING-792	255	477	222	0	3	1	0	0
ING-792	255	291	36	1	3	5	0	2
ING-792	255	477	222	0	3	4	1	0
ING-792	255	256	1	1	3	1	1	0
ING-792	256	262	6	1	3	2	0	0
ING-792	256	477	221	0	3	4	1	0
ING-792	256	477	221	0	3	1	1	0
ING-792	256	335	79	1	3	4	1	1
ING-792	257	477	220	0	3	4	0	0
ING-793	258	310	52	1	3	4	1	0
ING-793	259	266	7	1	2	1	1	0
ING-793	259	282	23	1	5	4	0	0
ING-793	259	260	1	1	3	1	1	0
ING-793	259	322	63	1	3	4	0	1
ING-793	260	477	217	0	3	3	1	0
ING-793	260	477	217	0	3	4	1	0
ING-793	260	261	1	1	3	1	1	0
ING-793	260	261	1	1	3	4	1	0
ING-793	260	261	1	1	3	4	1	0
ING-794	261	266	5	1	3	4	0	0
ING-794	262	274	12	1	3	4	0	0
ING-794	262	477	215	0	3	2	0	0
ING-794	263	264	1	1	3	4	1	0
ING-794	263	266	3	1	3	4	1	0
ING-794	263	266	3	1	4	4	1	0
ING-794	263	266	3	1	4	4	1	0
ING-794	264	265	1	1	3	4	1	0
ING-794	264	265	1	1	4	4	1	0
ING-794	266	267	1	1	3	2	1	0
ING-795	266	288	22	1	3	5	1	2
ING-795	266	267	1	1	4	4	1	0
ING-795	266	267	1	1	3	4	1	0
ING-795	268	477	209	0	3	4	1	3
ING-795	268	477	209	0	3	4	4	1
ING-795	268	269	1	1	5	4	1	0
ING-795	268	477	209	0	3	4	1	0
ING-795	269	270	1	1	4	1	1	0
ING-795	269	270	1	1	4	4	1	0
ING-795	269	477	208	0	3	1	0	1
ING-796	270	477	207	0	3	1	0	0
ING-796	270	294	24	1	3	4	1	0
ING-796	270	271	1	1	3	4	1	0
ING-796	272	276	4	1	3	1	1	0
ING-796	273	298	25	1	4	4	1	0
ING-796	273	274	1	1	3	3	1	0
ING-796	273	477	204	0	3	4	0	0
ING-796	273	274	1	1	3	1	1	0
ING-796	273	274	1	1	3	4	2	0
ING-796	274	477	203	0	3	1	0	3
ING-797	274	315	41	1	3	2	1	0
ING-797	274	275	1	1	4	1	1	0
ING-797	274	275	1	1	5	1	1	0
ING-797	274	275	1	1	5	4	1	0
ING-797	274	275	1	1	3	1	1	0
ING-797	275	477	202	0	3	2	0	0
ING-797	275	276	1	1	3	4	0	0
ING-797	275	276	1	1	3	2	1	0
ING-797	276	277	1	1	3	4	0	1
ING-797	276	277	1	1	3	1	0	0
ING-798	276	459	183	1	3	3	1	3
ING-798	277	280	3	1	3	4	1	0
ING-798	277	280	3	1	3	4	1	0
ING-798	277	280	3	1	3	4	1	0
ING-798	277	280	3	1	3	4	1	0
ING-798	277	278	1	1	3	1	0	0
ING-798	279	297	18	1	3	4	1	0
ING-798	280	281	1	1	3	1	0	0
ING-798	280	281	1	1	3	4	0	0
ING-798	280	477	197	0	3	4	0	0
ING-799	280	304	24	1	3	4	1	0
ING-799	281	477	196	0	3	4	0	1
ING-799	281	477	196	0	3	4	1	0
ING-799	281	477	196	0	3	4	1	0
ING-799	281	477	196	0	3	4	1	0
ING-799	281	282	1	1	3	1	1	0
ING-799	281	282	1	1	3	4	0	0
ING-799	281	282	1	1	3	4	0	0
ING-799	281	282	1	1	3	1	1	0
ING-799	281	477	196	0	5	4	0	0
ING-800	281	297	16	1	3	4	1	0
ING-800	282	295	13	1	4	2	1	0
ING-800	282	295	13	1	3	4	1	0
ING-800	282	313	31	1	3	4	1	0
ING-800	282	283	1	1	3	1	1	0
ING-800	282	283	1	1	4	4	1	0
ING-800	282	283	1	1	3	1	1	0
ING-800	282	287	5	1	4	4	0	0
ING-800	283	314	31	1	3	4	2	0
ING-800	284	477	193	0	4	1	0	0
ING-801	284	285	1	1	3	1	0	0
ING-801	284	312	28	1	3	1	1	1
ING-801	287	290	3	1	3	4	4	0
ING-801	287	288	1	1	3	4	1	0
ING-801	287	288	1	1	3	5	1	0
ING-801	287	288	1	1	3	1	1	0
ING-801	287	288	1	1	3	1	1	1
ING-801	287	288	1	1	3	5	1	0
ING-801	287	288	1	1	3	1	1	1
ING-801	287	408	121	1	3	4	2	1
ING-802	287	294	7	1	4	4	1	0
ING-802	287	288	1	1	4	4	1	0
ING-802	287	288	1	1	4	4	1	0
ING-802	287	288	1	1	4	4	1	0
ING-802	288	289	1	1	4	4	1	0
ING-802	288	289	1	1	3	3	1	0
ING-802	288	289	1	1	3	4	1	0
ING-802	288	303	15	1	3	2	1	0
ING-802	288	477	189	0	3	3	0	0
ING-803	288	289	1	1	4	4	1	0
ING-803	289	417	128	1	3	4	0	1
ING-803	289	312	23	1	3	4	2	0
ING-803	290	477	187	0	3	4	1	0
ING-803	290	304	14	1	3	4	1	0
ING-803	290	477	187	0	3	4	1	0
ING-803	290	477	187	0	3	4	1	0
ING-803	290	477	187	0	3	4	1	0
ING-803	290	301	11	1	3	4	1	1
ING-803	290	477	187	0	4	4	1	0
ING-804	290	477	187	0	4	4	1	0
ING-804	290	477	187	0	4	4	1	0
ING-804	291	292	1	1	3	4	1	0
ING-804	291	292	1	1	4	4	1	0
ING-804	291	292	1	1	3	1	1	0
ING-804	291	292	1	1	3	1	1	0
ING-804	293	294	1	1	3	4	1	0
ING-804	294	477	183	0	3	1	0	0
ING-804	294	295	1	1	4	4	1	0
ING-804	298	299	1	1	3	4	1	0
ING-805	298	299	1	1	3	2	1	0
ING-805	298	301	3	1	3	4	1	1
ING-805	298	299	1	1	3	1	0	1
ING-805	298	299	1	1	3	2	1	0
ING-805	300	301	1	1	3	1	1	0
ING-805	300	301	1	1	3	1	1	0
ING-805	300	303	3	1	3	4	1	0
ING-805	300	302	2	1	3	4	1	0
ING-805	301	310	9	1	3	4	1	1
ING-805	302	303	1	1	3	1	1	0
ING-806	302	477	175	0	3	1	0	0
ING-806	303	450	147	1	3	4	1	0
ING-806	303	309	6	1	4	4	1	0
ING-806	303	477	174	0	4	4	0	0
ING-806	303	304	1	1	3	4	3	0
ING-806	304	315	11	1	3	4	1	0
ING-806	305	315	10	1	1	1	1	0
ING-806	305	306	1	1	4	1	1	0
ING-806	305	308	3	1	3	4	0	1
ING-806	305	477	172	0	4	4	0	0
ING-807	306	348	42	1	3	4	1	0
ING-807	306	338	32	1	3	4	1	0
ING-807	306	477	171	0	3	4	0	0
ING-807	308	477	169	0	3	4	0	0
ING-807	308	314	6	1	4	1	1	0
ING-807	309	477	168	0	3	2	0	0
ING-807	309	315	6	1	3	1	1	0
ING-807	309	477	168	0	3	4	0	0
ING-807	309	312	3	1	3	2	2	0
ING-807	310	477	167	0	3	1	0	1
ING-808	310	477	167	0	2	1	0	0
ING-808	311	312	1	1	3	1	1	0
ING-808	311	312	1	1	3	1	1	0
ING-808	311	312	1	1	3	1	1	1
ING-808	311	312	1	1	3	1	1	1
ING-808	311	477	166	0	3	4	0	1
ING-808	312	315	3	1	3	4	1	1
ING-808	312	313	1	1	2	1	1	0
ING-808	312	313	1	1	4	1	1	0
ING-808	313	314	1	1	3	1	1	0
ING-809	314	315	1	1	3	1	0	1
ING-809	315	316	1	1	3	4	1	0
ING-809	315	316	1	1	3	1	0	2
ING-809	315	316	1	1	3	4	1	1
ING-809	315	318	3	1	3	4	1	1
ING-809	315	316	1	1	3	4	0	1
ING-809	315	316	1	1	3	2	1	0
ING-809	315	316	1	1	3	4	1	1
ING-809	315	316	1	1	3	4	1	0
ING-809	315	477	162	0	3	1	0	0
ING-810	316	317	1	1	1	4	3	0
ING-810	316	317	1	1	3	1	1	0
ING-810	316	317	1	1	3	4	1	0
ING-810	316	317	1	1	3	4	1	0
ING-810	316	325	9	1	1	4	2	0
ING-810	316	317	1	1	3	4	0	0
ING-810	316	317	1	1	3	1	0	0
ING-810	317	318	1	1	3	4	1	0
ING-810	317	318	1	1	3	4	4	0
ING-810	317	318	1	1	3	2	1	0
ING-811	318	477	159	0	4	4	0	0
ING-811	319	477	158	0	3	4	0	0
ING-811	319	320	1	1	2	1	1	0
ING-811	319	374	55	1	3	4	0	0
ING-811	319	477	158	0	3	4	0	0
ING-811	319	325	6	1	5	4	1	0
ING-811	319	477	158	0	3	4	1	1
ING-811	319	349	30	1	3	2	1	4
ING-811	321	349	28	1	3	2	1	2
ING-811	322	323	1	1	1	4	4	0
ING-812	322	346	24	1	3	4	2	0
ING-812	322	324	2	1	3	2	1	0
ING-812	323	477	154	0	3	1	0	0
ING-812	323	324	1	1	3	3	1	0
ING-812	324	325	1	1	3	4	2	0
ING-812	325	326	1	1	3	4	1	0
ING-812	325	409	84	1	3	4	1	0
ING-812	325	326	1	1	3	2	0	0
ING-812	325	326	1	1	3	1	1	0
ING-812	325	326	1	1	3	2	0	0
ING-813	325	409	84	1	3	4	1	0
ING-813	326	327	1	1	3	1	1	0
ING-813	329	330	1	1	3	4	1	0
ING-813	330	331	1	1	3	1	1	0
ING-813	330	331	1	1	3	1	1	0
ING-813	330	331	1	1	3	1	1	0
ING-813	330	331	1	1	3	1	1	0
ING-813	330	331	1	1	3	3	1	0
ING-813	330	331	1	1	3	4	1	1
ING-813	331	332	1	1	3	2	1	3
ING-814	331	332	1	1	3	1	1	0
ING-814	333	334	1	1	3	1	1	0
ING-814	333	334	1	1	4	4	1	0
ING-814	335	336	1	1	3	3	2	0
ING-814	335	336	1	1	3	3	1	1
ING-814	335	336	1	1	3	3	1	0
ING-814	335	477	142	0	3	3	1	0
ING-814	335	336	1	1	3	3	1	0
ING-814	335	336	1	1	3	3	1	0
ING-814	335	336	1	1	3	3	3	0
ING-815	335	336	1	1	3	3	1	0
ING-815	335	336	1	1	3	3	1	0
ING-815	336	337	1	1	3	3	1	0
ING-815	336	337	1	1	4	1	1	0
ING-815	336	346	10	1	4	1	1	0
ING-815	336	337	1	1	3	1	1	0
ING-815	336	337	1	1	3	3	1	0
ING-815	336	337	1	1	3	3	1	0
ING-815	336	337	1	1	3	3	1	0
ING-815	336	337	1	1	3	3	1	0
ING-816	337	338	1	1	3	1	1	0
ING-816	337	338	1	1	4	4	1	0
ING-816	338	477	139	0	3	1	1	0
ING-816	338	339	1	1	3	4	1	0
ING-816	338	339	1	1	3	1	1	0
ING-816	338	339	1	1	4	1	1	0
ING-816	339	340	1	1	3	4	1	0
ING-816	340	477	137	0	3	1	1	0
ING-816	340	346	6	1	3	4	1	1
ING-816	343	380	37	1	3	2	1	1
ING-817	344	347	3	1	3	4	3	1
ING-817	344	345	1	1	3	4	0	1
ING-817	345	346	1	1	4	4	1	0
ING-817	345	346	1	1	3	1	1	0
ING-817	345	354	9	1	3	2	1	0
ING-817	346	347	1	1	4	4	0	0
ING-817	348	349	1	1	5	4	1	0
ING-817	348	349	1	1	5	1	1	0
ING-817	348	477	129	0	3	1	0	2
ING-817	349	350	1	1	3	3	4	0
ING-818	349	350	1	1	3	3	4	0
ING-818	349	353	4	1	3	3	4	0
ING-818	350	351	1	1	3	4	0	0
ING-818	350	353	3	1	3	3	2	0
ING-818	352	353	1	1	3	4	1	1
ING-818	352	353	1	1	3	1	1	0
ING-818	352	477	125	0	3	1	0	0
ING-818	353	371	18	1	3	4	1	1
ING-818	353	354	1	1	3	4	2	0
ING-818	353	354	1	1	3	4	0	0
ING-819	354	355	1	1	4	4	1	0
ING-819	354	380	26	1	3	4	1	0
ING-819	354	355	1	1	3	4	0	1
ING-819	354	477	123	0	3	4	0	0
ING-819	356	477	121	0	3	4	1	0
ING-819	360	361	1	1	3	4	1	0
-359	0	29	29	1	3	1	1	0
-359	4	29	25	1	3	1	1	0
-359	4	29	25	1	3	1	1	0
-360	4	29	25	1	3	1	1	0
-360	7	8	1	1	4	3	1	0
-360	9	10	1	1	4	3	1	0
-360	23	24	1	1	3	3	1	0
-360	24	29	5	1	3	3	1	0
-360	24	29	5	1	3	3	1	0
-360	24	29	5	1	3	3	1	0
-360	24	30	6	1	3	3	1	0
-360	24	30	6	1	3	3	1	0
-361	24	30	6	1	3	3	1	0
-361	24	30	6	1	3	3	1	0
-361	24	30	6	1	3	3	1	0
-361	24	30	6	1	3	3	1	0
-361	24	30	6	1	3	3	1	0
-361	24	30	6	1	3	3	1	0
-361	24	30	6	1	3	3	1	0
-361	24	30	6	1	3	3	1	0
-362	24	30	6	1	3	3	1	0
-362	24	30	6	1	3	3	1	0
-362	24	30	6	1	3	3	1	0
-362	27	30	3	1	3	1	1	1
-362	29	87	58	1	3	4	1	0
-362	29	30	1	1	3	3	1	0
-362	29	30	1	1	3	3	1	0
-362	31	32	1	1	3	3	1	0
-362	31	32	1	1	3	3	1	0
-362	39	46	7	1	3	1	1	0
-363	39	84	45	1	3	1	0	0
-363	39	40	1	1	3	3	1	0
-363	39	40	1	1	3	3	1	0
-363	44	45	1	1	3	1	1	0
-363	45	46	1	1	3	3	1	0
-363	45	46	1	1	3	3	1	0
-363	46	47	1	1	3	3	1	0
-363	52	60	8	1	3	1	1	0
-363	55	56	1	1	3	3	1	0
-363	55	56	1	1	3	3	1	0
-364	57	58	1	1	3	3	1	0
-364	57	58	1	1	3	3	1	0
-364	57	58	1	1	3	3	1	0
-364	60	61	1	1	3	3	1	0
-364	60	61	1	1	3	3	1	0
-364	60	61	1	1	3	3	0	0
-364	60	61	1	1	3	3	1	0
-364	60	61	1	1	3	3	1	0
-365	65	66	1	1	4	3	1	0
-365	66	67	1	1	3	1	0	0
-365	69	70	1	1	3	3	1	0
-365	71	72	1	1	3	3	1	0
-365	72	79	7	1	3	1	1	0
-365	72	73	1	1	3	3	1	0
-365	72	477	405	0	3	3	3	0
-365	74	75	1	1	3	3	1	0
-365	77	78	1	1	3	3	1	0
-365	78	79	1	1	3	1	0	0
-366	79	80	1	1	3	3	1	0
-366	80	81	1	1	3	3	1	0
-366	80	81	1	1	3	3	1	0
-366	80	84	4	1	3	3	1	0
-366	82	84	2	1	3	3	1	0
-366	82	84	2	1	3	3	1	0
-366	82	84	2	1	3	3	1	0
-366	82	84	2	1	3	3	1	0
-366	82	84	2	1	3	3	1	0
-367	82	84	2	1	3	3	1	0
-367	82	84	2	1	3	3	1	0
-367	82	84	2	1	3	3	1	0
-367	82	84	2	1	3	3	1	0
-367	82	84	2	1	3	3	1	0
-367	82	84	2	1	3	3	1	0
-367	82	84	2	1	3	3	1	0
-367	82	84	2	1	3	3	1	0
-367	82	83	1	1	3	3	1	0
-367	82	83	1	1	3	3	1	0
-368	82	83	1	1	3	3	1	0
-368	82	83	1	1	3	3	1	0
-368	82	83	1	1	3	3	1	0
-368	87	116	29	1	3	3	1	0
-368	90	333	243	1	3	4	0	0
-368	101	120	19	1	3	3	1	0
-368	106	120	14	1	3	2	1	0
-368	109	116	7	1	4	3	1	0
-368	114	117	3	1	3	4	1	0
-369	117	119	2	1	3	1	1	0
-369	118	119	1	1	3	3	1	0
-369	118	119	1	1	3	3	1	0
-369	118	119	1	1	3	3	1	0
-369	118	119	1	1	3	3	1	0
-369	118	119	1	1	3	3	1	0
-369	118	119	1	1	3	3	1	0
-369	129	130	1	1	3	3	1	0
-369	129	130	1	1	3	3	1	0
-370	129	130	1	1	3	3	1	0
-370	129	130	1	1	3	4	1	0
-370	130	131	1	1	3	3	1	0
-370	133	134	1	1	3	3	1	0
-370	135	136	1	1	3	3	1	0
-370	138	140	2	1	3	3	0	0
-370	138	140	2	1	3	3	0	0
-370	138	140	2	1	3	3	0	0
-370	138	140	2	1	3	3	0	0
-370	138	140	2	1	3	3	0	0
-371	138	140	2	1	3	3	0	0
-371	138	140	2	1	3	3	0	0
-371	138	140	2	1	3	3	0	0
-371	138	140	2	1	3	3	0	0
-371	138	140	2	1	3	3	0	0
-371	140	141	1	1	4	3	1	0
-371	148	152	4	1	3	3	1	0
-371	148	153	5	1	3	3	1	0
-371	148	153	5	1	3	3	1	0
-371	148	153	5	1	3	3	1	1
-372	148	153	5	1	3	3	1	0
-372	148	153	5	1	3	3	1	1
-372	148	151	3	1	3	3	1	0
-372	148	150	2	1	3	3	1	0
-372	148	150	2	1	3	3	1	0
-372	148	150	2	1	3	3	1	0
-372	148	150	2	1	3	3	1	0
-372	149	150	1	1	3	3	1	0
-372	149	150	1	1	3	3	1	0
-372	149	150	1	1	3	3	1	0
-373	149	150	1	1	3	3	1	0
-373	149	150	1	1	3	3	1	0
-373	149	150	1	1	3	3	1	0
-373	149	150	1	1	3	3	1	0
-373	149	150	1	1	3	3	1	0
-373	149	150	1	1	3	3	1	0
-373	149	150	1	1	3	3	1	0
-373	149	150	1	1	3	3	1	0
-373	149	150	1	1	3	3	1	0
-373	155	477	322	0	2	1	0	0
-374	161	162	1	1	3	3	1	0
-374	161	162	1	1	3	3	1	0
-374	162	169	7	1	3	3	1	1
-374	164	184	20	1	3	1	1	1
-374	169	170	1	1	3	3	1	0
-374	169	171	2	1	3	3	1	0
-374	169	171	2	1	3	3	1	0
-374	169	170	1	1	3	3	1	0
-374	172	181	9	1	3	3	1	0
-374	172	181	9	1	3	3	1	0
-375	172	181	9	1	3	3	1	0
-375	172	182	10	1	3	3	1	0
-375	172	182	10	1	3	3	1	0
-375	172	181	9	1	3	3	1	0
-375	178	179	1	1	3	3	1	0
-375	178	182	4	1	3	3	1	0
-375	183	184	1	1	3	3	1	0
-375	192	193	1	1	3	1	0	0
-375	192	477	285	0	3	1	0	0
-375	193	200	7	1	3	3	0	0
-376	193	200	7	1	3	3	0	0
-376	193	477	284	0	3	3	0	0
-376	198	199	1	1	3	3	1	0
-376	198	477	279	0	1	5	1	0
-376	203	204	1	1	3	3	1	0
-376	205	206	1	1	3	3	1	0
-376	205	206	1	1	3	3	1	0
-376	205	206	1	1	3	3	1	0
-376	206	207	1	1	3	3	1	0
-376	206	207	1	1	3	3	1	0
-377	210	211	1	1	3	3	1	0
-377	211	215	4	1	3	3	1	0
-377	212	213	1	1	3	3	1	0
-377	212	213	1	1	3	3	1	0
-377	212	213	1	1	3	3	1	0
-377	215	216	1	1	3	3	1	0
-377	215	216	1	1	3	3	1	0
-377	215	216	1	1	3	3	1	0
-377	215	216	1	1	3	3	1	0
-377	215	216	1	1	3	3	1	0
-378	215	216	1	1	3	3	1	0
-378	215	216	1	1	3	3	1	0
-378	215	216	1	1	3	3	1	0
-378	216	217	1	1	3	3	1	0
-378	233	234	1	1	3	3	1	0
-378	233	234	1	1	3	3	1	0
-378	235	236	1	1	3	3	1	0
-378	238	239	1	1	3	3	1	0
-378	238	239	1	1	3	3	1	0
-379	245	246	1	1	3	3	1	0
-379	254	477	223	0	4	1	0	0
-379	255	256	1	1	3	3	1	0
-379	255	256	1	1	3	3	1	0
-379	259	260	1	1	3	1	1	0
-379	259	260	1	1	3	3	1	0
-379	259	260	1	1	3	3	1	1
-379	259	260	1	1	3	3	1	0
-379	259	260	1	1	3	3	1	0
-379	259	260	1	1	3	3	1	0
-380	259	260	1	1	3	3	1	0
-380	259	260	1	1	3	3	1	0
-380	259	260	1	1	3	3	1	0
-380	259	260	1	1	3	3	1	0
-380	259	260	1	1	3	3	1	0
-380	268	269	1	1	3	3	1	0
-380	270	318	48	1	3	3	1	0
-380	273	274	1	1	3	3	1	0
-380	273	274	1	1	3	3	1	0
-380	274	300	26	1	3	3	0	0
-381	276	277	1	1	3	3	1	0
-381	281	283	2	1	3	3	1	0
-381	289	302	13	1	3	3	1	3
-381	295	296	1	1	3	2	1	0
-381	299	300	1	1	3	3	1	0
-381	299	300	1	1	3	3	1	0
-381	299	300	1	1	3	3	1	0
-381	299	300	1	1	3	3	1	0
-382	299	300	1	1	3	3	1	0
-382	299	300	1	1	3	3	1	0
-382	299	300	1	1	3	3	1	0
-382	299	300	1	1	3	3	1	0
-382	299	300	1	1	3	3	1	0
-382	299	300	1	1	3	3	1	0
-382	299	300	1	1	3	3	1	0
-382	299	300	1	1	3	3	1	1
-382	299	300	1	1	3	3	1	0
-382	299	300	1	1	3	3	1	0
-383	300	301	1	1	3	3	1	0
-383	300	301	1	1	3	3	1	0
-383	300	301	1	1	3	3	1	0
-383	300	301	1	1	3	3	1	0
-383	300	301	1	1	3	3	1	0
-383	300	301	1	1	3	3	1	0
-383	300	301	1	1	3	3	1	0
-383	300	301	1	1	3	3	1	0
-383	300	301	1	1	3	3	1	0
-384	300	301	1	1	3	3	1	0
-384	300	301	1	1	3	3	1	0
-384	300	301	1	1	3	3	1	0
-384	300	301	1	1	3	3	1	0
-384	300	301	1	1	3	3	1	0
-385	301	302	1	1	3	3	1	0
-385	301	302	1	1	3	3	1	0
-385	311	315	4	1	3	1	1	2
-385	313	316	3	1	3	3	1	0
-385	314	315	1	1	2	1	1	1
-385	315	316	1	1	2	1	0	1
-385	318	319	1	1	3	3	1	0
-385	322	323	1	1	3	3	1	0
-385	323	326	3	1	3	3	1	0
-386	324	326	2	1	3	3	1	0
-386	324	325	1	1	3	3	1	0
-386	330	333	3	1	3	3	1	0
-386	333	334	1	1	3	3	1	0
-386	333	334	1	1	3	3	1	0
-386	333	334	1	1	3	3	1	0
-386	333	334	1	1	3	3	1	0
-386	333	334	1	1	3	3	1	0
-386	333	335	2	1	3	3	1	0
-386	333	334	1	1	3	3	1	0
-387	333	334	1	1	3	3	1	0
-387	333	334	1	1	3	3	1	0
-387	333	334	1	1	3	3	1	0
-387	333	334	1	1	3	3	1	0
-387	333	334	1	1	3	3	1	0
-387	333	334	1	1	3	3	1	0
-387	333	334	1	1	3	3	1	0
-387	333	334	1	1	3	3	1	0
-387	333	334	1	1	3	3	1	0
-387	333	334	1	1	3	3	1	0
-388	333	334	1	1	3	3	1	0
-388	333	334	1	1	3	3	1	0
-388	333	334	1	1	3	3	1	0
-388	333	334	1	1	3	3	1	0
-388	333	334	1	1	3	3	1	0
-388	333	334	1	1	3	3	1	0
-388	333	334	1	1	3	3	1	0
-388	333	334	1	1	3	3	1	0
-389	333	334	1	1	3	3	1	0
-389	333	334	1	1	3	3	1	0
-389	333	334	1	1	3	3	1	0
-389	333	335	2	1	3	3	1	0
-389	333	335	2	1	3	3	1	0
-389	333	335	2	1	3	3	1	0
-389	347	354	7	1	3	3	1	0
-389	347	354	7	1	3	3	1	0
-389	347	355	8	1	3	3	1	0
-389	347	355	8	1	3	3	1	0
-390	347	355	8	1	3	3	1	0
-390	347	355	8	1	3	3	1	0
-390	347	355	8	1	3	3	1	0
-390	347	354	7	1	3	3	1	0
-390	347	355	8	1	3	3	1	0
-390	347	354	7	1	3	3	1	0
-390	347	351	4	1	3	1	1	0
-390	347	354	7	1	3	3	1	0
-390	347	354	7	1	3	3	1	0
-390	347	354	7	1	3	3	1	0
-391	347	354	7	1	3	3	1	0
-391	347	354	7	1	3	3	1	0
-391	347	354	7	1	3	3	1	0
-391	347	354	7	1	3	3	1	0
-391	352	353	1	1	3	1	1	0
X4-199	31	477	446	0	3	3	0	0
X4-199	161	477	316	0	3	3	0	0
LR-1183	8	477	469	0	3	2	0	3
LR-1184	9	477	468	0	4	3	0	0
LR-1185	11	477	466	0	3	2	0	1
LR-1185	14	477	463	0	5	1	0	0
LR-1187	18	477	459	0	4	3	0	0
LR-1189	23	477	454	0	4	1	0	0
LR-1192	29	30	1	1	4	5	2	0
LR-1193	30	39	9	1	4	1	2	0
LR-1193	32	477	445	0	3	1	0	0
LR-1194	32	45	13	1	3	2	2	1
LR-1203	56	137	81	1	4	3	2	2
LR-1215	85	99	14	1	4	5	2	0
LR-1215	86	93	7	1	1	5	1	0
LR-1225	109	477	368	0	3	5	0	3
LR-1237	136	137	1	1	4	5	2	0
LR-1240	144	214	70	1	4	3	2	1
LR-1241	148	178	30	1	4	5	2	0
LR-1241	148	178	30	1	4	5	2	3
LR-1245	155	210	55	1	4	3	2	2
LR-1246	157	477	320	0	4	3	0	1
LR-1246	157	210	53	1	4	3	2	2
LR-1252	177	477	300	0	3	5	0	0
LR-1252	178	197	19	1	4	5	2	0
LR-1253	184	185	1	1	4	3	2	0
LR-1255	197	211	14	1	4	3	2	3
LR-1255	197	211	14	1	4	5	2	0
LR-1256	197	477	280	0	4	3	0	1
LR-1260	210	477	267	0	4	5	0	0
LR-1260	211	477	266	0	4	5	0	1
LR-1268	231	477	246	0	4	3	0	1
LR-1276	253	477	224	0	4	5	0	0
LR-1277	256	296	40	1	4	3	2	1
LR-1285	283	477	194	0	5	4	0	0
LR-1285	283	477	194	0	4	3	0	0
LR-1287	287	296	9	1	4	3	2	1
LR-1287	288	477	189	0	4	5	0	1
LR-1290	295	296	1	1	4	5	2	0
LR-1296	309	312	3	1	3	5	2	1
LR-1296	309	477	168	0	3	5	0	1
LR-1296	309	477	168	0	4	3	0	0
LR-1297	310	322	12	1	4	3	2	1
LR-1297	310	361	51	1	4	5	2	1
LR-1298	317	477	160	0	4	4	0	1
LR-1300	322	336	14	1	4	1	0	0
LR-1304	340	477	137	0	3	2	0	1
LR-1309	361	364	3	1	4	5	2	2
ARK-2293	0	2	2	1	3	1	1	0
ARK-2293	0	30	30	1	3	1	0	0
ARK-2293	1	7	6	1	3	2	0	0
ARK-2293	1	5	4	1	4	4	1	0
ARK-2293	1	2	1	1	3	5	1	1
ARK-2293	1	3	2	1	3	4	1	0
ARK-2294	1	4	3	1	4	1	1	0
ARK-2294	1	100	99	1	3	4	1	2
ARK-2294	1	477	476	0	3	1	0	0
ARK-2294	1	477	476	0	4	4	0	0
ARK-2294	2	3	1	1	3	4	1	0
ARK-2294	2	3	1	1	3	4	1	0
ARK-2294	2	10	8	1	3	1	1	0
ARK-2294	2	477	475	0	3	4	0	0
ARK-2294	2	3	1	1	5	1	1	0
ARK-2294	2	4	2	1	2	1	2	2
ARK-2295	3	4	1	1	3	1	1	0
ARK-2295	3	9	6	1	3	1	2	0
ARK-2295	3	7	4	1	4	4	1	0
ARK-2295	3	4	1	1	3	1	1	0
ARK-2295	3	477	474	0	4	1	0	0
ARK-2295	3	477	474	0	3	1	0	0
ARK-2295	3	15	12	1	3	1	1	0
ARK-2295	3	4	1	1	3	1	1	0
ARK-2295	3	477	474	0	3	1	0	0
ARK-2295	3	13	10	1	3	4	1	1
ARK-2296	3	4	1	1	4	4	1	0
ARK-2296	3	4	1	1	3	1	1	0
ARK-2296	3	17	14	1	3	1	1	0
ARK-2296	3	477	474	0	3	4	0	0
ARK-2296	3	477	474	0	3	5	0	0
ARK-2296	3	477	474	0	3	1	0	0
ARK-2296	4	477	473	0	3	1	0	0
ARK-2296	4	10	6	1	4	1	1	0
ARK-2296	4	107	103	1	3	1	1	0
ARK-2296	4	30	26	1	4	5	0	0
ARK-2297	4	477	473	0	4	2	0	0
ARK-2297	4	164	160	1	4	1	0	0
ARK-2297	4	8	4	1	3	1	2	0
ARK-2297	4	6	2	1	3	1	1	0
ARK-2297	4	225	221	1	3	1	1	0
ARK-2297	4	11	7	1	3	1	2	0
ARK-2297	5	21	16	1	3	1	1	0
ARK-2297	5	42	37	1	1	1	1	2
ARK-2297	5	15	10	1	3	5	1	0
ARK-2297	5	7	2	1	3	4	1	0
ARK-2298	6	17	11	1	3	5	1	0
ARK-2298	6	8	2	1	3	1	1	0
ARK-2298	6	9	3	1	1	1	2	0
ARK-2298	6	7	1	1	2	1	2	0
ARK-2298	6	8	2	1	1	1	2	0
ARK-2298	7	8	1	1	1	1	1	0
ARK-2298	7	11	4	1	3	1	1	0
ARK-2298	7	477	470	0	3	4	0	0
ARK-2298	7	8	1	1	4	5	0	0
ARK-2298	7	9	2	1	4	1	0	1
ARK-2299	7	8	1	1	1	1	1	0
ARK-2299	7	15	8	1	2	1	0	0
ARK-2299	7	8	1	1	3	1	1	0
ARK-2299	7	14	7	1	5	5	1	0
ARK-2299	7	10	3	1	3	4	1	0
ARK-2299	7	14	7	1	3	1	0	0
ARK-2299	7	477	470	0	3	1	0	0
ARK-2299	7	9	2	1	3	4	1	0
ARK-2299	8	9	1	1	3	1	1	1
ARK-2299	8	13	5	1	5	4	1	0
ARK-2300	8	21	13	1	1	1	1	0
ARK-2300	8	10	2	1	3	1	2	0
ARK-2300	8	477	469	0	4	1	0	0
ARK-2300	8	9	1	1	4	5	0	0
ARK-2300	8	112	104	1	3	1	2	0
ARK-2300	8	9	1	1	3	4	1	0
ARK-2300	8	9	1	1	4	5	0	0
ARK-2300	8	192	184	1	3	1	1	1
ARK-2300	8	11	3	1	3	2	1	1
ARK-2300	8	9	1	1	3	1	1	0
ARK-2301	8	158	150	1	3	2	1	0
ARK-2301	8	66	58	1	3	5	1	0
ARK-2301	8	431	423	1	3	4	1	0
ARK-2301	8	39	31	1	3	5	0	1
ARK-2301	8	477	469	0	3	5	0	0
ARK-2301	8	477	469	0	3	1	0	0
ARK-2301	8	17	9	1	4	5	0	0
ARK-2301	8	9	1	1	3	5	0	0
ARK-2301	8	9	1	1	3	1	1	0
ARK-2301	9	10	1	1	1	1	1	0
ARK-2302	9	32	23	1	1	1	2	1
ARK-2302	9	13	4	1	3	1	1	0
ARK-2302	9	10	1	1	3	1	0	0
ARK-2302	9	14	5	1	3	1	1	1
ARK-2302	9	18	9	1	4	4	1	0
ARK-2302	9	11	2	1	3	1	1	0
ARK-2302	9	21	12	1	3	4	0	0
ARK-2302	9	10	1	1	3	1	0	0
ARK-2302	9	11	2	1	3	1	1	0
ARK-2302	9	17	8	1	4	4	1	0
ARK-2303	9	240	231	1	3	5	1	2
ARK-2303	9	16	7	1	4	4	1	0
ARK-2303	9	25	16	1	3	4	1	0
ARK-2303	10	16	6	1	3	5	1	0
ARK-2303	10	234	224	1	5	4	1	0
ARK-2303	10	14	4	1	3	1	1	0
ARK-2303	10	12	2	1	4	4	1	0
ARK-2303	10	15	5	1	3	1	1	1
ARK-2303	10	13	3	1	4	1	3	0
ARK-2303	10	266	256	1	2	1	0	1
ARK-2304	10	63	53	1	4	4	2	0
ARK-2304	10	38	28	1	4	1	0	0
ARK-2304	10	228	218	1	3	1	1	0
ARK-2304	10	12	2	1	4	4	1	0
ARK-2304	10	16	6	1	4	1	1	1
ARK-2304	10	15	5	1	3	5	1	0
ARK-2304	10	11	1	1	3	5	2	0
ARK-2304	10	16	6	1	3	5	1	0
ARK-2304	10	18	8	1	3	5	1	1
ARK-2304	10	14	4	1	3	1	1	1
ARK-2305	10	16	6	1	3	1	0	0
ARK-2305	11	13	2	1	1	1	1	1
ARK-2305	11	17	6	1	3	5	1	0
ARK-2305	11	43	32	1	3	1	3	0
ARK-2305	11	18	7	1	3	1	1	0
ARK-2305	11	12	1	1	2	1	1	1
ARK-2305	11	477	466	0	4	4	0	1
ARK-2305	11	477	466	0	4	1	0	1
ARK-2305	11	477	466	0	3	4	0	0
ARK-2305	11	28	17	1	4	1	1	0
ARK-2306	11	15	4	1	4	2	0	0
ARK-2306	11	477	466	0	4	5	0	0
ARK-2306	12	16	4	1	5	4	1	0
ARK-2306	12	13	1	1	1	5	1	0
ARK-2306	12	17	5	1	3	5	1	0
ARK-2306	12	13	1	1	1	1	1	0
ARK-2306	12	21	9	1	4	4	0	0
ARK-2306	12	317	305	1	4	1	0	1
ARK-2306	13	477	464	0	3	1	0	0
ARK-2306	13	14	1	1	3	5	1	0
ARK-2307	13	14	1	1	1	1	0	0
ARK-2307	13	14	1	1	3	4	0	0
ARK-2307	13	16	3	1	4	5	1	1
ARK-2307	13	477	464	0	4	5	0	0
ARK-2307	14	477	463	0	4	2	0	1
ARK-2307	14	15	1	1	3	1	0	0
ARK-2307	14	16	2	1	3	4	0	0
ARK-2307	14	15	1	1	4	4	0	0
ARK-2307	14	389	375	1	4	4	0	1
ARK-2307	14	17	3	1	3	1	1	0
ARK-2308	14	15	1	1	5	1	1	0
ARK-2308	14	24	10	1	3	4	1	0
ARK-2308	14	410	396	1	4	4	0	0
ARK-2308	14	58	44	1	4	5	0	0
ARK-2308	15	298	283	1	3	5	0	1
ARK-2308	15	18	3	1	4	4	1	0
ARK-2308	15	477	462	0	3	4	0	0
ARK-2308	15	20	5	1	4	1	1	0
ARK-2308	15	29	14	1	4	1	1	1
ARK-2308	15	18	3	1	4	1	1	0
ARK-2309	15	21	6	1	3	4	1	0
ARK-2309	15	19	4	1	4	4	1	0
ARK-2309	15	37	22	1	3	3	1	2
ARK-2309	15	16	1	1	3	5	1	0
ARK-2309	15	118	103	1	3	1	1	3
ARK-2309	15	16	1	1	3	1	1	0
ARK-2309	15	85	70	1	3	5	1	0
ARK-2309	15	60	45	1	3	5	1	0
ARK-2309	15	477	462	0	3	5	0	0
ARK-2309	15	92	77	1	3	5	1	0
ARK-2310	15	477	462	0	3	5	0	0
ARK-2310	15	477	462	0	3	5	0	0
ARK-2310	15	177	162	1	3	5	0	0
ARK-2310	15	18	3	1	4	1	1	0
ARK-2310	15	18	3	1	2	3	1	2
ARK-2310	16	31	15	1	2	5	1	2
ARK-2310	16	24	8	1	1	5	0	0
ARK-2310	16	31	15	1	1	5	1	1
ARK-2310	16	28	12	1	1	5	1	0
ARK-2310	16	28	12	1	1	5	0	4
ARK-2311	16	31	15	1	1	5	1	0
ARK-2311	16	30	14	1	2	5	1	4
ARK-2311	16	30	14	1	2	5	1	0
ARK-2311	16	25	9	1	2	5	0	0
ARK-2311	16	27	11	1	2	5	0	2
ARK-2311	16	23	7	1	1	5	0	0
ARK-2311	16	20	4	1	2	5	1	0
ARK-2311	16	27	11	1	3	5	0	0
ARK-2311	16	20	4	1	2	5	1	0
ARK-2311	16	17	1	1	3	1	1	0
ARK-2312	16	178	162	1	3	5	1	0
ARK-2312	16	21	5	1	3	1	1	1
ARK-2312	16	17	1	1	3	4	1	0
ARK-2312	16	17	1	1	3	1	0	0
ARK-2312	16	477	461	0	3	4	0	0
ARK-2312	16	17	1	1	3	1	0	0
ARK-2312	16	17	1	1	3	1	0	0
ARK-2312	16	18	2	1	4	5	1	3
ARK-2312	16	477	461	0	3	4	0	1
ARK-2312	16	24	8	1	3	4	1	0
ARK-2313	16	477	461	0	3	1	0	2
ARK-2313	16	247	231	1	4	5	1	1
ARK-2313	16	17	1	1	4	5	1	0
ARK-2313	16	17	1	1	4	1	1	0
ARK-2313	16	426	410	1	3	1	0	1
ARK-2313	16	18	2	1	1	1	1	0
ARK-2313	16	17	1	1	3	5	0	1
ARK-2313	16	18	2	1	3	5	1	1
ARK-2313	17	29	12	1	4	5	1	2
ARK-2313	17	477	460	0	3	1	0	0
ARK-2314	17	18	1	1	3	1	1	0
ARK-2314	17	18	1	1	3	4	1	0
ARK-2314	17	18	1	1	3	4	1	0
ARK-2314	17	18	1	1	3	4	1	0
ARK-2314	17	18	1	1	3	4	1	0
ARK-2314	17	18	1	1	3	5	0	0
ARK-2314	17	205	188	1	3	2	1	0
ARK-2314	17	18	1	1	3	1	1	0
ARK-2314	17	23	6	1	3	1	1	1
ARK-2314	17	18	1	1	3	4	1	0
ARK-2315	17	18	1	1	2	5	0	0
ARK-2315	17	477	460	0	3	5	0	2
ARK-2315	17	23	6	1	4	1	1	0
ARK-2315	17	477	460	0	3	4	0	1
ARK-2315	18	43	25	1	3	5	1	1
ARK-2315	18	394	376	1	3	4	1	2
ARK-2315	18	20	2	1	3	1	0	1
ARK-2315	18	31	13	1	4	1	1	0
ARK-2315	18	477	459	0	3	4	0	0
ARK-2315	18	66	48	1	3	4	1	2
ARK-2316	18	477	459	0	4	5	0	0
ARK-2316	19	149	130	1	4	4	1	1
ARK-2316	19	84	65	1	4	4	1	1
ARK-2316	19	25	6	1	5	5	1	1
ARK-2316	19	20	1	1	3	1	0	1
ARK-2316	19	20	1	1	4	1	0	1
ARK-2316	20	27	7	1	4	4	1	1
ARK-2316	20	83	63	1	4	4	1	1
ARK-2316	20	477	457	0	4	5	0	0
ARK-2316	20	21	1	1	4	5	1	1
ARK-2317	20	21	1	1	3	4	1	0
ARK-2317	20	477	457	0	3	5	0	0
ARK-2317	20	477	457	0	4	4	0	0
ARK-2317	21	68	47	1	3	1	2	1
ARK-2317	21	23	2	1	5	4	1	0
ARK-2317	21	22	1	1	3	1	0	1
ARK-2317	21	22	1	1	1	1	0	0
ARK-2317	21	23	2	1	3	1	1	0
ARK-2317	21	477	456	0	4	1	0	0
ARK-2317	21	477	456	0	3	5	0	2
ARK-2318	21	477	456	0	3	4	0	0
ARK-2318	21	477	456	0	3	3	0	0
ARK-2318	21	377	356	1	4	4	1	0
ARK-2318	21	477	456	0	3	1	0	0
ARK-2318	21	22	1	1	1	1	1	1
ARK-2318	22	477	455	0	4	1	0	0
ARK-2318	22	39	17	1	3	1	2	0
ARK-2318	22	25	3	1	3	1	0	0
ARK-2318	22	31	9	1	3	4	1	0
ARK-2318	22	43	21	1	3	1	1	1
ARK-2319	22	26	4	1	3	1	0	0
ARK-2319	22	477	455	0	2	1	0	0
ARK-2319	22	23	1	1	2	1	1	0
ARK-2319	22	23	1	1	4	4	0	1
ARK-2319	22	308	286	1	3	1	0	1
ARK-2319	22	136	114	1	3	1	0	0
ARK-2319	22	28	6	1	3	5	1	0
ARK-2319	22	477	455	0	3	5	0	1
ARK-2319	23	24	1	1	4	1	1	0
ARK-2319	23	28	5	1	3	4	1	0
ARK-2320	23	261	238	1	3	1	1	0
ARK-2320	23	27	4	1	2	1	0	0
ARK-2320	23	31	8	1	3	4	1	0
ARK-2320	23	50	27	1	1	5	1	0
ARK-2320	23	477	454	0	3	5	0	0
ARK-2320	23	25	2	1	2	1	1	0
ARK-2320	23	477	454	0	3	5	0	4
ARK-2320	23	25	2	1	1	1	3	3
ARK-2320	24	25	1	1	1	1	1	0
ARK-2320	24	28	4	1	1	1	1	1
ARK-2321	24	477	453	0	3	4	0	0
ARK-2321	24	25	1	1	3	1	0	0
ARK-2321	24	25	1	1	3	5	0	0
ARK-2321	24	25	1	1	3	1	0	0
ARK-2321	24	26	2	1	3	1	1	0
ARK-2321	24	477	453	0	3	1	0	0
ARK-2321	24	477	453	0	4	4	0	0
ARK-2321	24	43	19	1	3	4	1	2
ARK-2321	24	25	1	1	3	5	1	0
ARK-2321	24	28	4	1	3	5	1	0
ARK-2322	24	26	2	1	3	1	1	1
ARK-2322	24	477	453	0	3	1	0	0
ARK-2322	24	29	5	1	3	1	1	0
ARK-2322	25	28	3	1	3	1	1	1
ARK-2322	25	26	1	1	3	1	0	0
ARK-2322	25	26	1	1	3	1	1	1
ARK-2322	25	27	2	1	3	1	0	0
ARK-2322	25	477	452	0	4	5	0	1
ARK-2322	25	30	5	1	4	4	1	0
ARK-2322	25	296	271	1	5	4	0	0
ARK-2323	25	43	18	1	4	1	2	0
ARK-2323	25	201	176	1	4	5	1	2
ARK-2323	25	477	452	0	3	1	0	0
ARK-2323	25	26	1	1	3	1	1	0
ARK-2323	25	79	54	1	3	1	0	3
ARK-2323	25	43	18	1	4	2	1	1
ARK-2323	25	477	452	0	5	4	0	0
ARK-2323	25	477	452	0	3	2	0	1
ARK-2323	25	28	3	1	3	4	1	0
ARK-2323	25	60	35	1	3	1	0	0
ARK-2324	25	50	25	1	4	1	1	0
ARK-2324	25	26	1	1	4	1	0	0
ARK-2324	25	26	1	1	3	1	1	0
ARK-2324	25	247	222	1	1	1	3	4
ARK-2324	25	79	54	1	4	1	0	4
ARK-2324	26	27	1	1	3	1	1	0
ARK-2324	26	28	2	1	2	1	0	0
ARK-2324	26	31	5	1	3	4	1	0
ARK-2324	26	27	1	1	4	4	1	0
ARK-2324	26	30	4	1	3	4	1	0
ARK-2325	27	28	1	1	5	1	1	0
ARK-2325	27	477	450	0	4	1	0	0
ARK-2325	28	477	449	0	3	1	0	0
ARK-2325	28	32	4	1	3	4	1	0
ARK-2325	28	191	163	1	4	5	1	2
ARK-2325	28	477	449	0	4	5	0	2
ARK-2325	28	34	6	1	4	5	1	1
ARK-2325	28	287	259	1	3	5	1	3
ARK-2325	28	477	449	0	3	4	0	0
ARK-2325	28	197	169	1	3	4	1	0
ARK-2326	28	29	1	1	3	5	1	0
ARK-2326	28	29	1	1	3	5	1	0
ARK-2326	29	30	1	1	3	5	1	0
ARK-2326	29	477	448	0	3	1	0	0
ARK-2326	29	437	408	1	4	5	1	0
ARK-2326	29	477	448	0	3	4	0	2
ARK-2326	29	477	448	0	4	2	0	0
ARK-2326	29	30	1	1	1	1	1	0
ARK-2326	29	31	2	1	3	5	1	0
ARK-2326	29	39	10	1	4	4	0	0
ARK-2327	29	477	448	0	4	1	0	0
ARK-2327	29	66	37	1	4	1	1	1
ARK-2327	29	30	1	1	3	5	1	0
ARK-2327	29	30	1	1	3	1	0	0
ARK-2327	29	30	1	1	1	1	1	0
ARK-2327	29	30	1	1	3	1	1	0
ARK-2327	29	30	1	1	4	4	1	1
ARK-2327	29	30	1	1	3	1	0	1
ARK-2327	29	30	1	1	3	1	0	1
ARK-2327	30	31	1	1	4	4	1	0
ARK-2328	30	31	1	1	3	5	1	0
ARK-2328	30	31	1	1	3	1	2	0
ARK-2328	30	477	447	0	4	1	0	1
ARK-2328	30	31	1	1	4	1	0	1
ARK-2328	30	32	2	1	3	4	1	0
ARK-2328	30	91	61	1	4	4	1	0
ARK-2328	30	477	447	0	3	1	0	0
ARK-2328	30	477	447	0	4	1	0	0
ARK-2328	30	79	49	1	3	1	2	0
ARK-2328	30	31	1	1	3	1	1	0
ARK-2329	30	36	6	1	1	1	1	0
ARK-2329	31	65	34	1	3	1	2	0
ARK-2329	31	477	446	0	2	1	0	1
ARK-2329	31	32	1	1	3	1	1	0
ARK-2329	31	32	1	1	4	1	0	1
ARK-2329	31	32	1	1	4	4	1	0
ARK-2329	31	32	1	1	5	4	1	0
ARK-2329	31	477	446	0	3	1	0	0
ARK-2329	31	477	446	0	3	1	0	0
ARK-2329	31	477	446	0	4	1	0	0
ARK-2330	31	36	5	1	3	5	1	2
ARK-2330	31	32	1	1	2	1	1	0
ARK-2330	31	477	446	0	3	5	0	0
ARK-2330	31	43	12	1	3	4	1	0
ARK-2330	31	32	1	1	3	1	0	0
ARK-2330	31	33	2	1	4	4	1	1
ARK-2330	31	32	1	1	4	1	1	0
ARK-2330	31	35	4	1	1	1	1	0
ARK-2330	31	225	194	1	4	1	0	1
ARK-2330	31	179	148	1	3	1	0	0
ARK-2331	32	35	3	1	1	1	1	2
ARK-2331	32	33	1	1	4	5	1	0
ARK-2331	32	33	1	1	1	4	1	0
ARK-2331	32	42	10	1	3	5	1	1
ARK-2331	32	41	9	1	3	5	1	0
ARK-2331	32	36	4	1	3	1	1	0
ARK-2331	32	50	18	1	3	1	1	0
ARK-2331	32	33	1	1	3	4	1	0
ARK-2331	32	43	11	1	4	4	1	0
ARK-2331	32	37	5	1	3	5	1	0
ARK-2332	32	477	445	0	4	1	0	0
ARK-2332	32	383	351	1	3	5	0	1
ARK-2332	32	477	445	0	4	1	0	1
ARK-2332	32	43	11	1	3	5	1	0
ARK-2332	32	71	39	1	3	5	0	0
ARK-2332	32	204	172	1	3	5	1	1
ARK-2332	33	36	3	1	3	1	1	0
ARK-2332	33	37	4	1	3	5	1	0
ARK-2332	33	477	444	0	3	1	0	1
ARK-2332	33	63	30	1	4	5	2	0
ARK-2333	34	35	1	1	1	1	1	0
ARK-2333	34	35	1	1	5	1	0	0
ARK-2333	34	477	443	0	3	5	0	0
ARK-2333	35	87	52	1	4	4	0	0
ARK-2333	35	36	1	1	1	5	1	0
ARK-2333	35	59	24	1	3	1	0	0
ARK-2333	35	38	3	1	4	4	1	0
ARK-2333	35	477	442	0	3	1	0	1
ARK-2333	35	38	3	1	3	1	0	0
ARK-2333	35	38	3	1	3	1	0	0
ARK-2334	35	45	10	1	3	1	2	4
ARK-2334	36	107	71	1	3	5	1	0
ARK-2334	36	120	84	1	4	5	0	1
ARK-2334	36	42	6	1	4	5	0	0
ARK-2334	36	40	4	1	4	5	1	0
ARK-2334	36	37	1	1	3	1	1	0
ARK-2334	37	477	440	0	3	1	0	0
ARK-2334	37	39	2	1	4	4	0	0
ARK-2334	37	38	1	1	3	1	1	0
ARK-2334	37	38	1	1	4	4	0	0
ARK-2335	37	477	440	0	3	1	0	0
ARK-2335	37	57	20	1	3	1	1	0
ARK-2335	37	42	5	1	3	5	2	0
ARK-2335	37	477	440	0	4	4	0	0
ARK-2335	37	39	2	1	3	1	0	0
ARK-2335	37	116	79	1	3	1	1	3
ARK-2335	38	330	292	1	3	4	1	0
ARK-2335	38	199	161	1	4	4	0	0
ARK-2335	38	39	1	1	4	1	2	1
ARK-2335	38	45	7	1	5	4	1	1
ARK-2336	38	40	2	1	3	1	1	0
ARK-2336	38	81	43	1	3	1	1	1
ARK-2336	39	46	7	1	3	5	1	0
ARK-2336	39	40	1	1	3	3	0	0
ARK-2336	39	43	4	1	4	5	0	0
ARK-2336	39	57	18	1	3	1	2	1
ARK-2336	39	45	6	1	3	4	1	1
ARK-2336	39	299	260	1	4	4	1	0
ARK-2336	39	477	438	0	4	4	0	0
ARK-2336	39	477	438	0	3	5	0	0
ARK-2337	39	477	438	0	4	4	0	0
ARK-2337	39	41	2	1	3	1	0	0
ARK-2337	39	80	41	1	4	4	1	0
ARK-2337	39	40	1	1	3	1	0	0
ARK-2337	39	40	1	1	5	4	0	0
ARK-2337	39	102	63	1	4	4	1	1
ARK-2337	39	42	3	1	3	1	2	0
ARK-2337	39	45	6	1	1	1	2	1
ARK-2337	40	42	2	1	3	4	1	0
ARK-2337	40	43	3	1	3	4	1	0
ARK-2338	40	66	26	1	3	5	1	1
ARK-2338	40	477	437	0	3	1	0	1
ARK-2338	41	43	2	1	4	4	1	0
ARK-2338	41	50	9	1	4	4	1	0
ARK-2338	41	43	2	1	4	1	1	0
ARK-2338	41	389	348	1	3	2	0	0
ARK-2338	41	372	331	1	4	4	0	0
ARK-2338	41	42	1	1	3	1	1	0
ARK-2338	41	42	1	1	1	1	1	0
ARK-2338	42	59	17	1	3	4	1	0
ARK-2339	42	365	323	1	2	1	1	4
ARK-2339	42	43	1	1	4	1	2	1
ARK-2339	42	43	1	1	5	5	1	0
ARK-2339	42	43	1	1	3	1	0	0
ARK-2339	42	44	2	1	3	1	2	0
ARK-2339	42	477	435	0	4	4	0	0
ARK-2339	42	43	1	1	3	1	0	0
ARK-2339	42	43	1	1	3	1	0	0
ARK-2339	42	383	341	1	3	5	0	1
ARK-2339	42	44	2	1	3	1	1	2
ARK-2340	42	43	1	1	3	1	1	0
ARK-2340	42	273	231	1	4	5	1	0
ARK-2340	43	48	5	1	3	1	0	0
ARK-2340	43	44	1	1	3	1	0	0
ARK-2340	43	52	9	1	4	4	0	0
ARK-2340	43	59	16	1	3	1	1	0
ARK-2340	43	44	1	1	3	1	2	1
ARK-2340	43	477	434	0	3	4	0	0
ARK-2340	43	53	10	1	4	1	2	1
ARK-2340	43	46	3	1	4	4	0	1
ARK-2341	43	477	434	0	3	1	0	0
ARK-2341	43	477	434	0	4	4	0	0
ARK-2341	43	70	27	1	4	4	1	0
ARK-2341	43	45	2	1	1	1	1	1
ARK-2341	43	44	1	1	3	5	0	0
ARK-2341	43	220	177	1	3	1	1	1
ARK-2341	43	143	100	1	4	1	2	1
ARK-2341	43	58	15	1	4	1	1	0
ARK-2341	43	51	8	1	3	5	1	0
ARK-2341	44	45	1	1	3	1	1	0
ARK-2342	44	477	433	0	3	1	0	0
ARK-2342	44	45	1	1	3	1	1	0
ARK-2342	44	45	1	1	4	1	1	0
ARK-2342	44	50	6	1	3	1	0	1
ARK-2342	44	51	7	1	4	4	1	0
ARK-2342	44	235	191	1	3	1	1	1
ARK-2342	44	45	1	1	1	3	1	3
ARK-2342	44	477	433	0	2	1	0	0
ARK-2342	44	45	1	1	1	1	0	1
ARK-2342	44	249	205	1	3	5	1	1
ARK-2343	44	45	1	1	1	1	0	1
ARK-2343	44	477	433	0	3	5	0	0
ARK-2343	44	477	433	0	3	5	0	0
ARK-2343	45	122	77	1	3	1	3	3
ARK-2343	45	51	6	1	3	1	3	0
ARK-2343	45	477	432	0	3	1	0	0
ARK-2343	45	50	5	1	3	1	2	0
ARK-2343	45	477	432	0	3	2	0	0
ARK-2343	45	56	11	1	2	1	4	0
ARK-2343	45	477	432	0	4	1	0	0
ARK-2344	45	477	432	0	4	4	0	0
ARK-2344	45	477	432	0	4	5	0	0
ARK-2344	45	477	432	0	3	1	0	0
ARK-2344	45	477	432	0	3	2	0	4
ARK-2344	45	477	432	0	4	5	0	0
ARK-2344	46	57	11	1	3	4	1	0
ARK-2344	46	47	1	1	3	5	1	1
ARK-2344	46	47	1	1	3	4	1	0
ARK-2344	46	58	12	1	3	1	1	0
ARK-2344	46	56	10	1	4	1	2	0
ARK-2345	46	477	431	0	3	1	0	0
ARK-2345	46	200	154	1	5	3	1	2
ARK-2345	46	477	431	0	4	4	0	1
ARK-2345	46	477	431	0	3	1	0	0
ARK-2345	47	51	4	1	4	4	1	0
ARK-2345	47	113	66	1	3	4	1	4
ARK-2345	47	50	3	1	3	4	1	1
ARK-2345	47	50	3	1	3	1	2	0
ARK-2345	47	365	318	1	3	1	2	4
ARK-2345	47	54	7	1	3	1	1	0
ARK-2346	48	477	429	0	5	5	0	0
ARK-2346	48	191	143	1	3	1	1	0
ARK-2346	48	70	22	1	3	1	2	0
ARK-2346	49	51	2	1	2	1	0	0
ARK-2346	49	346	297	1	3	1	0	1
ARK-2346	49	94	45	1	4	4	0	0
ARK-2346	49	243	194	1	3	4	1	0
ARK-2346	49	477	428	0	3	4	0	0
ARK-2346	50	51	1	1	4	1	1	0
ARK-2346	50	477	427	0	3	1	0	2
ARK-2347	50	51	1	1	1	1	1	1
ARK-2347	50	59	9	1	3	1	0	0
ARK-2347	50	477	427	0	3	4	0	0
ARK-2347	51	52	1	1	5	1	0	0
ARK-2347	51	477	426	0	3	1	0	0
ARK-2347	51	52	1	1	1	1	1	0
ARK-2347	51	52	1	1	4	1	1	0
ARK-2347	51	61	10	1	4	1	0	0
ARK-2347	51	477	426	0	4	1	0	0
ARK-2347	51	477	426	0	4	1	0	0
ARK-2348	51	477	426	0	3	1	0	0
ARK-2348	51	52	1	1	1	1	1	0
ARK-2348	51	477	426	0	3	2	0	1
ARK-2348	51	254	203	1	3	5	0	0
ARK-2348	51	52	1	1	4	1	1	0
ARK-2348	51	477	426	0	3	2	0	2
ARK-2348	52	193	141	1	3	1	1	1
ARK-2348	52	477	425	0	3	1	0	0
ARK-2348	52	477	425	0	4	5	0	0
ARK-2348	52	122	70	1	3	1	3	3
ARK-2349	52	53	1	1	3	1	2	0
ARK-2349	52	56	4	1	3	5	2	0
ARK-2349	53	477	424	0	3	1	0	0
ARK-2349	53	59	6	1	4	1	0	1
ARK-2349	53	477	424	0	3	4	0	0
ARK-2349	53	65	12	1	3	1	0	0
ARK-2349	53	63	10	1	3	1	1	0
ARK-2349	53	407	354	1	3	4	0	0
ARK-2349	53	477	424	0	3	1	0	1
ARK-2349	53	477	424	0	3	4	0	0
ARK-2350	53	78	25	1	3	4	1	0
ARK-2350	53	57	4	1	5	3	1	0
ARK-2350	53	477	424	0	4	4	0	0
ARK-2350	53	137	84	1	3	5	1	0
ARK-2350	54	346	292	1	3	1	0	1
ARK-2350	54	477	423	0	3	1	0	3
ARK-2350	54	477	423	0	3	2	0	0
ARK-2350	54	477	423	0	3	5	0	2
ARK-2350	54	58	4	1	3	1	3	0
ARK-2350	54	57	3	1	4	5	1	0
ARK-2351	54	59	5	1	3	4	1	0
ARK-2351	55	477	422	0	3	2	0	0
ARK-2351	55	477	422	0	3	1	0	0
ARK-2351	55	128	73	1	1	1	0	0
ARK-2351	55	58	3	1	3	1	1	0
ARK-2351	56	253	197	1	3	1	0	0
ARK-2351	56	477	421	0	4	4	0	0
ARK-2351	56	58	2	1	4	1	1	0
ARK-2351	56	60	4	1	3	4	1	0
ARK-2351	57	477	420	0	3	1	0	0
ARK-2352	57	477	420	0	3	4	0	0
ARK-2352	57	267	210	1	3	5	0	4
ARK-2352	57	66	9	1	3	1	1	0
ARK-2352	57	58	1	1	3	1	2	0
ARK-2352	57	66	9	1	3	1	2	0
ARK-2352	57	65	8	1	3	1	3	0
ARK-2352	57	346	289	1	3	5	0	0
ARK-2352	57	128	71	1	2	1	0	0
ARK-2352	57	193	136	1	4	4	1	1
ARK-2352	57	191	134	1	4	4	1	0
ARK-2353	58	477	419	0	3	4	0	0
ARK-2353	58	477	419	0	3	4	0	0
ARK-2353	58	477	419	0	3	2	0	0
ARK-2353	58	73	15	1	3	3	1	0
ARK-2353	58	477	419	0	3	4	0	4
ARK-2353	58	65	7	1	4	4	0	0
ARK-2353	58	477	419	0	4	4	0	0
ARK-2353	58	477	419	0	3	1	0	0
ARK-2353	58	63	5	1	4	4	1	0
ARK-2353	58	477	419	0	3	2	0	1
ARK-2354	59	60	1	1	3	4	0	1
ARK-2354	59	61	2	1	3	2	1	0
ARK-2354	59	477	418	0	3	4	0	1
ARK-2354	59	477	418	0	3	1	0	0
ARK-2354	59	477	418	0	3	4	0	0
ARK-2354	59	331	272	1	3	1	0	0
ARK-2354	59	63	4	1	3	4	0	0
ARK-2354	59	71	12	1	3	1	1	0
ARK-2354	59	60	1	1	3	1	0	0
ARK-2354	59	83	24	1	3	1	1	0
ARK-2355	59	70	11	1	5	4	1	0
ARK-2355	59	60	1	1	4	1	2	0
ARK-2355	59	477	418	0	3	1	0	0
ARK-2355	59	74	15	1	3	4	2	0
ARK-2355	59	101	42	1	3	2	0	1
ARK-2355	59	229	170	1	3	5	1	2
ARK-2355	59	177	118	1	3	5	0	0
ARK-2355	59	177	118	1	3	5	0	0
ARK-2355	59	477	418	0	3	5	0	0
ARK-2355	59	63	4	1	3	5	1	0
ARK-2356	59	477	418	0	3	4	0	0
ARK-2356	60	477	417	0	3	5	0	0
ARK-2356	60	100	40	1	3	4	1	1
ARK-2356	60	477	417	0	4	4	0	0
ARK-2356	60	112	52	1	3	4	1	0
ARK-2356	60	116	56	1	4	4	1	0
ARK-2356	60	63	3	1	4	5	1	0
ARK-2356	60	93	33	1	3	1	0	2
ARK-2356	60	79	19	1	4	4	1	0
ARK-2356	60	63	3	1	3	1	2	0
ARK-2357	60	61	1	1	3	1	2	0
ARK-2357	60	477	417	0	3	4	0	0
ARK-2357	60	84	24	1	3	4	1	1
ARK-2357	61	231	170	1	3	4	1	1
ARK-2357	61	78	17	1	3	1	1	0
ARK-2357	61	477	416	0	3	1	0	0
ARK-2357	61	477	416	0	3	1	0	0
ARK-2357	61	79	18	1	3	5	1	0
ARK-2357	62	477	415	0	4	4	0	0
ARK-2357	62	80	18	1	5	5	0	0
ARK-2358	63	477	414	0	3	4	0	0
ARK-2358	63	74	11	1	3	5	1	0
ARK-2358	63	94	31	1	3	5	1	0
ARK-2358	63	93	30	1	3	5	1	0
ARK-2358	63	108	45	1	3	5	1	0
ARK-2358	63	64	1	1	3	5	1	0
ARK-2358	63	64	1	1	3	5	1	0
ARK-2358	63	92	29	1	3	5	1	0
ARK-2358	63	108	45	1	3	5	1	0
ARK-2358	63	112	49	1	3	5	1	0
ARK-2359	63	64	1	1	3	5	1	0
ARK-2359	63	65	2	1	3	5	1	0
ARK-2359	63	66	3	1	3	5	1	0
ARK-2359	63	94	31	1	3	5	1	0
ARK-2359	63	64	1	1	3	5	1	0
ARK-2359	63	109	46	1	3	5	1	0
ARK-2359	63	220	157	1	3	5	1	0
ARK-2359	63	282	219	1	3	5	1	0
ARK-2359	63	71	8	1	3	1	2	0
ARK-2359	63	80	17	1	2	1	2	1
ARK-2360	63	67	4	1	3	1	0	0
ARK-2360	63	64	1	1	4	3	2	0
ARK-2360	63	66	3	1	5	1	1	0
ARK-2360	63	172	109	1	3	1	0	0
ARK-2360	63	64	1	1	4	4	1	0
ARK-2360	63	68	5	1	4	1	0	0
ARK-2360	64	163	99	1	3	1	0	2
ARK-2360	64	477	413	0	4	4	0	0
ARK-2360	64	74	10	1	4	1	2	0
ARK-2360	64	477	413	0	4	4	0	0
ARK-2361	64	477	413	0	4	1	0	0
ARK-2361	64	65	1	1	3	5	1	0
ARK-2361	64	477	413	0	4	4	0	0
ARK-2361	64	477	413	0	3	1	0	0
ARK-2361	64	81	17	1	3	1	2	0
ARK-2361	64	81	17	1	4	5	1	1
ARK-2361	65	66	1	1	3	2	0	1
ARK-2361	65	66	1	1	3	4	1	0
ARK-2361	65	70	5	1	3	1	2	0
ARK-2361	65	477	412	0	4	5	0	0
ARK-2362	65	66	1	1	4	1	1	0
ARK-2362	65	477	412	0	3	1	0	0
ARK-2362	65	477	412	0	3	1	0	1
ARK-2362	66	74	8	1	2	1	2	3
ARK-2362	66	67	1	1	3	4	2	0
ARK-2362	66	477	411	0	3	1	0	0
ARK-2362	66	477	411	0	3	1	0	2
ARK-2362	66	134	68	1	5	4	1	0
ARK-2362	66	67	1	1	3	4	2	0
ARK-2362	66	187	121	1	4	1	0	0
ARK-2363	66	67	1	1	3	1	2	0
ARK-2363	66	477	411	0	3	2	0	0
ARK-2363	66	477	411	0	4	1	0	0
ARK-2363	66	211	145	1	3	5	1	0
ARK-2363	66	477	411	0	4	4	0	0
ARK-2363	67	74	7	1	4	1	1	0
ARK-2363	67	371	304	1	3	1	1	0
ARK-2363	67	93	26	1	3	1	2	0
ARK-2363	67	112	45	1	3	1	0	0
ARK-2363	67	87	20	1	3	1	2	1
ARK-2364	67	88	21	1	3	1	1	0
ARK-2364	67	477	410	0	4	1	0	0
ARK-2364	67	73	6	1	4	5	2	0
ARK-2364	68	446	378	1	5	1	1	1
ARK-2364	68	74	6	1	4	4	2	0
ARK-2364	68	84	16	1	4	4	2	0
ARK-2364	69	70	1	1	3	1	0	0
ARK-2364	69	334	265	1	3	5	1	0
ARK-2364	69	262	193	1	3	5	1	0
ARK-2364	69	150	81	1	3	1	3	0
ARK-2365	69	477	408	0	3	4	0	0
ARK-2365	70	74	4	1	4	4	0	0
ARK-2365	70	72	2	1	4	5	0	3
ARK-2365	70	477	407	0	3	4	0	0
ARK-2365	70	227	157	1	4	4	1	3
ARK-2365	70	477	407	0	3	4	0	0
ARK-2365	70	71	1	1	4	4	1	0
ARK-2365	70	477	407	0	3	4	0	1
ARK-2365	70	74	4	1	4	1	2	1
ARK-2365	70	477	407	0	3	5	0	0
ARK-2366	71	78	7	1	4	1	2	0
ARK-2366	71	477	406	0	3	2	0	0
ARK-2366	71	74	3	1	4	4	0	0
ARK-2366	71	345	274	1	3	1	1	1
ARK-2366	71	477	406	0	3	4	0	0
ARK-2366	71	77	6	1	3	4	0	0
ARK-2366	71	79	8	1	4	1	1	0
ARK-2366	71	137	66	1	3	1	0	0
ARK-2366	71	93	22	1	4	4	0	0
ARK-2366	71	477	406	0	4	2	0	0
ARK-2367	71	74	3	1	3	1	2	0
ARK-2367	71	74	3	1	2	1	2	0
ARK-2367	71	252	181	1	3	4	1	0
ARK-2367	71	477	406	0	4	1	0	0
ARK-2367	71	389	318	1	3	4	1	1
ARK-2367	72	87	15	1	4	4	1	0
ARK-2367	72	477	405	0	3	4	0	0
ARK-2367	72	74	2	1	3	1	0	2
ARK-2367	72	477	405	0	4	2	0	0
ARK-2367	72	239	167	1	3	1	1	0
ARK-2368	72	74	2	1	3	1	1	0
ARK-2368	72	477	405	0	4	4	0	0
ARK-2368	72	422	350	1	3	1	1	1
ARK-2368	72	74	2	1	3	4	1	0
ARK-2368	72	73	1	1	4	1	0	1
ARK-2368	72	394	322	1	3	1	0	2
ARK-2368	72	477	405	0	3	4	0	0
ARK-2368	73	106	33	1	3	5	1	0
ARK-2368	73	117	44	1	3	5	1	0
ARK-2368	73	477	404	0	3	1	0	0
ARK-2369	73	91	18	1	3	5	1	0
ARK-2369	73	78	5	1	4	4	2	0
ARK-2369	73	77	4	1	4	4	0	0
ARK-2369	73	372	299	1	4	4	0	0
ARK-2369	73	477	404	0	3	4	0	0
ARK-2369	73	74	1	1	5	4	2	0
ARK-2369	73	477	404	0	5	1	0	0
ARK-2369	73	123	50	1	3	1	4	0
ARK-2369	73	184	111	1	4	1	1	0
ARK-2369	73	86	13	1	4	4	1	0
ARK-2370	73	84	11	1	3	4	1	0
ARK-2370	74	477	403	0	3	1	0	0
ARK-2370	74	477	403	0	3	5	0	0
ARK-2370	74	477	403	0	3	5	0	0
ARK-2370	74	477	403	0	4	4	0	1
ARK-2370	74	477	403	0	4	4	0	0
ARK-2370	74	76	2	1	4	5	2	0
ARK-2370	74	237	163	1	3	4	0	0
ARK-2370	74	77	3	1	4	4	1	0
ARK-2370	74	319	245	1	2	5	0	0
ARK-2371	74	477	403	0	2	5	0	4
ARK-2371	74	142	68	1	3	5	1	1
ARK-2371	74	477	403	0	3	5	0	0
ARK-2371	74	91	17	1	3	5	1	0
ARK-2371	74	477	403	0	3	4	0	1
ARK-2371	74	263	189	1	3	1	0	1
ARK-2371	75	82	7	1	4	4	0	0
ARK-2371	75	477	402	0	3	4	0	4
ARK-2371	75	477	402	0	3	4	0	1
ARK-2371	75	477	402	0	3	4	0	3
ARK-2372	75	477	402	0	3	4	0	2
ARK-2372	75	477	402	0	3	4	0	1
ARK-2372	75	77	2	1	4	4	0	0
ARK-2372	75	118	43	1	3	5	1	1
ARK-2372	75	118	43	1	3	5	1	0
ARK-2372	75	477	402	0	4	5	0	0
ARK-2372	75	76	1	1	1	1	0	0
ARK-2372	76	88	12	1	3	5	1	0
ARK-2372	76	77	1	1	3	1	1	1
ARK-2372	76	80	4	1	3	1	2	1
ARK-2373	76	477	401	0	4	4	0	1
ARK-2373	76	200	124	1	3	1	2	0
ARK-2373	77	162	85	1	5	1	4	3
ARK-2373	77	99	22	1	5	1	0	1
ARK-2373	77	340	263	1	3	1	1	0
ARK-2373	77	96	19	1	4	4	0	0
ARK-2373	77	109	32	1	3	5	1	1
ARK-2373	77	99	22	1	4	1	0	1
ARK-2373	77	477	400	0	3	5	0	0
ARK-2373	77	477	400	0	2	1	0	0
ARK-2374	77	477	400	0	3	4	0	1
ARK-2374	77	477	400	0	4	1	0	0
ARK-2374	77	477	400	0	3	4	0	2
ARK-2374	78	88	10	1	4	1	1	0
ARK-2374	78	477	399	0	3	1	0	0
ARK-2374	78	477	399	0	3	1	0	0
ARK-2374	78	477	399	0	3	1	0	0
ARK-2374	78	106	28	1	3	5	1	0
ARK-2374	78	102	24	1	3	5	2	0
ARK-2374	78	440	362	1	3	5	1	0
ARK-2375	78	477	399	0	3	5	0	0
ARK-2375	78	99	21	1	3	2	1	1
ARK-2375	78	477	399	0	3	5	0	0
ARK-2375	78	477	399	0	3	5	0	0
ARK-2375	78	149	71	1	1	1	2	1
ARK-2375	78	477	399	0	3	5	0	0
ARK-2375	78	477	399	0	3	5	0	0
ARK-2375	78	477	399	0	3	5	0	0
ARK-2375	78	477	399	0	3	2	0	1
ARK-2375	78	81	3	1	3	1	3	0
ARK-2376	79	80	1	1	3	1	2	0
ARK-2376	79	83	4	1	3	1	0	0
ARK-2376	79	101	22	1	3	5	1	0
ARK-2376	79	477	398	0	3	5	0	0
ARK-2376	79	477	398	0	3	1	0	0
ARK-2376	80	86	6	1	3	5	1	0
ARK-2376	80	477	397	0	3	1	0	0
ARK-2376	80	88	8	1	3	1	0	0
ARK-2376	80	477	397	0	4	1	0	0
ARK-2376	80	81	1	1	4	4	2	0
ARK-2377	80	87	7	1	3	4	1	0
ARK-2377	80	477	397	0	3	1	0	0
ARK-2377	80	168	88	1	3	4	1	1
ARK-2377	80	180	100	1	5	1	0	0
ARK-2377	80	247	167	1	3	1	0	1
ARK-2377	81	126	45	1	3	1	2	1
ARK-2377	81	176	95	1	4	4	1	0
ARK-2377	81	477	396	0	5	1	0	0
ARK-2377	81	170	89	1	5	1	1	0
ARK-2377	81	477	396	0	3	5	0	0
ARK-2378	81	134	53	1	3	1	2	0
ARK-2378	81	303	222	1	3	4	1	2
ARK-2378	81	477	396	0	3	1	0	0
ARK-2378	81	82	1	1	3	5	1	0
ARK-2378	81	87	6	1	3	1	0	0
ARK-2378	81	87	6	1	3	1	1	1
ARK-2378	81	154	73	1	3	1	1	1
ARK-2378	81	84	3	1	4	1	1	0
ARK-2378	82	83	1	1	4	1	3	0
ARK-2378	82	242	160	1	3	1	0	0
ARK-2379	82	477	395	0	3	1	0	0
ARK-2379	82	92	10	1	3	1	0	1
ARK-2379	83	237	154	1	4	5	1	0
ARK-2379	84	477	393	0	4	4	0	0
ARK-2379	84	85	1	1	3	1	1	1
ARK-2379	84	85	1	1	4	4	0	0
ARK-2379	84	477	393	0	4	5	0	0
ARK-2379	85	477	392	0	3	1	0	0
ARK-2379	85	477	392	0	4	4	0	1
ARK-2379	85	111	26	1	3	1	1	0
ARK-2380	85	477	392	0	4	5	0	0
ARK-2380	85	477	392	0	3	1	0	0
ARK-2380	85	93	8	1	4	1	2	0
ARK-2380	85	156	71	1	3	4	1	0
ARK-2380	85	86	1	1	3	1	0	1
ARK-2380	86	477	391	0	3	4	0	0
ARK-2380	86	87	1	1	3	1	2	1
ARK-2380	86	113	27	1	3	5	1	1
ARK-2380	86	88	2	1	3	1	2	0
ARK-2380	86	97	11	1	4	1	2	0
ARK-2381	86	477	391	0	4	1	0	0
ARK-2381	87	477	390	0	3	1	0	0
ARK-2381	87	132	45	1	4	4	0	0
ARK-2381	87	477	390	0	4	4	0	0
ARK-2381	87	91	4	1	3	1	0	1
ARK-2381	87	102	15	1	3	1	2	0
ARK-2381	87	98	11	1	3	1	3	1
ARK-2381	87	381	294	1	3	4	1	2
ARK-2381	87	477	390	0	3	4	0	0
ARK-2381	87	477	390	0	3	1	0	0
ARK-2382	87	255	168	1	5	4	1	1
ARK-2382	87	114	27	1	3	5	1	0
ARK-2382	87	95	8	1	3	4	2	0
ARK-2382	87	95	8	1	3	1	2	0
ARK-2382	87	114	27	1	4	5	0	1
ARK-2382	87	91	4	1	3	1	1	0
ARK-2382	87	93	6	1	3	5	1	0
ARK-2382	87	88	1	1	2	1	2	0
ARK-2382	87	95	8	1	4	4	1	0
ARK-2382	88	338	250	1	3	1	1	0
ARK-2383	88	116	28	1	5	4	1	0
ARK-2383	88	477	389	0	3	4	0	1
ARK-2383	88	477	389	0	3	4	0	0
ARK-2383	88	477	389	0	3	1	0	0
ARK-2383	88	91	3	1	3	1	1	0
ARK-2383	88	106	18	1	3	1	2	0
ARK-2383	88	430	342	1	3	4	1	2
ARK-2383	89	477	388	0	4	1	0	0
ARK-2383	90	93	3	1	3	4	2	0
ARK-2383	90	477	387	0	4	4	0	3
ARK-2384	90	119	29	1	3	1	0	0
ARK-2384	91	99	8	1	4	4	1	0
ARK-2384	91	115	24	1	3	4	0	0
ARK-2384	91	129	38	1	3	1	0	0
ARK-2384	91	477	386	0	3	1	0	0
ARK-2384	91	477	386	0	3	5	0	0
ARK-2384	91	119	28	1	3	2	1	0
ARK-2384	91	97	6	1	4	5	1	0
ARK-2384	91	92	1	1	3	1	0	2
ARK-2384	91	97	6	1	4	5	1	0
ARK-2385	91	137	46	1	3	1	3	2
ARK-2385	91	477	386	0	5	1	0	0
ARK-2385	91	129	38	1	1	1	2	1
ARK-2385	91	120	29	1	5	1	2	0
ARK-2385	92	96	4	1	4	4	0	0
ARK-2385	92	477	385	0	3	1	0	0
ARK-2385	92	137	45	1	4	2	1	0
ARK-2385	92	139	47	1	4	1	1	0
ARK-2385	92	477	385	0	3	5	0	0
ARK-2385	92	95	3	1	3	5	1	0
ARK-2386	92	93	1	1	3	1	0	1
ARK-2386	93	95	2	1	4	4	1	0
ARK-2386	93	477	384	0	3	1	0	1
ARK-2386	93	95	2	1	3	1	0	0
ARK-2386	93	99	6	1	3	5	1	0
ARK-2386	93	94	1	1	3	1	0	0
ARK-2386	93	97	4	1	3	4	0	1
ARK-2386	93	102	9	1	4	4	2	0
ARK-2386	93	94	1	1	3	1	2	0
ARK-2386	93	94	1	1	3	1	0	0
ARK-2387	93	95	2	1	3	5	1	0
ARK-2387	93	99	6	1	4	5	1	0
ARK-2387	94	477	383	0	3	1	0	0
ARK-2387	94	105	11	1	3	4	1	0
ARK-2387	94	226	132	1	3	4	1	4
ARK-2387	94	106	12	1	3	4	1	1
ARK-2387	94	477	383	0	3	1	0	0
ARK-2387	94	109	15	1	3	4	1	0
ARK-2387	95	96	1	1	3	1	0	0
ARK-2387	95	477	382	0	3	4	0	0
ARK-2388	95	114	19	1	3	4	1	0
ARK-2388	95	98	3	1	3	5	2	0
ARK-2388	95	96	1	1	4	1	1	0
ARK-2388	95	98	3	1	3	1	0	0
ARK-2388	95	132	37	1	3	1	0	0
ARK-2388	95	192	97	1	3	1	0	0
ARK-2388	95	347	252	1	3	5	1	0
ARK-2388	95	477	382	0	3	5	0	0
ARK-2388	95	112	17	1	3	1	1	0
ARK-2388	95	477	382	0	3	5	0	0
ARK-2389	95	477	382	0	3	1	0	2
ARK-2389	95	410	315	1	4	2	0	2
ARK-2389	96	97	1	1	4	4	1	0
ARK-2389	96	97	1	1	4	1	1	0
ARK-2389	97	477	380	0	4	4	0	2
ARK-2389	97	477	380	0	3	1	0	0
ARK-2389	97	102	5	1	3	4	1	0
ARK-2389	97	477	380	0	4	5	0	1
ARK-2389	97	99	2	1	3	1	0	0
ARK-2389	98	252	154	1	3	5	1	2
ARK-2390	98	150	52	1	3	5	1	0
ARK-2390	98	196	98	1	3	5	0	0
ARK-2390	98	115	17	1	3	5	1	0
ARK-2390	98	154	56	1	3	5	1	0
ARK-2390	98	477	379	0	3	1	0	0
ARK-2390	98	102	4	1	3	5	1	0
ARK-2390	98	477	379	0	3	5	0	0
ARK-2390	98	300	202	1	3	5	0	0
ARK-2390	98	213	115	1	3	5	1	0
ARK-2390	98	215	117	1	3	5	1	0
ARK-2391	98	477	379	0	3	4	0	0
ARK-2391	98	215	117	1	3	5	1	0
ARK-2391	98	171	73	1	3	5	1	1
ARK-2391	98	217	119	1	3	5	1	0
ARK-2391	98	192	94	1	3	5	1	0
ARK-2391	98	212	114	1	3	5	1	0
ARK-2391	98	115	17	1	3	5	1	1
ARK-2391	98	105	7	1	3	5	1	0
ARK-2391	98	106	8	1	3	5	1	0
ARK-2391	98	108	10	1	3	5	1	1
ARK-2392	98	151	53	1	3	5	1	0
ARK-2392	98	126	28	1	3	5	1	0
ARK-2392	98	136	38	1	3	5	1	0
ARK-2392	98	121	23	1	3	5	1	0
ARK-2392	98	108	10	1	3	5	1	1
ARK-2392	98	136	38	1	3	5	1	0
ARK-2392	98	107	9	1	3	5	1	0
ARK-2392	98	177	79	1	3	5	1	0
ARK-2392	98	207	109	1	3	5	1	0
ARK-2392	98	144	46	1	3	1	0	2
ARK-2393	98	126	28	1	3	5	1	0
ARK-2393	98	162	64	1	3	5	1	0
ARK-2393	98	227	129	1	3	5	1	0
ARK-2393	98	162	64	1	3	5	1	0
ARK-2393	98	172	74	1	3	5	1	0
ARK-2393	98	140	42	1	3	5	1	0
ARK-2393	98	189	91	1	3	5	1	0
ARK-2393	98	218	120	1	3	5	1	0
ARK-2393	98	225	127	1	3	5	1	0
ARK-2393	98	227	129	1	3	5	1	0
ARK-2394	98	228	130	1	3	5	1	0
ARK-2394	98	120	22	1	3	1	3	2
ARK-2394	98	102	4	1	3	5	2	0
ARK-2394	98	477	379	0	4	4	0	0
ARK-2394	98	100	2	1	3	4	1	0
ARK-2394	98	477	379	0	4	4	0	1
ARK-2394	98	99	1	1	3	1	0	1
ARK-2394	98	99	1	1	4	4	1	0
ARK-2394	99	106	7	1	3	2	2	0
ARK-2394	99	361	262	1	4	4	0	0
ARK-2395	99	101	2	1	3	1	0	0
ARK-2395	99	100	1	1	3	1	1	0
ARK-2395	99	477	378	0	3	4	0	0
ARK-2395	99	101	2	1	3	2	0	0
ARK-2395	99	477	378	0	4	1	0	0
ARK-2395	99	101	2	1	5	1	0	0
ARK-2395	99	105	6	1	4	4	1	0
ARK-2395	99	205	106	1	3	4	1	0
ARK-2395	100	101	1	1	4	4	0	0
ARK-2395	100	104	4	1	3	1	0	0
ARK-2396	100	101	1	1	4	4	1	0
ARK-2396	100	477	377	0	4	1	0	1
ARK-2396	100	101	1	1	4	4	2	0
ARK-2396	100	102	2	1	4	4	3	0
ARK-2396	100	477	377	0	3	1	0	0
ARK-2396	100	101	1	1	3	4	0	0
ARK-2396	100	102	2	1	3	4	1	0
ARK-2396	101	477	376	0	4	4	0	0
ARK-2396	101	477	376	0	3	1	0	0
ARK-2396	101	477	376	0	3	1	0	0
ARK-2397	101	103	2	1	3	1	0	0
ARK-2397	101	102	1	1	3	1	2	0
ARK-2397	101	128	27	1	3	4	1	0
ARK-2397	101	113	12	1	4	4	1	0
ARK-2397	102	402	300	1	3	1	0	0
ARK-2397	102	127	25	1	3	1	1	0
ARK-2397	102	108	6	1	4	1	1	0
ARK-2397	102	477	375	0	4	1	0	1
ARK-2397	102	477	375	0	4	1	0	0
ARK-2397	102	103	1	1	5	4	1	0
ARK-2398	102	477	375	0	3	4	0	1
ARK-2398	102	477	375	0	3	4	0	1
ARK-2398	103	477	374	0	3	1	0	0
ARK-2398	103	477	374	0	4	4	0	0
ARK-2398	104	158	54	1	3	2	1	0
ARK-2398	104	477	373	0	4	4	0	0
ARK-2398	104	106	2	1	3	1	2	0
ARK-2398	104	477	373	0	3	3	0	0
ARK-2398	104	477	373	0	4	4	0	0
ARK-2398	105	108	3	1	2	1	2	0
ARK-2399	105	113	8	1	3	5	1	0
ARK-2399	105	148	43	1	3	1	2	0
ARK-2399	105	477	372	0	4	4	0	0
ARK-2399	105	120	15	1	3	4	1	0
ARK-2399	105	477	372	0	3	4	0	1
ARK-2399	105	477	372	0	3	1	0	0
ARK-2399	105	477	372	0	3	4	0	0
ARK-2399	105	239	134	1	3	1	1	0
ARK-2399	106	198	92	1	4	4	0	0
ARK-2399	106	107	1	1	3	5	0	0
ARK-2400	106	477	371	0	3	1	0	2
ARK-2400	106	107	1	1	3	1	0	0
ARK-2400	106	113	7	1	3	1	2	0
ARK-2400	106	119	13	1	3	4	1	0
ARK-2400	106	144	38	1	5	5	0	0
ARK-2400	106	218	112	1	3	4	1	0
ARK-2400	107	225	118	1	3	4	0	0
ARK-2400	107	108	1	1	3	1	3	0
ARK-2400	107	477	370	0	3	1	0	0
ARK-2400	107	477	370	0	3	1	0	1
ARK-2401	107	477	370	0	3	1	0	0
ARK-2401	107	477	370	0	4	4	0	0
ARK-2401	107	114	7	1	3	1	1	0
ARK-2401	107	121	14	1	3	1	1	0
ARK-2401	107	108	1	1	5	4	2	0
ARK-2401	107	108	1	1	4	1	0	0
ARK-2401	107	477	370	0	3	4	0	0
ARK-2401	107	126	19	1	3	4	1	2
ARK-2401	107	343	236	1	4	1	1	1
ARK-2401	107	477	370	0	4	1	0	0
ARK-2402	107	477	370	0	3	4	0	0
ARK-2402	108	109	1	1	3	1	2	0
ARK-2402	108	109	1	1	3	1	2	0
ARK-2402	108	395	287	1	3	5	0	1
ARK-2402	108	112	4	1	4	4	1	0
ARK-2402	108	477	369	0	3	1	0	1
ARK-2402	108	109	1	1	3	5	1	0
ARK-2402	108	133	25	1	3	2	1	0
ARK-2402	108	109	1	1	2	1	0	0
ARK-2402	108	110	2	1	4	4	1	0
ARK-2403	109	122	13	1	3	1	0	0
ARK-2403	109	112	3	1	4	4	0	0
ARK-2403	109	110	1	1	3	1	0	0
ARK-2403	109	110	1	1	3	1	2	0
ARK-2403	109	111	2	1	3	1	0	1
ARK-2403	109	123	14	1	3	4	1	0
ARK-2403	109	477	368	0	3	4	0	0
ARK-2403	109	477	368	0	3	5	0	0
ARK-2403	109	114	5	1	3	5	1	0
ARK-2403	109	123	14	1	3	5	1	0
ARK-2404	109	134	25	1	3	5	1	0
ARK-2404	109	129	20	1	3	5	0	0
ARK-2404	110	220	110	1	3	5	0	1
ARK-2404	111	126	15	1	4	1	1	0
ARK-2404	111	115	4	1	3	5	1	1
ARK-2404	111	477	366	0	3	5	0	0
ARK-2404	111	477	366	0	3	1	0	0
ARK-2404	111	112	1	1	3	5	0	0
ARK-2404	111	112	1	1	3	5	0	0
ARK-2404	112	477	365	0	4	4	0	0
ARK-2405	112	114	2	1	3	1	1	0
ARK-2405	112	477	365	0	3	1	0	0
ARK-2405	112	113	1	1	3	4	0	0
ARK-2405	112	113	1	1	4	4	0	0
ARK-2405	112	113	1	1	3	5	1	0
ARK-2405	112	477	365	0	3	5	0	0
ARK-2405	112	113	1	1	4	1	1	0
ARK-2405	112	115	3	1	4	4	1	0
ARK-2405	112	134	22	1	3	4	1	1
ARK-2405	113	477	364	0	3	1	0	0
ARK-2406	113	477	364	0	4	1	0	0
ARK-2406	113	120	7	1	3	1	1	0
ARK-2406	113	115	2	1	3	1	2	0
ARK-2406	113	422	309	1	3	5	1	0
ARK-2406	113	301	188	1	4	1	0	0
ARK-2406	113	477	364	0	3	1	0	0
ARK-2406	113	477	364	0	3	4	0	0
ARK-2406	113	130	17	1	3	1	1	2
ARK-2406	113	128	15	1	3	1	2	0
ARK-2406	113	115	2	1	3	5	1	0
ARK-2407	113	197	84	1	3	5	1	0
ARK-2407	113	197	84	1	3	5	1	1
ARK-2407	113	119	6	1	3	4	1	0
ARK-2407	113	129	16	1	3	5	1	0
ARK-2407	113	477	364	0	3	1	0	0
ARK-2407	114	477	363	0	4	4	0	0
ARK-2407	114	127	13	1	3	1	1	0
ARK-2407	114	115	1	1	3	5	0	0
ARK-2407	114	477	363	0	3	1	0	0
ARK-2407	114	477	363	0	4	4	0	0
ARK-2408	114	477	363	0	5	4	0	0
ARK-2408	114	477	363	0	3	1	0	0
ARK-2408	114	301	187	1	4	1	0	0
ARK-2408	114	115	1	1	4	4	1	0
ARK-2408	114	477	363	0	3	4	0	0
ARK-2408	114	116	2	1	3	1	2	0
ARK-2408	114	115	1	1	3	1	0	0
ARK-2408	114	477	363	0	3	1	0	1
ARK-2408	114	477	363	0	4	4	0	0
ARK-2408	114	121	7	1	3	1	0	0
ARK-2409	114	238	124	1	3	5	1	1
ARK-2409	114	477	363	0	3	5	0	2
ARK-2409	114	115	1	1	4	5	0	0
ARK-2409	114	198	84	1	4	5	0	0
ARK-2409	115	116	1	1	5	4	1	0
ARK-2409	115	477	362	0	3	1	0	0
ARK-2409	115	116	1	1	3	1	0	1
ARK-2409	115	477	362	0	3	5	0	0
ARK-2409	115	477	362	0	2	1	0	0
ARK-2409	115	116	1	1	3	1	0	1
ARK-2410	115	477	362	0	4	4	0	0
ARK-2410	115	312	197	1	3	4	1	1
ARK-2410	115	345	230	1	3	4	1	2
ARK-2410	115	420	305	1	3	4	1	1
ARK-2410	115	116	1	1	3	1	2	0
ARK-2410	115	407	292	1	3	4	0	0
ARK-2410	115	477	362	0	3	4	0	0
ARK-2410	116	121	5	1	1	1	2	1
ARK-2410	116	117	1	1	3	1	1	0
ARK-2410	116	283	167	1	4	4	1	1
ARK-2411	116	122	6	1	3	1	1	0
ARK-2411	116	121	5	1	5	4	1	1
ARK-2411	116	127	11	1	4	4	0	2
ARK-2411	116	117	1	1	3	1	0	1
ARK-2411	116	477	361	0	3	5	0	0
ARK-2411	116	136	20	1	3	5	1	0
ARK-2411	117	477	360	0	3	1	0	0
ARK-2411	117	127	10	1	3	4	1	0
ARK-2411	118	477	359	0	3	5	0	0
ARK-2411	118	158	40	1	4	5	1	0
ARK-2412	119	477	358	0	4	4	0	3
ARK-2412	119	141	22	1	3	4	1	0
ARK-2412	119	477	358	0	4	4	0	0
ARK-2412	119	121	2	1	4	1	1	1
ARK-2412	119	123	4	1	3	5	1	0
ARK-2412	119	477	358	0	4	4	0	0
ARK-2412	119	126	7	1	4	4	1	0
ARK-2412	119	221	102	1	4	4	1	0
ARK-2412	120	127	7	1	4	4	2	0
ARK-2412	120	198	78	1	4	4	1	0
ARK-2413	120	477	357	0	3	5	0	0
ARK-2413	120	121	1	1	4	4	1	0
ARK-2413	120	128	8	1	3	5	1	0
ARK-2413	120	121	1	1	3	1	2	0
ARK-2413	120	161	41	1	5	5	1	0
ARK-2413	120	477	357	0	3	1	0	0
ARK-2413	120	123	3	1	4	4	1	0
ARK-2413	120	129	9	1	3	1	1	0
ARK-2413	120	121	1	1	3	1	0	1
ARK-2413	121	477	356	0	3	5	0	4
ARK-2414	121	477	356	0	3	1	0	1
ARK-2414	121	128	7	1	2	1	1	0
ARK-2414	121	122	1	1	3	5	0	0
ARK-2414	121	126	5	1	3	1	1	0
ARK-2414	121	477	356	0	3	2	0	0
ARK-2414	121	127	6	1	3	2	0	1
ARK-2414	121	150	29	1	3	5	1	2
ARK-2414	121	123	2	1	3	1	0	0
ARK-2414	121	477	356	0	3	4	0	1
ARK-2414	121	137	16	1	4	4	1	0
ARK-2415	121	477	356	0	3	1	0	0
ARK-2415	121	260	139	1	3	1	1	1
ARK-2415	121	346	225	1	2	1	0	2
ARK-2415	121	477	356	0	3	1	0	1
ARK-2415	121	287	166	1	3	1	0	0
ARK-2415	121	133	12	1	3	5	1	0
ARK-2415	121	252	131	1	3	4	1	0
ARK-2415	121	123	2	1	3	5	1	0
ARK-2415	121	135	14	1	3	5	1	0
ARK-2415	121	137	16	1	3	5	1	0
ARK-2416	121	126	5	1	3	4	1	1
ARK-2416	121	217	96	1	3	4	1	0
ARK-2416	121	477	356	0	4	4	0	0
ARK-2416	121	477	356	0	3	4	0	0
ARK-2416	121	477	356	0	3	4	0	0
ARK-2416	122	191	69	1	3	1	1	0
ARK-2416	122	123	1	1	3	1	2	0
ARK-2416	122	123	1	1	3	1	1	0
ARK-2416	122	123	1	1	3	1	2	0
ARK-2416	122	123	1	1	3	1	2	0
ARK-2417	122	126	4	1	3	1	0	0
ARK-2417	122	477	355	0	4	5	0	0
ARK-2417	122	130	8	1	3	4	1	0
ARK-2417	122	477	355	0	3	1	0	1
ARK-2417	123	477	354	0	4	5	0	0
ARK-2417	123	477	354	0	3	4	0	0
ARK-2417	123	331	208	1	4	1	0	0
ARK-2417	123	477	354	0	3	1	0	0
ARK-2417	123	407	284	1	3	2	0	0
ARK-2418	123	477	354	0	3	4	0	0
ARK-2418	123	128	5	1	3	4	1	0
ARK-2418	123	130	7	1	4	4	1	0
ARK-2418	123	477	354	0	3	5	0	0
ARK-2418	123	477	354	0	5	4	0	0
ARK-2418	123	125	2	1	3	5	1	0
ARK-2418	123	133	10	1	3	5	1	0
ARK-2418	123	156	33	1	3	5	1	0
ARK-2418	124	127	3	1	3	4	2	1
ARK-2418	124	477	353	0	3	1	0	0
ARK-2419	124	174	50	1	4	1	1	0
ARK-2419	124	158	34	1	5	5	1	0
ARK-2419	125	477	352	0	3	1	0	0
ARK-2419	125	136	11	1	3	2	1	0
ARK-2419	126	477	351	0	4	4	0	1
ARK-2419	126	200	74	1	4	1	1	0
ARK-2419	126	372	246	1	3	1	1	1
ARK-2419	126	130	4	1	3	5	1	0
ARK-2419	126	131	5	1	3	5	1	0
ARK-2419	126	127	1	1	3	1	0	0
ARK-2420	126	477	351	0	3	4	0	0
ARK-2420	126	172	46	1	3	1	0	0
ARK-2420	126	477	351	0	3	4	0	0
ARK-2420	126	477	351	0	3	4	0	0
ARK-2420	127	177	50	1	4	4	1	0
ARK-2420	127	407	280	1	3	1	0	0
ARK-2420	127	142	15	1	4	4	1	1
ARK-2420	127	293	166	1	3	5	1	0
ARK-2420	127	477	350	0	4	1	0	0
ARK-2420	127	141	14	1	4	4	1	0
ARK-2421	127	477	350	0	3	1	0	0
ARK-2421	127	415	288	1	3	1	1	2
ARK-2421	127	282	155	1	3	5	0	1
ARK-2421	127	287	160	1	3	1	0	1
ARK-2421	127	128	1	1	3	1	2	0
ARK-2421	127	155	28	1	3	4	1	0
ARK-2421	128	162	34	1	3	1	2	0
ARK-2421	128	287	159	1	3	1	0	1
ARK-2421	128	477	349	0	3	4	0	0
ARK-2421	128	331	203	1	4	4	0	1
ARK-2422	128	477	349	0	3	1	0	0
ARK-2422	128	477	349	0	3	4	0	0
ARK-2422	128	324	196	1	4	4	0	0
ARK-2422	128	477	349	0	3	1	0	0
ARK-2422	128	158	30	1	5	5	1	0
ARK-2422	128	477	349	0	3	2	0	0
ARK-2422	128	477	349	0	3	1	0	0
ARK-2422	128	477	349	0	3	1	0	0
ARK-2422	128	133	5	1	4	1	1	0
ARK-2422	128	313	185	1	2	1	0	0
ARK-2423	128	143	15	1	3	1	2	0
ARK-2423	128	134	6	1	4	2	1	1
ARK-2423	129	150	21	1	3	2	1	0
ARK-2423	129	302	173	1	3	1	0	0
ARK-2423	129	140	11	1	3	5	1	0
ARK-2423	129	163	34	1	3	5	1	0
ARK-2423	129	477	348	0	3	5	0	0
ARK-2423	129	477	348	0	3	5	0	0
ARK-2423	129	477	348	0	4	1	0	1
ARK-2423	129	415	286	1	3	1	1	1
ARK-2424	129	477	348	0	3	2	0	0
ARK-2424	129	134	5	1	4	1	1	0
ARK-2424	129	140	11	1	3	4	1	0
ARK-2424	129	340	211	1	3	4	1	1
ARK-2424	129	144	15	1	3	4	1	1
ARK-2424	129	477	348	0	3	1	0	0
ARK-2424	129	133	4	1	3	4	2	0
ARK-2424	129	407	278	1	4	4	0	0
ARK-2424	129	164	35	1	3	4	1	0
ARK-2424	130	407	277	1	3	1	0	0
ARK-2425	130	138	8	1	3	4	1	0
ARK-2425	130	219	89	1	3	5	1	3
ARK-2425	130	431	301	1	3	5	1	2
ARK-2425	130	477	347	0	3	5	0	0
ARK-2425	130	477	347	0	3	4	0	0
ARK-2425	131	132	1	1	3	1	2	2
ARK-2425	131	247	116	1	3	4	0	0
ARK-2425	131	143	12	1	1	1	4	0
ARK-2425	131	477	346	0	3	2	0	0
ARK-2425	132	134	2	1	2	1	2	0
ARK-2426	132	477	345	0	4	4	0	0
ARK-2426	132	477	345	0	3	1	0	0
ARK-2426	132	133	1	1	5	4	2	0
ARK-2426	132	133	1	1	1	1	2	1
ARK-2426	132	477	345	0	3	1	0	0
ARK-2426	132	477	345	0	3	1	0	0
ARK-2426	133	477	344	0	3	1	0	0
ARK-2426	133	165	32	1	3	4	0	0
ARK-2426	133	200	67	1	4	4	1	1
ARK-2426	133	477	344	0	4	4	0	0
ARK-2427	133	134	1	1	3	5	0	0
ARK-2427	133	134	1	1	3	1	0	0
ARK-2427	133	134	1	1	3	1	0	1
ARK-2427	133	477	344	0	3	1	0	2
ARK-2427	133	477	344	0	3	4	0	0
ARK-2427	134	135	1	1	3	4	1	0
ARK-2427	134	149	15	1	4	1	1	0
ARK-2427	134	137	3	1	5	4	1	0
ARK-2427	134	428	294	1	3	1	0	0
ARK-2427	134	157	23	1	3	1	0	0
ARK-2428	134	477	343	0	4	4	0	2
ARK-2428	134	477	343	0	3	4	0	0
ARK-2428	134	477	343	0	5	4	0	0
ARK-2428	134	477	343	0	5	4	0	0
ARK-2428	134	477	343	0	3	1	0	0
ARK-2428	134	477	343	0	3	1	0	1
ARK-2428	134	135	1	1	4	5	0	0
ARK-2428	134	477	343	0	3	4	0	0
ARK-2428	134	207	73	1	3	2	1	0
ARK-2428	134	135	1	1	3	1	0	0
ARK-2429	134	154	20	1	3	5	1	0
ARK-2429	135	477	342	0	3	1	0	0
ARK-2429	135	141	6	1	3	1	0	0
ARK-2429	135	477	342	0	3	5	0	0
ARK-2429	135	142	7	1	3	1	1	0
ARK-2429	135	477	342	0	3	1	0	0
ARK-2429	135	232	97	1	3	5	1	1
ARK-2429	135	205	70	1	3	5	1	0
ARK-2429	135	477	342	0	3	4	0	0
ARK-2429	135	477	342	0	3	2	0	0
ARK-2430	135	154	19	1	4	1	1	0
ARK-2430	135	477	342	0	4	4	0	0
ARK-2430	136	140	4	1	3	1	0	0
ARK-2430	136	137	1	1	4	4	1	0
ARK-2430	136	477	341	0	3	5	0	0
ARK-2430	136	197	61	1	4	4	1	0
ARK-2430	136	477	341	0	4	4	0	0
ARK-2430	136	200	64	1	3	5	1	0
ARK-2430	136	137	1	1	3	4	1	0
ARK-2430	136	140	4	1	1	1	2	0
ARK-2431	136	137	1	1	3	5	1	0
ARK-2431	136	212	76	1	3	4	0	0
ARK-2431	137	138	1	1	3	4	1	0
ARK-2431	137	141	4	1	2	1	2	0
ARK-2431	137	477	340	0	3	1	0	0
ARK-2431	137	141	4	1	3	1	0	0
ARK-2431	137	477	340	0	3	4	0	2
ARK-2431	137	283	146	1	4	1	0	1
ARK-2431	137	477	340	0	3	1	0	1
ARK-2431	137	164	27	1	4	1	1	0
ARK-2432	137	140	3	1	3	1	0	0
ARK-2432	137	141	4	1	4	4	1	0
ARK-2432	138	143	5	1	3	1	2	1
ARK-2432	138	140	2	1	4	1	0	0
ARK-2432	139	174	35	1	3	5	1	3
ARK-2432	139	140	1	1	4	5	1	0
ARK-2432	139	151	12	1	3	4	1	0
ARK-2432	140	175	35	1	4	4	1	0
ARK-2432	140	141	1	1	5	4	1	0
ARK-2432	140	143	3	1	4	4	1	0
ARK-2433	140	151	11	1	3	4	1	0
ARK-2433	140	149	9	1	3	5	1	0
ARK-2433	140	143	3	1	3	4	1	0
ARK-2433	140	340	200	1	3	2	1	1
ARK-2433	140	147	7	1	3	5	2	0
ARK-2433	140	477	337	0	3	1	0	0
ARK-2433	140	170	30	1	3	4	0	0
ARK-2433	141	150	9	1	3	4	1	0
ARK-2433	141	477	336	0	2	1	0	0
ARK-2433	141	203	62	1	4	4	1	0
ARK-2434	141	201	60	1	3	4	0	0
ARK-2434	141	218	77	1	4	1	1	0
ARK-2434	141	477	336	0	3	4	0	0
ARK-2434	141	477	336	0	3	1	0	0
ARK-2434	141	143	2	1	3	1	0	0
ARK-2434	141	458	317	1	4	4	1	0
ARK-2434	141	477	336	0	3	1	0	0
ARK-2434	141	477	336	0	4	1	0	0
ARK-2434	141	142	1	1	3	1	1	1
ARK-2434	141	142	1	1	3	1	0	1
ARK-2435	141	143	2	1	3	1	1	1
ARK-2435	141	151	10	1	3	1	1	0
ARK-2435	141	477	336	0	3	1	0	0
ARK-2435	141	410	269	1	3	2	0	0
ARK-2435	141	477	336	0	3	2	0	0
ARK-2435	141	263	122	1	3	4	1	2
ARK-2435	141	153	12	1	3	4	1	1
ARK-2435	141	477	336	0	3	1	0	0
ARK-2435	141	477	336	0	4	1	0	0
ARK-2435	141	477	336	0	3	4	0	1
ARK-2436	141	395	254	1	3	4	1	1
ARK-2436	142	185	43	1	3	4	1	0
ARK-2436	142	477	335	0	3	1	0	0
ARK-2436	142	143	1	1	3	1	0	0
ARK-2436	142	143	1	1	3	1	2	1
ARK-2436	142	149	7	1	3	4	1	0
ARK-2436	142	144	2	1	4	4	1	1
ARK-2436	142	144	2	1	3	4	1	0
ARK-2436	142	144	2	1	3	1	1	0
ARK-2436	142	154	12	1	3	1	2	0
ARK-2437	142	191	49	1	3	1	0	0
ARK-2437	142	148	6	1	3	2	1	0
ARK-2437	142	172	30	1	3	2	1	0
ARK-2437	142	147	5	1	1	1	2	0
ARK-2437	143	477	334	0	3	5	0	3
ARK-2437	143	168	25	1	3	5	0	0
ARK-2437	143	149	6	1	4	1	0	0
ARK-2437	143	148	5	1	4	1	1	0
ARK-2437	143	144	1	1	5	5	2	2
ARK-2437	143	174	31	1	3	1	0	0
ARK-2438	143	144	1	1	2	1	1	1
ARK-2438	143	147	4	1	3	4	1	1
ARK-2438	143	477	334	0	3	5	0	0
ARK-2438	143	331	188	1	3	4	0	0
ARK-2438	143	149	6	1	3	1	2	0
ARK-2438	143	183	40	1	3	1	2	0
ARK-2438	143	178	35	1	3	5	1	0
ARK-2438	144	477	333	0	3	1	0	0
ARK-2438	144	477	333	0	3	1	0	0
ARK-2438	144	147	3	1	3	1	0	0
ARK-2439	144	477	333	0	4	1	0	0
ARK-2439	144	224	80	1	3	1	1	2
ARK-2439	144	147	3	1	1	3	2	0
ARK-2439	144	477	333	0	4	2	0	0
ARK-2439	144	477	333	0	4	1	0	0
ARK-2439	144	477	333	0	3	1	0	1
ARK-2439	144	165	21	1	3	2	1	1
ARK-2439	145	150	5	1	3	2	1	1
ARK-2439	145	349	204	1	3	4	0	1
ARK-2439	146	166	20	1	2	1	1	0
ARK-2440	147	477	330	0	2	1	0	0
ARK-2440	147	148	1	1	3	1	1	0
ARK-2440	147	198	51	1	3	2	0	0
ARK-2440	147	155	8	1	3	4	0	0
ARK-2440	147	396	249	1	3	1	0	0
ARK-2440	147	477	330	0	4	4	0	0
ARK-2440	148	477	329	0	4	5	0	0
ARK-2440	148	166	18	1	3	5	0	0
ARK-2440	148	178	30	1	5	4	1	0
ARK-2440	148	191	43	1	3	1	0	0
ARK-2441	148	477	329	0	3	4	0	1
ARK-2441	148	241	93	1	4	2	1	0
ARK-2441	148	159	11	1	3	2	1	0
ARK-2441	148	149	1	1	3	4	0	2
ARK-2441	148	150	2	1	2	1	2	1
ARK-2441	148	247	99	1	2	1	2	3
ARK-2441	148	162	14	1	4	1	1	0
ARK-2441	148	477	329	0	3	2	0	4
ARK-2441	148	176	28	1	3	5	1	1
ARK-2441	148	149	1	1	3	5	1	0
ARK-2442	148	183	35	1	3	5	1	0
ARK-2442	149	317	168	1	3	5	1	0
ARK-2442	149	477	328	0	3	5	0	1
ARK-2442	149	176	27	1	3	4	1	1
ARK-2442	149	200	51	1	3	4	1	0
ARK-2442	149	477	328	0	3	1	0	0
ARK-2442	149	477	328	0	3	1	0	0
ARK-2442	149	150	1	1	3	1	0	0
ARK-2442	149	182	33	1	4	4	1	0
ARK-2442	149	283	134	1	3	4	0	0
ARK-2443	149	477	328	0	3	5	0	0
ARK-2443	149	477	328	0	3	1	0	1
ARK-2443	149	477	328	0	3	2	0	2
ARK-2443	149	228	79	1	3	2	1	1
ARK-2443	149	302	153	1	3	2	1	4
ARK-2443	149	150	1	1	3	2	1	1
ARK-2443	149	150	1	1	5	4	0	0
ARK-2443	149	477	328	0	2	1	0	1
ARK-2443	150	189	39	1	3	1	0	0
ARK-2443	150	178	28	1	4	5	1	0
ARK-2444	150	477	327	0	3	1	0	0
ARK-2444	150	232	82	1	3	4	1	0
ARK-2444	150	477	327	0	4	4	0	0
ARK-2444	150	477	327	0	3	4	0	0
ARK-2444	150	151	1	1	3	5	2	1
ARK-2444	150	174	24	1	4	4	0	0
ARK-2444	150	177	27	1	4	1	1	0
ARK-2444	151	477	326	0	4	1	0	0
ARK-2444	151	477	326	0	3	1	0	0
ARK-2444	151	477	326	0	3	4	0	0
ARK-2445	151	477	326	0	3	1	0	0
ARK-2445	151	177	26	1	3	1	0	0
ARK-2445	151	165	14	1	4	1	2	0
ARK-2445	151	155	4	1	3	1	1	0
ARK-2445	151	158	7	1	4	4	1	1
ARK-2445	152	154	2	1	5	4	2	0
ARK-2445	154	477	323	0	4	1	0	0
ARK-2445	154	477	323	0	4	4	0	0
ARK-2445	154	172	18	1	3	1	0	0
ARK-2445	154	477	323	0	3	5	0	0
ARK-2446	154	477	323	0	3	5	0	0
ARK-2446	154	477	323	0	3	2	0	0
ARK-2446	154	477	323	0	2	4	0	0
ARK-2446	154	477	323	0	4	4	0	0
ARK-2446	154	477	323	0	3	4	0	0
ARK-2446	155	172	17	1	3	2	2	2
ARK-2446	155	163	8	1	3	1	1	0
ARK-2446	155	477	322	0	3	2	0	1
ARK-2446	155	159	4	1	4	1	2	0
ARK-2446	155	477	322	0	3	2	0	0
ARK-2447	155	191	36	1	4	4	1	0
ARK-2447	155	156	1	1	3	5	0	0
ARK-2447	155	477	322	0	3	1	0	1
ARK-2447	156	477	321	0	3	1	0	0
ARK-2447	156	477	321	0	3	1	0	1
ARK-2447	156	157	1	1	3	1	0	1
ARK-2447	156	165	9	1	4	1	0	0
ARK-2447	156	158	2	1	3	4	1	1
ARK-2447	156	165	9	1	3	5	1	0
ARK-2447	156	163	7	1	3	2	1	1
ARK-2448	157	158	1	1	4	4	0	1
ARK-2448	157	162	5	1	3	1	0	1
ARK-2448	157	158	1	1	3	5	0	0
ARK-2448	157	477	320	0	3	1	0	0
ARK-2448	157	387	230	1	3	1	1	0
ARK-2448	157	163	6	1	4	4	1	0
ARK-2448	157	435	278	1	4	1	1	0
ARK-2448	157	158	1	1	3	4	0	0
ARK-2448	157	200	43	1	4	1	1	0
ARK-2448	157	371	214	1	4	4	1	0
ARK-2449	157	165	8	1	5	4	1	0
ARK-2449	157	354	197	1	4	2	0	1
ARK-2449	158	477	319	0	2	1	0	0
ARK-2449	158	374	216	1	3	1	0	0
ARK-2449	158	477	319	0	4	5	0	0
ARK-2449	158	164	6	1	1	1	2	0
ARK-2449	158	161	3	1	4	1	1	1
ARK-2449	158	477	319	0	3	2	0	0
ARK-2449	158	332	174	1	3	2	0	1
ARK-2449	158	290	132	1	3	2	1	0
ARK-2450	158	163	5	1	3	1	1	0
ARK-2450	158	477	319	0	4	4	0	0
ARK-2450	159	162	3	1	3	5	2	1
ARK-2450	159	477	318	0	3	2	0	0
ARK-2450	159	160	1	1	3	2	0	0
ARK-2450	159	226	67	1	3	4	1	0
ARK-2450	159	162	3	1	3	1	3	1
ARK-2450	159	182	23	1	4	5	2	0
ARK-2450	160	161	1	1	3	1	0	0
ARK-2450	160	161	1	1	3	1	0	0
ARK-2451	160	161	1	1	3	4	0	0
ARK-2451	160	161	1	1	3	1	0	0
ARK-2451	160	477	317	0	3	1	0	0
ARK-2451	161	477	316	0	4	4	0	1
ARK-2451	161	162	1	1	3	1	0	0
ARK-2451	161	477	316	0	3	4	0	0
ARK-2451	161	297	136	1	4	4	1	0
ARK-2451	161	174	13	1	3	1	0	0
ARK-2451	161	172	11	1	4	4	1	0
ARK-2451	161	172	11	1	4	4	1	0
ARK-2452	161	162	1	1	5	1	1	0
ARK-2452	161	169	8	1	4	5	2	0
ARK-2452	161	372	211	1	3	4	1	0
ARK-2452	161	477	316	0	3	1	0	1
ARK-2452	161	477	316	0	3	4	0	0
ARK-2452	161	165	4	1	3	4	1	1
ARK-2452	162	168	6	1	4	1	1	0
ARK-2452	162	477	315	0	4	4	0	0
ARK-2452	162	477	315	0	3	4	0	0
ARK-2452	162	311	149	1	4	4	0	1
ARK-2453	162	191	29	1	2	1	2	0
ARK-2453	162	163	1	1	1	1	3	1
ARK-2453	162	172	10	1	3	4	0	1
ARK-2453	162	177	15	1	5	3	1	0
ARK-2453	162	169	7	1	4	4	1	1
ARK-2453	162	186	24	1	1	5	2	0
ARK-2453	162	211	49	1	5	1	2	0
ARK-2453	163	193	30	1	3	5	1	0
ARK-2453	163	255	92	1	3	5	0	1
ARK-2453	163	247	84	1	3	1	0	1
ARK-2454	163	477	314	0	3	4	0	1
ARK-2454	163	477	314	0	3	5	0	0
ARK-2454	163	169	6	1	3	2	2	0
ARK-2454	163	164	1	1	4	4	1	1
ARK-2454	163	365	202	1	4	4	1	0
ARK-2454	163	459	296	1	4	1	0	0
ARK-2454	163	164	1	1	3	1	0	0
ARK-2454	163	171	8	1	4	4	1	0
ARK-2454	163	168	5	1	3	1	1	0
ARK-2454	163	255	92	1	3	5	1	1
ARK-2455	163	477	314	0	3	2	0	0
ARK-2455	163	200	37	1	4	4	1	0
ARK-2455	163	176	13	1	1	1	3	0
ARK-2455	163	177	14	1	4	1	2	0
ARK-2455	163	477	314	0	3	5	0	1
ARK-2455	164	227	63	1	4	4	1	0
ARK-2455	164	169	5	1	3	1	1	0
ARK-2455	164	213	49	1	3	4	1	0
ARK-2455	164	196	32	1	4	4	1	0
ARK-2456	164	477	313	0	3	4	0	0
ARK-2456	164	351	187	1	3	5	1	0
ARK-2456	164	191	27	1	5	5	1	0
ARK-2456	164	165	1	1	3	1	1	0
ARK-2456	164	178	14	1	4	5	3	0
ARK-2456	164	169	5	1	3	4	1	0
ARK-2456	165	179	14	1	3	4	1	0
ARK-2456	165	477	312	0	3	1	0	2
ARK-2456	165	477	312	0	3	4	0	0
ARK-2456	165	187	22	1	3	1	1	0
ARK-2457	166	413	247	1	3	4	1	1
ARK-2457	166	171	5	1	4	4	1	0
ARK-2457	166	297	131	1	3	1	1	0
ARK-2457	167	168	1	1	3	1	1	0
ARK-2457	167	171	4	1	3	4	1	0
ARK-2457	167	170	3	1	4	4	1	0
ARK-2457	167	198	31	1	3	4	1	1
ARK-2457	168	331	163	1	3	1	0	1
ARK-2457	168	170	2	1	1	1	2	0
ARK-2457	168	477	309	0	3	5	0	1
ARK-2458	168	477	309	0	3	5	0	0
ARK-2458	168	210	42	1	3	5	0	0
ARK-2458	168	210	42	1	3	5	0	0
ARK-2458	168	169	1	1	3	1	2	0
ARK-2458	168	477	309	0	3	4	0	0
ARK-2458	168	477	309	0	4	5	0	0
ARK-2458	168	477	309	0	3	1	0	0
ARK-2458	168	477	309	0	3	4	0	0
ARK-2458	169	171	2	1	1	1	2	0
ARK-2458	169	171	2	1	1	1	4	0
ARK-2459	169	477	308	0	3	5	0	0
ARK-2459	169	477	308	0	4	4	0	0
ARK-2459	169	170	1	1	3	1	0	1
ARK-2459	169	170	1	1	3	1	0	1
ARK-2459	169	204	35	1	3	1	1	0
ARK-2459	169	170	1	1	3	5	0	0
ARK-2459	169	175	6	1	3	4	1	2
ARK-2459	170	477	307	0	4	2	0	0
ARK-2459	170	213	43	1	3	1	1	0
ARK-2459	170	410	240	1	3	1	0	2
ARK-2460	170	331	161	1	3	4	0	1
ARK-2460	170	277	107	1	3	1	1	1
ARK-2460	170	477	307	0	3	4	0	2
ARK-2460	170	178	8	1	5	1	3	0
ARK-2460	170	477	307	0	3	1	0	0
ARK-2460	170	177	7	1	4	4	1	1
ARK-2460	170	171	1	1	3	1	0	1
ARK-2460	170	477	307	0	3	1	0	2
ARK-2460	170	477	307	0	3	4	0	0
ARK-2460	170	211	41	1	4	4	1	0
ARK-2461	170	192	22	1	4	1	1	1
ARK-2461	170	477	307	0	3	4	0	0
ARK-2461	170	171	1	1	3	5	0	0
ARK-2461	170	171	1	1	4	1	2	0
ARK-2461	171	172	1	1	5	4	1	0
ARK-2461	171	477	306	0	3	5	0	2
ARK-2461	171	477	306	0	3	5	0	0
ARK-2461	171	477	306	0	3	1	0	0
ARK-2461	171	477	306	0	3	2	0	0
ARK-2461	171	477	306	0	3	5	0	0
ARK-2462	171	172	1	1	3	2	0	0
ARK-2462	171	434	263	1	3	1	1	1
ARK-2462	171	477	306	0	3	1	0	3
ARK-2462	171	477	306	0	3	1	0	0
ARK-2462	171	208	37	1	3	5	1	0
ARK-2462	171	477	306	0	3	4	0	0
ARK-2462	171	260	89	1	3	4	1	0
ARK-2462	172	477	305	0	3	1	0	0
ARK-2462	172	198	26	1	4	5	1	0
ARK-2462	172	477	305	0	4	1	0	0
ARK-2463	172	477	305	0	4	4	0	0
ARK-2463	172	477	305	0	3	5	0	0
ARK-2463	172	477	305	0	3	4	0	1
ARK-2463	173	175	2	1	4	1	1	0
ARK-2463	173	477	304	0	3	4	0	0
ARK-2463	173	184	11	1	3	4	1	0
ARK-2463	173	176	3	1	3	4	1	1
ARK-2463	173	218	45	1	3	4	1	0
ARK-2463	173	180	7	1	3	5	1	0
ARK-2463	173	231	58	1	5	4	0	0
ARK-2464	173	477	304	0	3	4	0	1
ARK-2464	174	477	303	0	3	1	0	0
ARK-2464	174	181	7	1	4	4	0	2
ARK-2464	174	179	5	1	4	4	0	1
ARK-2464	175	197	22	1	3	1	0	0
ARK-2464	175	178	3	1	4	1	1	0
ARK-2464	175	189	14	1	4	4	1	0
ARK-2464	175	477	302	0	3	4	0	4
ARK-2464	175	176	1	1	4	1	1	0
ARK-2464	175	176	1	1	4	1	0	0
ARK-2465	175	477	302	0	3	4	0	0
ARK-2465	175	477	302	0	4	2	0	0
ARK-2465	175	176	1	1	3	1	0	0
ARK-2465	175	212	37	1	4	1	1	0
ARK-2465	175	181	6	1	3	3	1	0
ARK-2465	175	477	302	0	3	4	0	4
ARK-2465	175	477	302	0	3	2	0	0
ARK-2465	176	403	227	1	3	1	0	1
ARK-2465	176	177	1	1	2	4	1	0
ARK-2465	176	177	1	1	3	1	1	0
ARK-2466	176	177	1	1	3	1	1	0
ARK-2466	176	477	301	0	3	1	0	0
ARK-2466	176	190	14	1	3	2	1	1
ARK-2466	177	477	300	0	4	1	0	0
ARK-2466	177	477	300	0	4	4	0	0
ARK-2466	177	182	5	1	3	4	1	0
ARK-2466	177	477	300	0	3	1	0	0
ARK-2466	177	191	14	1	3	1	0	0
ARK-2466	177	477	300	0	4	1	0	0
ARK-2466	177	429	252	1	3	1	3	0
ARK-2467	178	179	1	1	3	5	0	0
ARK-2467	178	477	299	0	4	4	0	0
ARK-2467	178	477	299	0	3	1	0	0
ARK-2467	178	185	7	1	4	4	1	0
ARK-2467	178	179	1	1	4	5	0	1
ARK-2467	178	185	7	1	3	4	1	0
ARK-2467	178	196	18	1	4	1	1	0
ARK-2467	178	198	20	1	2	1	3	0
ARK-2467	178	190	12	1	3	4	1	0
ARK-2467	178	179	1	1	3	1	0	0
ARK-2468	178	351	173	1	4	1	1	0
ARK-2468	178	197	19	1	3	1	1	0
ARK-2468	178	477	299	0	4	1	0	0
ARK-2468	178	182	4	1	2	4	1	0
ARK-2468	178	179	1	1	3	1	0	0
ARK-2468	178	226	48	1	4	4	1	0
ARK-2468	179	477	298	0	3	4	0	0
ARK-2468	179	353	174	1	3	1	3	0
ARK-2468	179	236	57	1	4	4	1	0
ARK-2468	179	477	298	0	3	1	0	0
ARK-2469	179	477	298	0	3	1	0	0
ARK-2469	179	192	13	1	3	4	1	0
ARK-2469	179	186	7	1	3	4	1	1
ARK-2469	179	477	298	0	3	1	0	1
ARK-2469	179	185	6	1	4	1	1	0
ARK-2469	179	477	298	0	3	1	0	0
ARK-2469	179	180	1	1	3	4	2	0
ARK-2469	179	191	12	1	3	4	1	0
ARK-2469	179	185	6	1	5	1	1	0
ARK-2469	179	203	24	1	3	1	1	0
ARK-2470	179	407	228	1	2	1	0	0
ARK-2470	180	477	297	0	3	4	0	0
ARK-2470	180	477	297	0	3	1	0	0
ARK-2470	180	477	297	0	4	4	0	0
ARK-2470	180	184	4	1	4	1	2	1
ARK-2470	180	213	33	1	4	1	1	0
ARK-2470	180	190	10	1	3	5	1	0
ARK-2470	181	477	296	0	3	4	0	0
ARK-2470	181	477	296	0	5	5	0	0
ARK-2470	181	184	3	1	4	4	1	1
ARK-2471	181	477	296	0	4	2	0	0
ARK-2471	181	185	4	1	4	1	1	0
ARK-2471	181	182	1	1	3	1	0	0
ARK-2471	182	193	11	1	3	1	1	0
ARK-2471	182	477	295	0	4	5	0	0
ARK-2471	182	183	1	1	2	1	1	0
ARK-2471	182	184	2	1	3	5	1	2
ARK-2471	182	199	17	1	3	1	1	1
ARK-2471	182	195	13	1	3	5	1	2
ARK-2471	182	213	31	1	3	1	0	0
ARK-2472	182	477	295	0	3	1	0	0
ARK-2472	182	239	57	1	3	1	1	0
ARK-2472	182	215	33	1	4	4	1	0
ARK-2472	182	477	295	0	3	5	0	0
ARK-2472	182	477	295	0	3	5	0	0
ARK-2472	182	477	295	0	3	5	0	0
ARK-2472	182	200	18	1	3	5	0	0
ARK-2472	183	184	1	1	3	4	1	0
ARK-2472	183	477	294	0	3	4	0	1
ARK-2472	183	477	294	0	3	1	0	0
ARK-2473	183	191	8	1	3	2	1	0
ARK-2473	183	477	294	0	3	1	0	0
ARK-2473	183	184	1	1	3	4	1	1
ARK-2473	183	477	294	0	4	1	0	0
ARK-2473	183	196	13	1	3	1	1	0
ARK-2473	183	477	294	0	3	4	0	0
ARK-2473	184	422	238	1	4	1	1	2
ARK-2473	184	186	2	1	3	4	1	1
ARK-2473	184	477	293	0	4	1	0	0
ARK-2473	184	187	3	1	2	1	2	0
ARK-2474	184	187	3	1	4	5	1	0
ARK-2474	185	192	7	1	3	2	0	1
ARK-2474	185	213	28	1	4	1	1	0
ARK-2474	185	186	1	1	4	1	1	0
ARK-2474	185	414	229	1	4	4	0	0
ARK-2474	185	477	292	0	4	1	0	0
ARK-2474	185	303	118	1	3	5	0	0
ARK-2474	185	197	12	1	3	4	1	1
ARK-2474	186	477	291	0	3	4	0	3
ARK-2474	186	187	1	1	3	1	1	0
ARK-2475	186	477	291	0	3	4	0	0
ARK-2475	186	407	221	1	3	4	0	0
ARK-2475	186	189	3	1	4	1	0	0
ARK-2475	186	191	5	1	5	5	0	0
ARK-2475	187	194	7	1	4	1	1	0
ARK-2475	187	199	12	1	3	1	2	0
ARK-2475	187	477	290	0	3	1	0	0
ARK-2475	187	188	1	1	5	4	1	0
ARK-2475	187	477	290	0	4	1	0	0
ARK-2475	187	189	2	1	3	4	1	0
ARK-2476	187	190	3	1	4	1	0	0
ARK-2476	188	192	4	1	4	4	1	0
ARK-2476	189	329	140	1	3	4	1	0
ARK-2476	189	232	43	1	3	4	1	0
ARK-2476	189	477	288	0	3	4	0	0
ARK-2476	189	190	1	1	4	2	0	0
ARK-2476	190	477	287	0	3	4	0	1
ARK-2476	190	245	55	1	3	4	0	0
ARK-2476	190	259	69	1	3	2	1	1
ARK-2476	190	195	5	1	3	5	0	0
ARK-2477	190	195	5	1	3	5	0	0
ARK-2477	190	210	20	1	3	5	1	1
ARK-2477	190	218	28	1	3	5	1	0
ARK-2477	190	214	24	1	3	5	1	0
ARK-2477	190	224	34	1	3	5	1	0
ARK-2477	190	274	84	1	3	5	0	0
ARK-2477	190	195	5	1	3	5	1	0
ARK-2477	190	263	73	1	3	5	1	1
ARK-2477	190	426	236	1	3	1	1	1
ARK-2477	190	395	205	1	3	5	1	0
ARK-2478	191	477	286	0	4	4	0	0
ARK-2478	191	193	2	1	1	1	2	0
ARK-2478	191	192	1	1	4	4	1	0
ARK-2478	191	431	240	1	3	1	1	0
ARK-2478	191	477	286	0	4	1	0	0
ARK-2478	191	233	42	1	3	4	1	1
ARK-2478	191	477	286	0	4	1	0	1
ARK-2478	191	297	106	1	4	1	1	2
ARK-2478	191	214	23	1	4	1	1	0
ARK-2478	191	477	286	0	3	4	0	0
ARK-2479	191	192	1	1	4	4	1	0
ARK-2479	192	477	285	0	3	1	0	0
ARK-2479	192	200	8	1	3	5	0	0
ARK-2479	192	449	257	1	3	4	1	0
ARK-2479	192	297	105	1	3	1	1	0
ARK-2479	192	206	14	1	3	2	1	0
ARK-2479	192	477	285	0	3	5	0	0
ARK-2479	193	194	1	1	3	1	0	0
ARK-2479	193	197	4	1	4	1	0	0
ARK-2479	193	195	2	1	3	2	0	1
ARK-2480	193	195	2	1	3	5	1	0
ARK-2480	193	207	14	1	3	4	1	0
ARK-2480	193	203	10	1	3	2	1	0
ARK-2480	194	313	119	1	3	4	0	0
ARK-2480	194	198	4	1	5	1	1	0
ARK-2480	194	196	2	1	3	5	1	0
ARK-2480	194	477	283	0	5	4	0	1
ARK-2480	194	195	1	1	5	4	1	0
ARK-2480	195	477	282	0	4	1	0	1
ARK-2480	195	209	14	1	2	1	4	0
ARK-2481	195	196	1	1	4	5	1	0
ARK-2481	195	200	5	1	3	5	1	0
ARK-2481	195	204	9	1	4	1	1	0
ARK-2481	195	196	1	1	3	1	3	1
ARK-2481	196	477	281	0	3	2	0	2
ARK-2481	196	477	281	0	4	4	0	0
ARK-2481	196	211	15	1	3	4	0	0
ARK-2481	196	218	22	1	3	2	1	0
ARK-2481	196	477	281	0	3	2	0	0
ARK-2481	196	226	30	1	3	2	1	0
ARK-2482	196	213	17	1	3	2	1	0
ARK-2482	196	213	17	1	3	2	1	0
ARK-2482	196	222	26	1	3	2	1	1
ARK-2482	196	477	281	0	4	4	0	0
ARK-2482	196	477	281	0	4	4	0	0
ARK-2482	196	198	2	1	2	1	0	0
ARK-2482	196	477	281	0	3	1	0	0
ARK-2482	196	477	281	0	3	4	0	0
ARK-2482	197	198	1	1	4	1	0	1
ARK-2482	197	207	10	1	3	1	1	1
ARK-2483	197	477	280	0	3	1	0	0
ARK-2483	197	477	280	0	3	4	0	0
ARK-2483	197	477	280	0	3	1	0	0
ARK-2483	197	303	106	1	3	1	0	0
ARK-2483	197	231	34	1	4	4	0	0
ARK-2483	197	477	280	0	4	1	0	0
ARK-2483	197	201	4	1	4	5	1	0
ARK-2483	197	477	280	0	3	2	0	0
ARK-2483	197	477	280	0	3	4	0	0
ARK-2483	197	477	280	0	3	1	0	1
ARK-2484	198	199	1	1	3	5	1	0
ARK-2484	198	477	279	0	4	1	0	0
ARK-2484	198	477	279	0	3	1	0	0
ARK-2484	198	477	279	0	3	1	0	0
ARK-2484	198	477	279	0	4	4	0	0
ARK-2484	198	477	279	0	3	5	0	0
ARK-2484	198	199	1	1	3	1	1	0
ARK-2484	198	203	5	1	3	1	0	0
ARK-2484	198	477	279	0	4	1	0	0
ARK-2484	198	205	7	1	4	4	1	0
ARK-2485	198	203	5	1	3	1	1	0
ARK-2485	198	281	83	1	5	4	1	0
ARK-2485	198	200	2	1	3	5	1	1
ARK-2485	198	203	5	1	3	4	0	0
ARK-2485	198	199	1	1	4	5	1	0
ARK-2485	199	477	278	0	4	4	0	0
ARK-2485	199	200	1	1	3	5	0	0
ARK-2485	199	407	208	1	3	1	0	0
ARK-2485	199	200	1	1	3	4	1	0
ARK-2485	199	203	4	1	3	1	0	0
ARK-2486	199	205	6	1	4	4	1	0
ARK-2486	199	200	1	1	3	5	1	0
ARK-2486	199	477	278	0	3	4	0	0
ARK-2486	199	477	278	0	3	5	0	2
ARK-2486	199	200	1	1	3	1	0	1
ARK-2486	199	207	8	1	3	4	1	2
ARK-2486	199	477	278	0	4	1	0	0
ARK-2486	199	206	7	1	1	1	1	0
ARK-2486	199	200	1	1	4	4	1	0
ARK-2486	199	477	278	0	3	1	0	0
ARK-2487	200	204	4	1	3	1	1	0
ARK-2487	200	201	1	1	3	4	1	0
ARK-2487	200	464	264	1	4	1	1	0
ARK-2487	200	201	1	1	3	1	1	0
ARK-2487	200	477	277	0	3	4	0	0
ARK-2487	200	477	277	0	4	4	0	0
ARK-2487	200	201	1	1	3	5	1	0
ARK-2487	200	477	277	0	3	4	0	0
ARK-2487	200	206	6	1	3	1	1	0
ARK-2487	200	201	1	1	3	1	2	0
ARK-2488	200	201	1	1	3	1	1	0
ARK-2488	202	207	5	1	4	5	1	0
ARK-2488	202	233	31	1	3	5	1	1
ARK-2488	202	203	1	1	3	5	1	0
ARK-2488	202	477	275	0	3	4	0	0
ARK-2488	203	204	1	1	3	4	0	0
ARK-2488	203	221	18	1	3	5	1	0
ARK-2488	203	204	1	1	3	5	1	0
ARK-2488	203	361	158	1	4	4	0	0
ARK-2488	203	253	50	1	3	1	2	1
ARK-2489	203	205	2	1	3	4	1	0
ARK-2489	203	205	2	1	3	1	2	0
ARK-2489	203	477	274	0	3	4	0	0
ARK-2489	203	212	9	1	3	4	1	0
ARK-2489	203	414	211	1	3	1	1	0
ARK-2489	203	204	1	1	3	1	1	1
ARK-2489	204	213	9	1	3	1	1	0
ARK-2489	204	206	2	1	3	1	0	0
ARK-2489	204	477	273	0	5	1	0	0
ARK-2489	204	296	92	1	4	4	0	0
ARK-2490	204	477	273	0	4	4	0	0
ARK-2490	204	303	99	1	3	4	1	0
ARK-2490	204	450	246	1	4	4	1	0
ARK-2490	204	407	203	1	3	4	0	0
ARK-2490	204	477	273	0	4	4	0	0
ARK-2490	204	477	273	0	3	1	0	0
ARK-2490	204	477	273	0	3	4	0	0
ARK-2490	204	477	273	0	3	2	0	1
ARK-2490	204	205	1	1	2	1	2	0
ARK-2490	204	240	36	1	2	1	2	1
ARK-2491	204	477	273	0	4	4	0	0
ARK-2491	204	205	1	1	3	1	1	0
ARK-2491	204	477	273	0	4	1	0	0
ARK-2491	204	477	273	0	3	4	0	0
ARK-2491	205	477	272	0	3	4	0	0
ARK-2491	205	477	272	0	3	1	0	2
ARK-2491	205	206	1	1	3	1	0	1
ARK-2491	205	297	92	1	3	4	0	0
ARK-2491	205	262	57	1	3	2	1	1
ARK-2491	205	206	1	1	3	1	1	1
ARK-2492	205	372	167	1	3	4	1	0
ARK-2492	205	207	2	1	3	1	0	0
ARK-2492	205	477	272	0	3	1	0	0
ARK-2492	205	477	272	0	3	5	0	0
ARK-2492	206	207	1	1	4	5	1	2
ARK-2492	206	477	271	0	3	1	0	0
ARK-2492	206	215	9	1	4	4	1	0
ARK-2492	206	207	1	1	3	1	3	0
ARK-2492	206	224	18	1	4	1	0	1
ARK-2492	206	207	1	1	5	4	1	0
ARK-2493	206	477	271	0	4	4	0	0
ARK-2493	206	477	271	0	3	1	0	0
ARK-2493	206	477	271	0	3	4	0	1
ARK-2493	206	350	144	1	3	4	1	4
ARK-2493	206	210	4	1	2	1	2	0
ARK-2493	206	447	241	1	3	1	2	0
ARK-2493	206	477	271	0	3	5	0	0
ARK-2493	206	212	6	1	3	1	1	0
ARK-2493	206	386	180	1	4	4	1	1
ARK-2493	206	477	271	0	4	4	0	0
ARK-2494	206	215	9	1	3	4	1	0
ARK-2494	207	477	270	0	3	4	0	0
ARK-2494	207	477	270	0	3	4	0	0
ARK-2494	207	208	1	1	4	4	1	1
ARK-2494	207	210	3	1	4	1	0	0
ARK-2494	207	214	7	1	4	4	1	0
ARK-2494	207	477	270	0	4	4	0	0
ARK-2494	207	477	270	0	4	2	0	0
ARK-2494	207	217	10	1	1	1	3	0
ARK-2494	207	211	4	1	4	1	0	0
ARK-2495	207	220	13	1	3	1	4	0
ARK-2495	207	212	5	1	3	4	1	0
ARK-2495	207	211	4	1	4	4	1	0
ARK-2495	207	477	270	0	3	4	0	0
ARK-2495	207	214	7	1	1	4	1	0
ARK-2495	208	477	269	0	3	1	0	0
ARK-2495	208	209	1	1	4	4	1	0
ARK-2495	208	210	2	1	3	1	3	1
ARK-2495	208	343	135	1	3	5	1	2
ARK-2495	208	477	269	0	3	4	0	1
ARK-2496	208	212	4	1	4	4	1	0
ARK-2496	208	477	269	0	3	1	0	0
ARK-2496	209	246	37	1	3	4	1	0
ARK-2496	209	210	1	1	4	1	1	0
ARK-2496	209	477	268	0	3	2	0	0
ARK-2496	209	477	268	0	3	1	0	0
ARK-2496	209	214	5	1	3	1	1	0
ARK-2496	210	211	1	1	4	5	1	0
ARK-2496	210	211	1	1	4	4	0	0
ARK-2496	210	477	267	0	3	1	0	0
ARK-2497	210	477	267	0	3	1	0	0
ARK-2497	210	212	2	1	3	5	1	0
ARK-2497	210	211	1	1	4	1	1	0
ARK-2497	210	211	1	1	4	4	0	1
ARK-2497	210	477	267	0	3	1	0	0
ARK-2497	211	212	1	1	3	1	0	1
ARK-2497	211	212	1	1	3	5	2	0
ARK-2497	211	214	3	1	3	1	0	0
ARK-2497	211	238	27	1	3	4	1	0
ARK-2497	211	218	7	1	3	4	1	0
ARK-2498	211	477	266	0	3	4	0	0
ARK-2498	211	217	6	1	4	1	1	0
ARK-2498	211	212	1	1	3	4	1	0
ARK-2498	211	477	266	0	3	1	0	0
ARK-2498	211	212	1	1	3	2	0	0
ARK-2498	212	477	265	0	3	1	0	0
ARK-2498	212	477	265	0	3	1	0	0
ARK-2498	212	215	3	1	2	1	2	2
ARK-2498	212	213	1	1	4	2	0	0
ARK-2498	212	214	2	1	3	4	0	1
ARK-2499	212	213	1	1	3	5	1	0
ARK-2499	212	217	5	1	3	5	1	0
ARK-2499	212	217	5	1	4	4	1	0
ARK-2499	213	214	1	1	3	4	1	0
ARK-2499	213	477	264	0	3	4	0	0
ARK-2499	213	477	264	0	3	1	0	0
ARK-2499	213	217	4	1	3	4	1	0
ARK-2499	213	214	1	1	3	1	1	0
ARK-2499	213	477	264	0	3	4	0	0
ARK-2499	213	252	39	1	3	4	1	0
ARK-2500	213	477	264	0	3	4	0	0
ARK-2500	213	215	2	1	3	4	1	0
ARK-2500	213	214	1	1	3	5	1	0
ARK-2500	213	290	77	1	3	1	1	1
ARK-2500	213	239	26	1	3	1	1	4
ARK-2500	213	239	26	1	3	1	1	0
ARK-2500	213	452	239	1	3	1	0	2
ARK-2500	213	244	31	1	3	5	1	0
ARK-2500	213	477	264	0	3	3	0	0
ARK-2500	213	214	1	1	2	1	1	1
ARK-2501	213	218	5	1	3	1	1	0
ARK-2501	214	215	1	1	4	1	1	0
ARK-2501	214	218	4	1	3	1	0	1
ARK-2501	214	237	23	1	4	1	0	0
ARK-2501	214	215	1	1	3	1	0	0
ARK-2501	214	477	263	0	4	3	0	0
ARK-2501	214	282	68	1	3	4	1	0
ARK-2501	214	477	263	0	3	5	0	0
ARK-2501	214	218	4	1	3	4	1	0
ARK-2501	214	217	3	1	2	1	1	0
ARK-2502	214	477	263	0	3	1	0	0
ARK-2502	214	251	37	1	3	1	1	1
ARK-2502	214	477	263	0	3	1	0	1
ARK-2502	214	305	91	1	4	4	2	0
ARK-2502	214	477	263	0	3	1	0	0
ARK-2502	215	217	2	1	3	4	1	0
ARK-2502	215	226	11	1	4	4	0	0
ARK-2502	215	248	33	1	4	1	0	1
ARK-2502	216	225	9	1	3	1	2	0
ARK-2502	216	235	19	1	3	5	1	1
ARK-2503	217	477	260	0	3	1	0	0
ARK-2503	217	227	10	1	4	1	1	0
ARK-2503	217	477	260	0	4	4	0	0
ARK-2503	217	224	7	1	3	1	1	0
ARK-2503	217	477	260	0	3	4	0	0
ARK-2503	217	420	203	1	3	4	1	0
ARK-2503	217	252	35	1	3	1	1	0
ARK-2503	217	218	1	1	4	1	0	0
ARK-2503	218	477	259	0	3	4	0	0
ARK-2503	218	477	259	0	3	4	0	2
ARK-2504	218	295	77	1	4	1	1	0
ARK-2504	218	219	1	1	3	1	1	0
ARK-2504	218	477	259	0	4	1	0	0
ARK-2504	218	225	7	1	5	4	1	0
ARK-2504	218	240	22	1	3	5	1	1
ARK-2504	218	219	1	1	3	4	1	0
ARK-2504	218	219	1	1	4	1	1	0
ARK-2504	218	220	2	1	3	5	1	0
ARK-2504	218	271	53	1	4	4	1	0
ARK-2504	218	477	259	0	3	4	0	0
ARK-2505	218	477	259	0	3	4	0	0
ARK-2505	218	225	7	1	1	1	1	1
ARK-2505	218	219	1	1	4	5	0	0
ARK-2505	218	477	259	0	5	4	0	0
ARK-2505	219	220	1	1	4	4	0	0
ARK-2505	219	220	1	1	3	1	0	1
ARK-2505	219	477	258	0	3	4	0	0
ARK-2505	219	477	258	0	3	5	0	0
ARK-2505	219	220	1	1	3	1	1	0
ARK-2505	219	477	258	0	3	1	0	0
ARK-2506	219	224	5	1	3	1	0	1
ARK-2506	219	477	258	0	2	1	0	0
ARK-2506	220	278	58	1	3	4	1	0
ARK-2506	220	221	1	1	5	3	1	0
ARK-2506	220	477	257	0	4	1	0	0
ARK-2506	220	477	257	0	3	1	0	0
ARK-2506	220	228	8	1	3	4	0	1
ARK-2506	220	477	257	0	3	1	0	0
ARK-2506	220	221	1	1	3	5	1	0
ARK-2506	220	224	4	1	3	4	1	0
ARK-2507	220	477	257	0	3	1	0	0
ARK-2507	220	477	257	0	3	4	0	0
ARK-2507	220	248	28	1	4	1	1	0
ARK-2507	220	235	15	1	5	4	1	0
ARK-2507	220	477	257	0	4	3	0	0
ARK-2507	220	477	257	0	3	5	0	0
ARK-2507	220	221	1	1	3	1	2	1
ARK-2507	220	221	1	1	5	4	1	0
ARK-2507	220	477	257	0	3	1	0	0
ARK-2507	220	477	257	0	3	4	0	1
ARK-2508	220	237	17	1	4	4	0	0
ARK-2508	221	222	1	1	1	1	3	1
ARK-2508	221	227	6	1	5	5	1	0
ARK-2508	221	477	256	0	3	4	0	0
ARK-2508	221	222	1	1	1	1	2	0
ARK-2508	221	477	256	0	3	1	0	0
ARK-2508	221	225	4	1	3	4	0	1
ARK-2508	221	477	256	0	3	4	0	0
ARK-2508	221	225	4	1	3	4	1	0
ARK-2508	221	222	1	1	4	4	2	0
ARK-2509	221	224	3	1	3	1	1	0
ARK-2509	222	252	30	1	2	1	0	1
ARK-2509	222	223	1	1	3	1	1	0
ARK-2509	223	233	10	1	4	4	1	0
ARK-2509	223	477	254	0	3	1	0	0
ARK-2509	223	232	9	1	3	3	1	0
ARK-2509	224	225	1	1	3	1	1	0
ARK-2509	224	417	193	1	3	5	1	0
ARK-2509	224	310	86	1	3	1	1	0
ARK-2509	224	225	1	1	3	5	1	0
ARK-2510	224	477	253	0	3	1	0	0
ARK-2510	224	387	163	1	3	1	0	0
ARK-2510	224	313	89	1	3	4	1	0
ARK-2510	224	477	253	0	3	1	0	0
ARK-2510	224	225	1	1	3	5	1	0
ARK-2510	224	233	9	1	5	4	1	0
ARK-2510	224	235	11	1	3	1	0	1
ARK-2510	224	477	253	0	3	1	0	0
ARK-2510	225	248	23	1	4	4	1	0
ARK-2510	225	477	252	0	3	1	0	0
ARK-2511	225	282	57	1	3	5	0	0
ARK-2511	225	226	1	1	3	4	1	1
ARK-2511	225	240	15	1	3	1	0	0
ARK-2511	225	226	1	1	3	4	1	0
ARK-2511	225	232	7	1	1	1	3	1
ARK-2511	225	226	1	1	3	4	1	0
ARK-2511	225	228	3	1	3	1	1	0
ARK-2511	225	245	20	1	3	4	1	0
ARK-2511	225	317	92	1	3	4	1	0
ARK-2511	225	239	14	1	4	1	0	1
ARK-2512	226	227	1	1	3	1	0	1
ARK-2512	226	477	251	0	3	4	0	0
ARK-2512	226	228	2	1	5	4	1	0
ARK-2512	226	477	251	0	3	1	0	0
ARK-2512	226	235	9	1	3	1	2	0
ARK-2512	226	477	251	0	3	1	0	0
ARK-2512	226	234	8	1	4	1	1	0
ARK-2512	226	234	8	1	3	5	1	1
ARK-2512	226	477	251	0	4	1	0	0
ARK-2512	227	234	7	1	3	5	0	1
ARK-2513	227	477	250	0	3	1	0	0
ARK-2513	227	231	4	1	4	1	0	0
ARK-2513	227	232	5	1	3	1	1	2
ARK-2513	227	234	7	1	3	5	1	0
ARK-2513	227	232	5	1	3	1	1	2
ARK-2513	227	248	21	1	1	1	0	1
ARK-2513	227	477	250	0	3	1	0	0
ARK-2513	228	229	1	1	5	1	1	0
ARK-2513	228	229	1	1	4	1	0	1
ARK-2513	228	477	249	0	3	1	0	1
ARK-2514	228	233	5	1	4	4	1	0
ARK-2514	228	230	2	1	3	5	1	0
ARK-2514	228	229	1	1	3	4	1	0
ARK-2514	228	229	1	1	3	4	0	1
ARK-2514	228	232	4	1	3	1	2	0
ARK-2514	228	333	105	1	4	1	0	1
ARK-2514	228	229	1	1	3	1	0	1
ARK-2514	228	421	193	1	3	1	0	1
ARK-2514	228	338	110	1	3	4	0	1
ARK-2514	228	232	4	1	3	1	1	1
ARK-2515	228	477	249	0	3	1	0	3
ARK-2515	228	477	249	0	3	4	0	0
ARK-2515	228	477	249	0	3	5	0	1
ARK-2515	229	477	248	0	5	4	0	0
ARK-2515	229	477	248	0	3	1	0	0
ARK-2515	230	233	3	1	4	1	0	0
ARK-2515	230	231	1	1	3	5	0	2
ARK-2515	230	477	247	0	3	2	0	1
ARK-2515	231	407	176	1	3	1	1	0
ARK-2515	231	233	2	1	3	1	1	0
ARK-2516	231	232	1	1	3	5	1	0
ARK-2516	231	232	1	1	3	1	1	0
ARK-2516	231	477	246	0	4	1	0	0
ARK-2516	231	233	2	1	3	1	1	0
ARK-2516	231	234	3	1	4	1	3	2
ARK-2516	231	477	246	0	3	1	0	0
ARK-2516	232	477	245	0	4	4	0	0
ARK-2516	232	234	2	1	4	1	1	0
ARK-2516	232	233	1	1	4	1	0	0
ARK-2516	232	477	245	0	3	1	0	0
ARK-2517	232	255	23	1	4	4	1	0
ARK-2517	232	477	245	0	3	1	0	0
ARK-2517	232	233	1	1	3	1	0	1
ARK-2517	232	233	1	1	3	1	0	1
ARK-2517	232	235	3	1	3	1	1	1
ARK-2517	232	252	20	1	3	1	1	2
ARK-2517	232	247	15	1	3	1	1	0
ARK-2517	232	477	245	0	4	1	0	0
ARK-2517	232	235	3	1	4	4	1	0
ARK-2517	232	301	69	1	3	5	1	0
ARK-2518	232	477	245	0	4	1	0	0
ARK-2518	232	233	1	1	3	1	1	1
ARK-2518	232	233	1	1	3	1	0	1
ARK-2518	233	242	9	1	4	1	1	4
ARK-2518	233	234	1	1	4	5	1	0
ARK-2518	233	477	244	0	3	5	0	0
ARK-2518	233	477	244	0	3	4	0	4
ARK-2518	233	477	244	0	3	5	0	0
ARK-2518	233	477	244	0	3	5	0	0
ARK-2518	233	267	34	1	3	5	0	0
ARK-2519	233	477	244	0	3	5	0	0
ARK-2519	233	477	244	0	3	5	0	0
ARK-2519	233	234	1	1	3	5	0	1
ARK-2519	233	477	244	0	3	1	0	1
ARK-2519	233	407	174	1	3	2	0	0
ARK-2519	233	235	2	1	4	4	0	0
ARK-2519	233	444	211	1	3	2	1	1
ARK-2519	233	234	1	1	5	4	0	0
ARK-2519	233	477	244	0	3	1	0	0
ARK-2519	233	236	3	1	4	1	0	0
ARK-2520	233	477	244	0	3	1	0	0
ARK-2520	233	426	193	1	4	1	0	0
ARK-2520	233	278	45	1	4	2	1	0
ARK-2520	233	477	244	0	3	1	0	1
ARK-2520	233	234	1	1	4	1	1	0
ARK-2520	234	235	1	1	5	1	2	0
ARK-2520	234	303	69	1	1	1	1	3
ARK-2520	234	242	8	1	3	5	1	1
ARK-2520	234	235	1	1	3	4	1	0
ARK-2520	234	235	1	1	3	4	1	0
ARK-2521	234	235	1	1	3	1	0	0
ARK-2521	234	477	243	0	3	1	0	0
ARK-2521	234	239	5	1	3	4	1	0
ARK-2521	234	239	5	1	3	3	1	0
ARK-2521	234	235	1	1	1	1	1	0
ARK-2521	234	477	243	0	4	5	0	0
ARK-2521	234	477	243	0	3	4	0	0
ARK-2521	234	477	243	0	3	1	0	0
ARK-2521	234	239	5	1	4	1	1	0
ARK-2521	234	477	243	0	3	1	0	0
ARK-2522	235	354	119	1	5	4	0	1
ARK-2522	235	253	18	1	3	1	1	0
ARK-2522	235	248	13	1	4	4	1	0
ARK-2522	235	236	1	1	3	4	0	0
ARK-2522	235	477	242	0	3	4	0	0
ARK-2522	235	250	15	1	4	4	0	0
ARK-2522	235	239	4	1	4	4	0	0
ARK-2522	235	238	3	1	4	4	0	1
ARK-2522	235	247	12	1	4	4	1	0
ARK-2522	235	236	1	1	1	1	0	0
ARK-2523	235	477	242	0	3	1	0	0
ARK-2523	235	247	12	1	3	1	2	0
ARK-2523	235	477	242	0	3	2	0	0
ARK-2523	235	241	6	1	3	4	1	0
ARK-2523	235	236	1	1	3	5	2	0
ARK-2523	235	240	5	1	3	4	1	0
ARK-2523	235	477	242	0	5	4	0	0
ARK-2523	236	249	13	1	3	1	1	0
ARK-2523	236	257	21	1	4	5	1	0
ARK-2523	236	477	241	0	4	4	0	0
ARK-2524	236	239	3	1	1	1	1	0
ARK-2524	236	253	17	1	4	4	1	1
ARK-2524	236	477	241	0	4	4	0	0
ARK-2524	237	296	59	1	4	4	1	1
ARK-2524	237	477	240	0	3	1	0	0
ARK-2524	237	355	118	1	4	5	1	0
ARK-2524	237	477	240	0	3	1	0	0
ARK-2524	238	477	239	0	3	5	0	0
ARK-2524	238	246	8	1	3	5	1	0
ARK-2524	238	239	1	1	5	5	1	0
ARK-2525	238	429	191	1	3	1	3	4
ARK-2525	238	239	1	1	3	1	0	1
ARK-2525	238	248	10	1	4	4	1	2
ARK-2525	238	240	2	1	4	4	3	0
ARK-2525	238	407	169	1	4	4	0	1
ARK-2525	238	298	60	1	5	4	1	0
ARK-2525	238	242	4	1	3	5	1	0
ARK-2525	238	242	4	1	3	1	0	1
ARK-2525	239	247	8	1	3	5	1	1
ARK-2525	239	240	1	1	3	4	0	0
ARK-2526	239	240	1	1	3	4	1	0
ARK-2526	239	477	238	0	4	4	0	0
ARK-2526	239	477	238	0	3	4	0	0
ARK-2526	239	477	238	0	3	1	0	1
ARK-2526	239	242	3	1	3	1	1	0
ARK-2526	239	244	5	1	2	1	0	1
ARK-2526	239	240	1	1	2	1	1	1
ARK-2526	239	249	10	1	3	5	1	0
ARK-2526	240	248	8	1	2	1	1	1
ARK-2526	240	291	51	1	3	4	1	1
ARK-2527	240	293	53	1	4	5	1	0
ARK-2527	240	353	113	1	2	1	1	1
ARK-2527	240	372	132	1	3	5	0	0
ARK-2527	240	241	1	1	3	5	2	0
ARK-2527	240	339	99	1	3	5	1	1
ARK-2527	241	242	1	1	3	4	1	0
ARK-2527	241	477	236	0	3	1	0	0
ARK-2527	241	346	105	1	4	1	1	0
ARK-2527	241	252	11	1	3	1	1	0
ARK-2527	241	247	6	1	4	1	0	0
ARK-2528	241	477	236	0	3	5	0	0
ARK-2528	241	477	236	0	3	1	0	0
ARK-2528	241	280	39	1	4	4	1	0
ARK-2528	241	242	1	1	3	1	1	1
ARK-2528	241	242	1	1	3	1	0	1
ARK-2528	241	477	236	0	4	4	0	0
ARK-2528	241	242	1	1	3	4	1	1
ARK-2528	241	242	1	1	4	4	1	0
ARK-2528	241	242	1	1	3	1	1	0
ARK-2528	242	243	1	1	3	1	1	0
ARK-2529	242	243	1	1	3	5	1	0
ARK-2529	242	260	18	1	3	1	1	0
ARK-2529	242	243	1	1	2	1	0	1
ARK-2529	242	301	59	1	3	1	0	1
ARK-2529	242	477	235	0	3	5	0	0
ARK-2529	242	255	13	1	3	1	1	1
ARK-2529	242	243	1	1	3	5	1	0
ARK-2529	242	246	4	1	3	5	0	0
ARK-2529	242	245	3	1	4	5	1	0
ARK-2529	243	477	234	0	3	2	0	2
ARK-2530	243	247	4	1	4	4	1	0
ARK-2530	243	248	5	1	4	1	0	0
ARK-2530	243	477	234	0	3	1	0	0
ARK-2530	243	477	234	0	3	1	0	0
ARK-2530	243	245	2	1	4	5	1	0
ARK-2530	243	477	234	0	3	1	0	0
ARK-2530	243	247	4	1	2	1	1	1
ARK-2530	244	246	2	1	3	1	1	0
ARK-2530	244	246	2	1	3	1	1	0
ARK-2530	244	477	233	0	4	4	0	0
ARK-2531	244	246	2	1	3	1	1	0
ARK-2531	245	477	232	0	3	1	0	0
ARK-2531	245	307	62	1	3	5	0	1
ARK-2531	245	248	3	1	3	1	2	1
ARK-2531	245	269	24	1	3	1	1	1
ARK-2531	245	273	28	1	3	1	0	0
ARK-2531	245	477	232	0	3	1	0	0
ARK-2531	246	248	2	1	1	1	1	0
ARK-2531	246	268	22	1	4	4	1	0
ARK-2531	246	273	27	1	2	5	1	0
ARK-2532	246	263	17	1	1	5	1	0
ARK-2532	246	263	17	1	1	5	1	0
ARK-2532	246	273	27	1	2	5	0	0
ARK-2532	246	273	27	1	3	5	0	0
ARK-2532	246	263	17	1	1	5	1	0
ARK-2532	246	273	27	1	3	5	0	1
ARK-2532	246	273	27	1	3	5	0	0
ARK-2532	246	263	17	1	2	5	0	0
ARK-2532	246	248	2	1	3	5	1	0
ARK-2532	246	477	231	0	3	5	0	0
ARK-2533	246	477	231	0	3	1	0	1
ARK-2533	246	477	231	0	3	1	0	0
ARK-2533	246	477	231	0	3	4	0	0
ARK-2533	246	248	2	1	4	4	0	0
ARK-2533	246	477	231	0	3	3	0	0
ARK-2533	246	247	1	1	4	4	1	0
ARK-2533	246	247	1	1	3	3	1	2
ARK-2533	246	248	2	1	3	5	1	0
ARK-2533	247	255	8	1	4	4	1	0
ARK-2533	247	262	15	1	3	5	1	0
ARK-2534	247	477	230	0	4	2	0	0
ARK-2534	247	477	230	0	3	4	0	2
ARK-2534	247	477	230	0	3	4	0	2
ARK-2534	247	249	2	1	4	4	0	0
ARK-2534	247	321	74	1	3	4	0	1
ARK-2534	247	250	3	1	3	5	1	2
ARK-2534	247	477	230	0	3	5	0	0
ARK-2534	247	297	50	1	3	5	1	2
ARK-2534	247	477	230	0	3	5	0	1
ARK-2534	247	477	230	0	3	5	0	2
ARK-2535	247	432	185	1	3	2	0	0
ARK-2535	247	477	230	0	3	5	0	0
ARK-2535	248	254	6	1	3	1	1	0
ARK-2535	248	477	229	0	3	5	0	0
ARK-2535	248	254	6	1	3	4	0	0
ARK-2535	248	477	229	0	3	2	0	0
ARK-2535	248	249	1	1	4	4	0	0
ARK-2535	248	255	7	1	4	1	2	0
ARK-2535	248	261	13	1	3	5	1	1
ARK-2535	248	477	229	0	3	4	0	1
ARK-2536	248	477	229	0	5	4	0	0
ARK-2536	248	477	229	0	4	4	0	0
ARK-2536	248	293	45	1	4	4	0	0
ARK-2536	249	254	5	1	3	1	1	0
ARK-2536	249	252	3	1	3	5	0	0
ARK-2536	249	252	3	1	3	5	0	0
ARK-2536	249	262	13	1	4	4	1	0
ARK-2536	249	477	228	0	3	1	0	0
ARK-2536	249	251	2	1	1	1	2	0
ARK-2536	249	293	44	1	4	4	0	0
ARK-2537	249	250	1	1	5	1	0	0
ARK-2537	249	254	5	1	5	1	2	0
ARK-2537	249	269	20	1	3	1	1	0
ARK-2537	250	477	227	0	4	4	0	0
ARK-2537	250	337	87	1	4	5	1	0
ARK-2537	250	251	1	1	4	4	1	0
ARK-2537	250	477	227	0	3	5	0	0
ARK-2537	250	477	227	0	3	1	0	0
ARK-2537	250	283	33	1	2	1	0	1
ARK-2537	250	268	18	1	3	5	1	0
ARK-2538	250	477	227	0	4	1	0	1
ARK-2538	250	262	12	1	4	4	1	0
ARK-2538	250	477	227	0	3	3	0	2
ARK-2538	250	477	227	0	3	2	0	2
ARK-2538	250	263	13	1	5	4	1	0
ARK-2538	251	254	3	1	3	5	0	0
ARK-2538	251	253	2	1	3	4	0	0
ARK-2538	251	255	4	1	3	1	1	0
ARK-2538	252	284	32	1	4	1	1	0
ARK-2538	252	253	1	1	3	1	1	0
ARK-2539	252	477	225	0	3	4	0	1
ARK-2539	252	258	6	1	3	4	0	0
ARK-2539	252	477	225	0	4	4	0	0
ARK-2539	252	289	37	1	4	4	1	0
ARK-2539	252	288	36	1	3	4	1	0
ARK-2539	252	253	1	1	4	4	0	0
ARK-2539	252	477	225	0	4	4	0	0
ARK-2539	252	477	225	0	4	1	0	0
ARK-2539	252	253	1	1	4	1	1	0
ARK-2539	252	253	1	1	2	1	1	0
ARK-2540	252	255	3	1	3	4	2	0
ARK-2540	253	477	224	0	3	4	0	0
ARK-2540	253	255	2	1	1	1	3	1
ARK-2540	253	477	224	0	3	1	0	0
ARK-2540	253	477	224	0	4	1	0	0
ARK-2540	253	426	173	1	3	1	0	0
ARK-2540	253	255	2	1	3	1	1	0
ARK-2540	253	462	209	1	3	1	1	1
ARK-2540	253	277	24	1	4	4	1	0
ARK-2540	253	263	10	1	3	4	0	0
ARK-2541	254	255	1	1	3	1	0	0
ARK-2541	254	477	223	0	3	2	0	0
ARK-2541	254	255	1	1	3	1	0	0
ARK-2541	254	291	37	1	1	1	0	0
ARK-2541	254	261	7	1	3	5	1	0
ARK-2541	254	255	1	1	3	4	1	1
ARK-2541	254	266	12	1	3	1	1	2
ARK-2541	254	262	8	1	3	1	1	0
ARK-2541	255	256	1	1	3	1	1	0
ARK-2541	255	256	1	1	3	5	1	0
ARK-2542	255	259	4	1	3	5	0	0
ARK-2542	255	477	222	0	3	4	0	0
ARK-2542	255	268	13	1	3	5	1	1
ARK-2542	255	259	4	1	5	4	1	0
ARK-2542	255	287	32	1	3	1	0	0
ARK-2542	255	258	3	1	3	1	2	0
ARK-2542	256	257	1	1	4	4	1	0
ARK-2542	256	259	3	1	3	1	1	2
ARK-2542	256	477	221	0	3	2	0	0
ARK-2542	256	270	14	1	3	4	1	0
ARK-2543	256	376	120	1	3	4	0	1
ARK-2543	256	259	3	1	4	1	1	0
ARK-2543	256	477	221	0	5	4	0	1
ARK-2543	256	330	74	1	4	4	0	0
ARK-2543	257	258	1	1	3	1	0	0
ARK-2543	257	259	2	1	3	1	0	0
ARK-2543	257	258	1	1	3	4	1	0
ARK-2543	257	301	44	1	4	4	0	0
ARK-2543	257	258	1	1	3	1	1	2
ARK-2543	257	258	1	1	4	1	1	0
ARK-2544	257	477	220	0	4	4	0	0
ARK-2544	257	426	169	1	3	2	0	0
ARK-2544	258	354	96	1	3	1	0	1
ARK-2544	259	260	1	1	3	1	1	0
ARK-2544	259	260	1	1	3	4	1	0
ARK-2544	259	260	1	1	3	4	1	0
ARK-2544	259	333	74	1	3	4	1	1
ARK-2544	259	271	12	1	4	4	1	0
ARK-2544	259	282	23	1	3	1	0	0
ARK-2544	259	270	11	1	3	4	1	0
ARK-2545	260	262	2	1	3	1	2	0
ARK-2545	260	329	69	1	3	1	2	0
ARK-2545	260	477	217	0	3	1	0	0
ARK-2545	260	273	13	1	3	5	1	1
ARK-2545	260	477	217	0	3	1	0	0
ARK-2545	260	301	41	1	3	1	0	1
ARK-2545	260	261	1	1	1	5	1	0
ARK-2545	260	262	2	1	3	4	1	0
ARK-2545	260	270	10	1	3	4	1	0
ARK-2545	261	477	216	0	3	4	0	0
ARK-2546	261	262	1	1	3	5	1	0
ARK-2546	261	279	18	1	3	1	1	1
ARK-2546	261	262	1	1	3	5	0	0
ARK-2546	261	477	216	0	3	1	0	0
ARK-2546	261	477	216	0	3	1	0	0
ARK-2546	261	264	3	1	3	4	1	0
ARK-2546	261	477	216	0	4	4	0	0
ARK-2546	261	477	216	0	3	1	0	0
ARK-2546	261	269	8	1	5	2	1	0
ARK-2546	261	263	2	1	3	4	1	2
ARK-2547	261	262	1	1	3	4	0	1
ARK-2547	261	262	1	1	3	1	2	0
ARK-2547	261	262	1	1	3	1	1	0
ARK-2547	262	265	3	1	3	1	1	0
ARK-2547	262	477	215	0	3	1	0	0
ARK-2547	262	477	215	0	3	4	0	1
ARK-2547	262	273	11	1	3	5	1	0
ARK-2547	262	477	215	0	3	1	0	0
ARK-2547	262	266	4	1	3	5	1	0
ARK-2547	262	276	14	1	3	5	1	0
ARK-2548	262	477	215	0	4	1	0	0
ARK-2548	262	269	7	1	3	5	1	0
ARK-2548	262	316	54	1	4	1	1	0
ARK-2548	262	275	13	1	3	5	1	0
ARK-2548	262	373	111	1	3	5	1	1
ARK-2548	262	269	7	1	3	5	1	0
ARK-2548	262	267	5	1	3	5	1	0
ARK-2548	262	263	1	1	3	5	1	0
ARK-2548	262	278	16	1	3	5	1	0
ARK-2548	262	265	3	1	3	5	1	0
ARK-2549	262	296	34	1	3	5	1	0
ARK-2549	262	307	45	1	3	1	0	0
ARK-2549	262	293	31	1	3	5	1	0
ARK-2549	262	291	29	1	3	1	1	2
ARK-2549	262	263	1	1	3	4	1	0
ARK-2549	263	267	4	1	1	1	1	0
ARK-2549	263	457	194	1	3	1	1	1
ARK-2549	263	281	18	1	3	4	1	2
ARK-2549	263	336	73	1	3	1	1	0
ARK-2549	263	264	1	1	3	5	1	0
ARK-2550	263	267	4	1	4	4	0	0
ARK-2550	263	333	70	1	3	4	1	1
ARK-2550	263	266	3	1	4	1	2	0
ARK-2550	263	267	4	1	3	1	2	1
ARK-2550	263	328	65	1	4	5	0	0
ARK-2550	263	270	7	1	4	1	1	0
ARK-2550	263	265	2	1	3	4	0	1
ARK-2550	263	294	31	1	3	5	0	0
ARK-2550	263	271	8	1	3	5	1	0
ARK-2550	263	268	5	1	3	1	2	0
ARK-2551	263	273	10	1	3	5	1	0
ARK-2551	263	268	5	1	3	1	0	0
ARK-2551	264	265	1	1	2	5	0	0
ARK-2551	264	477	213	0	4	4	0	0
ARK-2551	266	268	2	1	4	4	1	0
ARK-2551	266	336	70	1	3	4	1	0
ARK-2551	266	267	1	1	5	1	0	0
ARK-2551	266	268	2	1	3	1	0	1
ARK-2551	266	267	1	1	3	4	0	1
ARK-2551	266	267	1	1	3	1	1	1
ARK-2552	267	477	210	0	3	1	0	0
ARK-2552	267	277	10	1	4	1	1	0
ARK-2552	267	269	2	1	3	1	1	1
ARK-2552	267	272	5	1	3	1	1	0
ARK-2552	267	273	6	1	3	5	0	3
ARK-2552	267	269	2	1	3	1	1	0
ARK-2552	267	268	1	1	3	2	0	0
ARK-2552	267	477	210	0	3	1	0	0
ARK-2552	267	333	66	1	3	5	1	1
ARK-2553	267	379	112	1	3	5	1	0
ARK-2553	267	477	210	0	3	4	0	2
ARK-2553	267	477	210	0	3	5	0	0
ARK-2553	267	269	2	1	3	1	2	0
ARK-2553	267	268	1	1	3	1	1	0
ARK-2553	268	281	13	1	3	1	1	0
ARK-2553	268	269	1	1	3	1	2	1
ARK-2553	268	477	209	0	4	5	0	0
ARK-2553	268	275	7	1	1	1	1	0
ARK-2553	268	279	11	1	4	4	1	0
ARK-2554	268	269	1	1	3	1	1	0
ARK-2554	268	269	1	1	3	1	1	0
ARK-2554	268	270	2	1	3	1	1	1
ARK-2554	268	272	4	1	4	1	1	0
ARK-2554	268	477	209	0	3	1	0	0
ARK-2554	268	269	1	1	4	1	0	2
ARK-2554	268	269	1	1	3	1	1	1
ARK-2554	268	477	209	0	3	4	0	0
ARK-2554	269	477	208	0	3	4	0	0
ARK-2554	269	477	208	0	3	4	0	0
ARK-2555	269	426	157	1	3	1	0	0
ARK-2555	269	270	1	1	5	3	1	0
ARK-2555	269	426	157	1	3	1	0	0
ARK-2555	269	270	1	1	4	4	0	0
ARK-2555	269	273	4	1	3	1	0	0
ARK-2555	269	477	208	0	3	4	0	0
ARK-2555	269	477	208	0	3	2	0	0
ARK-2555	269	477	208	0	3	5	0	0
ARK-2555	269	477	208	0	3	5	0	0
ARK-2555	269	271	2	1	3	5	1	0
ARK-2556	269	291	22	1	3	2	1	0
ARK-2556	269	477	208	0	3	1	0	0
ARK-2556	270	426	156	1	4	2	0	0
ARK-2556	270	477	207	0	4	1	0	0
ARK-2556	270	477	207	0	4	1	0	0
ARK-2556	270	272	2	1	4	4	1	0
ARK-2556	270	284	14	1	3	4	1	0
ARK-2556	270	284	14	1	4	1	1	0
ARK-2556	270	272	2	1	3	1	3	0
ARK-2556	270	477	207	0	3	4	0	0
ARK-2557	271	272	1	1	4	1	2	0
ARK-2557	271	272	1	1	3	4	0	1
ARK-2557	271	272	1	1	3	5	2	0
ARK-2557	271	337	66	1	3	4	1	0
ARK-2557	271	418	147	1	4	4	0	0
ARK-2557	271	273	2	1	4	4	1	0
ARK-2557	272	274	2	1	3	4	1	0
ARK-2557	272	477	205	0	4	4	0	0
ARK-2557	272	274	2	1	4	1	1	1
ARK-2557	273	288	15	1	1	1	2	0
ARK-2558	273	280	7	1	3	1	0	0
ARK-2558	273	274	1	1	3	4	1	0
ARK-2558	273	290	17	1	3	1	0	0
ARK-2558	273	274	1	1	4	5	2	0
ARK-2558	273	477	204	0	3	5	0	1
ARK-2558	273	477	204	0	3	1	0	0
ARK-2558	273	275	2	1	4	1	1	0
ARK-2558	273	385	112	1	3	1	0	1
ARK-2558	273	477	204	0	3	1	0	0
ARK-2558	273	275	2	1	3	2	1	0
ARK-2559	274	477	203	0	3	1	1	0
ARK-2559	274	280	6	1	1	1	3	0
ARK-2559	274	275	1	1	3	4	1	0
ARK-2559	274	477	203	0	3	1	0	0
ARK-2559	274	477	203	0	3	1	0	0
ARK-2559	274	275	1	1	3	4	1	0
ARK-2559	274	364	90	1	3	5	0	1
ARK-2559	274	275	1	1	3	1	0	1
ARK-2559	274	283	9	1	3	3	1	0
ARK-2559	274	324	50	1	4	2	0	1
ARK-2560	275	278	3	1	4	1	1	0
ARK-2560	275	276	1	1	3	5	2	0
ARK-2560	275	276	1	1	3	1	1	0
ARK-2560	275	477	202	0	3	2	0	0
ARK-2560	275	477	202	0	3	5	0	0
ARK-2560	275	277	2	1	3	5	1	0
ARK-2560	275	277	2	1	3	5	1	0
ARK-2560	275	477	202	0	3	5	0	0
ARK-2560	275	477	202	0	3	5	0	0
ARK-2560	275	277	2	1	3	5	1	0
ARK-2561	275	278	3	1	3	5	1	0
ARK-2561	275	282	7	1	3	5	1	0
ARK-2561	275	282	7	1	3	5	1	0
ARK-2561	275	477	202	0	3	5	0	0
ARK-2561	275	477	202	0	3	5	0	0
ARK-2561	275	283	8	1	3	5	1	0
ARK-2561	275	477	202	0	3	5	0	0
ARK-2561	275	477	202	0	3	5	0	0
ARK-2561	275	303	28	1	3	5	1	0
ARK-2561	275	477	202	0	3	5	0	0
ARK-2562	275	477	202	0	3	5	0	0
ARK-2562	275	278	3	1	3	5	1	0
ARK-2562	275	278	3	1	3	5	1	0
ARK-2562	275	281	6	1	3	5	1	0
ARK-2562	275	281	6	1	3	5	1	0
ARK-2562	275	281	6	1	3	5	1	0
ARK-2562	275	277	2	1	3	5	1	0
ARK-2562	275	294	19	1	3	5	1	0
ARK-2562	275	477	202	0	3	5	0	0
ARK-2562	275	288	13	1	3	5	1	0
ARK-2563	275	280	5	1	3	5	1	0
ARK-2563	275	288	13	1	3	5	1	0
ARK-2563	275	288	13	1	3	5	1	0
ARK-2563	275	426	151	1	3	4	0	0
ARK-2563	275	477	202	0	4	4	0	0
ARK-2563	275	277	2	1	3	2	2	1
ARK-2563	275	282	7	1	4	1	1	0
ARK-2563	275	477	202	0	4	4	0	0
ARK-2563	276	307	31	1	4	4	1	0
ARK-2563	276	280	4	1	1	4	1	0
ARK-2564	276	477	201	0	3	5	0	0
ARK-2564	276	280	4	1	4	4	1	1
ARK-2564	276	354	78	1	4	4	1	0
ARK-2564	276	477	201	0	3	4	0	2
ARK-2564	276	277	1	1	1	1	1	0
ARK-2564	276	277	1	1	3	4	0	1
ARK-2564	276	278	2	1	4	1	1	0
ARK-2564	277	477	200	0	3	4	0	0
ARK-2564	277	301	24	1	3	1	0	0
ARK-2564	277	280	3	1	4	1	0	0
ARK-2565	277	409	132	1	3	3	0	0
ARK-2565	277	280	3	1	3	1	0	0
ARK-2565	277	477	200	0	3	1	0	0
ARK-2565	277	278	1	1	3	4	1	0
ARK-2565	277	477	200	0	4	1	0	1
ARK-2565	277	278	1	1	3	1	1	0
ARK-2565	277	295	18	1	3	5	2	0
ARK-2565	278	279	1	1	3	5	1	0
ARK-2565	278	279	1	1	3	5	1	0
ARK-2565	278	280	2	1	4	5	1	0
ARK-2566	278	284	6	1	4	1	1	0
ARK-2566	278	303	25	1	3	5	1	1
ARK-2566	278	283	5	1	3	5	1	0
ARK-2566	278	303	25	1	3	5	1	1
ARK-2566	278	284	6	1	3	5	1	0
ARK-2566	278	297	19	1	3	5	1	0
ARK-2566	278	280	2	1	4	5	1	1
ARK-2566	278	477	199	0	3	5	0	0
ARK-2566	278	477	199	0	3	5	0	0
ARK-2566	278	281	3	1	4	1	2	0
ARK-2567	278	284	6	1	5	5	1	0
ARK-2567	278	279	1	1	3	1	1	0
ARK-2567	279	304	25	1	4	4	1	0
ARK-2567	280	281	1	1	4	5	2	0
ARK-2567	280	283	3	1	4	1	2	0
ARK-2567	280	293	13	1	3	1	1	0
ARK-2567	280	309	29	1	3	5	1	0
ARK-2567	280	281	1	1	3	1	1	0
ARK-2567	280	324	44	1	3	2	0	0
ARK-2567	280	284	4	1	3	5	0	0
ARK-2568	280	289	9	1	3	1	1	0
ARK-2568	280	477	197	0	3	4	0	0
ARK-2568	280	290	10	1	4	1	1	0
ARK-2568	281	290	9	1	5	4	1	0
ARK-2568	281	284	3	1	3	4	1	0
ARK-2568	281	284	3	1	4	1	1	0
ARK-2568	281	283	2	1	4	4	0	1
ARK-2568	281	477	196	0	4	1	0	0
ARK-2568	281	282	1	1	2	1	0	3
ARK-2568	281	371	90	1	4	4	1	0
ARK-2569	281	284	3	1	3	5	1	1
ARK-2569	281	303	22	1	3	5	1	0
ARK-2569	281	400	119	1	1	1	1	1
ARK-2569	281	288	7	1	4	4	0	1
ARK-2569	281	477	196	0	4	1	0	0
ARK-2569	282	477	195	0	3	1	0	0
ARK-2569	282	344	62	1	3	4	1	0
ARK-2569	282	284	2	1	3	1	1	0
ARK-2569	282	477	195	0	3	1	0	0
ARK-2569	282	283	1	1	3	4	1	0
ARK-2570	282	283	1	1	2	5	1	1
ARK-2570	282	477	195	0	4	4	0	0
ARK-2570	282	283	1	1	3	4	0	0
ARK-2570	282	283	1	1	3	4	0	0
ARK-2570	282	291	9	1	3	1	1	3
ARK-2570	282	288	6	1	3	3	1	0
ARK-2570	283	284	1	1	3	1	0	0
ARK-2570	283	477	194	0	4	1	0	0
ARK-2570	283	284	1	1	3	1	1	0
ARK-2570	283	284	1	1	3	1	0	1
ARK-2571	283	285	2	1	3	1	1	0
ARK-2571	283	285	2	1	4	4	1	0
ARK-2571	283	284	1	1	4	4	1	0
ARK-2571	283	388	105	1	4	4	1	0
ARK-2571	283	285	2	1	1	1	3	0
ARK-2571	284	477	193	0	3	4	0	0
ARK-2571	284	287	3	1	4	4	1	0
ARK-2571	284	477	193	0	3	1	0	0
ARK-2571	284	285	1	1	3	5	1	0
ARK-2571	284	477	193	0	4	4	0	1
ARK-2572	284	385	101	1	4	4	0	0
ARK-2572	284	477	193	0	3	1	0	0
ARK-2572	285	477	192	0	4	4	0	0
ARK-2572	285	301	16	1	4	5	0	0
ARK-2572	285	477	192	0	3	5	0	0
ARK-2572	285	477	192	0	3	5	0	0
ARK-2572	285	286	1	1	4	1	3	2
ARK-2572	285	286	1	1	3	1	1	0
ARK-2572	286	477	191	0	3	2	0	0
ARK-2572	287	329	42	1	4	4	0	0
ARK-2573	287	293	6	1	3	1	1	0
ARK-2573	287	289	2	1	3	4	0	1
ARK-2573	287	477	190	0	3	4	0	0
ARK-2573	287	426	139	1	3	1	0	1
ARK-2573	287	289	2	1	4	4	1	0
ARK-2573	287	289	2	1	4	1	1	0
ARK-2573	287	288	1	1	4	5	2	0
ARK-2573	287	296	9	1	4	3	1	0
ARK-2573	287	288	1	1	1	1	1	1
ARK-2573	287	289	2	1	3	1	0	1
ARK-2574	288	477	189	0	3	1	0	1
ARK-2574	288	289	1	1	4	1	1	0
ARK-2574	288	289	1	1	4	5	0	0
ARK-2574	288	477	189	0	3	1	0	0
ARK-2574	288	331	43	1	4	4	0	1
ARK-2574	288	291	3	1	3	1	1	0
ARK-2574	288	297	9	1	3	4	1	0
ARK-2574	288	293	5	1	3	4	1	0
ARK-2574	288	289	1	1	3	1	0	0
ARK-2574	288	289	1	1	3	1	0	0
ARK-2575	288	477	189	0	3	5	0	2
ARK-2575	288	389	101	1	3	5	0	2
ARK-2575	288	477	189	0	4	4	0	0
ARK-2575	289	294	5	1	4	1	1	1
ARK-2575	289	290	1	1	5	4	2	0
ARK-2575	289	302	13	1	4	4	1	0
ARK-2575	289	477	188	0	3	1	0	0
ARK-2575	289	293	4	1	4	5	1	1
ARK-2575	289	308	19	1	4	3	1	2
ARK-2575	289	477	188	0	3	1	0	0
ARK-2576	290	291	1	1	4	4	1	0
ARK-2576	290	291	1	1	3	1	0	0
ARK-2576	290	456	166	1	3	5	0	1
ARK-2576	290	291	1	1	3	5	1	0
ARK-2576	290	308	18	1	3	4	1	1
ARK-2576	290	365	75	1	3	4	1	0
ARK-2576	290	408	118	1	5	1	0	0
ARK-2576	290	301	11	1	3	1	3	0
ARK-2576	290	291	1	1	3	1	2	0
ARK-2576	290	477	187	0	3	1	0	0
ARK-2577	290	477	187	0	4	4	0	0
ARK-2577	290	294	4	1	3	1	1	0
ARK-2577	290	296	6	1	3	1	1	1
ARK-2577	290	302	12	1	3	4	1	1
ARK-2577	290	477	187	0	3	4	0	0
ARK-2577	290	477	187	0	3	1	0	0
ARK-2577	291	307	16	1	4	1	1	0
ARK-2577	291	477	186	0	3	4	0	1
ARK-2577	291	317	26	1	3	4	2	1
ARK-2577	291	293	2	1	5	5	1	0
ARK-2578	291	477	186	0	4	4	0	0
ARK-2578	291	477	186	0	4	2	0	0
ARK-2578	291	477	186	0	4	2	0	0
ARK-2578	291	477	186	0	4	1	0	0
ARK-2578	292	477	185	0	3	4	0	1
ARK-2578	292	293	1	1	5	4	1	0
ARK-2578	292	327	35	1	4	1	3	0
ARK-2578	292	301	9	1	3	1	0	0
ARK-2578	292	477	185	0	3	2	0	0
ARK-2578	292	477	185	0	3	2	0	0
ARK-2579	292	302	10	1	3	4	1	0
ARK-2579	293	295	2	1	3	1	1	0
ARK-2579	293	477	184	0	3	1	0	1
ARK-2579	294	298	4	1	3	1	1	0
ARK-2579	294	295	1	1	3	5	0	0
ARK-2579	294	295	1	1	4	1	2	0
ARK-2579	294	295	1	1	3	4	0	1
ARK-2579	294	301	7	1	3	1	3	4
ARK-2579	294	296	2	1	4	5	1	1
ARK-2579	294	319	25	1	3	1	1	0
ARK-2580	294	295	1	1	4	3	0	0
ARK-2580	294	295	1	1	3	1	1	0
ARK-2580	294	477	183	0	3	2	0	0
ARK-2580	294	297	3	1	4	1	1	0
ARK-2580	295	477	182	0	3	1	0	0
ARK-2580	295	296	1	1	4	5	1	0
ARK-2580	295	300	5	1	5	4	1	0
ARK-2580	295	297	2	1	4	4	0	0
ARK-2580	295	297	2	1	5	4	1	0
ARK-2580	295	304	9	1	3	4	0	1
ARK-2581	295	477	182	0	5	1	0	0
ARK-2581	295	386	91	1	3	4	1	0
ARK-2581	295	296	1	1	3	1	1	1
ARK-2581	295	296	1	1	3	1	0	0
ARK-2581	295	425	130	1	3	1	0	1
ARK-2581	295	351	56	1	3	2	1	2
ARK-2581	295	301	6	1	2	1	2	0
ARK-2581	296	300	4	1	3	1	1	0
ARK-2581	296	313	17	1	3	4	0	0
ARK-2581	296	298	2	1	3	5	1	0
ARK-2582	296	297	1	1	4	1	0	1
ARK-2582	296	298	2	1	3	3	1	0
ARK-2582	296	298	2	1	3	1	2	0
ARK-2582	296	407	111	1	2	1	0	1
ARK-2582	296	331	35	1	4	5	0	1
ARK-2582	296	389	93	1	3	2	0	1
ARK-2582	296	477	181	0	3	5	0	4
ARK-2582	296	305	9	1	3	1	2	2
ARK-2582	296	298	2	1	4	4	1	0
ARK-2582	297	331	34	1	3	1	1	2
ARK-2583	297	331	34	1	3	5	0	0
ARK-2583	297	331	34	1	3	5	0	0
ARK-2583	297	298	1	1	1	1	1	1
ARK-2583	297	303	6	1	4	5	1	1
ARK-2583	297	477	180	0	4	1	0	0
ARK-2583	297	298	1	1	4	1	1	1
ARK-2583	297	298	1	1	4	3	1	1
ARK-2583	297	304	7	1	4	1	3	1
ARK-2583	297	432	135	1	5	3	1	0
ARK-2583	297	313	16	1	4	4	1	0
ARK-2584	297	298	1	1	3	1	1	0
ARK-2584	297	477	180	0	3	5	0	2
ARK-2584	297	298	1	1	3	5	1	1
ARK-2584	297	477	180	0	3	5	0	1
ARK-2584	297	477	180	0	3	5	0	1
ARK-2584	297	300	3	1	3	5	1	0
ARK-2584	298	299	1	1	3	4	0	1
ARK-2584	298	303	5	1	3	5	1	0
ARK-2584	298	302	4	1	3	5	1	0
ARK-2584	298	477	179	0	4	5	0	0
ARK-2585	298	308	10	1	3	1	1	0
ARK-2585	298	299	1	1	5	4	1	0
ARK-2585	298	307	9	1	5	4	0	0
ARK-2585	298	426	128	1	3	1	0	0
ARK-2585	298	299	1	1	2	1	4	0
ARK-2585	298	303	5	1	3	4	1	2
ARK-2585	298	301	3	1	4	4	1	0
ARK-2585	298	379	81	1	4	4	1	0
ARK-2585	298	299	1	1	3	2	0	3
ARK-2585	299	300	1	1	3	4	1	0
ARK-2586	299	303	4	1	3	4	1	0
ARK-2586	299	305	6	1	5	4	1	0
ARK-2586	300	303	3	1	3	5	1	0
ARK-2586	301	430	129	1	3	1	3	0
ARK-2586	301	302	1	1	3	5	1	0
ARK-2586	301	427	126	1	3	5	1	0
ARK-2586	301	309	8	1	4	1	2	0
ARK-2586	301	325	24	1	3	3	1	1
ARK-2586	301	317	16	1	4	4	1	0
ARK-2586	301	477	176	0	3	1	0	0
ARK-2587	301	302	1	1	4	1	0	0
ARK-2587	301	309	8	1	3	4	1	2
ARK-2587	301	477	176	0	3	4	0	0
ARK-2587	301	368	67	1	3	1	0	1
ARK-2587	301	477	176	0	3	5	0	4
ARK-2587	301	305	4	1	3	4	0	2
ARK-2587	301	334	33	1	3	4	1	1
ARK-2587	301	345	44	1	3	4	1	1
ARK-2587	301	477	176	0	4	4	0	1
ARK-2587	302	303	1	1	3	1	0	2
ARK-2588	302	477	175	0	3	1	0	0
ARK-2588	302	303	1	1	4	4	0	0
ARK-2588	302	308	6	1	4	4	0	0
ARK-2588	302	303	1	1	4	5	2	1
ARK-2588	302	304	2	1	3	4	1	0
ARK-2588	302	310	8	1	4	4	1	0
ARK-2588	302	303	1	1	4	4	1	0
ARK-2588	302	386	84	1	3	4	1	0
ARK-2588	302	477	175	0	3	2	0	0
ARK-2588	302	477	175	0	3	2	0	0
ARK-2589	302	308	6	1	3	1	0	0
ARK-2589	303	304	1	1	3	4	1	0
ARK-2589	303	360	57	1	5	4	1	0
ARK-2589	303	304	1	1	4	4	1	0
ARK-2589	303	477	174	0	4	4	0	0
ARK-2589	303	313	10	1	4	5	0	0
ARK-2589	303	477	174	0	3	1	0	0
ARK-2589	303	310	7	1	3	4	1	0
ARK-2589	303	477	174	0	3	1	0	0
ARK-2589	303	304	1	1	3	5	2	0
ARK-2590	303	308	5	1	4	4	1	0
ARK-2590	303	306	3	1	3	1	1	0
ARK-2590	303	477	174	0	3	4	0	0
ARK-2590	303	477	174	0	3	1	0	0
ARK-2590	303	310	7	1	3	4	2	1
ARK-2590	303	332	29	1	3	4	1	0
ARK-2590	304	309	5	1	3	1	2	1
ARK-2590	304	477	173	0	3	1	0	0
ARK-2590	304	311	7	1	3	3	1	0
ARK-2590	304	305	1	1	5	1	2	0
ARK-2591	304	360	56	1	3	1	0	1
ARK-2591	304	425	121	1	4	4	0	0
ARK-2591	304	305	1	1	3	1	0	0
ARK-2591	304	308	4	1	4	4	1	0
ARK-2591	304	477	173	0	3	1	0	1
ARK-2591	304	477	173	0	3	5	0	0
ARK-2591	304	477	173	0	3	5	0	0
ARK-2591	304	407	103	1	3	4	0	0
ARK-2591	304	305	1	1	3	1	2	0
ARK-2591	304	338	34	1	3	1	0	1
ARK-2592	304	477	173	0	4	4	0	1
ARK-2592	304	316	12	1	2	1	2	0
ARK-2592	304	410	106	1	3	1	2	0
ARK-2592	305	306	1	1	1	1	0	0
ARK-2592	305	316	11	1	3	4	0	0
ARK-2592	305	477	172	0	3	1	0	0
ARK-2592	305	309	4	1	3	4	1	0
ARK-2592	305	477	172	0	4	4	0	0
ARK-2592	305	425	120	1	3	1	0	0
ARK-2592	305	477	172	0	3	4	0	0
ARK-2593	305	308	3	1	4	1	2	0
ARK-2593	306	307	1	1	4	5	1	0
ARK-2593	306	307	1	1	2	5	0	0
ARK-2593	306	307	1	1	5	5	3	0
ARK-2593	306	319	13	1	3	1	3	2
ARK-2593	307	379	72	1	4	4	1	0
ARK-2593	307	477	170	0	3	1	0	0
ARK-2593	307	477	170	0	3	4	0	0
ARK-2593	307	308	1	1	4	1	0	0
ARK-2593	308	364	56	1	3	5	0	0
ARK-2594	308	477	169	0	4	4	0	0
ARK-2594	308	425	117	1	3	1	0	0
ARK-2594	308	316	8	1	3	1	1	0
ARK-2594	308	477	169	0	3	1	0	0
ARK-2594	308	309	1	1	4	5	1	0
ARK-2594	308	312	4	1	4	4	1	0
ARK-2594	308	309	1	1	3	5	1	0
ARK-2594	309	316	7	1	3	4	1	0
ARK-2594	309	477	168	0	3	1	0	0
ARK-2594	309	315	6	1	3	5	0	1
ARK-2595	309	310	1	1	3	1	1	0
ARK-2595	309	477	168	0	4	4	0	0
ARK-2595	309	311	2	1	3	1	1	0
ARK-2595	309	355	46	1	2	5	0	0
ARK-2595	309	324	15	1	3	5	1	2
ARK-2595	309	311	2	1	4	5	1	0
ARK-2595	309	318	9	1	3	5	1	0
ARK-2595	310	324	14	1	3	4	1	2
ARK-2595	310	312	2	1	3	1	0	0
ARK-2595	310	320	10	1	3	1	1	0
ARK-2596	310	329	19	1	3	2	1	0
ARK-2596	310	312	2	1	3	1	0	0
ARK-2596	310	311	1	1	3	5	1	0
ARK-2596	310	477	167	0	4	4	0	0
ARK-2596	310	311	1	1	5	4	1	0
ARK-2596	310	317	7	1	4	5	1	0
ARK-2596	310	477	167	0	3	1	0	0
ARK-2596	310	311	1	1	4	4	0	0
ARK-2596	311	312	1	1	3	1	0	0
ARK-2596	311	312	1	1	3	1	0	0
ARK-2597	311	353	42	1	5	4	0	0
ARK-2597	311	312	1	1	4	4	1	0
ARK-2597	311	314	3	1	5	4	1	0
ARK-2597	311	312	1	1	4	4	1	0
ARK-2597	311	318	7	1	3	4	1	0
ARK-2597	311	312	1	1	4	4	0	1
ARK-2597	311	312	1	1	4	4	0	0
ARK-2597	311	333	22	1	4	4	1	0
ARK-2597	311	477	166	0	5	1	0	0
ARK-2597	311	312	1	1	4	1	2	0
ARK-2598	311	312	1	1	3	5	0	0
ARK-2598	311	391	80	1	3	5	1	0
ARK-2598	311	432	121	1	3	1	0	0
ARK-2598	311	477	166	0	4	1	0	1
ARK-2598	311	313	2	1	4	5	1	0
ARK-2598	312	477	165	0	3	5	0	0
ARK-2598	312	317	5	1	3	4	1	0
ARK-2598	312	477	165	0	3	1	0	0
ARK-2598	312	313	1	1	3	1	2	0
ARK-2598	312	331	19	1	4	1	1	0
ARK-2599	312	477	165	0	3	1	0	0
ARK-2599	312	313	1	1	3	2	0	0
ARK-2599	312	380	68	1	3	1	2	0
ARK-2599	312	477	165	0	3	1	0	0
ARK-2599	312	477	165	0	3	5	0	1
ARK-2599	312	477	165	0	4	1	0	0
ARK-2599	312	313	1	1	3	1	0	0
ARK-2599	312	396	84	1	4	5	1	0
ARK-2599	312	331	19	1	3	4	1	0
ARK-2599	312	337	25	1	3	1	0	0
ARK-2600	313	314	1	1	3	1	0	0
ARK-2600	313	477	164	0	3	4	0	0
ARK-2600	313	372	59	1	3	1	1	0
ARK-2600	313	316	3	1	5	4	1	1
ARK-2600	314	432	118	1	3	4	1	0
ARK-2600	314	315	1	1	3	1	1	0
ARK-2600	314	320	6	1	4	4	1	0
ARK-2600	314	316	2	1	4	1	1	0
ARK-2600	314	316	2	1	3	5	0	0
ARK-2600	314	316	2	1	3	5	0	0
ARK-2601	314	316	2	1	3	5	3	0
ARK-2601	315	318	3	1	3	1	3	0
ARK-2601	315	464	149	1	3	1	1	0
ARK-2601	315	316	1	1	4	4	1	0
ARK-2601	315	318	3	1	3	4	1	0
ARK-2601	315	332	17	1	3	4	1	0
ARK-2601	315	427	112	1	3	4	1	0
ARK-2601	315	425	110	1	3	1	0	0
ARK-2601	315	318	3	1	3	4	0	0
ARK-2601	315	367	52	1	3	1	2	2
ARK-2602	315	477	162	0	3	1	0	1
ARK-2602	315	326	11	1	2	1	1	0
ARK-2602	315	477	162	0	3	5	0	0
ARK-2602	315	316	1	1	4	5	1	0
ARK-2602	315	322	7	1	3	1	1	0
ARK-2602	315	330	15	1	4	4	1	1
ARK-2602	315	322	7	1	3	5	1	0
ARK-2602	315	319	4	1	4	1	0	0
ARK-2602	316	477	161	0	3	2	0	1
ARK-2602	316	317	1	1	3	5	1	0
ARK-2603	316	317	1	1	3	5	1	0
ARK-2603	316	319	3	1	3	1	0	0
ARK-2603	316	317	1	1	3	5	1	0
ARK-2603	316	321	5	1	3	5	1	0
ARK-2603	316	319	3	1	3	5	1	0
ARK-2603	316	318	2	1	3	5	1	0
ARK-2603	316	318	2	1	3	5	1	0
ARK-2603	316	317	1	1	3	1	0	0
ARK-2603	316	326	10	1	3	1	1	0
ARK-2603	316	477	161	0	4	1	0	0
ARK-2604	316	319	3	1	3	1	0	1
ARK-2604	316	319	3	1	3	1	0	4
ARK-2604	316	317	1	1	3	5	2	0
ARK-2604	316	322	6	1	4	4	1	0
ARK-2604	316	318	2	1	4	1	1	0
ARK-2604	316	477	161	0	3	1	0	0
ARK-2604	316	477	161	0	3	3	0	0
ARK-2604	316	380	64	1	3	1	0	0
ARK-2604	316	425	109	1	3	1	2	0
ARK-2604	317	329	12	1	4	4	0	0
ARK-2605	317	319	2	1	3	4	0	0
ARK-2605	317	343	26	1	4	1	0	0
ARK-2605	317	477	160	0	4	4	0	0
ARK-2605	317	318	1	1	3	4	0	0
ARK-2605	317	318	1	1	4	1	0	0
ARK-2605	317	318	1	1	3	4	1	0
ARK-2605	317	477	160	0	3	1	0	0
ARK-2605	317	318	1	1	3	1	2	1
ARK-2605	317	477	160	0	4	4	0	0
ARK-2605	317	332	15	1	3	1	0	0
ARK-2606	317	333	16	1	3	4	1	0
ARK-2606	317	477	160	0	5	4	0	0
ARK-2606	317	477	160	0	4	4	0	0
ARK-2606	317	319	2	1	3	1	0	1
ARK-2606	317	331	14	1	3	5	0	0
ARK-2606	317	371	54	1	3	4	1	1
ARK-2606	317	324	7	1	4	5	1	0
ARK-2606	318	319	1	1	3	1	0	0
ARK-2606	318	322	4	1	3	1	1	0
ARK-2606	318	319	1	1	3	5	2	0
ARK-2607	318	477	159	0	3	1	0	0
ARK-2607	318	322	4	1	3	1	1	0
ARK-2607	318	319	1	1	3	4	0	1
ARK-2607	318	319	1	1	3	4	1	1
ARK-2607	318	319	1	1	3	1	2	0
ARK-2607	318	477	159	0	3	1	0	0
ARK-2607	318	323	5	1	5	4	1	0
ARK-2607	318	477	159	0	3	1	0	0
ARK-2607	318	349	31	1	1	1	3	0
ARK-2607	318	323	5	1	4	1	2	0
ARK-2608	318	335	17	1	1	1	2	2
ARK-2608	318	332	14	1	4	4	1	0
ARK-2608	318	402	84	1	3	1	3	2
ARK-2608	318	336	18	1	4	1	1	0
ARK-2608	318	323	5	1	3	1	3	0
ARK-2608	319	325	6	1	3	1	1	0
ARK-2608	319	477	158	0	3	1	0	0
ARK-2608	319	477	158	0	4	1	0	0
ARK-2608	319	477	158	0	4	4	0	1
ARK-2608	319	435	116	1	3	4	1	1
ARK-2609	319	322	3	1	4	4	1	0
ARK-2609	319	320	1	1	4	4	1	0
ARK-2609	319	320	1	1	3	1	2	0
ARK-2609	319	320	1	1	3	1	0	0
ARK-2609	319	337	18	1	1	4	1	1
ARK-2609	319	320	1	1	2	1	1	0
ARK-2609	319	331	12	1	3	3	0	1
ARK-2609	320	477	157	0	3	4	0	0
ARK-2609	320	346	26	1	3	4	1	0
ARK-2609	320	325	5	1	4	4	1	0
ARK-2610	320	329	9	1	3	1	2	0
ARK-2610	320	407	87	1	3	1	0	0
ARK-2610	320	324	4	1	4	5	0	0
ARK-2610	320	436	116	1	3	1	1	1
ARK-2610	320	477	157	0	3	4	0	0
ARK-2610	321	322	1	1	3	5	1	0
ARK-2610	321	325	4	1	4	5	1	0
ARK-2610	321	323	2	1	3	4	1	0
ARK-2610	321	326	5	1	3	5	1	1
ARK-2610	321	324	3	1	4	1	3	0
ARK-2611	322	477	155	0	3	1	0	0
ARK-2611	322	477	155	0	3	4	0	0
ARK-2611	322	323	1	1	3	1	1	0
ARK-2611	322	323	1	1	3	1	0	1
ARK-2611	322	331	9	1	3	1	2	0
ARK-2611	322	323	1	1	4	4	0	0
ARK-2611	322	477	155	0	3	1	0	0
ARK-2611	322	326	4	1	3	4	1	0
ARK-2611	322	323	1	1	3	2	4	0
ARK-2611	322	337	15	1	3	1	2	0
ARK-2612	322	324	2	1	4	5	3	0
ARK-2612	322	329	7	1	4	4	1	0
ARK-2612	322	324	2	1	3	4	1	0
ARK-2612	322	477	155	0	3	5	0	0
ARK-2612	323	324	1	1	4	4	1	0
ARK-2612	323	407	84	1	4	1	1	1
ARK-2612	323	371	48	1	4	1	0	0
ARK-2612	323	324	1	1	5	3	1	0
ARK-2612	323	425	102	1	4	1	0	0
ARK-2612	323	324	1	1	3	5	1	0
ARK-2613	323	477	154	0	4	4	0	1
ARK-2613	323	477	154	0	3	1	0	0
ARK-2613	323	448	125	1	3	4	1	0
ARK-2613	324	332	8	1	3	4	1	0
ARK-2613	324	325	1	1	3	5	1	0
ARK-2613	324	477	153	0	3	4	0	0
ARK-2613	324	325	1	1	3	1	0	0
ARK-2613	324	331	7	1	3	1	3	0
ARK-2613	324	477	153	0	4	4	0	0
ARK-2613	324	343	19	1	3	2	1	1
ARK-2614	324	326	2	1	3	5	1	0
ARK-2614	324	330	6	1	3	5	1	0
ARK-2614	324	331	7	1	3	5	1	0
ARK-2614	324	477	153	0	3	2	0	0
ARK-2614	325	326	1	1	3	1	1	0
ARK-2614	325	329	4	1	3	1	0	1
ARK-2614	325	425	100	1	3	1	0	0
ARK-2614	325	331	6	1	3	1	2	0
ARK-2614	325	328	3	1	3	5	1	0
ARK-2614	325	337	12	1	3	1	0	0
ARK-2615	325	477	152	0	3	1	0	0
ARK-2615	325	336	11	1	4	4	1	0
ARK-2615	326	437	111	1	2	1	1	1
ARK-2615	326	329	3	1	4	4	1	0
ARK-2615	326	477	151	0	1	1	0	1
ARK-2615	326	369	43	1	3	4	0	1
ARK-2615	326	327	1	1	4	4	1	0
ARK-2615	326	329	3	1	3	1	0	0
ARK-2615	326	332	6	1	4	4	1	0
ARK-2615	326	331	5	1	3	1	1	0
ARK-2616	327	343	16	1	4	4	0	1
ARK-2616	327	335	8	1	4	4	1	0
ARK-2616	327	425	98	1	3	1	0	0
ARK-2616	327	332	5	1	3	4	1	0
ARK-2616	328	477	149	0	4	5	0	0
ARK-2616	328	335	7	1	3	4	0	0
ARK-2616	328	477	149	0	3	1	0	0
ARK-2616	328	329	1	1	3	1	0	0
ARK-2616	328	329	1	1	3	5	1	0
ARK-2616	328	329	1	1	3	5	1	0
ARK-2617	329	389	60	1	3	4	1	0
ARK-2617	329	330	1	1	3	5	0	0
ARK-2617	329	372	43	1	3	4	0	0
ARK-2617	329	477	148	0	4	2	0	0
ARK-2617	329	477	148	0	3	1	0	0
ARK-2617	329	477	148	0	3	1	0	0
ARK-2617	329	442	113	1	4	4	1	0
ARK-2617	329	332	3	1	3	4	1	0
ARK-2617	329	337	8	1	3	5	1	1
ARK-2617	330	477	147	0	3	1	0	0
ARK-2618	330	334	4	1	4	4	1	0
ARK-2618	330	336	6	1	3	1	2	0
ARK-2618	330	477	147	0	3	4	0	0
ARK-2618	330	425	95	1	3	1	0	0
ARK-2618	330	332	2	1	3	1	2	0
ARK-2618	330	477	147	0	4	4	0	0
ARK-2618	330	332	2	1	3	1	2	0
ARK-2618	330	389	59	1	3	1	0	1
ARK-2618	330	333	3	1	2	1	2	1
ARK-2618	330	334	4	1	4	5	1	0
ARK-2619	330	331	1	1	3	4	0	0
ARK-2619	330	360	30	1	4	5	1	0
ARK-2619	330	427	97	1	4	4	1	1
ARK-2619	330	342	12	1	3	5	1	0
ARK-2619	331	339	8	1	3	4	1	1
ARK-2619	331	335	4	1	4	1	1	0
ARK-2619	331	340	9	1	3	1	1	0
ARK-2619	331	477	146	0	3	1	0	0
ARK-2619	331	335	4	1	4	1	3	0
ARK-2619	331	477	146	0	4	1	0	0
ARK-2620	331	333	2	1	3	1	0	1
ARK-2620	331	333	2	1	3	1	3	0
ARK-2620	331	477	146	0	3	4	0	0
ARK-2620	331	379	48	1	3	5	1	0
ARK-2620	331	477	146	0	3	4	0	0
ARK-2620	331	427	96	1	3	4	1	0
ARK-2620	331	477	146	0	3	1	0	0
ARK-2620	331	344	13	1	4	5	1	1
ARK-2620	331	335	4	1	4	1	1	1
ARK-2620	331	477	146	0	4	4	0	1
ARK-2621	332	334	2	1	2	5	0	0
ARK-2621	332	333	1	1	3	1	3	0
ARK-2621	332	334	2	1	4	4	1	0
ARK-2621	332	339	7	1	3	2	0	0
ARK-2621	332	425	93	1	5	5	0	0
ARK-2621	332	417	85	1	3	5	1	3
ARK-2621	332	335	3	1	3	5	1	0
ARK-2621	332	477	145	0	3	5	0	0
ARK-2621	332	477	145	0	3	5	0	0
ARK-2621	332	333	1	1	3	1	2	0
ARK-2622	332	477	145	0	3	1	0	0
ARK-2622	332	477	145	0	3	5	0	1
ARK-2622	332	477	145	0	3	5	0	1
ARK-2622	332	477	145	0	3	5	0	0
ARK-2622	332	456	124	1	4	1	1	0
ARK-2622	332	477	145	0	3	5	0	0
ARK-2622	332	334	2	1	3	5	1	0
ARK-2622	333	366	33	1	4	4	1	1
ARK-2622	333	387	54	1	3	1	3	1
ARK-2622	333	425	92	1	4	1	0	0
ARK-2623	333	336	3	1	4	4	1	0
ARK-2623	333	337	4	1	3	1	0	1
ARK-2623	333	334	1	1	3	4	0	0
ARK-2623	333	337	4	1	1	1	4	0
ARK-2623	333	334	1	1	3	1	0	1
ARK-2623	333	336	3	1	5	4	1	0
ARK-2623	333	339	6	1	3	2	1	0
ARK-2623	333	334	1	1	3	1	0	0
ARK-2623	333	477	144	0	3	4	0	0
ARK-2623	333	344	11	1	3	2	1	1
ARK-2624	333	408	75	1	3	1	0	0
ARK-2624	334	335	1	1	3	5	1	0
ARK-2624	334	335	1	1	4	1	0	0
ARK-2624	334	349	15	1	3	5	1	0
ARK-2624	335	339	4	1	3	4	0	0
ARK-2624	335	341	6	1	3	4	0	0
ARK-2624	335	351	16	1	4	4	1	0
ARK-2624	335	477	142	0	3	4	0	0
ARK-2624	335	360	25	1	4	4	0	0
ARK-2624	336	477	141	0	3	4	0	0
ARK-2625	336	337	1	1	3	5	0	0
ARK-2625	336	338	2	1	4	1	0	0
ARK-2625	336	338	2	1	3	5	1	0
ARK-2625	336	337	1	1	4	1	1	1
ARK-2625	336	389	53	1	3	4	1	0
ARK-2625	336	350	14	1	3	1	1	0
ARK-2625	336	337	1	1	3	1	2	0
ARK-2625	336	477	141	0	3	4	0	0
ARK-2625	336	477	141	0	3	4	0	0
ARK-2625	336	337	1	1	3	1	0	1
ARK-2626	337	477	140	0	3	4	0	0
ARK-2626	337	432	95	1	4	1	0	0
ARK-2626	337	353	16	1	4	4	1	0
ARK-2626	337	340	3	1	3	4	1	0
ARK-2626	337	338	1	1	4	4	0	0
ARK-2626	337	344	7	1	3	1	2	0
ARK-2626	337	425	88	1	4	4	2	2
ARK-2626	337	372	35	1	1	1	2	1
ARK-2626	337	477	140	0	3	4	0	1
ARK-2626	338	354	16	1	4	1	2	0
ARK-2627	338	339	1	1	3	1	0	0
ARK-2627	338	477	139	0	3	4	0	0
ARK-2627	338	425	87	1	3	1	1	1
ARK-2627	338	339	1	1	4	4	0	0
ARK-2627	338	426	88	1	4	1	1	0
ARK-2627	338	339	1	1	4	5	1	1
ARK-2627	338	339	1	1	3	1	0	0
ARK-2627	338	366	28	1	3	5	1	0
ARK-2627	338	477	139	0	3	1	0	0
ARK-2627	338	407	69	1	3	4	0	0
ARK-2628	338	369	31	1	3	1	0	1
ARK-2628	338	340	2	1	4	1	1	0
ARK-2628	338	340	2	1	3	4	0	1
ARK-2628	338	342	4	1	3	1	1	0
ARK-2628	338	353	15	1	4	1	0	0
ARK-2628	339	355	16	1	4	4	1	0
ARK-2628	339	343	4	1	5	5	1	0
ARK-2628	339	343	4	1	4	4	1	0
ARK-2628	339	442	103	1	3	2	1	0
ARK-2628	339	340	1	1	3	4	1	0
ARK-2629	339	347	8	1	3	1	0	0
ARK-2629	339	346	7	1	3	4	0	0
ARK-2629	339	340	1	1	4	1	0	0
ARK-2629	339	344	5	1	3	1	2	0
ARK-2629	339	340	1	1	5	4	1	0
ARK-2629	339	477	138	0	3	1	0	0
ARK-2629	339	340	1	1	4	5	0	0
ARK-2629	339	346	7	1	3	4	1	0
ARK-2629	339	340	1	1	3	4	1	0
ARK-2629	340	477	137	0	3	1	0	0
ARK-2630	340	344	4	1	4	4	1	0
ARK-2630	340	477	137	0	2	2	0	0
ARK-2630	340	477	137	0	4	4	0	0
ARK-2630	340	344	4	1	4	4	1	0
ARK-2630	340	341	1	1	3	4	1	0
ARK-2630	340	477	137	0	3	4	0	0
ARK-2630	340	368	28	1	4	1	1	0
ARK-2630	340	343	3	1	3	1	3	0
ARK-2630	340	353	13	1	3	1	1	0
ARK-2630	340	477	137	0	3	4	0	0
ARK-2631	340	477	137	0	3	5	0	0
ARK-2631	341	353	12	1	3	4	0	1
ARK-2631	341	344	3	1	3	4	1	0
ARK-2631	342	346	4	1	3	4	1	0
ARK-2631	342	343	1	1	3	4	0	0
ARK-2631	343	348	5	1	4	1	3	0
ARK-2631	343	344	1	1	3	4	3	2
ARK-2631	343	344	1	1	3	1	1	0
ARK-2631	343	353	10	1	5	4	1	0
ARK-2631	343	344	1	1	4	4	1	0
ARK-2632	343	408	65	1	3	1	0	0
ARK-2632	343	477	134	0	3	4	0	0
ARK-2632	343	346	3	1	3	4	1	0
ARK-2632	343	372	29	1	3	1	1	0
ARK-2632	343	353	10	1	4	4	1	1
ARK-2632	343	477	134	0	3	1	0	0
ARK-2632	343	477	134	0	4	1	0	0
ARK-2632	343	344	1	1	3	5	4	0
ARK-2632	343	344	1	1	3	4	0	0
ARK-2632	343	477	134	0	3	4	0	1
ARK-2633	343	477	134	0	4	1	0	1
ARK-2633	344	346	2	1	4	4	0	0
ARK-2633	344	477	133	0	3	1	0	0
ARK-2633	344	345	1	1	3	1	0	0
ARK-2633	344	372	28	1	3	1	0	0
ARK-2633	344	346	2	1	3	4	0	0
ARK-2633	344	369	25	1	3	1	0	0
ARK-2633	344	347	3	1	3	5	1	0
ARK-2633	344	477	133	0	4	5	0	0
ARK-2633	344	370	26	1	4	1	1	0
ARK-2634	344	346	2	1	4	4	1	0
ARK-2634	344	477	133	0	3	5	0	0
ARK-2634	345	477	132	0	4	4	0	0
ARK-2634	345	438	93	1	5	4	1	0
ARK-2634	345	477	132	0	4	4	0	0
ARK-2634	345	477	132	0	3	5	0	0
ARK-2634	345	477	132	0	3	5	0	2
ARK-2634	345	424	79	1	4	4	0	0
ARK-2634	345	346	1	1	3	5	1	0
ARK-2634	345	372	27	1	1	4	1	1
ARK-2635	345	378	33	1	3	4	1	0
ARK-2635	345	385	40	1	4	1	3	0
ARK-2635	346	350	4	1	3	1	3	0
ARK-2635	346	413	67	1	4	4	1	0
ARK-2635	346	477	131	0	3	2	0	0
ARK-2635	346	347	1	1	3	1	2	0
ARK-2635	346	477	131	0	1	5	0	0
ARK-2635	346	477	131	0	3	4	0	1
ARK-2635	346	424	78	1	3	1	0	0
ARK-2635	346	368	22	1	3	1	0	0
ARK-2636	346	347	1	1	5	4	1	0
ARK-2636	346	477	131	0	3	1	0	0
ARK-2636	346	348	2	1	4	4	1	0
ARK-2636	346	363	17	1	4	4	1	0
ARK-2636	346	347	1	1	4	4	1	0
ARK-2636	346	477	131	0	4	1	0	0
ARK-2636	346	352	6	1	3	1	3	0
ARK-2636	346	351	5	1	3	4	0	0
ARK-2636	347	348	1	1	3	4	1	1
ARK-2636	347	348	1	1	3	5	0	0
ARK-2637	347	348	1	1	3	1	2	0
ARK-2637	347	350	3	1	4	4	1	0
ARK-2637	347	349	2	1	3	1	1	0
ARK-2637	347	477	130	0	4	2	0	0
ARK-2637	348	366	18	1	4	5	1	1
ARK-2637	348	352	4	1	3	4	0	0
ARK-2637	348	477	129	0	4	4	0	0
ARK-2637	348	352	4	1	3	1	0	0
ARK-2637	348	394	46	1	3	4	1	0
ARK-2637	349	391	42	1	3	1	3	0
ARK-2638	350	477	127	0	3	1	0	0
ARK-2638	350	352	2	1	3	1	0	0
ARK-2638	350	351	1	1	3	1	2	0
ARK-2638	350	371	21	1	4	4	1	0
ARK-2638	350	351	1	1	3	5	1	0
ARK-2638	350	477	127	0	3	1	0	0
ARK-2638	350	351	1	1	3	4	0	0
ARK-2638	350	424	74	1	3	1	0	0
ARK-2638	351	477	126	0	3	1	0	0
ARK-2638	351	403	52	1	4	4	1	0
ARK-2639	351	352	1	1	3	4	1	0
ARK-2639	351	352	1	1	3	5	0	0
ARK-2639	351	353	2	1	4	4	2	0
ARK-2639	351	352	1	1	4	1	0	0
ARK-2639	351	352	1	1	5	1	3	0
ARK-2639	351	424	73	1	3	1	0	2
ARK-2639	351	357	6	1	3	1	0	0
ARK-2639	351	477	126	0	3	5	1	0
ARK-2639	351	410	59	1	4	4	0	1
ARK-2639	351	477	126	0	3	5	0	0
ARK-2640	351	407	56	1	4	1	0	0
ARK-2640	351	407	56	1	3	1	0	0
ARK-2640	352	369	17	1	3	5	2	0
ARK-2640	352	367	15	1	4	1	1	0
ARK-2640	352	424	72	1	3	1	0	0
ARK-2640	352	357	5	1	3	1	0	0
ARK-2640	352	357	5	1	4	4	0	0
ARK-2640	352	424	72	1	3	1	0	0
ARK-2640	352	424	72	1	3	1	0	0
ARK-2640	352	353	1	1	3	4	2	0
ARK-2641	352	477	125	0	3	2	0	0
ARK-2641	352	477	125	0	3	1	0	0
ARK-2641	352	477	125	0	3	2	0	1
ARK-2641	352	477	125	0	4	4	0	2
ARK-2641	352	373	21	1	4	1	1	0
ARK-2641	352	353	1	1	3	4	0	0
ARK-2641	352	354	2	1	3	5	1	0
ARK-2641	353	407	54	1	4	5	0	0
ARK-2641	353	477	124	0	3	1	0	0
ARK-2641	353	357	4	1	3	1	0	0
ARK-2642	353	424	71	1	4	4	1	0
ARK-2642	353	356	3	1	3	1	0	1
ARK-2642	353	354	1	1	3	1	3	0
ARK-2642	353	477	124	0	3	1	0	0
ARK-2642	353	360	7	1	4	5	1	0
ARK-2642	354	477	123	0	3	4	0	0
ARK-2642	354	358	4	1	3	1	2	0
ARK-2642	354	355	1	1	3	1	2	3
ARK-2642	355	356	1	1	4	4	1	1
ARK-2642	355	380	25	1	3	4	0	1
ARK-2643	355	356	1	1	3	5	1	0
ARK-2643	356	477	121	0	3	1	1	0
ARK-2643	356	392	36	1	3	4	1	0
ARK-2643	357	361	4	1	3	2	0	0
ARK-2643	357	477	120	0	5	4	0	0
ARK-2643	357	360	3	1	3	4	1	0
ARK-2643	357	477	120	0	3	1	0	0
ARK-2643	358	360	2	1	3	1	1	4
ARK-2643	358	360	2	1	5	5	0	0
ARK-2643	358	477	119	0	3	4	0	0
ARK-2644	358	477	119	0	4	4	0	0
ARK-2644	359	366	7	1	2	4	0	1
ARK-2644	359	390	31	1	3	5	0	0
ARK-2644	359	363	4	1	3	5	1	0
ARK-2644	359	361	2	1	4	1	3	0
ARK-2644	359	368	9	1	3	5	1	0
ARK-2644	359	361	2	1	4	4	1	0
ARK-2644	359	367	8	1	3	5	1	0
ARK-2644	359	373	14	1	3	4	1	0
ARK-2644	359	422	63	1	4	4	1	0
ARK-2645	359	377	18	1	4	4	1	0
ARK-2645	359	360	1	1	4	1	1	0
ARK-2645	360	361	1	1	3	1	0	0
ARK-2645	360	361	1	1	3	1	0	0
ARK-2645	360	368	8	1	5	1	0	0
ARK-2645	360	361	1	1	3	1	0	0
ARK-2645	360	378	18	1	4	5	1	0
ARK-2645	360	381	21	1	4	2	1	0
ARK-2645	361	424	63	1	3	1	0	0
ARK-2645	361	374	13	1	3	4	1	0
ARK-2646	361	362	1	1	3	5	0	0
ARK-2646	361	362	1	1	3	5	0	0
ARK-2646	361	379	18	1	3	5	1	0
ARK-2646	361	386	25	1	3	5	1	0
ARK-2646	361	362	1	1	3	5	0	0
ARK-2646	361	362	1	1	3	5	0	0
ARK-2646	361	381	20	1	3	5	1	0
ARK-2646	361	362	1	1	3	5	0	0
ARK-2646	361	362	1	1	3	5	0	0
ARK-2646	361	362	1	1	3	5	0	0
ARK-2647	361	364	3	1	3	5	1	0
ARK-2647	361	362	1	1	3	5	0	0
ARK-2647	361	362	1	1	3	5	0	0
ARK-2647	361	362	1	1	3	5	0	0
ARK-2647	361	362	1	1	3	5	0	0
ARK-2647	361	362	1	1	3	5	0	0
ARK-2647	361	362	1	1	3	5	0	0
ARK-2647	361	383	22	1	3	5	1	0
ARK-2647	361	362	1	1	3	5	0	0
ARK-2647	361	362	1	1	3	5	0	0
ARK-2648	361	362	1	1	3	5	0	0
ARK-2648	361	362	1	1	3	5	0	0
ARK-2648	361	375	14	1	3	5	1	0
ARK-2648	361	362	1	1	3	5	0	0
ARK-2648	361	362	1	1	3	5	0	0
ARK-2648	361	362	1	1	3	5	0	0
ARK-2648	361	362	1	1	3	5	0	0
ARK-2648	361	362	1	1	3	5	0	0
ARK-2648	361	362	1	1	3	5	0	0
ARK-2648	361	367	6	1	3	5	1	0
ARK-2649	361	362	1	1	3	5	0	0
ARK-2649	361	371	10	1	3	5	1	0
ARK-2649	361	425	64	1	3	2	0	0
ARK-2649	361	374	13	1	4	4	1	0
ARK-2649	361	477	116	0	4	4	0	0
ARK-2649	361	364	3	1	3	4	1	0
ARK-2649	361	362	1	1	4	1	3	1
ARK-2649	361	477	116	0	5	4	0	0
ARK-2649	361	477	116	0	3	2	0	0
ARK-2649	362	365	3	1	3	1	1	0
ARK-2650	362	364	2	1	5	4	0	0
ARK-2650	362	367	5	1	4	1	2	0
ARK-2650	362	367	5	1	4	4	1	0
ARK-2650	362	375	13	1	4	5	1	1
ARK-2650	362	364	2	1	4	4	1	0
ARK-2650	363	477	114	0	4	4	0	0
ARK-2650	363	424	61	1	3	1	0	0
OT-24	10	477	467	0	2	2	0	0
OT-24	10	477	467	0	3	2	0	0
OT-24	10	477	467	0	3	2	0	0
OT-24	10	477	467	0	3	2	0	0
OT-24	10	477	467	0	2	2	0	0
OT-25	17	477	460	0	4	4	1	0
OT-25	18	477	459	0	3	4	0	0
OT-25	22	477	455	0	4	4	0	0
OT-25	23	477	454	0	4	1	0	0
OT-25	23	477	454	0	4	1	0	0
OT-25	23	477	454	0	4	1	0	0
OT-25	23	477	454	0	5	4	0	0
OT-25	23	30	7	1	3	1	0	0
OT-25	23	477	454	0	3	1	0	0
OT-25	23	477	454	0	3	1	0	0
OT-26	37	477	440	0	3	1	0	0
OT-26	37	477	440	0	3	1	0	0
OT-26	37	477	440	0	2	1	0	1
OT-26	42	477	435	0	3	4	0	0
OT-26	42	477	435	0	3	4	0	0
OT-26	43	44	1	1	3	2	0	0
OT-26	45	477	432	0	3	4	0	0
OT-26	45	477	432	0	3	4	0	0
OT-26	64	477	413	0	4	4	0	0
OT-26	81	477	396	0	3	4	0	0
OT-27	81	477	396	0	3	1	0	0
OT-27	121	477	356	0	2	5	0	0
OT-27	122	477	355	0	3	1	0	0
OT-27	133	477	344	0	3	1	1	0
OT-27	191	477	286	0	3	1	0	0
OT-27	210	477	267	0	4	2	0	0
OT-27	220	477	257	0	5	1	0	0
OT-27	226	477	251	0	3	4	0	0
OT-27	227	262	35	1	3	4	0	1
OT-27	241	477	236	0	4	1	0	0
OT-28	241	477	236	0	3	4	0	0
OT-28	259	477	218	0	3	5	0	4
OT-28	259	477	218	0	3	5	0	4
OT-28	262	263	1	1	4	4	0	0
OT-28	262	263	1	1	4	4	0	0
OT-28	262	263	1	1	3	4	0	0
OT-28	297	477	180	0	3	1	0	0
OT-28	324	477	153	0	4	1	0	0
OT-28	329	477	148	0	3	1	1	0
OT-28	331	477	146	0	3	1	1	0
OT-29	340	477	137	0	3	1	1	0
OT-29	350	477	127	0	4	3	0	0
OOP-327	7	477	470	0	1	1	0	0
OOP-327	7	283	276	1	3	4	1	0
OOP-327	7	477	470	0	3	1	0	0
OOP-327	7	8	1	1	3	5	1	0
OOP-327	11	477	466	0	3	4	0	1
OOP-327	15	32	17	1	1	1	0	0
OOP-327	16	477	461	0	3	1	0	0
OOP-327	18	477	459	0	4	1	0	0
OOP-328	22	477	455	0	3	1	0	0
OOP-328	28	477	449	0	3	4	0	0
OOP-328	36	477	441	0	3	1	0	0
OOP-328	36	44	8	1	4	1	1	0
OOP-328	37	477	440	0	4	1	0	0
OOP-328	39	477	438	0	3	1	0	0
OOP-328	44	477	433	0	4	3	0	0
OOP-328	45	46	1	1	4	1	0	0
OOP-328	49	53	4	1	3	1	1	0
OOP-328	53	326	273	1	4	5	2	0
OOP-329	53	477	424	0	4	5	0	0
OOP-329	60	477	417	0	3	1	1	0
OOP-329	72	477	405	0	3	3	0	0
OOP-329	72	79	7	1	3	5	1	0
OOP-329	73	477	404	0	3	1	0	0
OOP-329	73	477	404	0	3	4	0	1
OOP-329	77	477	400	0	4	3	0	0
OOP-329	77	477	400	0	4	1	0	0
OOP-329	78	477	399	0	2	1	0	0
OOP-329	79	477	398	0	3	2	0	0
OOP-330	79	81	2	1	3	5	1	0
OOP-330	79	99	20	1	3	5	0	1
OOP-330	81	83	2	1	3	3	1	0
OOP-330	81	83	2	1	3	3	1	0
OOP-330	83	84	1	1	3	5	1	0
OOP-330	84	477	393	0	3	3	1	2
OOP-330	84	477	393	0	4	1	1	0
OOP-330	84	87	3	1	4	3	1	0
OOP-330	84	87	3	1	3	5	1	0
OOP-330	87	107	20	1	3	5	1	0
OOP-331	94	150	56	1	4	2	0	0
OOP-331	95	477	382	0	3	2	0	2
OOP-331	104	477	373	0	2	1	0	0
OOP-331	105	200	95	1	3	4	1	4
OOP-331	106	477	371	0	3	1	0	0
OOP-331	108	477	369	0	3	5	0	0
OOP-331	108	477	369	0	3	5	0	0
OOP-331	109	477	368	0	3	1	0	0
OOP-331	112	116	4	1	3	5	1	0
OOP-331	112	148	36	1	3	5	1	1
OOP-332	115	477	362	0	3	1	0	0
OOP-332	116	129	13	1	3	1	1	0
OOP-332	123	129	6	1	4	1	1	0
OOP-332	129	477	348	0	3	4	1	0
OOP-332	130	136	6	1	3	5	1	0
OOP-332	136	477	341	0	3	3	0	1
OOP-332	144	282	138	1	4	4	1	0
OOP-332	144	283	139	1	4	4	1	0
OOP-332	144	178	34	1	3	5	1	0
OOP-332	144	200	56	1	3	5	1	0
OOP-333	148	193	45	1	3	1	1	0
OOP-333	154	167	13	1	4	5	1	2
OOP-333	156	178	22	1	3	3	1	2
OOP-333	156	170	14	1	3	3	1	2
OOP-333	165	175	10	1	3	4	1	1
OOP-333	168	196	28	1	3	5	1	0
OOP-333	171	477	306	0	3	1	2	0
OOP-333	172	477	305	0	3	1	0	2
OOP-333	176	196	20	1	3	5	1	0
OOP-333	176	477	301	0	1	1	0	0
OOP-334	192	477	285	0	4	1	0	0
OOP-334	198	477	279	0	3	1	1	0
OOP-334	199	297	98	1	3	4	1	0
OOP-334	199	200	1	1	3	5	1	0
OOP-334	200	201	1	1	3	5	1	0
OOP-334	203	221	18	1	3	5	1	0
OOP-334	203	207	4	1	3	5	1	0
OOP-335	203	207	4	1	3	1	1	0
OOP-335	203	220	17	1	3	5	1	0
OOP-335	204	205	1	1	3	4	1	0
OOP-335	205	207	2	1	3	1	1	0
OOP-335	205	477	272	0	4	4	0	0
OOP-335	206	297	91	1	3	5	1	1
OOP-335	211	477	266	0	1	1	0	0
OOP-335	218	220	2	1	3	4	1	0
OOP-335	219	477	258	0	3	1	0	0
OOP-335	219	221	2	1	4	4	1	0
OOP-336	220	221	1	1	3	1	1	0
OOP-336	221	477	256	0	4	4	0	0
OOP-336	224	227	3	1	3	1	1	0
OOP-336	224	239	15	1	3	5	1	0
OOP-336	227	233	6	1	3	4	1	0
OOP-336	233	239	6	1	3	4	0	0
OOP-336	233	235	2	1	3	5	1	0
OOP-336	233	239	6	1	3	5	1	0
OOP-336	233	242	9	1	3	5	1	0
OOP-336	234	477	243	0	3	4	0	0
OOP-337	234	477	243	0	3	4	0	0
OOP-337	234	238	4	1	3	5	1	0
OOP-337	235	477	242	0	3	4	0	0
OOP-337	239	242	3	1	3	5	1	0
OOP-337	240	477	237	0	1	5	0	0
OOP-337	241	245	4	1	3	5	1	0
OOP-337	242	282	40	1	3	5	1	1
OOP-337	242	477	235	0	3	4	1	1
OOP-337	245	283	38	1	3	1	2	1
OOP-337	246	477	231	0	3	1	0	0
OOP-338	246	254	8	1	3	1	1	0
OOP-338	252	289	37	1	3	5	1	0
OOP-338	252	317	65	1	3	5	1	0
OOP-338	252	254	2	1	4	5	1	0
OOP-338	260	287	27	1	3	5	1	1
OOP-338	260	477	217	0	4	1	0	0
OOP-338	267	477	210	0	4	3	0	0
OOP-338	273	477	204	0	2	5	1	0
OOP-338	273	477	204	0	4	5	1	0
OOP-338	273	477	204	0	1	1	0	0
OOP-339	281	296	15	1	3	5	1	0
OOP-339	283	290	7	1	3	5	1	0
OOP-339	287	477	190	0	3	3	0	1
OOP-339	288	336	48	1	3	1	2	1
OOP-339	290	291	1	1	3	5	1	0
OOP-339	290	297	7	1	3	5	1	0
OOP-339	290	340	50	1	3	5	2	2
OOP-339	291	477	186	0	3	1	0	0
OOP-339	296	297	1	1	3	5	1	0
OOP-339	296	297	1	1	3	5	1	0
OOP-340	296	303	7	1	3	5	1	0
OOP-340	296	477	181	0	3	1	0	0
OOP-340	302	477	175	0	3	1	0	0
OOP-340	312	313	1	1	3	3	0	0
OOP-340	317	322	5	1	3	5	1	1
OOP-340	323	325	2	1	3	5	1	1
OOP-340	323	324	1	1	3	5	0	0
OOP-340	323	324	1	1	3	5	0	0
OOP-340	325	326	1	1	3	5	0	0
OOP-340	325	326	1	1	3	3	1	0
OOP-341	325	326	1	1	3	4	1	0
OOP-341	326	329	3	1	3	5	1	0
OOP-341	330	331	1	1	3	5	0	0
OOP-341	330	331	1	1	3	5	1	0
OOP-341	330	331	1	1	3	5	1	0
OOP-341	333	336	3	1	3	1	1	0
OOP-341	333	338	5	1	4	4	0	0
OOP-341	337	338	1	1	3	5	0	0
OOP-341	338	477	139	0	3	3	2	2
HD-79	1	2	1	1	4	2	0	0
HD-79	6	350	344	1	3	1	1	0
HD-79	8	10	2	1	3	1	1	0
HD-79	11	12	1	1	3	1	1	1
HD-79	24	37	13	1	3	1	1	0
HD-79	28	30	2	1	4	1	1	0
HD-79	30	31	1	1	3	4	1	1
HD-79	31	48	17	1	3	4	1	1
HD-79	31	37	6	1	3	1	1	0
HD-80	31	32	1	1	3	1	1	0
HD-80	31	37	6	1	3	1	1	0
HD-80	36	37	1	1	3	1	1	0
HD-80	37	141	104	1	3	1	1	0
HD-80	44	45	1	1	1	1	0	0
HD-80	63	64	1	1	3	2	1	0
HD-80	63	64	1	1	3	2	1	4
HD-80	64	65	1	1	3	1	1	0
HD-80	69	70	1	1	3	4	1	1
HD-80	70	450	380	1	3	4	0	0
HD-81	74	450	376	1	1	1	0	0
HD-81	85	477	392	0	4	4	0	0
HD-81	85	108	23	1	4	2	1	1
HD-81	96	99	3	1	3	1	1	0
HD-81	99	112	13	1	4	4	1	1
HD-81	102	105	3	1	3	2	1	4
HD-81	105	106	1	1	3	4	1	3
HD-81	105	108	3	1	3	2	1	2
HD-81	106	114	8	1	3	4	1	4
HD-81	106	134	28	1	4	4	1	3
HD-82	106	114	8	1	3	4	1	1
HD-82	107	108	1	1	3	2	1	1
HD-82	113	477	364	0	3	5	0	3
HD-82	126	127	1	1	4	4	0	0
HD-82	134	147	13	1	3	3	1	0
HD-82	144	147	3	1	4	4	1	0
HD-82	144	145	1	1	3	4	1	0
HD-82	161	163	2	1	3	1	1	0
HD-82	161	477	316	0	3	1	0	0
HD-82	169	170	1	1	4	4	1	0
HD-83	171	172	1	1	3	4	1	0
HD-83	183	186	3	1	4	4	1	0
HD-83	189	190	1	1	3	4	1	1
HD-83	191	393	202	1	3	1	1	0
HD-83	198	202	4	1	3	4	1	1
HD-83	205	206	1	1	3	4	1	1
HD-83	205	206	1	1	3	4	1	1
HD-83	210	216	6	1	3	2	1	0
HD-83	211	216	5	1	3	4	1	0
HD-83	219	237	18	1	2	1	1	0
HD-84	221	222	1	1	3	1	1	0
HD-84	235	237	2	1	3	4	1	0
HD-84	246	248	2	1	3	4	1	1
HD-84	256	257	1	1	2	1	1	0
HD-84	259	322	63	1	2	1	0	0
HD-84	262	263	1	1	3	5	0	0
HD-84	273	275	2	1	3	1	1	0
HD-84	274	283	9	1	3	1	1	1
HD-84	280	283	3	1	3	1	1	0
HD-84	287	309	22	1	3	1	1	0
HD-85	288	293	5	1	4	2	1	0
HD-85	289	477	188	0	3	1	0	0
HD-85	289	291	2	1	4	1	1	0
HD-85	296	450	154	1	3	4	0	0
HD-85	296	450	154	1	3	1	0	2
HD-85	298	299	1	1	3	1	0	2
HD-85	300	477	177	0	3	4	0	0
HD-85	301	302	1	1	4	4	1	0
HD-85	301	302	1	1	4	4	1	0
HD-85	302	303	1	1	3	4	1	0
HD-86	309	315	6	1	3	1	1	1
HD-86	311	314	3	1	4	1	1	0
HD-86	316	321	5	1	3	4	1	0
HD-86	318	477	159	0	4	4	0	0
HD-86	318	321	3	1	3	4	1	0
HD-86	318	322	4	1	3	4	1	1
HD-86	319	320	1	1	4	1	1	0
HD-86	319	320	1	1	4	1	1	0
HD-86	319	321	2	1	3	4	1	0
HD-86	323	324	1	1	3	1	0	0
HD-87	324	332	8	1	4	4	1	1
HD-87	325	405	80	1	3	4	1	1
HD-87	325	405	80	1	3	4	1	1
HD-87	333	335	2	1	4	1	1	0
HD-87	337	338	1	1	3	1	0	0
HD-87	345	349	4	1	3	3	1	0
HD-87	346	349	3	1	3	5	1	0
HD-87	354	356	2	1	3	1	1	0
HD-87	357	363	6	1	3	4	1	0
ANBOL-146	51	477	426	0	2	1	0	0
ANBOL-146	66	290	224	1	1	5	2	0
ANBOL-146	66	290	224	1	1	1	0	0
ANBOL-146	106	291	185	1	3	4	0	0
ANBOL-146	108	109	1	1	3	4	0	0
ANBOL-147	185	477	292	0	3	5	1	0
ANBOL-147	256	291	35	1	3	1	1	0
ANBOL-147	315	477	162	0	3	1	1	0
ANBOL-147	327	334	7	1	3	1	1	0
ANBOL-147	327	334	7	1	3	1	1	0
ANBOL-147	327	334	7	1	4	1	1	0
ANBOL-147	327	334	7	1	5	4	1	0
ATISTICS-	14	477	463	0	4	3	0	0
ATISTICS-	14	20	6	1	4	5	0	1
ATISTICS-	20	477	457	0	4	3	0	1
ATISTICS-	22	23	1	1	4	5	0	0
ATISTICS-	59	477	418	0	3	3	0	3
ATISTICS-	139	477	338	0	3	5	0	0
EVE-4	74	477	403	0	3	4	0	0
EVE-5	75	477	402	0	4	4	0	0
EVE-5	79	477	398	0	3	1	0	0
EVE-5	79	477	398	0	3	1	0	0
EVE-5	130	477	347	0	4	4	0	0
ORM-287	1	4	3	1	3	1	3	0
ORM-287	2	12	10	1	4	4	4	0
ORM-287	2	49	47	1	2	1	0	1
ORM-287	2	7	5	1	2	1	4	1
ORM-288	2	116	114	1	4	4	0	0
ORM-288	2	4	2	1	3	1	1	1
ORM-288	3	157	154	1	1	3	1	1
ORM-288	4	477	473	0	3	1	0	0
ORM-288	4	159	155	1	3	1	0	2
ORM-288	7	9	2	1	3	1	1	0
ORM-288	7	477	470	0	3	4	0	0
ORM-288	8	21	13	1	3	5	1	0
ORM-288	8	477	469	0	3	5	0	0
ORM-288	8	477	469	0	3	5	0	0
ORM-289	8	477	469	0	3	5	0	0
ORM-289	8	316	308	1	4	4	1	0
ORM-289	9	11	2	1	5	1	4	0
ORM-289	9	11	2	1	4	1	1	0
ORM-289	9	14	5	1	5	1	4	0
ORM-289	9	477	468	0	3	5	0	0
ORM-289	9	54	45	1	3	4	2	0
ORM-289	10	20	10	1	3	4	1	0
ORM-289	10	39	29	1	3	2	1	0
ORM-289	11	12	1	1	5	4	1	0
ORM-290	17	18	1	1	2	1	2	0
ORM-290	17	21	4	1	3	4	2	0
ORM-290	17	109	92	1	3	4	1	0
ORM-290	18	20	2	1	3	1	2	0
ORM-290	21	23	2	1	1	3	1	1
ORM-290	21	477	456	0	3	1	0	0
ORM-290	22	31	9	1	2	1	2	0
ORM-290	22	31	9	1	3	1	1	1
ORM-290	23	102	79	1	1	3	1	1
ORM-290	23	99	76	1	1	4	1	1
ORM-291	23	31	8	1	3	1	1	0
ORM-291	23	56	33	1	3	1	4	0
ORM-291	24	25	1	1	1	1	4	0
ORM-291	26	36	10	1	1	1	2	1
ORM-291	26	36	10	1	3	4	2	1
ORM-291	27	175	148	1	4	2	0	0
ORM-291	28	31	3	1	3	4	1	0
ORM-291	29	31	2	1	4	4	4	0
ORM-291	30	32	2	1	1	1	4	0
ORM-291	31	477	446	0	3	5	0	0
ORM-292	31	477	446	0	3	5	0	0
ORM-292	31	477	446	0	3	5	0	0
ORM-292	31	477	446	0	2	5	0	0
ORM-292	31	477	446	0	3	5	0	0
ORM-292	31	88	57	1	3	5	1	1
ORM-292	31	477	446	0	2	5	0	0
ORM-292	31	477	446	0	3	5	0	0
ORM-292	31	32	1	1	3	1	1	0
ORM-292	31	477	446	0	3	1	0	1
ORM-292	31	477	446	0	3	4	0	0
ORM-293	32	477	445	0	3	1	0	0
ORM-293	32	477	445	0	3	1	0	0
ORM-293	32	44	12	1	3	1	1	0
ORM-293	33	36	3	1	4	4	1	0
ORM-293	35	37	2	1	3	1	1	0
ORM-293	35	42	7	1	3	4	0	0
ORM-293	36	44	8	1	1	3	1	1
ORM-293	36	38	2	1	1	3	1	1
ORM-293	36	477	441	0	4	4	0	0
ORM-293	36	49	13	1	4	4	1	0
ORM-294	37	40	3	1	3	1	1	0
ORM-294	37	38	1	1	3	1	1	0
ORM-294	37	38	1	1	3	1	2	0
ORM-294	37	38	1	1	1	1	0	0
ORM-294	40	477	437	0	3	1	0	0
ORM-294	43	477	434	0	3	5	0	0
ORM-294	43	477	434	0	3	1	0	0
ORM-294	44	477	433	0	3	3	0	1
ORM-294	44	47	3	1	5	4	1	0
ORM-294	44	477	433	0	4	1	2	0
ORM-295	44	48	4	1	3	1	1	0
ORM-295	46	47	1	1	3	1	1	0
ORM-295	46	54	8	1	4	3	3	0
ORM-295	46	199	153	1	1	3	1	0
ORM-295	46	71	25	1	3	4	0	0
ORM-295	46	48	2	1	3	1	0	0
ORM-295	46	48	2	1	3	1	0	0
ORM-295	47	50	3	1	1	1	1	0
ORM-295	48	50	2	1	3	4	1	0
ORM-295	48	49	1	1	4	4	0	1
ORM-296	49	51	2	1	3	5	3	0
ORM-296	49	51	2	1	4	4	1	0
ORM-296	50	477	427	0	3	4	0	0
ORM-296	50	274	224	1	3	5	1	0
ORM-296	50	477	427	0	3	3	0	0
ORM-296	50	56	6	1	3	1	1	0
ORM-296	50	477	427	0	3	1	0	0
ORM-296	50	56	6	1	3	1	2	0
ORM-296	50	59	9	1	3	1	2	0
ORM-296	51	54	3	1	4	1	1	0
ORM-297	53	78	25	1	3	1	0	1
ORM-297	54	60	6	1	3	5	1	0
ORM-297	54	199	145	1	3	5	1	0
ORM-297	54	56	2	1	3	5	1	0
ORM-297	54	193	139	1	3	5	1	0
ORM-297	56	70	14	1	3	1	1	1
ORM-297	56	59	3	1	3	1	1	0
ORM-297	56	88	32	1	4	4	1	0
ORM-297	56	59	3	1	1	1	3	0
ORM-297	57	100	43	1	3	1	4	0
ORM-298	57	59	2	1	4	1	1	0
ORM-298	57	59	2	1	3	1	3	0
ORM-298	58	477	419	0	3	4	0	0
ORM-298	58	94	36	1	2	1	1	2
ORM-298	59	477	418	0	4	4	0	0
ORM-298	60	120	60	1	3	1	3	0
ORM-298	63	65	2	1	3	1	1	0
ORM-298	64	78	14	1	3	1	1	0
ORM-298	65	133	68	1	3	1	2	1
ORM-298	65	78	13	1	3	1	3	0
ORM-299	67	347	280	1	3	4	1	1
ORM-299	68	477	409	0	5	4	0	0
ORM-299	68	314	246	1	4	4	0	2
ORM-299	70	88	18	1	3	1	2	0
ORM-299	71	92	21	1	3	1	4	0
ORM-299	72	477	405	0	1	1	0	0
ORM-299	77	477	400	0	3	4	0	0
ORM-299	77	88	11	1	3	4	2	0
ORM-299	77	78	1	1	3	4	1	0
ORM-299	77	79	2	1	4	4	1	0
ORM-300	77	477	400	0	3	3	0	0
ORM-300	78	477	399	0	3	1	0	0
ORM-300	79	80	1	1	4	1	0	0
ORM-300	80	92	12	1	3	4	0	1
ORM-300	82	86	4	1	3	3	1	0
ORM-300	82	98	16	1	3	3	4	0
ORM-300	82	88	6	1	3	4	2	0
ORM-300	83	88	5	1	3	3	1	0
ORM-300	83	477	394	0	4	3	0	0
ORM-300	83	88	5	1	4	1	1	0
ORM-301	84	86	2	1	3	2	0	0
ORM-301	85	88	3	1	4	4	4	0
ORM-301	85	88	3	1	3	1	1	0
ORM-301	86	189	103	1	3	1	2	0
ORM-301	87	88	1	1	3	5	0	1
ORM-301	87	91	4	1	5	3	1	0
ORM-301	88	477	389	0	3	4	0	0
ORM-301	88	112	24	1	3	4	1	0
ORM-301	90	91	1	1	3	1	1	0
ORM-301	92	477	385	0	3	4	0	0
ORM-302	92	99	7	1	3	1	1	0
ORM-302	98	119	21	1	3	1	1	1
ORM-302	99	108	9	1	3	4	2	0
ORM-302	99	102	3	1	3	1	1	0
ORM-302	99	109	10	1	3	2	0	0
ORM-302	100	108	8	1	3	4	1	0
ORM-302	100	102	2	1	3	2	4	0
ORM-302	100	101	1	1	3	2	4	0
ORM-302	101	189	88	1	3	1	2	0
ORM-302	105	119	14	1	3	4	1	0
ORM-303	106	477	371	0	3	5	0	0
ORM-303	106	477	371	0	4	4	0	0
ORM-303	107	477	370	0	3	1	0	0
ORM-303	107	477	370	0	3	1	0	0
ORM-303	108	126	18	1	3	4	0	0
ORM-303	108	133	25	1	3	1	1	0
ORM-303	109	144	35	1	3	4	1	0
ORM-303	112	115	3	1	5	4	1	0
ORM-303	112	477	365	0	3	1	0	0
ORM-303	112	122	10	1	3	4	3	0
ORM-304	113	133	20	1	3	4	1	0
ORM-304	113	121	8	1	4	4	1	0
ORM-304	115	141	26	1	3	1	1	0
ORM-304	115	116	1	1	3	1	4	0
ORM-304	115	119	4	1	3	4	1	0
ORM-304	116	477	361	0	4	4	0	0
ORM-304	116	189	73	1	1	1	2	0
ORM-304	117	189	72	1	3	1	2	0
ORM-304	119	153	34	1	3	1	1	0
ORM-304	119	477	358	0	3	1	0	0
ORM-305	119	477	358	0	3	1	0	0
ORM-305	119	477	358	0	3	1	0	0
ORM-305	119	120	1	1	3	1	4	0
ORM-305	119	151	32	1	3	1	1	0
ORM-305	119	477	358	0	3	4	0	0
ORM-305	121	150	29	1	3	1	3	0
ORM-305	122	190	68	1	4	1	1	0
ORM-305	123	477	354	0	3	1	1	0
ORM-305	123	126	3	1	3	1	0	0
ORM-305	125	126	1	1	3	1	4	0
ORM-306	126	127	1	1	4	5	3	0
ORM-306	127	190	63	1	3	4	1	0
ORM-306	127	477	350	0	5	1	0	1
ORM-306	127	129	2	1	5	1	1	0
ORM-306	128	172	44	1	4	4	1	0
ORM-306	128	132	4	1	4	1	1	0
ORM-306	129	477	348	0	4	4	0	0
ORM-306	129	130	1	1	3	1	0	0
ORM-306	129	141	12	1	3	1	2	0
ORM-306	130	133	3	1	3	4	2	0
ORM-307	130	140	10	1	3	1	1	0
ORM-307	131	477	346	0	3	4	0	0
ORM-307	133	134	1	1	3	1	1	0
ORM-307	134	140	6	1	3	1	1	0
ORM-307	134	477	343	0	4	1	0	0
ORM-307	134	136	2	1	3	1	1	0
ORM-307	135	136	1	1	3	1	0	0
ORM-307	136	141	5	1	3	4	1	0
ORM-307	136	477	341	0	4	1	0	0
ORM-307	136	141	5	1	3	1	1	0
ORM-308	140	477	337	0	4	1	0	0
ORM-308	141	477	336	0	1	1	0	0
ORM-308	142	189	47	1	4	1	3	0
ORM-308	142	144	2	1	3	4	2	0
ORM-308	143	151	8	1	3	1	0	0
ORM-308	144	477	333	0	4	4	0	0
ORM-308	146	151	5	1	5	3	2	0
ORM-308	147	153	6	1	3	1	2	0
ORM-308	148	149	1	1	4	5	0	0
ORM-308	148	151	3	1	5	3	3	0
ORM-309	149	189	40	1	2	1	2	1
ORM-309	151	155	4	1	3	1	1	0
ORM-309	151	155	4	1	3	1	1	0
ORM-309	152	154	2	1	3	4	1	0
ORM-309	155	163	8	1	4	4	3	0
ORM-309	155	477	322	0	3	1	0	0
ORM-309	155	158	3	1	3	1	1	0
ORM-309	156	159	3	1	3	1	3	0
ORM-309	157	158	1	1	3	1	1	0
ORM-309	158	219	61	1	3	4	1	2
ORM-310	160	477	317	0	3	4	0	0
ORM-310	162	477	315	0	3	4	0	0
ORM-310	163	166	3	1	3	1	3	0
ORM-310	163	167	4	1	3	1	1	0
ORM-310	164	477	313	0	3	1	0	0
ORM-310	164	261	97	1	3	3	1	0
ORM-310	164	477	313	0	4	4	0	0
ORM-310	164	269	105	1	3	1	0	0
ORM-310	165	477	312	0	3	4	0	0
ORM-310	165	167	2	1	2	1	3	0
ORM-311	165	175	10	1	3	1	2	0
ORM-311	166	169	3	1	5	3	1	0
ORM-311	168	477	309	0	3	4	0	0
ORM-311	168	169	1	1	3	5	1	0
ORM-311	168	169	1	1	3	5	1	0
ORM-311	169	170	1	1	3	4	1	0
ORM-311	169	171	2	1	5	1	1	0
ORM-311	170	175	5	1	3	1	1	0
ORM-311	171	172	1	1	3	1	1	0
ORM-311	173	182	9	1	3	5	1	0
ORM-312	174	177	3	1	3	1	1	0
ORM-312	174	176	2	1	3	1	2	0
ORM-312	174	176	2	1	2	1	1	0
ORM-312	176	319	143	1	3	1	2	0
ORM-312	177	178	1	1	2	1	1	0
ORM-312	177	189	12	1	3	4	1	4
ORM-312	177	189	12	1	4	1	1	1
ORM-312	177	189	12	1	4	1	1	1
ORM-312	177	477	300	0	3	1	0	2
ORM-312	177	178	1	1	5	1	1	0
ORM-313	177	219	42	1	4	2	1	0
ORM-313	177	248	71	1	3	4	1	0
ORM-313	179	477	298	0	4	1	0	0
ORM-313	179	221	42	1	3	4	1	4
ORM-313	179	192	13	1	3	4	1	0
ORM-313	179	190	11	1	3	1	1	0
ORM-313	179	190	11	1	3	1	1	0
ORM-313	179	190	11	1	3	1	1	0
ORM-313	179	182	3	1	3	4	1	0
ORM-313	182	234	52	1	3	1	0	1
ORM-314	182	477	295	0	3	1	0	0
ORM-314	182	192	10	1	2	1	1	0
ORM-314	184	185	1	1	4	4	1	0
ORM-314	185	190	5	1	3	1	1	0
ORM-314	185	263	78	1	3	4	0	1
ORM-314	188	222	34	1	1	5	0	0
ORM-314	190	477	287	0	1	1	0	0
ORM-314	191	261	70	1	4	2	1	3
ORM-314	192	193	1	1	1	1	1	0
ORM-314	193	477	284	0	3	1	0	0
ORM-315	193	213	20	1	4	4	1	2
ORM-315	193	477	284	0	2	1	0	1
ORM-315	194	477	283	0	3	1	0	0
ORM-315	196	477	281	0	3	4	0	0
ORM-315	197	477	280	0	3	2	0	0
ORM-315	197	477	280	0	4	3	0	0
ORM-315	197	253	56	1	4	5	1	0
ORM-315	200	217	17	1	3	4	1	1
ORM-315	200	209	9	1	4	1	1	0
ORM-315	204	205	1	1	3	1	1	0
ORM-316	206	477	271	0	3	4	0	0
ORM-316	207	209	2	1	3	1	2	0
ORM-316	207	259	52	1	2	1	1	0
ORM-316	208	210	2	1	5	1	0	0
ORM-316	209	210	1	1	4	1	4	0
ORM-316	211	477	266	0	3	4	0	0
ORM-316	212	214	2	1	4	1	1	0
ORM-316	212	214	2	1	4	1	1	0
ORM-316	212	214	2	1	3	1	1	0
ORM-316	212	214	2	1	3	1	1	0
ORM-317	212	214	2	1	3	1	1	0
ORM-317	213	216	3	1	3	5	0	0
ORM-317	213	477	264	0	3	1	0	0
ORM-317	213	477	264	0	4	4	0	1
ORM-317	213	477	264	0	4	1	0	0
ORM-317	214	217	3	1	4	2	1	0
ORM-317	214	215	1	1	2	1	1	1
ORM-317	214	477	263	0	4	1	0	0
ORM-317	214	477	263	0	3	4	0	0
ORM-317	217	221	4	1	1	1	1	0
ORM-318	217	221	4	1	1	1	1	0
ORM-318	217	221	4	1	1	1	1	0
ORM-318	217	221	4	1	1	1	1	0
ORM-318	217	222	5	1	1	1	1	0
ORM-318	218	225	7	1	3	1	2	0
ORM-318	218	477	259	0	3	1	0	0
ORM-318	220	477	257	0	3	4	0	1
ORM-318	220	477	257	0	3	4	0	1
ORM-318	220	477	257	0	4	4	0	1
ORM-318	220	477	257	0	3	4	0	0
ORM-319	221	477	256	0	5	3	0	0
ORM-319	221	477	256	0	4	4	0	1
ORM-319	221	477	256	0	5	3	0	0
ORM-319	221	477	256	0	3	4	0	0
ORM-319	225	227	2	1	4	1	1	0
ORM-319	226	227	1	1	3	1	0	0
ORM-319	226	231	5	1	4	4	1	0
ORM-319	227	259	32	1	3	3	1	0
ORM-319	227	252	25	1	4	4	1	0
ORM-319	227	252	25	1	1	3	2	0
ORM-320	232	234	2	1	3	1	1	0
ORM-320	233	234	1	1	3	1	3	0
ORM-320	234	477	243	0	3	4	0	1
ORM-320	234	246	12	1	3	1	1	1
ORM-320	236	477	241	0	4	3	0	2
ORM-320	239	259	20	1	3	4	1	0
ORM-320	239	254	15	1	3	1	1	0
ORM-320	239	241	2	1	3	1	1	0
ORM-320	240	246	6	1	4	1	1	0
ORM-320	241	477	236	0	3	1	0	0
ORM-321	246	248	2	1	4	1	1	0
ORM-321	246	477	231	0	3	3	0	0
ORM-321	246	477	231	0	3	1	0	0
ORM-321	247	249	2	1	3	1	1	0
ORM-321	248	477	229	0	3	1	0	0
ORM-321	248	249	1	1	3	1	1	0
ORM-321	249	252	3	1	3	1	1	0
ORM-321	252	255	3	1	3	1	1	0
ORM-321	253	255	2	1	3	1	1	0
ORM-321	253	255	2	1	3	1	1	0
ORM-322	253	255	2	1	4	1	1	0
ORM-322	254	255	1	1	3	1	1	0
ORM-322	254	256	2	1	4	4	3	0
ORM-322	255	256	1	1	3	1	1	0
ORM-322	255	259	4	1	4	1	1	0
ORM-322	256	259	3	1	3	1	1	0
ORM-322	256	259	3	1	3	4	1	0
ORM-322	259	260	1	1	3	4	1	0
ORM-322	259	260	1	1	3	1	1	0
ORM-322	260	262	2	1	3	4	1	0
ORM-323	261	262	1	1	3	1	1	0
ORM-323	261	477	216	0	4	1	0	0
ORM-323	262	267	5	1	3	2	1	0
ORM-323	263	459	196	1	3	2	3	0
ORM-323	264	267	3	1	3	2	1	0
ORM-323	268	270	2	1	3	1	1	0
ORM-323	268	270	2	1	4	1	1	0
ORM-323	269	273	4	1	4	1	1	0
ORM-323	272	276	4	1	1	1	1	0
ORM-323	272	275	3	1	1	1	1	0
ORM-324	273	275	2	1	3	1	1	0
ORM-324	273	275	2	1	3	1	1	0
ORM-324	274	276	2	1	4	4	1	0
ORM-324	275	287	12	1	3	4	1	1
ORM-324	275	277	2	1	4	1	1	0
ORM-324	276	277	1	1	1	1	1	0
ORM-324	276	277	1	1	4	1	1	0
ORM-324	277	280	3	1	4	1	1	0
ORM-324	280	281	1	1	3	1	1	0
ORM-324	280	283	3	1	3	1	1	0
ORM-325	280	294	14	1	4	3	0	0
ORM-325	283	284	1	1	2	1	1	0
ORM-325	283	284	1	1	3	1	1	0
ORM-325	283	287	4	1	3	3	1	0
ORM-325	284	287	3	1	3	1	1	0
ORM-325	284	287	3	1	4	1	1	0
ORM-325	287	477	190	0	1	4	0	0
ORM-325	287	477	190	0	4	4	0	0
ORM-325	288	291	3	1	5	4	1	0
ORM-325	289	477	188	0	3	2	0	0
ORM-326	289	295	6	1	3	4	1	0
ORM-326	290	303	13	1	4	5	1	0
ORM-326	290	294	4	1	3	1	1	0
ORM-326	291	294	3	1	4	4	1	0
ORM-326	291	309	18	1	4	1	0	0
ORM-326	291	305	14	1	4	1	1	0
ORM-326	291	477	186	0	3	1	0	0
ORM-326	293	294	1	1	3	3	0	0
ORM-326	293	294	1	1	3	3	1	0
ORM-326	294	295	1	1	3	1	1	0
ORM-327	294	351	57	1	3	5	1	0
ORM-327	294	477	183	0	3	2	0	0
ORM-327	294	338	44	1	3	1	0	0
ORM-327	295	296	1	1	2	1	1	0
ORM-327	296	453	157	1	3	4	1	0
ORM-327	296	305	9	1	4	1	1	0
ORM-327	298	354	56	1	1	1	1	0
ORM-327	298	299	1	1	2	1	0	0
ORM-327	298	304	6	1	3	1	1	0
ORM-327	307	347	40	1	3	1	1	1
ORM-328	309	477	168	0	3	1	0	0
ORM-328	309	477	168	0	3	4	0	0
ORM-328	309	439	130	1	3	1	1	0
ORM-328	310	477	167	0	3	1	0	0
ORM-328	311	316	5	1	3	1	1	0
ORM-328	312	477	165	0	4	2	0	0
ORM-328	316	477	161	0	3	1	0	0
ORM-328	319	320	1	1	3	1	0	0
ORM-328	319	327	8	1	1	1	1	0
ORM-328	322	344	22	1	5	3	2	0
ORM-329	323	332	9	1	4	3	1	0
ORM-329	326	477	151	0	3	1	0	0
ORM-329	330	335	5	1	3	4	2	0
ORM-329	336	477	141	0	4	4	0	0
ORM-329	336	344	8	1	3	5	1	0
ORM-329	337	351	14	1	3	1	1	0
ORM-329	338	344	6	1	5	5	1	0
ORM-329	338	344	6	1	3	1	1	0
ORM-329	339	477	138	0	3	2	0	0
ORM-329	339	477	138	0	3	4	0	0
ORM-330	341	351	10	1	3	1	1	0
ORM-330	341	344	3	1	3	1	2	0
ORM-330	343	351	8	1	3	1	1	0
ORM-330	344	351	7	1	4	1	1	0
ORM-330	347	477	130	0	3	5	0	0
ORM-330	347	477	130	0	3	5	0	0
ORM-330	351	477	126	0	4	3	0	0
R-322	238	239	1	1	3	1	1	0
REAMS-56	3	477	474	0	3	2	0	0
REAMS-56	3	477	474	0	3	2	0	0
REAMS-57	4	7	3	1	3	1	1	0
REAMS-57	4	7	3	1	3	5	1	0
REAMS-57	8	477	469	0	3	4	0	0
REAMS-57	8	88	80	1	3	3	1	0
REAMS-57	8	19	11	1	3	3	1	0
REAMS-57	9	477	468	0	3	4	0	0
REAMS-57	9	477	468	0	3	4	0	0
REAMS-57	9	477	468	0	3	3	0	0
REAMS-57	29	477	448	0	3	2	0	0
REAMS-57	30	477	447	0	3	1	0	0
REAMS-58	31	44	13	1	3	4	1	0
REAMS-58	32	477	445	0	3	2	0	0
REAMS-58	44	88	44	1	3	3	1	0
REAMS-58	44	88	44	1	3	2	1	0
REAMS-58	45	106	61	1	3	3	1	0
REAMS-58	45	88	43	1	3	3	1	0
REAMS-58	82	88	6	1	3	4	1	0
REAMS-58	83	88	5	1	3	3	1	0
REAMS-58	85	88	3	1	3	3	1	0
REAMS-58	88	165	77	1	3	3	1	0
REAMS-59	91	477	386	0	3	3	1	0
REAMS-59	91	92	1	1	3	3	1	0
REAMS-59	92	93	1	1	3	3	1	0
REAMS-59	92	477	385	0	3	3	0	0
REAMS-59	92	100	8	1	3	3	1	0
REAMS-59	94	95	1	1	3	1	1	0
REAMS-59	94	95	1	1	3	1	1	0
REAMS-59	94	95	1	1	3	1	1	0
REAMS-59	94	95	1	1	3	1	1	0
REAMS-59	95	188	93	1	4	3	1	0
REAMS-60	98	126	28	1	3	1	1	0
REAMS-60	100	126	26	1	3	1	1	0
REAMS-60	100	126	26	1	3	1	1	0
REAMS-60	105	126	21	1	3	4	1	0
REAMS-60	118	119	1	1	4	4	1	0
REAMS-60	129	199	70	1	3	4	0	0
REAMS-60	152	188	36	1	3	3	1	0
REAMS-60	152	188	36	1	3	3	1	0
REAMS-60	165	179	14	1	3	3	1	0
REAMS-60	169	179	10	1	3	3	1	0
REAMS-61	171	282	111	1	3	3	1	0
REAMS-61	172	291	119	1	3	3	1	0
REAMS-61	196	477	281	0	3	2	0	0
REAMS-61	199	202	3	1	3	1	0	0
REAMS-61	281	282	1	1	3	2	0	0
REAMS-61	282	305	23	1	3	3	0	1
REAMS-61	291	302	11	1	3	4	0	0
REAMS-61	291	477	186	0	3	4	0	0
REAMS-61	291	301	10	1	3	4	0	0
REAMS-61	291	477	186	0	3	4	0	0
REAMS-62	291	477	186	0	3	4	0	0
REAMS-62	293	477	184	0	3	4	0	0
REAMS-62	293	301	8	1	3	4	0	0
REAMS-62	293	302	9	1	3	3	0	0
REAMS-62	293	301	8	1	3	4	0	0
REAMS-62	297	301	4	1	3	1	0	0
REAMS-62	297	301	4	1	3	1	0	0
REAMS-62	297	301	4	1	3	4	0	0
REAMS-62	297	301	4	1	3	1	0	0
REAMS-62	301	302	1	1	3	3	0	0
REAMS-63	302	374	72	1	3	4	0	0
REAMS-63	333	381	48	1	3	2	0	0
BMARINE-1	239	477	238	0	3	2	0	0
BMARINE-1	252	309	57	1	3	2	0	1
BMARINE-1	252	261	9	1	2	2	0	1
BMARINE-1	255	263	8	1	2	2	0	0
BMARINE-1	255	477	222	0	3	2	0	0
BMARINE-1	261	288	27	1	2	2	0	0
BMARINE-1	261	262	1	1	3	2	0	0
BMARINE-1	261	270	9	1	2	2	0	0
BMARINE-1	262	477	215	0	3	2	0	0
BMARINE-1	266	267	1	1	2	2	0	0
BMARINE-	98	477	379	0	3	2	0	3
BMARINE-2	278	281	3	1	3	2	0	0
BMARINE-2	283	477	194	0	2	2	0	0
BMARINE-2	285	288	3	1	2	2	0	0
BMARINE-2	287	477	190	0	3	2	0	0
BMARINE-2	291	316	25	1	4	2	0	0
BMARINE-2	294	477	183	0	3	2	0	0
BMARINE-2	302	322	20	1	3	2	0	0
BMARINE-2	306	477	171	0	3	2	0	0
BMARINE-2	312	319	7	1	3	2	0	0
BMARINE-2	335	477	142	0	3	2	0	0
BMARINE-	201	224	23	1	3	2	0	1
BMARINE-3	335	345	10	1	4	2	0	0
BMARINE-3	340	359	19	1	1	2	0	0
BMARINE-3	345	346	1	1	3	2	0	0
BMARINE-3	350	370	20	1	3	2	0	0
BMARINE-3	357	477	120	0	3	2	0	0
BMARINE-3	361	370	9	1	3	2	0	0
BMARINE-	235	345	110	1	3	2	0	0
BMARINE-	202	477	275	0	3	2	0	0
BMARINE-	233	252	19	1	3	2	0	1
BMARINE-	235	477	242	0	3	2	0	0
BMARINE-	235	477	242	0	3	2	0	0
BMARINE-	237	477	240	0	3	2	0	0
PERSET-	10	377	367	1	3	3	0	0
PERSET-	47	377	330	1	3	1	0	0
PERSET-	349	377	28	1	1	1	0	0
REFIRE-145	3	5	2	1	2	4	0	0
REFIRE-145	4	477	473	0	3	2	1	0
REFIRE-145	9	477	468	0	3	4	0	0
REFIRE-146	10	477	467	0	4	4	1	0
REFIRE-146	11	12	1	1	4	3	1	0
REFIRE-146	11	477	466	0	3	1	1	0
REFIRE-146	12	48	36	1	3	3	1	0
REFIRE-146	13	477	464	0	3	1	0	0
REFIRE-146	16	20	4	1	3	4	0	1
REFIRE-146	22	304	282	1	3	1	1	2
REFIRE-146	22	70	48	1	3	1	0	0
REFIRE-146	28	477	449	0	4	1	1	0
REFIRE-146	28	477	449	0	4	1	0	0
REFIRE-147	32	477	445	0	3	1	0	0
REFIRE-147	35	48	13	1	3	3	1	0
REFIRE-147	36	48	12	1	3	3	1	1
REFIRE-147	38	47	9	1	3	1	0	1
REFIRE-147	38	305	267	1	3	4	1	0
REFIRE-147	40	61	21	1	3	1	1	0
REFIRE-147	49	477	428	0	3	1	0	0
REFIRE-147	49	477	428	0	3	2	0	0
REFIRE-147	50	305	255	1	3	1	0	1
REFIRE-147	50	83	33	1	3	1	1	1
REFIRE-148	51	477	426	0	3	1	0	0
REFIRE-148	51	56	5	1	3	3	1	0
REFIRE-148	51	56	5	1	3	3	1	0
REFIRE-148	52	56	4	1	3	3	0	0
REFIRE-148	52	61	9	1	3	3	1	0
REFIRE-148	52	61	9	1	3	3	1	0
REFIRE-148	52	61	9	1	3	3	1	0
REFIRE-148	52	90	38	1	3	3	1	0
REFIRE-148	52	61	9	1	3	3	1	0
REFIRE-148	53	56	3	1	3	3	1	0
REFIRE-149	55	75	20	1	4	4	1	0
REFIRE-149	58	60	2	1	3	4	1	0
REFIRE-149	59	477	418	0	3	1	0	0
REFIRE-149	64	305	241	1	3	2	1	2
REFIRE-149	64	477	413	0	3	2	1	0
REFIRE-149	64	75	11	1	3	2	1	0
REFIRE-149	65	477	412	0	3	1	0	0
REFIRE-149	65	477	412	0	3	4	0	0
REFIRE-149	67	76	9	1	3	1	1	0
REFIRE-149	70	305	235	1	3	1	0	3
REFIRE-150	72	76	4	1	1	1	0	0
REFIRE-150	73	477	404	0	3	1	0	0
REFIRE-150	74	119	45	1	3	1	0	2
REFIRE-150	76	119	43	1	3	1	1	1
REFIRE-150	76	77	1	1	3	3	1	1
REFIRE-150	80	477	397	0	4	4	0	0
REFIRE-150	83	93	10	1	3	1	1	0
REFIRE-150	85	477	392	0	4	1	0	2
REFIRE-150	86	477	391	0	3	1	0	0
REFIRE-150	87	477	390	0	3	1	0	0
REFIRE-151	92	93	1	1	3	3	1	0
REFIRE-151	92	93	1	1	1	1	0	0
REFIRE-151	95	100	5	1	3	1	1	1
REFIRE-151	98	477	379	0	3	1	0	0
REFIRE-151	99	477	378	0	3	1	0	0
REFIRE-151	100	111	11	1	4	1	1	0
REFIRE-151	109	477	368	0	3	2	3	0
REFIRE-151	109	477	368	0	4	1	0	0
REFIRE-151	125	129	4	1	3	3	1	0
REFIRE-151	127	477	350	0	3	1	0	0
REFIRE-152	127	387	260	1	3	1	0	0
REFIRE-152	127	477	350	0	4	3	0	0
REFIRE-152	136	138	2	1	3	1	1	0
REFIRE-152	140	256	116	1	3	1	0	0
REFIRE-152	148	477	329	0	4	1	0	0
REFIRE-152	162	477	315	0	3	1	0	0
REFIRE-152	172	477	305	0	3	4	0	0
REFIRE-152	172	477	305	0	3	4	0	0
REFIRE-152	174	477	303	0	3	1	0	0
REFIRE-152	176	477	301	0	3	2	0	0
REFIRE-153	177	477	300	0	4	1	0	0
REFIRE-153	180	320	140	1	3	2	1	0
REFIRE-153	181	277	96	1	4	1	1	0
REFIRE-153	185	477	292	0	3	4	0	0
REFIRE-153	185	386	201	1	3	1	1	0
REFIRE-153	191	236	45	1	4	1	1	0
REFIRE-153	191	477	286	0	5	1	0	0
REFIRE-153	192	477	285	0	3	1	0	1
REFIRE-153	199	200	1	1	4	1	1	0
REFIRE-153	202	477	275	0	3	1	0	0
REFIRE-154	203	257	54	1	4	5	1	0
REFIRE-154	204	312	108	1	3	1	0	1
REFIRE-154	205	477	272	0	3	4	0	0
REFIRE-154	205	477	272	0	3	1	0	0
REFIRE-154	206	477	271	0	5	1	0	0
REFIRE-154	212	477	265	0	4	4	0	0
REFIRE-154	213	391	178	1	3	1	1	1
REFIRE-154	214	477	263	0	3	1	0	0
REFIRE-154	219	477	258	0	3	2	0	0
REFIRE-154	221	477	256	0	4	1	0	0
REFIRE-155	223	228	5	1	4	1	1	1
REFIRE-155	225	477	252	0	3	3	0	0
REFIRE-155	225	226	1	1	3	4	1	0
REFIRE-155	226	477	251	0	3	1	0	0
REFIRE-155	227	228	1	1	5	4	1	1
REFIRE-155	227	228	1	1	4	4	1	0
REFIRE-155	232	477	245	0	1	1	0	0
REFIRE-155	234	477	243	0	3	4	0	0
REFIRE-155	235	477	242	0	3	1	0	0
REFIRE-155	236	256	20	1	3	1	1	0
REFIRE-156	236	477	241	0	3	3	1	0
REFIRE-156	237	253	16	1	3	1	1	0
REFIRE-156	237	253	16	1	3	4	1	1
REFIRE-156	239	477	238	0	3	1	0	0
REFIRE-156	247	279	32	1	3	1	1	1
REFIRE-156	248	253	5	1	3	4	1	0
REFIRE-156	249	288	39	1	3	1	0	1
REFIRE-156	253	255	2	1	3	4	0	1
REFIRE-156	255	330	75	1	3	1	1	0
REFIRE-156	257	258	1	1	3	3	1	0
REFIRE-157	257	477	220	0	3	1	0	0
REFIRE-157	258	259	1	1	4	5	1	0
REFIRE-157	260	477	217	0	3	1	0	1
REFIRE-157	260	477	217	0	2	1	0	1
REFIRE-157	269	477	208	0	1	1	1	0
REFIRE-157	273	477	204	0	4	4	0	0
REFIRE-157	273	477	204	0	3	1	0	0
REFIRE-157	274	284	10	1	3	1	0	0
REFIRE-157	275	276	1	1	3	3	1	0
REFIRE-157	275	276	1	1	3	1	1	0
REFIRE-158	276	477	201	0	3	1	0	0
REFIRE-158	277	283	6	1	3	1	0	0
REFIRE-158	281	283	2	1	1	1	0	0
REFIRE-158	282	477	195	0	3	2	0	0
REFIRE-158	294	424	130	1	4	4	1	0
REFIRE-158	296	477	181	0	3	1	0	0
REFIRE-158	296	477	181	0	3	1	0	0
REFIRE-158	302	305	3	1	3	1	1	4
REFIRE-158	303	304	1	1	3	1	0	1
REFIRE-159	305	330	25	1	3	4	1	0
REFIRE-159	307	317	10	1	3	4	1	0
REFIRE-159	307	477	170	0	3	4	1	0
REFIRE-159	311	320	9	1	3	1	1	1
REFIRE-159	314	317	3	1	3	4	1	0
REFIRE-159	314	317	3	1	3	4	1	0
REFIRE-159	314	317	3	1	3	5	1	0
REFIRE-159	314	317	3	1	3	4	1	0
REFIRE-159	314	317	3	1	3	5	1	0
REFIRE-159	316	477	161	0	3	1	0	0
REFIRE-160	321	322	1	1	3	3	1	0
REFIRE-160	322	477	155	0	3	1	0	0
REFIRE-160	324	338	14	1	3	1	1	0
REFIRE-160	325	477	152	0	4	4	1	0
REFIRE-160	331	334	3	1	3	1	0	0
REFIRE-160	333	335	2	1	3	1	1	0
REFIRE-160	335	336	1	1	3	1	1	0
REFIRE-160	338	339	1	1	3	3	1	0
REFIRE-160	342	343	1	1	3	4	1	0
REFIRE-160	342	343	1	1	3	3	1	0
REFIRE-161	342	343	1	1	4	5	0	1
REFIRE-161	342	351	9	1	3	3	1	1
REFIRE-161	342	372	30	1	3	1	0	0
REFIRE-161	342	343	1	1	3	1	1	0
REFIRE-161	344	347	3	1	3	1	1	1
REFIRE-161	346	477	131	0	3	1	0	0
REFIRE-161	348	349	1	1	3	1	1	0
REFIRE-161	350	477	127	0	3	1	1	0
REFIRE-161	360	477	117	0	3	4	0	0
REFIRE-161	363	364	1	1	3	4	1	0
N-471	15	41	26	1	3	5	1	0
N-471	38	39	1	1	4	3	0	0
N-472	60	63	3	1	3	4	0	0
N-472	64	66	2	1	3	1	0	0
N-472	66	193	127	1	3	1	1	0
N-472	66	477	411	0	3	4	0	0
N-472	67	477	410	0	3	4	0	0
N-472	73	102	29	1	3	1	1	2
N-472	73	477	404	0	3	1	0	0
N-472	73	74	1	1	3	1	0	2
N-472	74	477	403	0	4	1	0	0
N-472	77	477	400	0	3	4	1	2
N-473	81	477	396	0	3	4	0	0
N-473	84	477	393	0	3	5	0	0
N-473	88	477	389	0	3	1	0	0
N-473	94	111	17	1	3	1	0	0
N-473	94	111	17	1	3	1	1	0
N-473	102	299	197	1	3	3	0	0
N-473	102	291	189	1	4	1	0	0
N-473	105	111	6	1	4	1	0	0
N-473	106	477	371	0	4	2	0	0
N-473	114	477	363	0	4	1	0	0
N-474	115	193	78	1	3	1	1	0
N-474	126	193	67	1	3	1	1	0
N-474	126	127	1	1	3	1	0	0
N-474	137	477	340	0	3	1	0	0
N-474	157	477	320	0	3	1	0	0
N-474	172	413	241	1	3	5	0	3
N-474	172	477	305	0	3	5	0	0
N-474	172	477	305	0	4	5	0	0
N-474	172	477	305	0	3	5	0	0
N-474	172	477	305	0	3	5	0	0
N-475	172	477	305	0	3	5	0	0
N-475	172	477	305	0	3	5	0	0
N-475	172	477	305	0	3	5	0	0
N-475	172	477	305	0	3	2	0	1
N-475	175	477	302	0	3	2	0	0
N-475	175	477	302	0	3	5	0	0
N-475	177	178	1	1	3	1	0	1
N-475	178	477	299	0	4	5	0	0
N-475	178	477	299	0	3	1	1	2
N-475	179	477	298	0	3	1	0	0
N-476	184	408	224	1	3	1	0	2
N-476	185	477	292	0	3	2	0	0
N-476	190	477	287	0	3	1	0	0
N-476	192	477	285	0	3	1	0	0
N-476	202	207	5	1	4	1	0	0
N-476	202	203	1	1	4	1	0	0
N-476	209	477	268	0	3	1	0	0
N-476	211	212	1	1	3	1	1	0
N-476	224	287	63	1	3	1	0	0
N-476	226	477	251	0	3	1	0	0
N-477	234	477	243	0	3	1	0	0
N-477	253	477	224	0	4	1	0	0
N-477	256	477	221	0	4	1	0	1
N-477	256	305	49	1	3	3	1	3
N-477	256	266	10	1	3	1	1	2
N-477	256	266	10	1	2	1	0	1
N-477	259	266	7	1	3	1	1	2
N-477	264	477	213	0	3	3	0	0
N-477	266	477	211	0	4	5	0	0
N-477	266	477	211	0	4	5	0	0
N-478	291	477	186	0	3	3	0	1
N-478	297	477	180	0	3	3	0	0
N-478	301	302	1	1	3	1	0	0
N-478	302	477	175	0	4	1	0	0
N-478	315	477	162	0	4	1	0	2
N-478	315	316	1	1	3	3	0	0
N-478	315	477	162	0	3	3	0	1
N-478	318	477	159	0	3	1	0	0
N-478	318	351	33	1	3	2	0	0
N-479	318	477	159	0	3	2	0	0
N-479	324	333	9	1	3	1	0	0
N-479	325	326	1	1	3	1	1	0
N-479	331	334	3	1	3	1	0	0
N-479	335	477	142	0	3	1	0	1
N-479	336	477	141	0	3	4	0	2
N-479	343	347	4	1	2	1	0	0
N-479	347	477	130	0	4	1	0	0
N-479	354	477	123	0	3	4	0	0
N-479	360	477	117	0	3	4	0	0
N-480	360	477	117	0	4	4	0	0
NAPSE-110	283	477	194	0	4	4	0	0
NAPSE-110	307	433	126	1	1	3	0	0
NCOPE-125	1	477	476	0	3	3	1	1
NCOPE-125	2	3	1	1	3	2	2	0
NCOPE-126	2	3	1	1	3	1	0	0
NCOPE-126	3	4	1	1	3	1	2	0
NCOPE-126	4	5	1	1	3	3	2	1
NCOPE-126	21	22	1	1	4	1	2	0
NCOPE-126	22	50	28	1	4	4	0	0
NCOPE-126	28	29	1	1	3	1	2	0
NCOPE-126	29	30	1	1	3	1	2	0
NCOPE-126	29	36	7	1	3	4	2	1
NCOPE-126	29	32	3	1	3	1	0	0
NCOPE-126	36	52	16	1	3	1	2	0
NCOPE-127	37	129	92	1	3	2	2	1
NCOPE-127	38	39	1	1	3	1	0	0
NCOPE-127	39	42	3	1	3	1	2	0
NCOPE-127	40	41	1	1	1	1	0	0
NCOPE-127	41	43	2	1	3	4	2	0
NCOPE-127	42	51	9	1	3	1	2	0
NCOPE-127	43	50	7	1	3	1	2	1
NCOPE-127	53	477	424	0	4	1	0	0
NCOPE-127	53	54	1	1	3	1	0	1
NCOPE-127	60	61	1	1	3	2	2	0
NCOPE-128	65	66	1	1	3	4	2	1
NCOPE-128	70	74	4	1	3	2	1	0
NCOPE-128	73	74	1	1	3	1	2	2
NCOPE-128	74	77	3	1	4	2	2	0
NCOPE-128	77	79	2	1	3	1	0	0
NCOPE-128	80	81	1	1	3	1	2	0
NCOPE-128	81	82	1	1	3	1	0	1
NCOPE-128	84	93	9	1	3	2	1	0
NCOPE-128	87	94	7	1	3	1	2	1
NCOPE-128	88	89	1	1	3	2	2	0
NCOPE-129	91	92	1	1	3	1	2	1
NCOPE-129	92	93	1	1	3	1	2	0
NCOPE-129	93	94	1	1	3	4	2	0
NCOPE-129	93	94	1	1	4	1	3	0
NCOPE-129	93	94	1	1	3	1	2	1
NCOPE-129	94	157	63	1	4	4	2	1
NCOPE-129	95	98	3	1	3	1	1	0
NCOPE-129	98	158	60	1	4	1	2	0
NCOPE-129	99	100	1	1	3	1	2	0
NCOPE-129	99	106	7	1	3	4	2	0
NCOPE-130	99	109	10	1	3	4	1	0
NCOPE-130	101	102	1	1	3	1	2	0
NCOPE-130	101	102	1	1	4	4	2	0
NCOPE-130	112	113	1	1	4	1	2	0
NCOPE-130	112	113	1	1	3	1	2	0
NCOPE-130	112	113	1	1	3	1	0	0
NCOPE-130	113	115	2	1	3	1	2	0
NCOPE-130	115	116	1	1	3	1	2	1
NCOPE-130	122	126	4	1	3	1	2	0
NCOPE-130	130	148	18	1	3	1	2	0
NCOPE-131	133	134	1	1	4	2	2	0
NCOPE-131	134	135	1	1	3	4	1	0
NCOPE-131	134	147	13	1	3	1	2	0
NCOPE-131	139	140	1	1	4	1	0	0
NCOPE-131	141	143	2	1	3	1	2	0
NCOPE-131	141	147	6	1	3	1	2	1
NCOPE-131	142	143	1	1	4	2	2	0
NCOPE-131	146	147	1	1	4	1	2	1
NCOPE-131	148	149	1	1	3	1	2	0
NCOPE-131	148	149	1	1	3	1	2	0
NCOPE-132	151	152	1	1	3	1	2	0
NCOPE-132	161	170	9	1	3	1	2	0
NCOPE-132	161	162	1	1	3	4	3	0
NCOPE-132	162	163	1	1	3	4	1	0
NCOPE-132	163	164	1	1	3	4	2	0
NCOPE-132	171	477	306	0	4	4	0	0
NCOPE-132	172	173	1	1	3	1	2	0
NCOPE-132	177	179	2	1	3	3	1	0
NCOPE-132	177	182	5	1	4	4	2	0
NCOPE-132	177	182	5	1	3	4	2	0
NCOPE-133	182	183	1	1	3	1	0	0
NCOPE-133	186	187	1	1	3	1	1	0
NCOPE-133	189	477	288	0	3	3	1	1
NCOPE-133	189	190	1	1	3	1	3	0
NCOPE-133	190	191	1	1	5	1	2	1
NCOPE-133	191	192	1	1	3	1	2	0
NCOPE-133	191	192	1	1	3	4	3	0
NCOPE-133	193	194	1	1	3	1	3	1
NCOPE-133	196	197	1	1	3	1	3	0
NCOPE-133	196	219	23	1	4	1	3	0
NCOPE-134	200	201	1	1	3	1	3	0
NCOPE-134	200	201	1	1	4	4	3	1
NCOPE-134	202	203	1	1	3	1	2	0
NCOPE-134	204	206	2	1	3	1	3	0
NCOPE-134	204	205	1	1	3	1	3	1
NCOPE-134	204	206	2	1	4	4	0	0
NCOPE-134	206	207	1	1	3	1	3	0
NCOPE-134	211	212	1	1	3	1	3	0
NCOPE-134	212	220	8	1	3	2	2	0
NCOPE-134	216	477	261	0	3	2	0	0
NCOPE-135	220	221	1	1	3	1	3	0
NCOPE-135	221	222	1	1	3	1	0	1
NCOPE-135	221	222	1	1	3	1	3	0
NCOPE-135	222	223	1	1	5	1	3	0
NCOPE-135	224	225	1	1	3	1	3	0
NCOPE-135	224	225	1	1	4	4	3	0
NCOPE-135	227	228	1	1	3	1	3	0
NCOPE-135	227	228	1	1	3	1	3	0
NCOPE-135	227	228	1	1	3	1	3	0
NCOPE-135	239	240	1	1	4	2	0	1
NCOPE-136	245	246	1	1	3	1	3	0
NCOPE-136	246	247	1	1	3	1	3	0
NCOPE-136	247	248	1	1	3	1	2	0
NCOPE-136	247	248	1	1	4	1	2	0
NCOPE-136	247	248	1	1	1	1	2	0
NCOPE-136	247	248	1	1	3	1	2	0
NCOPE-136	247	248	1	1	3	1	3	0
NCOPE-136	252	273	21	1	3	2	3	0
NCOPE-136	252	329	77	1	3	2	3	0
NCOPE-136	253	283	30	1	3	2	2	1
NCOPE-137	254	255	1	1	3	1	3	0
NCOPE-137	255	256	1	1	3	1	1	0
NCOPE-137	259	260	1	1	3	1	2	1
NCOPE-137	259	262	3	1	3	1	3	1
NCOPE-137	262	263	1	1	3	1	3	0
NCOPE-137	268	269	1	1	3	1	3	0
NCOPE-137	269	277	8	1	4	1	3	0
NCOPE-137	273	274	1	1	4	1	3	0
NCOPE-137	275	276	1	1	4	4	0	0
NCOPE-137	277	280	3	1	3	4	3	0
NCOPE-138	282	283	1	1	3	1	3	0
NCOPE-138	282	338	56	1	3	3	2	1
NCOPE-138	282	283	1	1	3	4	3	0
NCOPE-138	283	284	1	1	3	1	3	0
NCOPE-138	287	288	1	1	3	4	3	0
NCOPE-138	287	288	1	1	3	4	3	0
NCOPE-138	291	303	12	1	3	1	0	0
NCOPE-138	295	296	1	1	3	1	3	0
NCOPE-138	295	302	7	1	3	1	3	0
NCOPE-138	296	297	1	1	3	1	3	0
NCOPE-139	304	305	1	1	3	1	3	0
NCOPE-139	305	315	10	1	3	1	3	0
NCOPE-139	308	310	2	1	3	4	2	0
NCOPE-139	308	309	1	1	4	1	3	0
NCOPE-139	309	333	24	1	3	4	3	0
NCOPE-139	310	319	9	1	3	2	2	1
NCOPE-139	315	316	1	1	4	4	3	0
NCOPE-139	319	325	6	1	3	4	2	0
NCOPE-139	322	323	1	1	3	1	1	0
NCOPE-139	323	324	1	1	3	1	2	0
NCOPE-140	326	477	151	0	3	3	2	2
NCOPE-140	329	477	148	0	3	2	2	1
NCOPE-140	329	361	32	1	3	3	2	1
NCOPE-140	330	477	147	0	4	1	2	1
NCOPE-140	331	332	1	1	4	1	2	0
NCOPE-140	336	337	1	1	3	1	3	0
NCOPE-140	336	337	1	1	3	1	2	0
NCOPE-140	337	338	1	1	4	1	3	0
NCOPE-140	338	339	1	1	3	1	3	0
NCOPE-140	340	341	1	1	3	4	3	0
NCOPE-141	343	477	134	0	3	3	1	0
NCOPE-141	343	344	1	1	3	1	3	0
NCOPE-141	343	344	1	1	3	4	3	0
NCOPE-141	345	351	6	1	3	5	1	0
NCOPE-141	345	351	6	1	3	5	1	0
NCOPE-141	346	347	1	1	3	4	3	0
NCOPE-141	346	347	1	1	3	1	3	0
NCOPE-141	351	385	34	1	3	5	1	0
NCOPE-141	353	354	1	1	3	1	3	0
NCOPE-142	354	355	1	1	3	1	3	0
NCOPE-142	354	477	123	0	3	5	1	0
NCOPE-142	361	362	1	1	4	4	3	0
STEMML-205	1	477	476	0	4	4	0	0
STEMML-205	2	25	23	1	3	3	1	0
STEMML-205	4	15	11	1	3	1	1	0
STEMML-205	5	11	6	1	3	3	1	0
STEMML-206	6	11	5	1	3	1	1	0
STEMML-206	7	477	470	0	3	5	1	0
STEMML-206	7	11	4	1	3	5	1	0
STEMML-206	7	11	4	1	3	5	1	0
STEMML-206	11	477	466	0	3	5	0	2
STEMML-206	11	477	466	0	3	5	0	0
STEMML-206	11	214	203	1	3	5	1	0
STEMML-206	11	35	24	1	3	5	1	0
STEMML-206	11	15	4	1	3	1	1	0
STEMML-207	13	33	20	1	3	5	1	0
STEMML-207	13	15	2	1	3	1	1	0
STEMML-207	13	15	2	1	3	1	1	0
STEMML-207	15	16	1	1	3	1	1	0
STEMML-207	18	19	1	1	3	1	1	0
STEMML-207	24	54	30	1	3	1	1	0
STEMML-207	24	477	453	0	3	5	1	0
STEMML-207	24	477	453	0	3	5	0	1
STEMML-207	24	92	68	1	3	3	1	0
STEMML-207	24	477	453	0	3	5	0	0
STEMML-208	24	477	453	0	3	1	0	0
STEMML-208	24	33	9	1	3	5	1	0
STEMML-208	24	37	13	1	3	5	1	0
STEMML-208	26	477	451	0	3	5	0	2
STEMML-208	26	138	112	1	3	5	1	4
STEMML-208	26	174	148	1	3	5	1	4
STEMML-208	26	144	118	1	3	5	1	1
STEMML-208	26	210	184	1	3	5	1	4
STEMML-208	26	477	451	0	3	5	0	0
STEMML-208	26	477	451	0	3	5	0	0
STEMML-209	26	217	191	1	3	5	1	0
STEMML-209	26	36	10	1	3	5	1	0
STEMML-209	26	36	10	1	3	3	1	1
STEMML-209	26	36	10	1	3	5	1	0
STEMML-209	26	36	10	1	3	5	1	0
STEMML-209	26	36	10	1	3	5	1	0
STEMML-209	26	36	10	1	3	5	1	0
STEMML-209	27	36	9	1	3	5	1	0
STEMML-209	27	36	9	1	3	1	1	0
STEMML-209	27	36	9	1	3	5	1	0
STEMML-210	30	36	6	1	3	1	1	0
STEMML-210	30	36	6	1	3	1	1	0
STEMML-210	30	477	447	0	3	4	0	1
STEMML-210	30	477	447	0	3	4	0	1
STEMML-210	32	477	445	0	3	3	0	0
STEMML-210	32	36	4	1	3	5	1	0
STEMML-210	32	36	4	1	3	5	1	0
STEMML-210	32	477	445	0	3	5	0	0
STEMML-210	33	36	3	1	3	5	1	0
STEMML-210	33	205	172	1	3	5	1	0
STEMML-211	33	61	28	1	3	5	1	0
STEMML-211	33	477	444	0	3	5	0	0
STEMML-211	33	477	444	0	3	5	0	0
STEMML-211	33	477	444	0	3	5	0	0
STEMML-211	33	477	444	0	3	5	0	0
STEMML-211	33	477	444	0	3	5	0	0
STEMML-211	33	477	444	0	3	5	0	0
STEMML-211	33	192	159	1	3	5	1	0
STEMML-211	33	477	444	0	3	5	0	0
STEMML-211	33	192	159	1	3	5	1	0
STEMML-212	33	35	2	1	3	5	1	0
STEMML-212	33	477	444	0	3	5	0	0
STEMML-212	33	477	444	0	3	5	0	0
STEMML-212	33	477	444	0	3	5	0	0
STEMML-212	33	477	444	0	3	5	0	0
STEMML-212	33	477	444	0	3	5	0	0
STEMML-212	33	477	444	0	3	5	0	0
STEMML-212	33	477	444	0	3	5	0	0
STEMML-212	33	477	444	0	3	5	0	0
STEMML-212	34	36	2	1	3	5	1	0
STEMML-213	34	255	221	1	3	3	1	0
STEMML-213	35	166	131	1	3	5	1	0
STEMML-213	36	37	1	1	3	1	1	0
STEMML-213	36	37	1	1	3	5	1	0
STEMML-213	37	167	130	1	3	5	1	0
STEMML-213	37	43	6	1	3	5	1	0
STEMML-213	38	54	16	1	3	1	1	0
STEMML-213	38	477	439	0	4	1	0	0
STEMML-213	38	477	439	0	4	1	0	0
STEMML-213	39	40	1	1	3	1	1	0
STEMML-214	39	54	15	1	3	1	1	0
STEMML-214	40	477	437	0	3	5	0	0
STEMML-214	40	477	437	0	3	5	0	0
STEMML-214	40	41	1	1	3	1	1	0
STEMML-214	40	41	1	1	3	1	1	0
STEMML-214	40	41	1	1	3	1	1	0
STEMML-214	41	477	436	0	3	5	0	0
STEMML-214	43	47	4	1	3	1	1	0
STEMML-214	45	54	9	1	3	5	1	0
STEMML-214	46	47	1	1	4	3	1	0
STEMML-215	46	47	1	1	3	1	1	0
STEMML-215	46	47	1	1	3	1	1	0
STEMML-215	47	48	1	1	3	1	1	0
STEMML-215	47	48	1	1	3	1	1	0
STEMML-215	49	54	5	1	3	1	1	0
STEMML-215	49	54	5	1	3	3	1	0
STEMML-215	50	54	4	1	3	1	1	0
STEMML-215	51	54	3	1	3	1	1	0
STEMML-215	52	54	2	1	3	1	1	0
STEMML-215	52	477	425	0	3	5	0	0
STEMML-216	53	54	1	1	3	5	1	0
STEMML-216	53	54	1	1	3	1	1	0
STEMML-216	58	59	1	1	3	1	1	0
STEMML-216	58	59	1	1	3	1	1	0
STEMML-216	58	60	2	1	3	3	1	0
STEMML-216	59	477	418	0	3	5	0	0
STEMML-216	60	61	1	1	3	1	1	1
STEMML-216	61	62	1	1	3	5	1	0
STEMML-216	62	477	415	0	3	3	0	0
STEMML-216	65	477	412	0	3	3	0	0
STEMML-217	65	66	1	1	3	1	1	0
STEMML-217	65	66	1	1	3	5	1	0
STEMML-217	65	66	1	1	3	5	1	0
STEMML-217	66	67	1	1	3	5	1	0
STEMML-217	66	477	411	0	3	1	0	0
STEMML-217	66	67	1	1	3	5	1	0
STEMML-217	66	67	1	1	3	5	1	0
STEMML-217	67	68	1	1	2	3	1	0
STEMML-217	67	68	1	1	3	5	1	0
STEMML-218	67	68	1	1	3	1	1	0
STEMML-218	70	75	5	1	3	1	1	0
STEMML-218	70	71	1	1	3	5	1	0
STEMML-218	70	71	1	1	3	5	1	0
STEMML-218	70	71	1	1	3	5	1	0
STEMML-218	71	75	4	1	3	5	1	0
STEMML-218	71	75	4	1	3	5	1	0
STEMML-218	71	75	4	1	3	5	1	0
STEMML-218	74	75	1	1	3	5	1	0
STEMML-218	75	477	402	0	3	5	0	0
STEMML-219	75	83	8	1	3	3	1	0
STEMML-219	75	83	8	1	3	3	1	2
STEMML-219	76	477	401	0	3	5	0	1
STEMML-219	76	79	3	1	3	3	1	0
STEMML-219	76	79	3	1	3	3	1	0
STEMML-219	76	477	401	0	3	3	0	0
STEMML-219	76	80	4	1	3	3	1	0
STEMML-219	76	97	21	1	3	3	1	0
STEMML-219	76	477	401	0	3	3	0	0
STEMML-219	77	78	1	1	3	5	1	0
STEMML-220	77	78	1	1	3	5	1	0
STEMML-220	80	81	1	1	1	5	1	0
STEMML-220	80	83	3	1	3	3	1	0
STEMML-220	80	477	397	0	3	3	0	0
STEMML-220	80	81	1	1	3	5	1	0
STEMML-220	80	477	397	0	3	3	0	0
STEMML-220	81	477	396	0	3	3	0	0
STEMML-220	83	84	1	1	3	3	1	1
STEMML-220	83	477	394	0	3	5	0	0
STEMML-220	83	210	127	1	3	3	1	0
STEMML-221	83	85	2	1	3	3	1	0
STEMML-221	83	477	394	0	3	3	0	0
STEMML-221	84	85	1	1	3	3	1	0
STEMML-221	84	85	1	1	3	3	1	0
STEMML-221	85	86	1	1	3	3	1	0
STEMML-221	85	477	392	0	3	3	0	0
STEMML-221	87	477	390	0	3	3	0	0
STEMML-221	88	477	389	0	3	3	0	0
STEMML-221	89	91	2	1	3	5	1	0
STEMML-221	89	477	388	0	3	5	0	0
STEMML-222	89	91	2	1	3	5	1	0
STEMML-222	89	91	2	1	3	5	1	0
STEMML-222	89	91	2	1	3	5	1	0
STEMML-222	89	91	2	1	3	5	1	0
STEMML-222	89	91	2	1	3	5	1	0
STEMML-222	90	91	1	1	3	1	1	0
STEMML-222	92	477	385	0	3	3	0	0
STEMML-222	92	477	385	0	3	3	0	0
STEMML-222	92	477	385	0	3	3	0	0
STEMML-222	92	93	1	1	3	3	1	0
STEMML-223	92	158	66	1	3	3	1	0
STEMML-223	92	477	385	0	3	3	0	0
STEMML-223	93	477	384	0	3	3	0	0
STEMML-223	93	142	49	1	3	3	1	0
STEMML-223	94	95	1	1	1	3	1	0
STEMML-223	95	141	46	1	3	3	1	0
STEMML-223	96	102	6	1	3	5	1	0
STEMML-223	96	116	20	1	3	5	1	0
STEMML-223	97	98	1	1	3	3	1	0
STEMML-223	102	477	375	0	3	5	0	0
STEMML-224	103	104	1	1	3	1	1	1
STEMML-224	103	104	1	1	3	5	1	0
STEMML-224	103	104	1	1	3	5	1	0
STEMML-224	103	104	1	1	3	5	1	0
STEMML-224	103	104	1	1	3	1	1	0
STEMML-224	104	169	65	1	3	1	1	0
STEMML-224	106	116	10	1	3	5	1	0
STEMML-224	107	141	34	1	3	1	1	0
STEMML-224	107	477	370	0	3	5	0	1
STEMML-224	107	108	1	1	3	5	1	0
STEMML-225	107	108	1	1	3	5	1	0
STEMML-225	107	109	2	1	3	5	1	1
STEMML-225	107	108	1	1	3	5	1	0
STEMML-225	107	477	370	0	3	3	0	0
STEMML-225	107	108	1	1	3	1	1	0
STEMML-225	108	109	1	1	3	5	1	0
STEMML-225	108	109	1	1	3	5	1	0
STEMML-225	108	109	1	1	3	5	1	0
STEMML-225	109	110	1	1	3	5	1	0
STEMML-226	109	110	1	1	3	5	1	0
STEMML-226	109	110	1	1	3	5	1	0
STEMML-226	109	110	1	1	3	5	1	0
STEMML-226	109	110	1	1	3	5	1	0
STEMML-226	109	141	32	1	3	1	1	0
STEMML-226	110	141	31	1	3	1	1	0
STEMML-226	110	477	367	0	3	1	0	0
STEMML-226	110	113	3	1	3	5	1	0
STEMML-226	110	113	3	1	3	5	1	0
STEMML-226	111	477	366	0	3	5	0	0
STEMML-227	111	113	2	1	3	5	1	0
STEMML-227	111	477	366	0	3	5	0	0
STEMML-227	111	477	366	0	3	1	0	0
STEMML-227	111	477	366	0	3	5	0	0
STEMML-227	111	477	366	0	3	5	0	0
STEMML-227	111	113	2	1	3	1	1	0
STEMML-227	111	113	2	1	3	5	1	0
STEMML-227	112	113	1	1	3	3	1	3
STEMML-227	114	118	4	1	3	3	1	0
STEMML-227	116	118	2	1	3	5	1	0
STEMML-228	116	118	2	1	3	5	1	0
STEMML-228	116	118	2	1	3	5	1	0
STEMML-228	116	118	2	1	3	5	1	0
STEMML-228	116	118	2	1	3	1	1	1
STEMML-228	117	118	1	1	3	3	1	0
STEMML-228	118	477	359	0	3	5	0	0
STEMML-228	118	119	1	1	3	5	1	0
STEMML-228	118	119	1	1	3	5	1	0
STEMML-228	118	119	1	1	3	5	1	0
STEMML-228	118	440	322	1	3	5	1	0
STEMML-229	118	477	359	0	3	5	0	0
STEMML-229	118	440	322	1	3	5	1	0
STEMML-229	118	440	322	1	3	5	1	0
STEMML-229	119	120	1	1	3	1	1	0
STEMML-229	121	141	20	1	3	1	1	0
STEMML-229	121	122	1	1	3	5	1	0
STEMML-229	121	137	16	1	3	5	1	0
STEMML-229	123	141	18	1	3	1	1	0
STEMML-229	123	130	7	1	3	5	1	0
STEMML-229	123	133	10	1	3	5	1	0
STEMML-230	123	164	41	1	3	5	1	0
STEMML-230	123	194	71	1	3	5	1	0
STEMML-230	123	221	98	1	3	5	1	0
STEMML-230	123	477	354	0	3	5	0	0
STEMML-230	123	225	102	1	3	5	1	0
STEMML-230	126	141	15	1	3	1	1	0
STEMML-230	128	134	6	1	3	5	1	0
STEMML-230	128	477	349	0	3	5	0	0
STEMML-230	128	129	1	1	3	5	1	0
STEMML-230	128	129	1	1	3	5	1	0
STEMML-231	128	129	1	1	3	5	1	0
STEMML-231	128	130	2	1	3	5	1	0
STEMML-231	129	477	348	0	3	5	0	0
STEMML-231	129	477	348	0	3	5	0	0
STEMML-231	129	130	1	1	3	5	1	0
STEMML-231	130	131	1	1	3	3	1	0
STEMML-231	130	477	347	0	3	1	0	0
STEMML-231	132	133	1	1	3	5	1	1
STEMML-231	132	134	2	1	3	5	1	1
STEMML-231	132	138	6	1	3	5	1	1
STEMML-232	132	138	6	1	3	5	1	1
STEMML-232	132	144	12	1	3	5	1	1
STEMML-232	132	144	12	1	3	5	1	1
STEMML-232	132	477	345	0	3	5	0	1
STEMML-232	132	155	23	1	3	5	1	2
STEMML-232	134	141	7	1	3	1	1	0
STEMML-232	134	141	7	1	3	1	1	0
STEMML-232	136	137	1	1	3	5	1	0
STEMML-232	136	137	1	1	3	5	1	0
STEMML-232	137	141	4	1	3	5	1	0
STEMML-233	138	477	339	0	3	3	0	0
STEMML-233	138	139	1	1	3	5	1	0
STEMML-233	138	477	339	0	3	5	0	0
STEMML-233	138	142	4	1	3	5	1	1
STEMML-233	139	140	1	1	3	3	1	1
STEMML-233	139	141	2	1	3	5	1	1
STEMML-233	140	477	337	0	3	1	0	0
STEMML-233	140	141	1	1	3	1	1	0
STEMML-233	141	477	336	0	3	2	0	0
STEMML-234	142	169	27	1	3	1	1	0
STEMML-234	142	477	335	0	3	1	0	0
STEMML-234	142	477	335	0	3	5	0	0
STEMML-234	143	169	26	1	3	1	1	0
STEMML-234	144	152	8	1	3	5	1	1
STEMML-234	144	145	1	1	3	5	1	1
STEMML-234	144	145	1	1	3	5	1	1
STEMML-234	148	169	21	1	3	1	1	0
STEMML-234	148	149	1	1	3	5	1	1
STEMML-234	148	151	3	1	3	5	1	1
STEMML-235	149	150	1	1	3	1	1	0
STEMML-235	150	151	1	1	3	3	1	0
STEMML-235	150	151	1	1	3	5	1	1
STEMML-235	151	169	18	1	3	1	1	0
STEMML-235	151	477	326	0	3	5	0	1
STEMML-235	152	477	325	0	3	5	0	0
STEMML-235	152	169	17	1	3	3	1	0
STEMML-235	152	169	17	1	3	3	1	0
STEMML-235	153	154	1	1	3	5	1	1
STEMML-235	153	155	2	1	3	5	1	1
STEMML-236	154	477	323	0	3	3	0	0
STEMML-236	155	156	1	1	3	1	1	0
STEMML-236	155	156	1	1	3	1	1	0
STEMML-236	155	477	322	0	3	1	0	0
STEMML-236	155	156	1	1	3	5	1	0
STEMML-236	155	477	322	0	3	5	0	1
STEMML-236	156	157	1	1	3	5	1	0
STEMML-236	156	157	1	1	3	5	1	0
STEMML-236	156	157	1	1	3	5	1	0
STEMML-236	157	167	10	1	3	1	1	0
STEMML-237	157	169	12	1	3	1	1	0
STEMML-237	157	158	1	1	3	5	1	0
STEMML-237	157	158	1	1	3	5	1	0
STEMML-237	157	158	1	1	3	5	1	1
STEMML-237	157	158	1	1	3	5	1	0
STEMML-237	157	169	12	1	3	3	1	0
STEMML-237	157	164	7	1	3	5	1	0
STEMML-237	159	160	1	1	3	1	1	0
STEMML-237	160	161	1	1	3	5	1	0
STEMML-237	161	162	1	1	3	3	1	1
STEMML-238	161	162	1	1	2	5	1	0
STEMML-238	161	162	1	1	3	5	1	0
STEMML-238	161	162	1	1	3	5	1	0
STEMML-238	162	163	1	1	3	1	1	1
STEMML-238	162	477	315	0	3	3	0	0
STEMML-238	162	165	3	1	3	3	1	0
STEMML-238	162	477	315	0	3	3	0	0
STEMML-238	162	477	315	0	3	3	0	0
STEMML-238	162	169	7	1	3	1	1	0
STEMML-238	162	163	1	1	3	5	1	0
STEMML-239	163	164	1	1	3	3	1	0
STEMML-239	163	164	1	1	3	5	1	0
STEMML-239	163	164	1	1	3	5	1	0
STEMML-239	163	164	1	1	3	5	1	0
STEMML-239	163	164	1	1	3	5	1	0
STEMML-239	164	477	313	0	3	5	0	0
STEMML-239	165	169	4	1	3	1	1	1
STEMML-239	165	168	3	1	3	1	1	0
STEMML-239	166	167	1	1	3	1	1	0
STEMML-240	166	167	1	1	3	1	1	1
STEMML-240	166	167	1	1	3	1	1	0
STEMML-240	166	167	1	1	3	5	1	0
STEMML-240	166	193	27	1	3	1	1	0
STEMML-240	167	168	1	1	3	1	1	0
STEMML-240	167	168	1	1	3	3	1	0
STEMML-240	167	168	1	1	3	1	1	0
STEMML-240	169	170	1	1	3	3	1	0
STEMML-240	169	176	7	1	3	1	1	0
STEMML-240	169	172	3	1	3	5	1	0
STEMML-241	169	477	308	0	3	1	0	0
STEMML-241	169	477	308	0	3	5	0	0
STEMML-241	169	193	24	1	3	1	1	0
STEMML-241	169	172	3	1	3	1	1	0
STEMML-241	170	193	23	1	3	1	1	0
STEMML-241	171	172	1	1	3	5	1	0
STEMML-241	171	173	2	1	3	5	1	0
STEMML-241	172	173	1	1	3	5	1	0
STEMML-241	174	193	19	1	3	5	1	1
STEMML-241	174	198	24	1	3	5	1	1
STEMML-242	174	210	36	1	3	5	1	2
STEMML-242	174	477	303	0	3	5	0	1
STEMML-242	174	202	28	1	3	5	1	1
STEMML-242	174	205	31	1	3	5	1	2
STEMML-242	174	210	36	1	3	5	1	1
STEMML-242	176	188	12	1	3	1	1	0
STEMML-242	178	477	299	0	3	1	0	0
STEMML-242	178	477	299	0	3	1	0	0
STEMML-242	188	189	1	1	3	1	1	0
STEMML-242	188	189	1	1	3	1	1	0
STEMML-243	192	193	1	1	3	5	1	0
STEMML-243	193	194	1	1	3	1	1	0
STEMML-243	193	477	284	0	3	5	0	0
STEMML-243	193	477	284	0	3	5	0	0
STEMML-243	193	194	1	1	3	5	1	0
STEMML-243	193	477	284	0	3	5	0	0
STEMML-243	193	194	1	1	3	5	1	0
STEMML-243	193	194	1	1	3	1	1	0
STEMML-243	193	194	1	1	3	1	1	0
STEMML-244	193	199	6	1	3	1	1	0
STEMML-244	194	195	1	1	3	1	1	0
STEMML-244	194	195	1	1	3	5	1	0
STEMML-244	194	199	5	1	3	5	1	2
STEMML-244	196	197	1	1	3	5	1	0
STEMML-244	196	477	281	0	3	5	0	0
STEMML-244	197	253	56	1	3	5	1	1
STEMML-244	197	477	280	0	3	5	0	1
STEMML-244	197	198	1	1	3	5	1	0
STEMML-244	198	199	1	1	3	5	1	0
STEMML-245	198	199	1	1	3	5	1	0
STEMML-245	198	477	279	0	3	5	0	0
STEMML-245	198	199	1	1	3	5	1	0
STEMML-245	198	199	1	1	3	5	1	0
STEMML-245	198	199	1	1	3	1	1	0
STEMML-245	199	200	1	1	3	5	1	0
STEMML-245	199	201	2	1	3	5	1	0
STEMML-245	199	200	1	1	3	5	1	1
STEMML-245	199	220	21	1	3	5	1	0
STEMML-245	201	202	1	1	3	5	1	0
STEMML-246	201	477	276	0	3	5	0	0
STEMML-246	201	213	12	1	3	5	1	0
STEMML-246	202	203	1	1	3	5	1	0
STEMML-246	205	206	1	1	3	3	1	1
STEMML-246	205	477	272	0	3	3	0	0
STEMML-246	205	477	272	0	3	5	0	0
STEMML-246	206	208	2	1	3	3	1	0
STEMML-246	206	477	271	0	3	1	0	0
STEMML-246	206	440	234	1	3	5	1	0
STEMML-246	208	211	3	1	3	1	1	0
STEMML-247	208	477	269	0	3	3	0	0
STEMML-247	210	211	1	1	3	5	1	0
STEMML-247	210	477	267	0	3	3	0	1
STEMML-247	211	477	266	0	3	3	0	0
STEMML-247	211	477	266	0	3	5	0	0
STEMML-247	211	477	266	0	3	1	0	0
STEMML-247	211	477	266	0	3	1	0	0
STEMML-247	212	213	1	1	3	1	1	0
STEMML-247	212	477	265	0	3	1	0	0
STEMML-247	213	440	227	1	3	5	1	0
STEMML-248	213	214	1	1	3	1	1	0
STEMML-248	213	477	264	0	3	1	0	0
STEMML-248	213	214	1	1	3	1	1	0
STEMML-248	214	215	1	1	3	1	1	0
STEMML-248	214	215	1	1	3	1	1	0
STEMML-248	214	477	263	0	3	1	0	0
STEMML-248	217	477	260	0	3	5	0	0
STEMML-248	219	220	1	1	3	1	1	0
STEMML-248	225	251	26	1	3	5	1	0
STEMML-248	267	270	3	1	3	3	1	0
STEMML-249	267	270	3	1	3	5	1	0
STEMML-249	267	270	3	1	3	5	1	0
STEMML-249	269	270	1	1	3	3	1	0
STEMML-249	269	270	1	1	3	5	1	0
STEMML-249	269	270	1	1	3	3	1	0
STEMML-249	269	270	1	1	3	3	1	0
STEMML-249	284	286	2	1	4	5	1	0
STEMML-249	297	477	180	0	5	5	0	0
STEMML-249	299	477	178	0	3	3	0	0
STEMML-249	332	333	1	1	4	2	1	0
STEMML-250	334	338	4	1	3	3	1	0
STEMML-250	334	338	4	1	3	3	1	0
STEMML-250	334	338	4	1	3	3	1	0
STEMML-250	338	339	1	1	3	3	1	0
STEMML-250	338	339	1	1	3	3	1	0
STEMML-250	341	342	1	1	3	5	1	0
STEMML-250	344	345	1	1	3	3	1	0
STEMML-250	344	345	1	1	3	3	1	0
STEMML-250	349	350	1	1	3	3	1	0
JO-218	74	194	120	1	2	3	0	0
JO-218	190	192	2	1	4	1	1	0
JO-218	193	194	1	1	2	1	1	0
MAYA-32	5	89	84	1	4	1	0	0
MAYA-32	9	448	439	1	3	3	1	0
MAYA-32	16	19	3	1	3	1	1	0
MAYA-32	23	24	1	1	3	4	1	0
MAYA-32	29	35	6	1	3	1	1	0
MAYA-32	31	36	5	1	3	1	1	0
MAYA-32	42	43	1	1	3	1	1	0
MAYA-32	42	43	1	1	3	1	1	0
MAYA-33	63	116	53	1	4	4	1	0
MAYA-33	63	368	305	1	3	4	1	0
MAYA-33	64	78	14	1	4	1	1	0
MAYA-33	64	78	14	1	4	1	1	0
MAYA-33	72	266	194	1	3	4	1	0
MAYA-33	118	119	1	1	3	1	1	0
MAYA-33	118	190	72	1	3	1	1	0
MAYA-33	119	122	3	1	3	1	1	0
MAYA-33	136	165	29	1	3	3	1	2
MAYA-33	136	448	312	1	3	3	1	0
MAYA-34	145	178	33	1	3	2	1	0
MAYA-34	145	146	1	1	3	1	1	0
MAYA-34	154	477	323	0	3	3	0	1
MAYA-34	178	179	1	1	3	1	1	0
MAYA-34	178	190	12	1	3	4	1	0
MAYA-34	178	319	141	1	3	5	0	0
MAYA-34	200	204	4	1	3	3	1	0
MAYA-34	203	477	274	0	3	3	0	0
MAYA-34	242	323	81	1	2	1	1	0
MAYA-34	254	270	16	1	3	4	1	0
MAYA-35	261	323	62	1	3	1	1	0
MAYA-35	266	270	4	1	3	1	1	0
MAYA-35	266	270	4	1	3	4	1	0
MAYA-35	269	321	52	1	2	4	1	0
MAYA-35	269	322	53	1	3	4	1	0
MAYA-35	269	370	101	1	1	4	1	0
MAYA-35	271	477	206	0	3	4	0	0
MAYA-35	276	323	47	1	3	2	0	0
MAYA-35	291	319	28	1	4	1	1	0
MAYA-35	295	370	75	1	3	4	1	0
MAYA-36	321	322	1	1	3	4	1	0
MAYA-36	322	323	1	1	4	4	1	0
MAYA-36	322	323	1	1	3	4	1	0
MAYA-36	322	323	1	1	4	4	1	0
MAYA-36	323	379	56	1	5	4	1	0
MAYA-36	343	351	8	1	3	3	1	0
MAYA-36	343	345	2	1	3	5	1	1
MAYA-36	343	345	2	1	3	5	1	0
MAYA-36	343	351	8	1	3	5	1	0
MAYA-36	343	345	2	1	3	5	1	0
MAYA-37	343	351	8	1	3	5	1	0
MAYA-37	343	351	8	1	3	5	1	0
MAYA-37	344	370	26	1	3	4	1	0
P5-259	9	477	468	0	3	1	0	0
P5-259	58	477	419	0	3	4	0	0
P5-259	96	477	381	0	3	1	0	0
P5-259	120	477	357	0	4	1	0	0
P5-259	273	477	204	0	4	1	0	0
P5-260	301	477	176	0	3	1	0	0
P5-260	326	327	1	1	3	4	2	0
P5-260	329	477	148	0	2	1	0	0
P5-260	341	342	1	1	3	4	1	0
VERNA-102	3	477	474	0	4	2	0	0
VERNA-102	4	10	6	1	3	1	1	2
VERNA-102	7	8	1	1	3	1	1	0
VERNA-102	7	8	1	1	3	1	1	0
VERNA-103	7	8	1	1	3	2	1	0
VERNA-103	11	477	466	0	3	3	0	1
VERNA-103	11	477	466	0	3	1	0	0
VERNA-103	22	477	455	0	3	2	0	0
VERNA-103	22	477	455	0	3	2	0	0
VERNA-103	33	477	444	0	3	1	0	0
VERNA-103	33	69	36	1	3	1	0	0
VERNA-103	38	477	439	0	3	2	0	1
VERNA-103	51	477	426	0	3	2	0	0
VERNA-103	58	477	419	0	2	1	1	0
VERNA-104	101	477	376	0	3	1	0	0
VERNA-104	106	477	371	0	3	1	0	1
VERNA-104	107	477	370	0	3	5	0	2
VERNA-104	107	127	20	1	3	1	1	1
VERNA-104	129	130	1	1	3	1	1	0
VERNA-104	129	130	1	1	3	1	1	0
VERNA-104	129	130	1	1	3	1	1	0
VERNA-104	130	131	1	1	3	1	1	0
VERNA-104	130	131	1	1	3	2	1	0
VERNA-104	135	477	342	0	3	3	1	1
VERNA-105	135	378	243	1	3	3	1	1
VERNA-105	141	142	1	1	3	3	0	1
VERNA-105	216	477	261	0	3	2	4	0
VERNA-105	226	477	251	0	4	3	0	0
VERNA-105	226	477	251	0	4	1	0	0
VERNA-105	226	477	251	0	4	1	0	0
VERNA-105	226	477	251	0	3	1	0	0
VERNA-105	226	477	251	0	3	3	0	0
PHRA-27	9	15	6	1	3	2	1	1
PHRA-27	10	81	71	1	3	1	0	0
PHRA-28	11	477	466	0	3	4	0	0
PHRA-28	11	477	466	0	3	4	0	0
PHRA-28	15	17	2	1	3	1	1	1
PHRA-28	58	226	168	1	3	1	1	0
PHRA-28	58	226	168	1	3	1	1	0
PHRA-28	68	477	409	0	3	1	0	4
PHRA-28	75	137	62	1	3	1	1	0
PHRA-28	78	127	49	1	3	1	1	0
PHRA-28	121	126	5	1	1	1	1	1
PHRA-28	123	126	3	1	3	5	1	1
PHRA-29	127	477	350	0	4	4	0	0
PHRA-29	140	226	86	1	1	1	1	0
PHRA-29	165	169	4	1	3	1	1	0
PHRA-29	189	477	288	0	3	4	0	0
PHRA-29	224	226	2	1	3	4	1	0
PHRA-29	232	235	3	1	3	4	1	0
PHRA-29	232	477	245	0	1	4	1	0
XT-11	6	7	1	1	3	4	1	0
XT-11	8	426	418	1	3	1	1	1
XT-11	31	477	446	0	3	4	0	0
XT-11	40	42	2	1	3	2	1	0
XT-11	42	43	1	1	3	2	1	0
XT-11	42	43	1	1	3	2	1	0
XT-11	42	43	1	1	3	2	1	0
XT-11	43	44	1	1	3	2	1	0
XT-11	46	270	224	1	4	1	0	0
XT-11	51	93	42	1	3	1	1	0
XT-12	56	136	80	1	3	1	1	1
XT-12	93	94	1	1	3	4	1	0
XT-12	108	109	1	1	3	4	1	0
XT-12	137	138	1	1	3	1	1	2
XT-12	171	477	306	0	4	1	0	1
XT-12	198	200	2	1	3	1	0	0
XT-12	205	477	272	0	3	4	0	2
XT-12	209	303	94	1	4	4	1	0
XT-12	211	212	1	1	3	1	0	0
XT-12	211	213	2	1	3	1	0	0
XT-13	213	290	77	1	3	1	1	0
XT-13	213	290	77	1	3	1	1	0
XT-13	232	269	37	1	3	4	1	0
XT-13	234	235	1	1	3	2	1	0
XT-13	234	290	56	1	3	2	1	0
XT-13	234	290	56	1	3	2	1	0
XT-13	234	235	1	1	3	2	1	0
XT-13	234	290	56	1	3	2	1	0
XT-13	240	310	70	1	4	1	1	0
XT-13	252	270	18	1	3	4	0	0
XT-14	255	256	1	1	3	2	1	0
XT-14	262	263	1	1	3	4	1	0
XT-14	263	264	1	1	3	4	1	0
XT-14	269	270	1	1	3	2	1	0
XT-14	276	277	1	1	3	4	1	0
XT-14	276	277	1	1	3	2	1	0
XT-14	276	277	1	1	3	2	1	0
XT-14	277	278	1	1	3	2	1	0
XT-14	287	288	1	1	3	2	1	0
XT-14	344	477	133	0	3	1	0	0
Z-388	3	477	474	0	3	1	0	2
Z-388	3	4	1	1	3	1	0	0
Z-388	3	4	1	1	3	1	0	0
Z-388	4	191	187	1	4	1	0	1
Z-388	8	477	469	0	2	1	0	0
Z-388	12	477	465	0	3	1	0	0
Z-388	16	116	100	1	3	1	1	0
Z-388	16	52	36	1	3	4	1	3
Z-388	18	477	459	0	4	1	0	0
Z-389	21	141	120	1	3	1	0	0
Z-389	28	437	409	1	3	4	0	0
Z-389	29	65	36	1	3	2	1	2
Z-389	30	44	14	1	3	1	1	0
Z-389	30	39	9	1	3	1	1	1
Z-389	35	36	1	1	3	4	1	0
Z-389	46	47	1	1	3	1	1	0
Z-389	46	63	17	1	3	1	1	0
Z-389	46	49	3	1	3	1	1	0
Z-389	57	477	420	0	3	4	0	0
Z-390	65	67	2	1	3	1	0	2
Z-390	65	122	57	1	3	4	0	1
Z-390	65	141	76	1	3	5	1	1
Z-390	65	191	126	1	3	4	0	4
Z-390	66	477	411	0	3	1	0	0
Z-390	73	74	1	1	5	3	1	0
Z-390	78	477	399	0	3	1	0	0
Z-390	81	84	3	1	3	1	1	0
Z-390	91	94	3	1	3	2	0	0
Z-390	91	92	1	1	3	1	1	0
Z-391	93	477	384	0	3	1	0	0
Z-391	94	128	34	1	2	2	1	0
Z-391	98	189	91	1	3	1	2	1
Z-391	98	99	1	1	3	1	0	0
Z-391	99	119	20	1	3	1	1	0
Z-391	105	109	4	1	3	4	1	0
Z-391	106	193	87	1	2	4	1	0
Z-391	107	477	370	0	3	1	0	0
Z-391	107	477	370	0	3	1	0	0
Z-391	107	477	370	0	4	1	0	0
Z-392	107	112	5	1	3	1	0	0
Z-392	107	477	370	0	3	1	0	0
Z-392	109	477	368	0	3	4	0	0
Z-392	116	151	35	1	3	3	1	1
Z-392	119	123	4	1	3	1	2	0
Z-392	121	477	356	0	3	1	0	0
Z-392	121	122	1	1	3	5	1	0
Z-392	122	123	1	1	3	5	2	0
Z-392	122	423	301	1	3	1	0	0
Z-392	122	151	29	1	3	5	1	1
Z-393	122	127	5	1	3	5	2	0
Z-393	122	127	5	1	3	5	2	0
Z-393	126	128	2	1	3	1	2	0
Z-393	127	129	2	1	3	1	2	0
Z-393	128	207	79	1	3	1	2	2
Z-393	133	141	8	1	3	1	2	0
Z-393	134	477	343	0	3	1	0	1
Z-393	135	140	5	1	3	1	2	0
Z-393	136	155	19	1	3	1	2	0
Z-393	141	143	2	1	3	1	2	0
Z-394	142	143	1	1	3	1	2	0
Z-394	142	477	335	0	3	1	0	1
Z-394	143	204	61	1	3	1	2	0
Z-394	143	148	5	1	3	1	2	0
Z-394	148	157	9	1	3	5	1	0
Z-394	149	156	7	1	3	1	0	0
Z-394	150	154	4	1	3	5	1	0
Z-394	150	151	1	1	3	5	2	1
Z-394	152	154	2	1	3	1	1	1
Z-394	154	155	1	1	3	5	1	0
Z-395	155	477	322	0	3	1	0	1
Z-395	155	161	6	1	3	1	2	0
Z-395	155	410	255	1	3	4	2	0
Z-395	161	162	1	1	3	1	2	0
Z-395	166	186	20	1	3	1	2	0
Z-395	166	191	25	1	3	1	1	0
Z-395	169	477	308	0	3	1	0	1
Z-395	169	345	176	1	3	4	1	0
Z-395	171	239	68	1	3	4	1	0
Z-395	175	177	2	1	1	1	2	0
Z-396	175	179	4	1	3	1	2	0
Z-396	175	282	107	1	3	1	2	0
Z-396	176	178	2	1	3	1	2	0
Z-396	178	186	8	1	3	1	2	0
Z-396	178	192	14	1	3	1	2	0
Z-396	183	203	20	1	4	1	1	0
Z-396	185	477	292	0	3	1	0	0
Z-396	186	477	291	0	3	1	0	1
Z-396	189	190	1	1	3	4	0	0
Z-396	189	281	92	1	4	1	2	0
Z-397	192	193	1	1	3	1	2	0
Z-397	195	196	1	1	3	1	0	0
Z-397	199	260	61	1	3	1	2	1
Z-397	211	248	37	1	4	1	2	0
Z-397	212	220	8	1	2	1	2	3
Z-397	216	268	52	1	3	2	2	0
Z-397	218	295	77	1	3	1	1	0
Z-397	218	234	16	1	3	3	2	0
Z-397	224	227	3	1	3	1	2	0
Z-397	226	477	251	0	3	1	0	0
Z-398	227	239	12	1	3	1	2	0
Z-398	231	266	35	1	3	1	2	0
Z-398	235	263	28	1	3	1	2	0
Z-398	235	477	242	0	3	1	0	1
Z-398	238	477	239	0	2	1	1	2
Z-398	238	477	239	0	3	1	0	1
Z-398	246	261	15	1	3	3	1	0
Z-398	247	477	230	0	3	2	0	0
Z-398	247	256	9	1	3	3	1	0
Z-398	253	255	2	1	3	1	1	0
Z-399	253	282	29	1	3	1	2	0
Z-399	255	477	222	0	3	2	0	0
Z-399	256	477	221	0	3	1	1	0
Z-399	262	477	215	0	3	1	0	0
Z-399	269	270	1	1	3	5	2	0
Z-399	269	431	162	1	3	5	2	1
Z-399	270	477	207	0	4	4	0	0
Z-399	277	477	200	0	3	2	0	0
Z-399	277	323	46	1	3	3	1	0
Z-399	277	477	200	0	3	3	0	0
Z-400	277	477	200	0	3	3	0	0
Z-400	277	477	200	0	3	3	0	0
Z-400	279	442	163	1	3	3	1	0
Z-400	281	282	1	1	5	3	2	0
Z-400	282	409	127	1	3	1	3	0
Z-400	282	477	195	0	3	3	0	0
Z-400	289	456	167	1	3	5	0	1
Z-400	289	477	188	0	3	5	0	1
Z-400	289	477	188	0	3	5	0	1
Z-400	289	456	167	1	3	5	0	1
Z-401	289	477	188	0	4	4	0	0
Z-401	290	477	187	0	4	4	0	0
Z-401	291	298	7	1	3	5	2	0
Z-401	294	477	183	0	3	3	0	0
Z-401	301	477	176	0	3	5	0	0
Z-401	302	477	175	0	3	4	0	0
Z-401	303	456	153	1	3	5	0	0
Z-401	303	477	174	0	3	3	0	0
Z-401	316	477	161	0	3	2	0	0
Z-401	316	477	161	0	3	4	0	0
Z-402	329	477	148	0	3	4	0	1
Z-402	329	330	1	1	3	5	1	1
Z-402	329	330	1	1	3	1	2	1
Z-402	330	410	80	1	3	1	0	1
Z-402	332	477	145	0	3	1	0	0
Z-402	332	477	145	0	3	5	0	1
Z-402	339	477	138	0	3	1	0	0
Z-402	347	351	4	1	3	1	2	0
Z-402	351	392	41	1	3	1	2	0
Z-402	358	477	119	0	4	4	0	0
RIFT-444	2	3	1	1	4	4	1	0
RIFT-444	2	371	369	1	3	4	1	3
RIFT-444	3	477	474	0	3	4	0	1
RIFT-444	4	10	6	1	3	1	1	0
RIFT-444	4	367	363	1	3	1	0	2
RIFT-444	7	8	1	1	3	1	0	0
RIFT-444	8	10	2	1	3	1	1	0
RIFT-444	8	10	2	1	3	1	1	0
RIFT-444	8	71	63	1	3	3	1	1
RIFT-444	10	477	467	0	3	1	0	0
RIFT-445	10	11	1	1	4	4	1	0
RIFT-445	10	477	467	0	3	1	0	1
RIFT-445	11	12	1	1	4	4	1	0
RIFT-445	11	367	356	1	4	4	0	0
RIFT-445	11	32	21	1	3	1	1	0
RIFT-445	12	13	1	1	3	1	1	0
RIFT-445	13	14	1	1	5	1	1	0
RIFT-445	13	14	1	1	4	4	0	0
RIFT-445	13	378	365	1	3	5	0	0
RIFT-445	14	15	1	1	4	4	1	0
RIFT-446	15	23	8	1	4	4	1	2
RIFT-446	16	18	2	1	4	1	1	0
RIFT-446	16	18	2	1	4	1	1	0
RIFT-446	17	23	6	1	4	4	1	0
RIFT-446	18	23	5	1	2	1	1	1
RIFT-446	20	70	50	1	2	1	1	1
RIFT-446	21	477	456	0	3	1	0	0
RIFT-446	21	24	3	1	4	5	1	0
RIFT-446	21	24	3	1	3	5	1	0
RIFT-446	21	367	346	1	3	1	1	0
RIFT-447	22	23	1	1	4	3	1	0
RIFT-447	22	23	1	1	2	1	1	0
RIFT-447	23	24	1	1	5	1	1	0
RIFT-447	23	24	1	1	3	4	1	0
RIFT-447	24	73	49	1	3	4	1	0
RIFT-447	24	28	4	1	4	4	1	0
RIFT-447	25	78	53	1	3	1	1	0
RIFT-447	29	30	1	1	4	1	1	0
RIFT-447	29	158	129	1	2	1	1	2
RIFT-447	29	64	35	1	4	4	0	3
RIFT-448	29	64	35	1	4	1	1	1
RIFT-448	29	367	338	1	3	1	1	0
RIFT-448	29	84	55	1	5	1	0	1
RIFT-448	30	477	447	0	3	1	0	0
RIFT-448	30	477	447	0	4	1	0	0
RIFT-448	31	32	1	1	2	1	1	0
RIFT-448	32	61	29	1	4	3	1	0
RIFT-448	36	378	342	1	3	1	1	0
RIFT-448	37	477	440	0	3	1	0	0
RIFT-448	38	79	41	1	3	4	1	0
RIFT-449	38	39	1	1	3	4	1	1
RIFT-449	38	477	439	0	3	3	0	1
RIFT-449	39	40	1	1	3	1	1	0
RIFT-449	40	53	13	1	3	1	0	0
RIFT-449	43	277	234	1	4	4	1	0
RIFT-449	43	80	37	1	3	4	1	0
RIFT-449	43	270	227	1	4	2	1	3
RIFT-449	44	80	36	1	3	1	1	0
RIFT-449	52	61	9	1	4	4	1	0
RIFT-449	53	277	224	1	5	4	1	0
RIFT-450	57	477	420	0	3	1	0	2
RIFT-450	59	477	418	0	3	1	0	0
RIFT-450	60	477	417	0	3	5	0	1
RIFT-450	61	62	1	1	4	1	1	0
RIFT-450	62	71	9	1	3	4	0	1
RIFT-450	63	64	1	1	4	1	1	0
RIFT-450	63	432	369	1	4	1	2	1
RIFT-450	63	477	414	0	3	1	0	0
RIFT-450	64	65	1	1	3	4	1	2
RIFT-450	64	71	7	1	2	4	1	0
RIFT-451	65	368	303	1	2	1	0	2
RIFT-451	65	477	412	0	3	1	0	0
RIFT-451	65	371	306	1	3	4	1	4
RIFT-451	66	72	6	1	3	4	1	0
RIFT-451	68	375	307	1	3	4	0	2
RIFT-451	69	77	8	1	3	4	1	0
RIFT-451	70	74	4	1	3	4	1	1
RIFT-451	70	72	2	1	3	1	0	0
RIFT-451	71	477	406	0	3	1	0	0
RIFT-451	73	477	404	0	4	1	0	0
RIFT-452	74	477	403	0	4	5	0	0
RIFT-452	75	378	303	1	3	1	1	0
RIFT-452	76	477	401	0	3	1	0	0
RIFT-452	77	78	1	1	5	1	0	0
RIFT-452	78	79	1	1	3	1	1	0
RIFT-452	78	80	2	1	4	4	1	0
RIFT-452	78	477	399	0	4	4	0	0
RIFT-452	79	87	8	1	3	5	0	0
RIFT-452	80	477	397	0	3	1	0	1
RIFT-452	80	315	235	1	4	4	1	0
RIFT-453	81	87	6	1	3	2	1	0
RIFT-453	85	86	1	1	3	1	1	0
RIFT-453	85	120	35	1	4	4	1	0
RIFT-453	86	477	391	0	3	1	0	0
RIFT-453	86	477	391	0	3	1	0	1
RIFT-453	86	90	4	1	3	4	1	2
RIFT-453	87	92	5	1	3	1	0	0
RIFT-453	87	91	4	1	3	1	1	0
RIFT-453	89	90	1	1	3	4	0	0
RIFT-453	90	91	1	1	3	4	1	0
RIFT-454	91	92	1	1	3	1	1	0
RIFT-454	92	477	385	0	3	5	0	0
RIFT-454	93	352	259	1	2	1	1	0
RIFT-454	94	95	1	1	1	1	0	0
RIFT-454	94	95	1	1	1	1	0	0
RIFT-454	94	314	220	1	3	1	1	0
RIFT-454	95	361	266	1	3	1	0	0
RIFT-454	97	477	380	0	3	5	0	1
RIFT-454	98	158	60	1	3	1	1	0
RIFT-454	98	99	1	1	3	5	1	0
RIFT-455	99	396	297	1	3	5	0	3
RIFT-455	100	477	377	0	4	4	0	0
RIFT-455	101	106	5	1	4	4	0	0
RIFT-455	101	102	1	1	4	5	0	0
RIFT-455	101	102	1	1	3	1	1	0
RIFT-455	102	106	4	1	4	4	1	0
RIFT-455	102	120	18	1	3	1	1	3
RIFT-455	106	367	261	1	3	4	0	0
RIFT-455	106	107	1	1	3	1	1	0
RIFT-455	108	121	13	1	4	1	1	0
RIFT-456	115	376	261	1	4	1	1	1
RIFT-456	116	126	10	1	5	3	1	0
RIFT-456	121	122	1	1	3	1	1	0
RIFT-456	122	134	12	1	4	5	0	0
RIFT-456	123	172	49	1	4	1	1	4
RIFT-456	124	477	353	0	3	1	0	0
RIFT-456	128	129	1	1	4	4	1	1
RIFT-456	128	351	223	1	2	5	1	0
RIFT-456	129	477	348	0	3	1	0	0
RIFT-456	129	130	1	1	5	5	1	0
RIFT-457	131	477	346	0	3	4	0	0
RIFT-457	133	134	1	1	4	1	1	0
RIFT-457	133	375	242	1	3	4	0	0
RIFT-457	135	136	1	1	3	1	1	0
RIFT-457	143	477	334	0	4	4	0	0
RIFT-457	146	477	331	0	3	1	0	0
RIFT-457	153	477	324	0	4	1	0	1
RIFT-457	153	157	4	1	4	1	1	1
RIFT-457	155	157	2	1	4	4	1	0
RIFT-457	156	166	10	1	3	4	1	3
RIFT-458	157	158	1	1	4	1	1	0
RIFT-458	157	477	320	0	3	1	0	0
RIFT-458	159	160	1	1	4	1	1	0
RIFT-458	159	477	318	0	3	4	0	0
RIFT-458	159	166	7	1	2	1	0	0
RIFT-458	163	477	314	0	4	1	0	0
RIFT-458	165	183	18	1	3	1	1	0
RIFT-458	166	375	209	1	4	5	0	0
RIFT-458	171	172	1	1	3	1	1	0
RIFT-458	172	360	188	1	3	1	1	0
RIFT-459	172	360	188	1	3	1	1	0
RIFT-459	174	185	11	1	4	4	1	1
RIFT-459	176	183	7	1	2	1	1	0
RIFT-459	178	375	197	1	4	1	1	3
RIFT-459	178	360	182	1	4	1	0	1
RIFT-459	178	477	299	0	3	5	0	0
RIFT-459	182	477	295	0	5	5	0	0
RIFT-459	183	378	195	1	4	1	0	1
RIFT-459	184	185	1	1	3	1	0	1
RIFT-459	187	292	105	1	3	4	0	1
RIFT-460	195	477	282	0	3	1	0	1
RIFT-460	202	477	275	0	4	1	0	0
RIFT-460	202	391	189	1	2	1	0	0
RIFT-460	202	203	1	1	4	5	0	0
RIFT-460	209	212	3	1	4	4	1	0
RIFT-460	209	211	2	1	4	1	1	0
RIFT-460	210	477	267	0	3	1	0	1
RIFT-460	211	477	266	0	3	1	0	0
RIFT-460	212	477	265	0	3	1	0	0
RIFT-460	214	218	4	1	3	4	1	0
RIFT-461	215	216	1	1	4	5	0	0
RIFT-461	217	477	260	0	4	4	0	0
RIFT-461	217	477	260	0	3	2	0	0
RIFT-461	217	360	143	1	3	1	0	0
RIFT-461	217	218	1	1	3	2	1	0
RIFT-461	220	369	149	1	4	5	0	1
RIFT-461	220	221	1	1	3	5	0	0
RIFT-461	221	240	19	1	4	1	1	0
RIFT-461	222	284	62	1	3	1	1	0
RIFT-461	223	239	16	1	3	2	0	0
RIFT-462	224	258	34	1	3	1	1	0
RIFT-462	226	243	17	1	4	2	1	0
RIFT-462	228	240	12	1	4	1	1	0
RIFT-462	234	477	243	0	2	1	0	2
RIFT-462	236	405	169	1	3	4	0	0
RIFT-462	237	270	33	1	4	4	1	0
RIFT-462	242	244	2	1	3	1	1	0
RIFT-462	249	477	228	0	3	5	0	0
RIFT-462	251	477	226	0	4	5	0	0
RIFT-462	253	254	1	1	2	1	1	1
RIFT-463	254	255	1	1	1	5	0	0
RIFT-463	254	257	3	1	4	1	1	0
RIFT-463	256	477	221	0	5	1	0	0
RIFT-463	256	477	221	0	4	4	0	0
RIFT-463	256	257	1	1	4	1	1	0
RIFT-463	257	381	124	1	3	4	0	0
RIFT-463	257	367	110	1	3	5	0	0
RIFT-463	257	258	1	1	3	1	1	1
RIFT-463	261	477	216	0	3	1	0	1
RIFT-463	262	403	141	1	2	1	0	1
RIFT-464	262	477	215	0	3	4	0	1
RIFT-464	262	263	1	1	4	1	1	0
RIFT-464	266	267	1	1	5	1	1	0
RIFT-464	269	369	100	1	4	5	0	1
RIFT-464	274	275	1	1	2	1	1	0
RIFT-464	275	276	1	1	4	4	1	0
RIFT-464	275	276	1	1	5	4	1	0
RIFT-464	277	371	94	1	2	1	1	0
RIFT-464	277	284	7	1	3	1	1	0
RIFT-464	281	323	42	1	4	5	0	0
RIFT-465	284	288	4	1	3	1	1	0
RIFT-465	288	289	1	1	3	1	0	0
RIFT-465	289	369	80	1	4	5	0	0
RIFT-465	289	300	11	1	4	4	1	0
RIFT-465	291	386	95	1	4	4	1	1
RIFT-465	297	477	180	0	3	1	0	2
RIFT-465	302	338	36	1	3	1	1	0
RIFT-465	305	477	172	0	3	2	0	0
RIFT-465	307	308	1	1	3	1	1	0
RIFT-465	308	344	36	1	3	1	1	0
RIFT-466	309	360	51	1	4	1	1	0
RIFT-466	310	312	2	1	3	1	1	0
RIFT-466	310	315	5	1	3	1	1	0
RIFT-466	310	477	167	0	3	1	0	1
RIFT-466	315	316	1	1	4	4	1	0
RIFT-466	315	360	45	1	4	5	1	0
RIFT-466	320	322	2	1	4	3	1	0
RIFT-466	322	477	155	0	4	4	0	0
RIFT-466	323	325	2	1	4	4	1	0
RIFT-466	324	477	153	0	3	5	0	0
RIFT-467	324	325	1	1	4	1	1	0
RIFT-467	325	326	1	1	3	1	1	0
RIFT-467	326	327	1	1	3	1	1	0
RIFT-467	326	327	1	1	3	4	1	0
RIFT-467	326	331	5	1	3	4	1	0
RIFT-467	332	379	47	1	3	1	1	1
RIFT-467	333	338	5	1	4	3	1	0
RIFT-467	333	477	144	0	2	1	0	0
RIFT-467	340	371	31	1	4	4	1	2
RIFT-467	340	341	1	1	4	1	1	0
RIFT-468	350	351	1	1	2	1	1	0
RIFT-468	352	477	125	0	3	1	0	0
RIFT-468	353	477	124	0	3	1	0	1
RIFT-468	353	477	124	0	3	5	0	1
RIFT-468	356	358	2	1	5	1	1	0
RIFT-468	360	477	117	0	4	4	0	0
RIFT-468	360	378	18	1	3	5	0	1
RIFT-468	360	477	117	0	2	5	0	2
RIFT-468	360	407	47	1	1	5	1	1
RIFT-468	360	364	4	1	3	3	1	0
RIFT-469	360	364	4	1	3	3	1	0
RIFT-469	360	385	25	1	3	1	1	0
RIFT-469	360	361	1	1	2	3	1	0
RIFT-469	360	361	1	1	2	3	1	0
RIFT-469	361	367	6	1	3	4	1	1
RIFT-469	361	364	3	1	4	4	1	0
RIFT-469	361	364	3	1	4	4	1	0
RIFT-469	362	375	13	1	3	5	1	0
RIFT-469	363	388	25	1	2	3	1	1
RIFT-469	363	369	6	1	3	5	1	1
KA-253	2	477	475	0	3	4	0	0
KA-253	2	22	20	1	3	4	2	4
KA-253	2	477	475	0	3	4	0	1
KA-253	3	477	474	0	3	4	0	0
KA-253	3	477	474	0	3	4	0	0
KA-253	4	5	1	1	3	4	0	1
KA-254	4	477	473	0	3	4	0	0
KA-254	4	22	18	1	3	4	2	1
KA-254	4	477	473	0	4	4	1	0
KA-254	6	477	471	0	4	1	0	0
KA-254	7	477	470	0	3	1	0	0
KA-254	9	477	468	0	4	1	0	0
KA-254	11	477	466	0	3	4	0	0
KA-254	11	30	19	1	3	1	2	2
KA-254	14	477	463	0	4	4	0	1
KA-254	15	248	233	1	3	1	2	1
KA-255	21	333	312	1	5	1	2	0
KA-255	22	25	3	1	3	1	1	0
KA-255	22	248	226	1	1	4	2	3
KA-255	22	477	455	0	4	4	0	0
KA-255	24	477	453	0	4	4	0	0
KA-255	24	477	453	0	4	1	0	1
KA-255	25	30	5	1	3	4	2	0
KA-255	25	477	452	0	4	1	0	1
KA-255	29	477	448	0	4	2	1	0
KA-255	30	37	7	1	3	4	2	0
KA-256	30	31	1	1	3	1	0	0
KA-256	30	32	2	1	3	1	2	0
KA-256	32	477	445	0	3	1	0	1
KA-256	32	51	19	1	5	4	2	1
KA-256	32	35	3	1	3	1	2	0
KA-256	33	477	444	0	4	5	1	1
KA-256	35	477	442	0	4	5	1	1
KA-256	37	38	1	1	3	1	1	0
KA-256	38	66	28	1	4	1	2	0
KA-256	38	42	4	1	3	1	2	0
KA-257	39	51	12	1	4	3	2	1
KA-257	39	40	1	1	4	1	2	1
KA-257	39	477	438	0	4	3	0	1
KA-257	39	477	438	0	3	4	0	0
KA-257	42	477	435	0	3	5	0	0
KA-257	44	477	433	0	3	1	0	0
KA-257	45	65	20	1	4	4	2	0
KA-257	49	289	240	1	3	1	1	0
KA-257	50	56	6	1	3	1	2	3
KA-257	51	86	35	1	3	4	2	0
KA-258	51	52	1	1	4	1	2	0
KA-258	51	477	426	0	4	1	0	0
KA-258	51	87	36	1	3	1	2	0
KA-258	51	477	426	0	5	1	0	0
KA-258	51	87	36	1	4	4	2	0
KA-258	51	79	28	1	3	4	1	0
KA-258	51	52	1	1	4	4	0	0
KA-258	53	56	3	1	3	1	2	1
KA-258	54	56	2	1	3	1	2	1
KA-258	56	57	1	1	3	1	0	0
KA-259	57	65	8	1	2	1	2	0
KA-259	57	65	8	1	3	1	2	0
KA-259	58	65	7	1	4	4	2	1
KA-259	58	477	419	0	3	1	0	0
KA-259	59	65	6	1	3	1	2	1
KA-259	59	477	418	0	3	1	0	0
KA-259	60	477	417	0	3	4	1	0
KA-259	60	477	417	0	3	1	0	0
KA-259	63	64	1	1	1	4	2	1
KA-259	65	301	236	1	4	1	1	0
KA-260	65	66	1	1	1	3	2	0
KA-260	65	458	393	1	3	1	0	1
KA-260	66	477	411	0	3	4	0	0
KA-260	66	477	411	0	4	2	0	0
KA-260	67	68	1	1	1	1	2	0
KA-260	71	477	406	0	3	1	0	0
KA-260	71	72	1	1	3	1	0	0
KA-260	72	86	14	1	3	5	2	0
KA-260	74	77	3	1	4	1	1	0
KA-260	74	477	403	0	4	4	0	0
KA-261	77	477	400	0	3	4	0	0
KA-261	78	477	399	0	3	1	1	0
KA-261	83	477	394	0	3	1	0	0
KA-261	84	87	3	1	3	4	2	0
KA-261	86	87	1	1	1	3	2	2
KA-261	86	87	1	1	3	3	0	1
KA-261	86	87	1	1	3	3	2	1
KA-261	86	87	1	1	3	3	2	1
KA-261	86	87	1	1	3	3	2	0
KA-261	87	477	390	0	2	1	0	2
KA-262	87	88	1	1	5	3	2	0
KA-262	87	477	390	0	3	5	0	0
KA-262	87	180	93	1	3	3	0	2
KA-262	91	477	386	0	5	4	1	0
KA-262	91	477	386	0	3	1	0	0
KA-262	95	96	1	1	3	1	0	0
KA-262	95	96	1	1	1	1	0	0
KA-262	98	477	379	0	3	1	0	0
KA-262	100	129	29	1	4	4	2	0
KA-262	100	129	29	1	4	4	2	0
KA-263	101	477	376	0	3	1	0	0
KA-263	101	477	376	0	3	1	0	0
KA-263	102	477	375	0	4	4	0	1
KA-263	106	477	371	0	4	1	0	0
KA-263	108	109	1	1	3	3	2	1
KA-263	108	109	1	1	4	3	2	0
KA-263	113	120	7	1	3	1	1	0
KA-263	119	344	225	1	2	1	2	0
KA-263	120	266	146	1	3	1	1	0
KA-263	121	477	356	0	4	3	1	0
KA-264	121	477	356	0	3	1	0	0
KA-264	122	477	355	0	4	4	0	0
KA-264	127	477	350	0	3	4	0	0
KA-264	135	477	342	0	1	1	0	0
KA-264	136	137	1	1	3	3	2	0
KA-264	137	142	5	1	3	3	2	1
KA-264	140	141	1	1	5	4	0	1
KA-264	141	157	16	1	3	2	2	0
KA-264	141	477	336	0	3	1	0	0
KA-264	142	143	1	1	3	1	0	0
KA-265	143	477	334	0	1	1	0	0
KA-265	143	477	334	0	4	4	0	0
KA-265	144	477	333	0	3	1	0	0
KA-265	144	150	6	1	3	2	2	1
KA-265	148	477	329	0	3	1	0	0
KA-265	148	150	2	1	3	2	2	1
KA-265	150	151	1	1	3	3	2	0
KA-265	151	152	1	1	5	3	2	0
KA-265	151	247	96	1	4	4	1	0
KA-265	151	477	326	0	5	4	0	0
KA-266	154	477	323	0	3	3	0	0
KA-266	154	157	3	1	4	3	2	0
KA-266	157	158	1	1	4	3	2	0
KA-266	157	477	320	0	4	3	0	0
KA-266	157	158	1	1	5	3	2	0
KA-266	162	477	315	0	3	1	0	0
KA-266	162	477	315	0	4	1	0	0
KA-266	163	225	62	1	5	3	2	0
KA-266	164	165	1	1	3	3	2	0
KA-266	164	182	18	1	3	1	2	0
KA-267	165	477	312	0	5	3	0	0
KA-267	165	477	312	0	3	1	0	1
KA-267	165	225	60	1	3	3	2	0
KA-267	169	214	45	1	3	1	2	0
KA-267	170	477	307	0	5	3	0	2
KA-267	170	186	16	1	3	1	2	0
KA-267	170	477	307	0	3	1	0	0
KA-267	170	171	1	1	3	1	2	0
KA-267	170	477	307	0	3	1	0	0
KA-267	171	172	1	1	3	3	1	0
KA-268	176	477	301	0	3	1	0	1
KA-268	180	181	1	1	3	1	2	1
KA-268	182	183	1	1	5	3	2	0
KA-268	182	198	16	1	3	1	1	0
KA-268	183	186	3	1	4	4	0	1
KA-268	185	477	292	0	3	1	0	1
KA-268	190	191	1	1	3	1	2	0
KA-268	193	194	1	1	5	3	2	0
KA-268	197	205	8	1	3	1	2	1
KA-268	198	477	279	0	3	1	0	0
KA-269	198	205	7	1	3	4	2	0
KA-269	199	205	6	1	3	1	2	0
KA-269	206	207	1	1	3	3	2	1
KA-269	206	248	42	1	3	1	2	2
KA-269	206	477	271	0	3	1	0	0
KA-269	206	220	14	1	5	3	2	0
KA-269	206	477	271	0	4	4	0	1
KA-269	207	211	4	1	3	1	0	0
KA-269	210	477	267	0	3	1	0	0
KA-269	211	212	1	1	3	1	1	1
KA-270	211	477	266	0	3	1	0	0
KA-270	212	477	265	0	3	1	1	0
KA-270	212	214	2	1	3	1	0	0
KA-270	212	283	71	1	3	1	1	0
KA-270	214	215	1	1	5	3	2	1
KA-270	218	219	1	1	3	3	2	0
KA-270	219	220	1	1	5	3	2	0
KA-270	227	228	1	1	3	3	2	0
KA-270	227	477	250	0	4	1	0	0
KA-270	228	477	249	0	3	1	0	1
KA-271	228	229	1	1	3	4	0	0
KA-271	228	477	249	0	4	1	1	0
KA-271	230	477	247	0	3	1	0	0
KA-271	231	232	1	1	3	1	0	0
KA-271	231	477	246	0	3	1	0	0
KA-271	232	477	245	0	3	1	0	0
KA-271	233	246	13	1	3	1	2	1
KA-271	233	395	162	1	2	1	0	0
KA-271	238	477	239	0	4	1	0	0
KA-271	241	252	11	1	3	1	0	0
KA-272	244	477	233	0	3	2	1	0
KA-272	246	247	1	1	4	1	2	1
KA-272	246	477	231	0	3	1	0	1
KA-272	247	477	230	0	3	1	1	0
KA-272	247	477	230	0	3	1	0	0
KA-272	248	253	5	1	3	3	2	0
KA-272	256	367	111	1	3	3	2	1
KA-272	258	281	23	1	1	1	2	0
KA-272	259	260	1	1	3	1	0	2
KA-272	260	261	1	1	5	3	2	0
KA-273	261	262	1	1	3	1	2	1
KA-273	263	264	1	1	3	4	1	0
KA-273	266	267	1	1	3	3	2	0
KA-273	266	477	211	0	3	3	0	0
KA-273	267	294	27	1	3	1	0	0
KA-273	267	303	36	1	3	1	1	0
KA-273	267	268	1	1	3	3	2	0
KA-273	267	477	210	0	3	1	0	1
KA-273	267	268	1	1	3	3	2	0
KA-273	267	268	1	1	3	3	2	0
KA-274	270	477	207	0	5	1	0	0
KA-274	271	272	1	1	3	4	0	1
KA-274	273	274	1	1	3	1	2	0
KA-274	273	274	1	1	3	4	2	1
KA-274	274	477	203	0	3	1	0	0
KA-274	274	276	2	1	3	3	2	0
KA-274	275	477	202	0	4	1	0	0
KA-274	275	477	202	0	4	4	0	0
KA-274	275	276	1	1	5	3	2	0
KA-274	276	477	201	0	3	3	0	1
KA-275	277	477	200	0	3	3	0	1
KA-275	283	336	53	1	3	3	2	0
KA-275	284	477	193	0	5	1	0	1
KA-275	284	285	1	1	2	1	2	0
KA-275	284	285	1	1	3	3	2	0
KA-275	284	477	193	0	3	4	0	0
KA-275	288	407	119	1	3	4	2	2
KA-275	289	311	22	1	5	3	0	0
KA-275	290	477	187	0	3	1	1	1
KA-275	290	294	4	1	3	1	2	0
KA-276	290	304	14	1	3	1	1	0
KA-276	290	294	4	1	4	1	2	0
KA-276	291	355	64	1	3	4	2	0
KA-276	292	296	4	1	3	1	1	0
KA-276	294	295	1	1	5	3	2	0
KA-276	296	367	71	1	4	4	2	1
KA-276	297	477	180	0	4	4	0	0
KA-276	298	477	179	0	3	1	0	0
KA-276	302	477	175	0	3	1	1	0
KA-276	302	477	175	0	3	1	0	0
KA-277	304	317	13	1	3	4	2	0
KA-277	304	477	173	0	2	1	0	4
KA-277	308	477	169	0	3	1	0	0
KA-277	311	312	1	1	4	3	2	0
KA-277	311	477	166	0	3	1	0	0
KA-277	311	477	166	0	3	3	0	0
KA-277	312	317	5	1	1	1	2	2
KA-277	312	313	1	1	3	3	2	0
KA-277	312	317	5	1	3	3	2	2
KA-277	312	336	24	1	3	3	2	3
KA-278	313	316	3	1	3	1	2	0
KA-278	316	477	161	0	4	1	0	0
KA-278	316	317	1	1	1	3	2	0
KA-278	317	477	160	0	4	5	0	0
KA-278	322	323	1	1	5	3	2	0
KA-278	322	323	1	1	3	3	2	0
KA-278	326	477	151	0	3	1	0	0
KA-278	329	477	148	0	3	1	0	0
KA-278	330	336	6	1	3	3	2	1
KA-278	332	477	145	0	4	1	0	0
KA-279	336	477	141	0	4	4	0	0
KA-279	336	347	11	1	3	4	2	0
KA-279	336	477	141	0	3	4	0	0
KA-279	338	477	139	0	3	4	0	1
KA-279	338	477	139	0	3	1	1	0
KA-279	338	344	6	1	3	1	2	0
KA-279	339	477	138	0	3	4	1	0
KA-279	347	477	130	0	3	1	0	0
KA-279	347	348	1	1	3	4	2	0
KA-279	347	348	1	1	3	4	2	0
KA-280	347	348	1	1	3	4	2	0
KA-280	359	477	118	0	2	3	0	0
KA-280	360	395	35	1	2	1	0	0
LES-59	22	477	455	0	3	1	0	0
LES-59	99	477	378	0	3	3	0	0
LES-59	147	477	330	0	3	4	0	0
LES-59	185	249	64	1	3	1	2	0
LES-59	239	249	10	1	2	1	2	0
NKERPOP-186	2	130	128	1	4	4	0	0
NKERPOP-186	2	63	61	1	3	1	2	1
NKERPOP-186	4	21	17	1	4	4	2	0
NKERPOP-186	7	197	190	1	4	4	2	0
NKERPOP-186	7	80	73	1	3	4	1	1
NKERPOP-186	7	81	74	1	2	4	1	1
NKERPOP-186	7	20	13	1	3	1	2	0
NKERPOP-186	9	20	11	1	4	4	2	0
NKERPOP-186	11	114	103	1	4	1	2	0
NKERPOP-187	14	92	78	1	3	4	2	0
NKERPOP-187	15	22	7	1	3	4	1	0
NKERPOP-187	15	53	38	1	3	1	2	0
NKERPOP-187	17	29	12	1	3	1	2	0
NKERPOP-187	17	23	6	1	3	1	2	0
NKERPOP-187	18	36	18	1	3	1	1	0
NKERPOP-187	21	22	1	1	3	5	0	0
NKERPOP-187	21	38	17	1	3	4	2	1
NKERPOP-187	22	224	202	1	3	4	1	1
NKERPOP-187	24	30	6	1	4	1	2	0
NKERPOP-188	30	81	51	1	3	1	2	0
NKERPOP-188	30	31	1	1	1	1	0	0
NKERPOP-188	32	399	367	1	4	4	2	0
NKERPOP-188	32	50	18	1	3	1	2	0
NKERPOP-188	36	85	49	1	3	4	2	1
NKERPOP-188	38	64	26	1	5	4	2	0
NKERPOP-188	41	477	436	0	3	4	0	0
NKERPOP-188	42	49	7	1	3	4	0	0
NKERPOP-188	42	99	57	1	3	4	1	1
NKERPOP-188	44	357	313	1	3	4	2	0
NKERPOP-189	44	45	1	1	3	1	2	0
NKERPOP-189	44	59	15	1	3	1	2	1
NKERPOP-189	45	77	32	1	3	1	2	1
NKERPOP-189	49	50	1	1	3	1	0	1
NKERPOP-189	50	59	9	1	3	1	2	3
NKERPOP-189	50	70	20	1	3	1	0	2
NKERPOP-189	50	72	22	1	3	1	2	2
NKERPOP-189	51	155	104	1	3	4	3	0
NKERPOP-189	51	247	196	1	3	1	3	2
NKERPOP-189	51	52	1	1	3	1	0	0
NKERPOP-190	51	330	279	1	3	4	0	0
NKERPOP-190	52	71	19	1	4	4	2	1
NKERPOP-190	53	394	341	1	4	4	0	0
NKERPOP-190	56	108	52	1	3	4	1	0
NKERPOP-190	57	477	420	0	4	4	0	0
NKERPOP-190	57	477	420	0	3	1	0	0
NKERPOP-190	58	275	217	1	3	4	1	1
NKERPOP-190	59	64	5	1	4	1	2	0
NKERPOP-190	60	67	7	1	4	4	2	0
NKERPOP-190	61	81	20	1	3	1	0	1
NKERPOP-191	61	62	1	1	3	1	0	1
NKERPOP-191	64	70	6	1	3	4	2	0
NKERPOP-191	64	103	39	1	4	4	3	0
NKERPOP-191	64	267	203	1	3	4	1	3
NKERPOP-191	66	78	12	1	3	4	1	0
NKERPOP-191	66	67	1	1	3	4	0	0
NKERPOP-191	66	108	42	1	3	4	0	0
NKERPOP-191	68	69	1	1	4	1	2	0
NKERPOP-191	69	70	1	1	3	1	2	0
NKERPOP-191	69	71	2	1	3	1	2	0
NKERPOP-192	69	77	8	1	3	1	2	0
NKERPOP-192	69	477	408	0	3	4	0	0
NKERPOP-192	70	73	3	1	3	1	2	1
NKERPOP-192	71	114	43	1	3	1	0	0
NKERPOP-192	71	304	233	1	4	4	0	1
NKERPOP-192	74	477	403	0	3	4	0	0
NKERPOP-192	75	84	9	1	3	1	0	0
NKERPOP-192	78	101	23	1	3	1	2	0
NKERPOP-192	79	477	398	0	3	4	0	0
NKERPOP-192	81	82	1	1	3	4	0	0
NKERPOP-193	81	92	11	1	3	4	1	0
NKERPOP-193	84	311	227	1	3	4	0	0
NKERPOP-193	86	87	1	1	3	1	0	0
NKERPOP-193	92	133	41	1	3	1	3	0
NKERPOP-193	93	105	12	1	3	4	3	0
NKERPOP-193	99	112	13	1	3	1	0	0
NKERPOP-193	101	109	8	1	3	4	3	0
NKERPOP-193	102	105	3	1	3	4	0	0
NKERPOP-193	105	106	1	1	4	4	0	0
NKERPOP-193	107	112	5	1	4	4	0	0
NKERPOP-194	107	108	1	1	4	4	0	0
NKERPOP-194	107	114	7	1	4	4	1	0
NKERPOP-194	108	365	257	1	3	4	1	0
NKERPOP-194	108	127	19	1	3	4	1	0
NKERPOP-194	108	127	19	1	3	4	2	0
NKERPOP-194	108	224	116	1	4	4	3	0
NKERPOP-194	108	114	6	1	3	4	1	0
NKERPOP-194	108	114	6	1	3	1	3	0
NKERPOP-194	109	477	368	0	4	4	0	0
NKERPOP-194	109	110	1	1	5	1	1	0
NKERPOP-195	109	114	5	1	3	4	3	0
NKERPOP-195	111	221	110	1	5	4	3	0
NKERPOP-195	112	122	10	1	3	1	0	0
NKERPOP-195	112	114	2	1	2	4	3	0
NKERPOP-195	115	127	12	1	4	4	1	0
NKERPOP-195	115	477	362	0	4	1	0	0
NKERPOP-195	115	136	21	1	4	4	1	0
NKERPOP-195	116	117	1	1	3	1	0	0
NKERPOP-195	116	141	25	1	3	1	3	0
NKERPOP-195	126	280	154	1	2	4	3	1
NKERPOP-196	126	477	351	0	3	1	0	0
NKERPOP-196	127	131	4	1	4	1	3	0
NKERPOP-196	128	137	9	1	4	1	3	0
NKERPOP-196	128	150	22	1	3	1	3	0
NKERPOP-196	133	477	344	0	3	4	0	0
NKERPOP-196	136	155	19	1	4	4	0	0
NKERPOP-196	136	151	15	1	3	1	0	0
NKERPOP-196	136	220	84	1	4	4	1	1
NKERPOP-196	137	151	14	1	4	4	3	0
NKERPOP-196	140	205	65	1	5	4	0	0
NKERPOP-197	140	205	65	1	5	4	0	0
NKERPOP-197	140	205	65	1	5	4	0	0
NKERPOP-197	140	282	142	1	4	1	3	0
NKERPOP-197	140	141	1	1	3	1	0	0
NKERPOP-197	141	151	10	1	4	1	0	0
NKERPOP-197	142	156	14	1	3	4	1	0
NKERPOP-197	151	220	69	1	3	4	3	0
NKERPOP-197	154	234	80	1	3	4	3	0
NKERPOP-197	154	177	23	1	3	1	3	0
NKERPOP-197	154	168	14	1	3	1	2	0
NKERPOP-198	155	371	216	1	4	4	1	0
NKERPOP-198	156	168	12	1	3	1	0	0
NKERPOP-198	157	158	1	1	3	4	0	0
NKERPOP-198	161	211	50	1	4	4	0	0
NKERPOP-198	164	317	153	1	4	4	1	0
NKERPOP-198	168	178	10	1	4	4	3	0
NKERPOP-198	168	192	24	1	4	4	1	0
NKERPOP-198	168	197	29	1	3	4	1	2
NKERPOP-198	169	170	1	1	5	1	3	0
NKERPOP-198	170	177	7	1	4	4	3	0
NKERPOP-199	171	221	50	1	3	4	1	0
NKERPOP-199	171	477	306	0	3	4	0	1
NKERPOP-199	172	423	251	1	4	1	2	0
NKERPOP-199	178	197	19	1	3	4	1	1
NKERPOP-199	182	477	295	0	4	4	0	0
NKERPOP-199	183	192	9	1	3	4	3	0
NKERPOP-199	183	211	28	1	3	4	1	2
NKERPOP-199	185	193	8	1	4	4	0	0
NKERPOP-199	185	394	209	1	4	4	2	0
NKERPOP-199	189	198	9	1	4	1	3	0
NKERPOP-200	190	203	13	1	2	4	0	0
NKERPOP-200	190	477	287	0	3	4	0	0
NKERPOP-200	190	323	133	1	3	4	1	0
NKERPOP-200	191	207	16	1	3	1	0	0
NKERPOP-200	192	477	285	0	3	4	0	0
NKERPOP-200	192	218	26	1	4	1	3	0
NKERPOP-200	195	239	44	1	5	1	1	0
NKERPOP-200	195	211	16	1	4	4	0	0
NKERPOP-200	195	249	54	1	3	1	0	0
NKERPOP-200	196	200	4	1	3	1	3	0
NKERPOP-201	197	316	119	1	3	4	2	0
NKERPOP-201	197	203	6	1	4	4	3	0
NKERPOP-201	199	222	23	1	3	4	3	0
NKERPOP-201	199	346	147	1	3	4	2	0
NKERPOP-201	203	477	274	0	4	4	0	0
NKERPOP-201	206	275	69	1	3	4	3	0
NKERPOP-201	212	215	3	1	3	4	3	0
NKERPOP-201	213	224	11	1	4	4	3	0
NKERPOP-201	213	336	123	1	3	4	2	0
NKERPOP-201	218	415	197	1	2	1	0	0
NKERPOP-202	218	477	259	0	3	4	0	0
NKERPOP-202	219	246	27	1	3	1	2	0
NKERPOP-202	220	248	28	1	4	4	3	1
NKERPOP-202	220	248	28	1	4	4	3	1
NKERPOP-202	223	227	4	1	4	4	3	0
NKERPOP-202	225	269	44	1	2	4	3	0
NKERPOP-202	226	263	37	1	4	4	3	1
NKERPOP-202	236	477	241	0	3	4	0	0
NKERPOP-202	238	247	9	1	3	1	1	0
NKERPOP-202	247	260	13	1	4	1	1	0
NKERPOP-203	248	264	16	1	3	1	3	0
NKERPOP-203	248	255	7	1	4	4	1	0
NKERPOP-203	253	261	8	1	3	1	3	0
NKERPOP-203	253	260	7	1	4	4	1	1
NKERPOP-203	254	255	1	1	4	4	3	1
NKERPOP-203	255	269	14	1	3	4	2	0
NKERPOP-203	256	257	1	1	3	4	0	0
NKERPOP-203	258	277	19	1	5	4	1	0
NKERPOP-203	260	318	58	1	4	4	2	0
NKERPOP-203	261	270	9	1	3	4	1	0
NKERPOP-204	261	275	14	1	3	4	3	0
NKERPOP-204	261	276	15	1	3	4	1	0
NKERPOP-204	261	263	2	1	3	1	0	0
NKERPOP-204	262	283	21	1	2	1	0	1
NKERPOP-204	266	276	10	1	3	1	3	0
NKERPOP-204	267	274	7	1	4	4	3	0
NKERPOP-204	269	477	208	0	3	4	0	0
NKERPOP-204	269	270	1	1	3	4	0	0
NKERPOP-204	269	332	63	1	3	4	0	0
NKERPOP-204	269	276	7	1	3	4	1	0
NKERPOP-205	269	315	46	1	4	4	2	0
NKERPOP-205	269	333	64	1	3	1	0	0
NKERPOP-205	273	309	36	1	3	4	0	0
NKERPOP-205	273	280	7	1	3	4	1	0
NKERPOP-205	274	477	203	0	3	4	0	0
NKERPOP-205	274	276	2	1	4	4	3	0
NKERPOP-205	274	277	3	1	3	4	3	0
NKERPOP-205	275	294	19	1	3	1	0	0
NKERPOP-205	276	289	13	1	3	1	1	0
NKERPOP-205	280	312	32	1	3	4	1	1
NKERPOP-206	281	289	8	1	3	4	1	0
NKERPOP-206	282	294	12	1	3	4	1	0
NKERPOP-206	283	298	15	1	4	4	2	0
NKERPOP-206	283	477	194	0	4	4	0	1
NKERPOP-206	287	311	24	1	3	4	1	2
NKERPOP-206	287	308	21	1	2	4	2	0
NKERPOP-206	287	295	8	1	4	4	1	0
NKERPOP-206	287	313	26	1	4	4	2	0
NKERPOP-206	288	303	15	1	3	4	3	0
NKERPOP-206	288	313	25	1	4	4	2	0
NKERPOP-207	289	308	19	1	3	4	2	1
NKERPOP-207	289	301	12	1	3	4	2	0
NKERPOP-207	291	310	19	1	3	4	1	0
NKERPOP-207	291	295	4	1	3	4	2	0
NKERPOP-207	291	301	10	1	4	4	3	0
NKERPOP-207	294	343	49	1	3	4	1	0
NKERPOP-207	295	477	182	0	3	4	1	0
NKERPOP-207	295	302	7	1	4	4	2	0
NKERPOP-207	295	312	17	1	3	4	2	0
NKERPOP-207	295	322	27	1	3	4	1	1
NKERPOP-208	297	477	180	0	3	4	0	1
NKERPOP-208	298	301	3	1	3	1	2	0
NKERPOP-208	298	417	119	1	4	4	0	0
NKERPOP-208	301	477	176	0	3	4	0	0
NKERPOP-208	303	309	6	1	4	4	2	0
NKERPOP-208	304	477	173	0	4	4	0	0
NKERPOP-208	305	306	1	1	4	4	0	0
NKERPOP-208	306	307	1	1	4	1	0	1
NKERPOP-208	307	386	79	1	4	4	2	0
NKERPOP-208	308	477	169	0	3	4	0	0
NKERPOP-209	310	477	167	0	2	1	0	0
NKERPOP-209	311	312	1	1	4	1	2	0
NKERPOP-209	315	322	7	1	4	4	2	0
NKERPOP-209	315	322	7	1	3	4	1	0
NKERPOP-209	319	322	3	1	4	1	2	0
NKERPOP-209	319	332	13	1	3	1	2	0
NKERPOP-209	322	352	30	1	3	1	2	0
NKERPOP-209	323	350	27	1	4	4	2	0
NKERPOP-209	325	400	75	1	4	4	2	0
NKERPOP-209	329	477	148	0	4	4	0	0
NKERPOP-210	329	336	7	1	3	1	2	0
NKERPOP-210	329	337	8	1	3	4	1	0
NKERPOP-210	330	337	7	1	4	4	1	0
NKERPOP-210	330	337	7	1	4	4	1	0
NKERPOP-210	331	332	1	1	3	4	1	0
NKERPOP-210	331	371	40	1	3	1	2	0
NKERPOP-210	332	340	8	1	3	4	2	0
NKERPOP-210	333	477	144	0	3	1	0	0
NKERPOP-210	334	335	1	1	3	1	0	0
NKERPOP-210	336	337	1	1	3	1	0	0
NKERPOP-211	338	352	14	1	3	4	2	0
NKERPOP-211	344	347	3	1	3	4	1	0
NKERPOP-211	345	477	132	0	3	1	0	0
NKERPOP-211	346	363	17	1	4	1	2	0
NKERPOP-211	346	350	4	1	3	4	2	0
NKERPOP-211	347	477	130	0	4	4	0	0
NKERPOP-211	351	364	13	1	3	4	1	0
NKERPOP-211	351	352	1	1	4	4	1	0
NKERPOP-211	352	365	13	1	3	4	1	0
NKERPOP-211	352	363	11	1	3	4	1	0
NKERPOP-212	352	353	1	1	4	4	0	0
NKERPOP-212	359	365	6	1	3	4	3	0
NKERPOP-212	360	394	34	1	4	4	2	0
BAGO-183	1	21	20	1	3	3	1	0
BAGO-183	2	3	1	1	3	1	1	0
BAGO-183	3	4	1	1	3	3	3	0
BAGO-184	7	477	470	0	3	2	1	0
BAGO-184	9	477	468	0	3	2	0	0
BAGO-184	15	22	7	1	3	1	1	0
BAGO-184	17	477	460	0	4	3	1	0
BAGO-184	17	18	1	1	3	1	1	0
BAGO-184	23	31	8	1	3	4	1	0
BAGO-184	30	31	1	1	3	1	0	0
BAGO-184	31	51	20	1	3	1	0	1
BAGO-184	35	36	1	1	3	1	0	1
BAGO-184	37	38	1	1	4	1	1	0
BAGO-185	37	477	440	0	3	2	1	0
BAGO-185	37	65	28	1	3	2	0	0
BAGO-185	37	78	41	1	3	1	1	0
BAGO-185	38	477	439	0	3	1	1	0
BAGO-185	38	39	1	1	3	1	1	0
BAGO-185	44	65	21	1	3	2	1	1
BAGO-185	51	477	426	0	4	3	0	1
BAGO-185	51	52	1	1	4	1	1	0
BAGO-185	51	52	1	1	4	4	1	0
BAGO-185	51	52	1	1	4	4	1	1
BAGO-186	52	53	1	1	5	1	1	0
BAGO-186	57	59	2	1	3	2	1	0
BAGO-186	58	60	2	1	4	1	1	0
BAGO-186	58	477	419	0	3	2	1	0
BAGO-186	58	477	419	0	3	3	0	0
BAGO-186	58	64	6	1	3	1	1	0
BAGO-186	59	65	6	1	3	1	1	1
BAGO-186	59	65	6	1	3	2	1	0
BAGO-186	63	67	4	1	3	3	1	0
BAGO-186	63	477	414	0	3	4	1	0
BAGO-187	64	135	71	1	3	1	1	0
BAGO-187	65	66	1	1	4	1	1	0
BAGO-187	65	93	28	1	4	3	1	0
BAGO-187	66	67	1	1	3	1	1	0
BAGO-187	67	68	1	1	4	3	1	0
BAGO-187	67	477	410	0	3	1	0	0
BAGO-187	67	477	410	0	3	5	0	1
BAGO-187	73	226	153	1	3	2	1	1
BAGO-187	73	86	13	1	4	1	1	1
BAGO-187	73	203	130	1	3	4	1	0
BAGO-188	78	267	189	1	3	1	2	0
BAGO-188	79	94	15	1	3	4	1	0
BAGO-188	85	477	392	0	3	1	0	0
BAGO-188	86	87	1	1	4	1	1	1
BAGO-188	87	142	55	1	4	1	1	0
BAGO-188	93	94	1	1	3	4	1	0
BAGO-188	93	94	1	1	3	1	1	0
BAGO-188	93	94	1	1	4	1	1	1
BAGO-188	100	102	2	1	3	2	1	0
BAGO-188	100	115	15	1	3	3	1	0
BAGO-189	106	108	2	1	3	1	1	1
BAGO-189	107	109	2	1	3	1	1	0
BAGO-189	107	108	1	1	3	1	1	1
BAGO-189	114	123	9	1	4	3	1	0
BAGO-189	115	123	8	1	3	3	1	1
BAGO-189	115	116	1	1	3	1	1	0
BAGO-189	121	123	2	1	3	1	1	0
BAGO-189	134	217	83	1	4	4	1	0
BAGO-189	134	367	233	1	3	2	2	0
BAGO-189	135	137	2	1	4	1	1	0
BAGO-190	142	226	84	1	4	1	1	0
BAGO-190	142	185	43	1	4	1	0	0
BAGO-190	149	171	22	1	3	3	3	1
BAGO-190	156	157	1	1	4	2	1	0
BAGO-190	164	165	1	1	3	4	3	0
BAGO-190	170	172	2	1	3	4	1	1
BAGO-190	178	179	1	1	3	1	1	0
BAGO-190	185	186	1	1	3	2	1	2
BAGO-190	203	240	37	1	3	4	1	0
BAGO-190	205	238	33	1	3	1	1	0
BAGO-191	206	477	271	0	3	1	0	0
BAGO-191	210	218	8	1	3	1	0	0
BAGO-191	218	477	259	0	3	3	1	1
BAGO-191	218	219	1	1	4	2	1	0
BAGO-191	219	312	93	1	3	1	2	0
BAGO-191	225	262	37	1	4	4	1	0
BAGO-191	232	265	33	1	4	1	1	0
BAGO-191	233	235	2	1	4	4	1	0
BAGO-191	233	240	7	1	3	1	1	1
BAGO-191	234	240	6	1	3	2	1	1
BAGO-192	235	239	4	1	3	4	1	1
BAGO-192	235	477	242	0	4	4	0	0
BAGO-192	238	254	16	1	3	1	1	0
BAGO-192	239	254	15	1	3	1	1	0
BAGO-192	240	477	237	0	4	4	1	2
BAGO-192	242	477	235	0	4	1	1	1
BAGO-192	242	260	18	1	4	1	0	1
BAGO-192	248	265	17	1	3	1	1	0
BAGO-192	254	260	6	1	3	1	1	0
BAGO-192	256	324	68	1	4	1	1	0
BAGO-193	259	477	218	0	3	1	0	0
BAGO-193	260	477	217	0	3	1	1	0
BAGO-193	260	477	217	0	3	4	1	1
BAGO-193	262	264	2	1	3	4	1	0
BAGO-193	263	264	1	1	3	1	2	1
BAGO-193	263	477	214	0	3	1	1	1
BAGO-193	265	266	1	1	4	3	2	0
BAGO-193	266	477	211	0	4	1	0	0
BAGO-193	266	477	211	0	3	4	0	0
BAGO-193	267	269	2	1	4	4	2	0
BAGO-194	268	273	5	1	3	4	2	0
BAGO-194	268	269	1	1	4	1	2	2
BAGO-194	290	296	6	1	3	1	2	0
BAGO-194	290	302	12	1	3	2	2	1
BAGO-194	290	302	12	1	3	2	1	2
BAGO-194	290	477	187	0	4	2	0	2
BAGO-194	304	477	173	0	3	2	1	0
BAGO-194	304	305	1	1	3	1	2	0
BAGO-194	305	306	1	1	3	1	1	0
BAGO-194	311	312	1	1	5	1	0	0
BAGO-195	315	435	120	1	3	1	2	3
BAGO-195	315	366	51	1	3	3	2	1
BAGO-195	315	366	51	1	3	1	2	1
BAGO-195	318	408	90	1	5	1	1	0
BAGO-195	318	324	6	1	4	5	1	1
BAGO-195	319	324	5	1	4	2	1	1
BAGO-195	324	477	153	0	4	4	0	0
BAGO-195	324	434	110	1	3	2	2	0
BAGO-195	324	325	1	1	3	1	3	0
BAGO-195	324	477	153	0	3	3	0	0
BAGO-196	326	477	151	0	4	3	0	0
BAGO-196	331	332	1	1	4	1	1	0
BAGO-196	336	337	1	1	2	1	1	0
BAGO-196	338	345	7	1	3	1	2	0
BAGO-196	338	339	1	1	4	2	3	0
BAGO-196	339	340	1	1	4	3	1	0
BAGO-196	345	346	1	1	3	1	2	0
MAHAWK-168	120	477	357	0	1	1	0	0
MAHAWK-168	333	477	144	0	3	4	0	0
MEE-215	2	3	1	1	3	5	1	0
MEE-215	7	8	1	1	3	2	1	0
MEE-216	7	8	1	1	3	2	1	0
MEE-216	8	477	469	0	3	1	0	0
MEE-216	9	10	1	1	3	1	2	0
MEE-216	18	477	459	0	3	5	0	0
MEE-216	24	477	453	0	4	1	0	0
MEE-216	30	31	1	1	3	1	1	0
MEE-216	30	281	251	1	3	4	0	0
MEE-216	30	43	13	1	3	1	1	0
MEE-216	31	32	1	1	3	5	2	0
MEE-216	31	477	446	0	3	1	1	0
MEE-217	48	477	429	0	3	3	0	0
MEE-217	49	50	1	1	4	5	1	0
MEE-217	50	51	1	1	3	1	3	0
MEE-217	52	53	1	1	3	5	1	0
MEE-217	55	56	1	1	3	1	1	0
MEE-217	59	183	124	1	3	5	1	0
MEE-217	60	477	417	0	3	4	0	0
MEE-217	67	477	410	0	3	1	0	0
MEE-217	70	71	1	1	3	5	1	0
MEE-217	70	71	1	1	3	5	1	0
MEE-218	70	71	1	1	3	5	1	0
MEE-218	79	175	96	1	3	1	0	0
MEE-218	83	84	1	1	3	1	0	0
MEE-218	105	190	85	1	3	1	0	0
MEE-218	106	107	1	1	3	5	1	0
MEE-218	106	346	240	1	3	2	2	0
MEE-218	107	320	213	1	3	5	1	0
MEE-218	107	183	76	1	3	5	2	0
MEE-218	110	477	367	0	4	1	0	0
MEE-218	119	151	32	1	3	2	0	0
MEE-219	123	124	1	1	3	5	1	0
MEE-219	124	125	1	1	3	5	1	0
MEE-219	124	477	353	0	3	1	0	0
MEE-219	154	190	36	1	3	5	1	0
MEE-219	154	338	184	1	3	5	1	0
MEE-219	168	169	1	1	3	3	2	0
MEE-219	168	169	1	1	3	4	2	0
MEE-219	171	477	306	0	4	1	2	0
MEE-219	172	477	305	0	3	1	0	0
MEE-219	185	477	292	0	3	1	0	0
MEE-220	192	477	285	0	2	1	0	0
MEE-220	196	339	143	1	3	1	1	0
MEE-220	210	477	267	0	3	1	0	0
MEE-220	210	477	267	0	3	1	0	0
MEE-220	212	477	265	0	4	1	0	0
MEE-220	214	477	263	0	4	1	0	0
MEE-220	214	215	1	1	4	3	2	0
MEE-220	219	220	1	1	3	5	3	0
MEE-220	219	220	1	1	3	5	1	0
MEE-220	220	235	15	1	3	2	1	4
MEE-221	221	239	18	1	3	2	1	4
MEE-221	221	235	14	1	3	2	1	2
MEE-221	221	235	14	1	3	2	2	2
MEE-221	221	235	14	1	3	2	2	2
MEE-221	221	239	18	1	3	2	1	2
MEE-221	221	240	19	1	3	2	1	2
MEE-221	221	239	18	1	3	2	1	2
MEE-221	221	239	18	1	3	2	1	2
MEE-221	221	239	18	1	3	2	1	1
MEE-221	221	239	18	1	3	2	1	1
MEE-222	221	239	18	1	3	2	1	1
MEE-222	221	235	14	1	2	4	2	1
MEE-222	226	227	1	1	5	4	4	0
MEE-222	229	477	248	0	4	1	0	0
MEE-222	235	236	1	1	3	5	1	0
MEE-222	235	236	1	1	3	5	1	0
MEE-222	235	477	242	0	3	1	1	0
MEE-222	235	346	111	1	3	5	1	0
MEE-222	239	477	238	0	4	5	0	0
MEE-222	242	477	235	0	2	1	0	0
MEE-223	242	477	235	0	3	4	0	0
MEE-223	245	338	93	1	3	5	1	0
MEE-223	250	251	1	1	2	1	0	0
MEE-223	252	259	7	1	3	1	1	0
MEE-223	253	477	224	0	3	1	1	0
MEE-223	255	477	222	0	3	1	0	0
MEE-223	256	282	26	1	3	5	1	0
MEE-223	256	259	3	1	3	4	4	0
MEE-223	260	477	217	0	3	1	0	0
MEE-223	261	346	85	1	3	1	2	0
MEE-224	262	268	6	1	3	1	0	0
MEE-224	263	351	88	1	3	5	1	0
MEE-224	264	267	3	1	3	5	3	0
MEE-224	266	477	211	0	4	4	0	0
MEE-224	266	477	211	0	3	1	0	0
MEE-224	267	268	1	1	3	1	4	0
MEE-224	267	268	1	1	3	1	0	0
MEE-224	267	346	79	1	3	2	1	1
MEE-224	269	270	1	1	3	5	2	0
MEE-224	270	346	76	1	3	1	3	0
MEE-225	274	477	203	0	4	5	3	0
MEE-225	274	338	64	1	3	5	1	0
MEE-225	274	366	92	1	3	5	1	0
MEE-225	280	337	57	1	4	1	2	0
MEE-225	280	281	1	1	3	5	1	0
MEE-225	280	281	1	1	3	5	2	0
MEE-225	280	477	197	0	3	5	1	0
MEE-225	282	477	195	0	3	4	0	0
MEE-225	284	285	1	1	3	1	1	0
MEE-225	288	477	189	0	3	4	0	0
MEE-226	294	477	183	0	3	5	0	0
MEE-226	295	356	61	1	3	4	1	0
MEE-226	296	477	181	0	4	1	0	0
MEE-226	301	477	176	0	2	1	0	0
MEE-226	301	477	176	0	2	1	0	0
MEE-226	302	477	175	0	3	1	0	0
MEE-226	302	338	36	1	3	5	1	0
MEE-226	302	477	175	0	3	3	0	0
MEE-226	306	339	33	1	4	4	2	0
MEE-226	306	338	32	1	3	5	1	0
MEE-227	315	477	162	0	3	1	1	0
MEE-227	315	477	162	0	3	1	1	0
MEE-227	315	316	1	1	3	5	1	0
MEE-227	315	316	1	1	3	5	1	0
MEE-227	316	477	161	0	3	5	1	0
MEE-227	317	360	43	1	3	5	2	1
MEE-227	317	352	35	1	4	5	2	0
MEE-227	318	477	159	0	3	4	1	0
MEE-227	322	339	17	1	3	4	1	0
MEE-227	322	325	3	1	4	5	1	0
MEE-228	324	390	66	1	3	5	1	4
MEE-228	324	346	22	1	3	5	1	1
MEE-228	324	346	22	1	3	5	1	2
MEE-228	324	339	15	1	3	4	1	0
MEE-228	325	477	152	0	4	5	1	0
MEE-228	325	477	152	0	4	3	1	0
MEE-228	325	477	152	0	4	5	1	0
MEE-228	325	390	65	1	3	5	1	0
MEE-228	326	327	1	1	3	5	1	0
MEE-228	326	477	151	0	4	5	1	0
MEE-229	326	332	6	1	3	5	1	0
MEE-229	326	340	14	1	3	5	1	1
MEE-229	329	390	61	1	4	5	1	0
MEE-229	329	477	148	0	4	5	1	0
MEE-229	329	477	148	0	3	1	1	0
MEE-229	331	477	146	0	3	1	4	0
MEE-229	331	444	113	1	3	5	1	1
MEE-229	331	390	59	1	3	5	1	3
MEE-229	331	477	146	0	3	5	1	2
MEE-229	332	477	145	0	4	1	0	0
MEE-230	333	477	144	0	3	5	0	1
MEE-230	333	359	26	1	3	4	1	0
MEE-230	333	420	87	1	3	1	1	0
MEE-230	333	477	144	0	3	5	1	0
MEE-230	333	345	12	1	3	5	1	4
MEE-230	334	477	143	0	5	4	0	0
MEE-230	335	477	142	0	3	2	1	0
MEE-230	335	477	142	0	3	5	0	0
MEE-230	335	477	142	0	4	5	0	0
MEE-230	335	477	142	0	3	5	0	0
MEE-231	335	477	142	0	4	5	0	0
MEE-231	335	477	142	0	3	5	0	0
MEE-231	336	348	12	1	4	5	0	0
MEE-231	336	337	1	1	3	1	1	1
MEE-231	336	477	141	0	5	4	0	0
MEE-231	337	348	11	1	4	5	0	0
MEE-231	337	339	2	1	5	5	1	0
MEE-231	337	346	9	1	3	5	1	1
MEE-231	338	339	1	1	4	3	0	0
MEE-231	338	346	8	1	5	4	1	0
MEE-232	338	339	1	1	3	1	1	0
MEE-232	338	346	8	1	4	5	1	0
MEE-232	338	346	8	1	3	3	1	0
MEE-232	338	356	18	1	3	5	1	0
MEE-232	339	477	138	0	4	3	0	0
MEE-232	339	346	7	1	3	1	1	0
MEE-232	339	346	7	1	3	5	1	0
MEE-232	339	477	138	0	3	3	0	0
MEE-232	340	346	6	1	3	4	1	0
MEE-232	340	477	137	0	3	5	0	0
MEE-233	340	346	6	1	3	1	3	0
MEE-233	340	390	50	1	3	5	1	1
MEE-233	340	368	28	1	3	5	1	0
MEE-233	340	371	31	1	3	5	1	0
MEE-233	340	366	26	1	3	5	1	0
MEE-233	340	354	14	1	3	5	1	0
MEE-233	340	477	137	0	3	5	1	1
MEE-233	340	360	20	1	5	4	1	0
MEE-233	340	477	137	0	4	1	0	0
MEE-233	341	358	17	1	3	5	0	0
MEE-234	342	343	1	1	3	5	1	0
MEE-234	342	477	135	0	3	3	0	0
MEE-234	342	369	27	1	3	5	0	0
MEE-234	342	477	135	0	3	5	0	0
MEE-234	342	477	135	0	3	5	0	0
MEE-234	342	353	11	1	3	5	0	0
MEE-234	342	477	135	0	3	5	0	0
MEE-234	342	477	135	0	3	5	1	0
MEE-234	342	350	8	1	3	5	0	0
MEE-234	342	477	135	0	3	5	1	0
MEE-235	342	477	135	0	3	5	1	0
MEE-235	342	477	135	0	3	5	1	0
MEE-235	343	477	134	0	3	1	0	0
MEE-235	343	477	134	0	3	1	0	0
MEE-235	344	390	46	1	3	4	0	0
MEE-235	344	390	46	1	3	4	0	0
MEE-235	345	477	132	0	3	5	0	0
MEE-235	345	347	2	1	3	1	1	1
MEE-235	345	477	132	0	3	5	1	2
MEE-235	345	477	132	0	3	3	0	0
MEE-236	345	477	132	0	4	2	1	0
MEE-236	345	422	77	1	3	4	1	0
MEE-236	346	477	131	0	3	5	0	0
MEE-236	346	353	7	1	4	4	3	0
MEE-236	346	477	131	0	3	4	1	0
MEE-236	346	477	131	0	1	2	1	0
MEE-236	346	347	1	1	4	1	1	0
MEE-236	347	477	130	0	3	2	0	0
MEE-236	348	354	6	1	4	5	1	0
MEE-236	350	477	127	0	3	5	0	0
MEE-237	350	460	110	1	3	5	0	0
MEE-237	350	477	127	0	3	5	0	0
MEE-237	350	460	110	1	3	5	0	0
MEE-237	350	360	10	1	3	5	1	0
MEE-237	350	477	127	0	3	5	0	0
MEE-237	350	460	110	1	3	5	0	0
MEE-237	350	477	127	0	3	5	0	0
MEE-237	350	477	127	0	3	5	0	0
MEE-237	350	477	127	0	3	5	0	0
MEE-237	350	477	127	0	3	5	0	0
MEE-238	350	477	127	0	3	5	0	0
MEE-238	350	477	127	0	3	5	0	0
MEE-238	350	477	127	0	3	5	0	0
MEE-238	350	477	127	0	3	5	0	0
MEE-238	350	477	127	0	3	5	0	0
MEE-238	350	353	3	1	3	5	0	0
MEE-238	350	359	9	1	3	5	1	0
MEE-238	350	477	127	0	3	5	0	0
MEE-238	350	360	10	1	3	5	1	0
MEE-238	350	477	127	0	3	5	0	0
MEE-239	350	477	127	0	3	5	0	0
MEE-239	350	360	10	1	3	5	1	0
MEE-239	350	363	13	1	3	5	0	0
MEE-239	350	460	110	1	3	5	0	0
MEE-239	350	477	127	0	3	5	0	0
MEE-239	350	477	127	0	3	5	0	0
MEE-239	350	477	127	0	3	5	0	0
MEE-239	350	477	127	0	3	5	0	0
MEE-239	350	477	127	0	3	5	0	0
MEE-239	350	371	21	1	3	5	0	0
MEE-240	350	477	127	0	3	5	0	0
MEE-240	350	477	127	0	3	5	0	0
MEE-240	350	452	102	1	3	5	1	0
MEE-240	350	477	127	0	3	1	1	0
MEE-240	351	358	7	1	4	5	0	0
MEE-240	352	362	10	1	3	5	1	1
MEE-240	353	354	1	1	3	5	1	1
MEE-240	353	477	124	0	3	3	1	0
MEE-240	353	477	124	0	3	1	0	0
MEE-241	354	477	123	0	3	4	0	0
MEE-241	354	360	6	1	4	1	1	0
MEE-241	354	477	123	0	4	1	0	0
MEE-241	354	477	123	0	4	1	0	0
MEE-241	354	477	123	0	3	1	0	0
MEE-241	354	477	123	0	3	1	0	0
MEE-241	354	360	6	1	3	1	1	0
MEE-241	354	360	6	1	4	1	1	0
MEE-241	354	360	6	1	4	1	1	0
MEE-241	354	477	123	0	2	1	0	0
MEE-242	354	477	123	0	3	1	0	0
MEE-242	354	477	123	0	4	4	0	0
MEE-242	359	360	1	1	4	1	1	0
MEE-242	360	361	1	1	4	5	1	0
MEE-242	361	362	1	1	4	5	1	1
MEE-242	361	477	116	0	4	4	1	1
MEE-242	361	477	116	0	3	1	1	0
MEE-242	361	477	116	0	4	1	1	0
MEE-242	361	367	6	1	4	5	1	0
MEE-242	361	390	29	1	4	5	1	0
MEE-243	361	362	1	1	4	4	0	0
MEE-243	361	477	116	0	3	5	0	0
MEE-243	361	477	116	0	3	5	0	0
MEE-243	363	364	1	1	4	4	0	0
MEE-243	363	477	114	0	3	5	0	0
REE-46	1	2	1	1	3	1	1	0
REE-46	4	477	473	0	3	1	0	0
REE-46	36	477	441	0	3	1	0	0
REE-46	47	477	430	0	3	1	0	0
REE-46	47	277	230	1	3	1	1	1
REE-46	51	227	176	1	3	1	1	0
REE-46	63	64	1	1	3	1	1	0
REE-46	88	89	1	1	1	3	1	0
REE-47	102	110	8	1	2	4	1	0
REE-47	108	110	2	1	3	4	1	0
REE-47	126	477	351	0	3	1	0	0
REE-47	135	477	342	0	4	1	0	0
REE-47	142	267	125	1	3	4	1	0
REE-47	143	270	127	1	3	4	1	0
REE-47	164	477	313	0	3	1	0	0
REE-47	213	477	264	0	1	1	0	0
REE-47	213	477	264	0	3	1	0	0
REE-48	213	227	14	1	3	1	1	0
REE-48	215	477	262	0	2	4	0	0
REE-48	219	275	56	1	3	1	1	0
REE-48	223	267	44	1	3	4	1	0
REE-48	262	263	1	1	3	1	1	0
REE-48	268	273	5	1	3	1	1	1
REE-48	269	274	5	1	3	1	1	0
REE-48	275	277	2	1	3	4	1	0
REE-48	275	277	2	1	3	4	1	0
REE-48	280	281	1	1	4	1	1	1
REE-49	288	477	189	0	3	1	0	0
REE-49	305	306	1	1	3	1	1	0
REE-49	326	477	151	0	4	4	0	0
RQUE-35	183	237	54	1	3	1	1	0
RQUE-35	226	477	251	0	3	2	0	0
RQUE-35	237	477	240	0	3	1	0	0
RQUE-35	342	343	1	1	3	2	1	0
RQUE-35	342	477	135	0	3	4	0	0
RQUE-35	342	477	135	0	3	4	1	0
RQUE-35	342	370	28	1	3	2	1	0
AFODION-286	1	7	6	1	3	1	1	0
AFODION-287	1	477	476	0	3	1	1	0
AFODION-287	1	35	34	1	3	4	0	0
AFODION-287	1	143	142	1	3	5	0	0
AFODION-287	2	91	89	1	3	1	0	0
AFODION-287	2	85	83	1	3	1	0	0
AFODION-287	3	4	1	1	4	5	1	0
AFODION-287	3	39	36	1	4	1	1	0
AFODION-287	3	106	103	1	2	1	1	0
AFODION-287	3	477	474	0	3	1	0	0
AFODION-287	3	10	7	1	3	1	1	0
AFODION-288	3	8	5	1	3	5	1	0
AFODION-288	4	32	28	1	3	1	1	0
AFODION-288	4	477	473	0	3	4	1	0
AFODION-288	4	59	55	1	3	4	1	0
AFODION-288	4	477	473	0	3	4	1	0
AFODION-288	4	106	102	1	3	1	1	0
AFODION-288	6	39	33	1	2	1	0	0
AFODION-288	6	10	4	1	4	1	1	0
AFODION-288	7	206	199	1	3	4	1	0
AFODION-288	7	477	470	0	3	5	0	0
AFODION-289	7	23	16	1	3	1	1	0
AFODION-289	7	39	32	1	3	1	0	0
AFODION-289	7	8	1	1	3	1	1	0
AFODION-289	8	39	31	1	3	1	0	0
AFODION-289	8	477	469	0	3	1	1	0
AFODION-289	8	10	2	1	3	5	1	0
AFODION-289	8	10	2	1	3	1	1	0
AFODION-289	8	10	2	1	3	1	1	0
AFODION-289	8	9	1	1	3	1	1	0
AFODION-289	9	477	468	0	3	1	1	0
AFODION-290	9	477	468	0	3	1	0	0
AFODION-290	10	477	467	0	3	1	0	0
AFODION-290	10	23	13	1	3	1	1	0
AFODION-290	10	477	467	0	3	1	1	0
AFODION-290	10	15	5	1	3	4	1	0
AFODION-290	10	106	96	1	3	1	1	0
AFODION-290	11	477	466	0	3	1	0	0
AFODION-290	11	477	466	0	4	3	1	0
AFODION-290	12	37	25	1	3	1	1	0
AFODION-290	15	477	462	0	3	5	0	0
AFODION-291	15	477	462	0	3	5	0	0
AFODION-291	15	23	8	1	3	1	1	0
AFODION-291	15	29	14	1	3	1	1	0
AFODION-291	16	17	1	1	3	1	1	0
AFODION-291	16	17	1	1	3	1	0	0
AFODION-291	17	477	460	0	3	1	1	0
AFODION-291	17	93	76	1	3	1	0	0
AFODION-291	17	477	460	0	3	2	1	0
AFODION-291	18	21	3	1	3	1	1	0
AFODION-291	18	172	154	1	5	1	0	0
AFODION-292	18	477	459	0	3	2	0	0
AFODION-292	18	477	459	0	3	5	0	0
AFODION-292	21	477	456	0	3	1	1	0
AFODION-292	22	477	455	0	3	5	0	0
AFODION-292	23	477	454	0	3	1	0	0
AFODION-292	24	477	453	0	3	1	0	0
AFODION-292	24	190	166	1	3	4	1	0
AFODION-292	24	37	13	1	3	1	1	0
AFODION-292	24	25	1	1	3	4	1	0
AFODION-292	25	477	452	0	3	5	0	0
AFODION-293	25	32	7	1	3	1	0	0
AFODION-293	25	32	7	1	3	1	0	0
AFODION-293	27	106	79	1	3	1	1	0
AFODION-293	27	76	49	1	3	1	1	0
AFODION-293	28	477	449	0	3	5	0	0
AFODION-293	28	56	28	1	3	1	1	0
AFODION-293	29	39	10	1	2	1	0	0
AFODION-293	29	477	448	0	3	1	0	0
AFODION-293	30	477	447	0	3	5	0	0
AFODION-293	30	477	447	0	3	1	0	0
AFODION-294	30	477	447	0	3	1	1	0
AFODION-294	31	34	3	1	3	1	1	0
AFODION-294	31	32	1	1	3	1	1	0
AFODION-294	31	39	8	1	5	1	1	0
AFODION-294	31	477	446	0	3	1	0	0
AFODION-294	31	76	45	1	5	1	1	0
AFODION-294	31	477	446	0	3	2	0	1
AFODION-294	31	477	446	0	3	4	0	0
AFODION-294	32	477	445	0	3	2	0	0
AFODION-294	32	477	445	0	3	4	0	0
AFODION-295	32	477	445	0	4	4	0	0
AFODION-295	33	35	2	1	3	1	1	0
AFODION-295	33	248	215	1	3	1	1	0
AFODION-295	33	477	444	0	3	4	0	1
AFODION-295	33	53	20	1	3	5	1	0
AFODION-295	35	477	442	0	3	1	0	0
AFODION-295	37	477	440	0	4	1	1	0
AFODION-295	37	477	440	0	3	1	0	0
AFODION-295	44	72	28	1	3	4	0	0
AFODION-295	45	50	5	1	4	1	0	0
AFODION-296	45	477	432	0	3	5	0	0
AFODION-296	46	477	431	0	3	2	0	1
AFODION-296	46	56	10	1	3	1	0	0
AFODION-296	46	477	431	0	3	4	1	0
AFODION-296	49	51	2	1	3	1	1	0
AFODION-296	51	52	1	1	3	1	1	0
AFODION-296	51	58	7	1	3	1	1	0
AFODION-296	51	52	1	1	3	1	1	0
AFODION-296	52	245	193	1	3	5	1	0
AFODION-296	54	58	4	1	3	1	1	0
AFODION-297	56	477	421	0	4	1	0	0
AFODION-297	57	477	420	0	3	5	0	0
AFODION-297	57	477	420	0	3	1	0	0
AFODION-297	58	130	72	1	3	5	0	0
AFODION-297	59	63	4	1	3	1	1	1
AFODION-297	59	477	418	0	3	1	1	1
AFODION-297	59	477	418	0	3	5	1	0
AFODION-297	59	72	13	1	3	1	1	0
AFODION-297	64	70	6	1	3	1	0	0
AFODION-297	64	477	413	0	3	4	0	0
AFODION-298	64	477	413	0	3	2	0	0
AFODION-298	64	106	42	1	3	1	0	0
AFODION-298	65	477	412	0	3	4	0	0
AFODION-298	65	66	1	1	3	1	1	0
AFODION-298	67	73	6	1	3	4	0	0
AFODION-298	67	78	11	1	3	5	1	0
AFODION-298	67	85	18	1	4	5	1	0
AFODION-298	68	477	409	0	3	5	1	0
AFODION-298	70	74	4	1	3	1	0	0
AFODION-298	70	130	60	1	3	5	0	0
AFODION-299	70	71	1	1	3	1	1	0
AFODION-299	72	106	34	1	3	1	0	0
AFODION-299	73	477	404	0	3	5	0	0
AFODION-299	73	477	404	0	3	5	0	0
AFODION-299	75	477	402	0	4	4	1	0
AFODION-299	75	477	402	0	3	5	1	0
AFODION-299	75	477	402	0	4	1	1	0
AFODION-299	76	425	349	1	3	1	1	0
AFODION-299	77	80	3	1	3	1	1	0
AFODION-299	77	95	18	1	3	1	1	0
AFODION-300	77	78	1	1	3	1	1	0
AFODION-300	78	130	52	1	3	5	0	0
AFODION-300	78	79	1	1	3	1	1	0
AFODION-300	79	477	398	0	3	2	0	0
AFODION-300	79	170	91	1	3	1	1	0
AFODION-300	79	81	2	1	3	1	1	0
AFODION-300	79	85	6	1	3	1	1	0
AFODION-300	80	136	56	1	3	1	0	0
AFODION-300	81	136	55	1	3	1	0	0
AFODION-300	81	477	396	0	3	4	0	0
AFODION-301	82	477	395	0	3	2	0	0
AFODION-301	84	477	393	0	3	5	0	2
AFODION-301	84	477	393	0	3	2	0	1
AFODION-301	84	477	393	0	4	4	1	0
AFODION-301	85	102	17	1	3	3	1	0
AFODION-301	85	141	56	1	3	1	1	0
AFODION-301	86	477	391	0	3	1	1	0
AFODION-301	91	477	386	0	3	4	0	0
AFODION-301	92	98	6	1	3	1	1	0
AFODION-301	93	106	13	1	3	1	0	0
AFODION-302	97	102	5	1	3	3	1	0
AFODION-302	98	110	12	1	3	3	1	0
AFODION-302	100	107	7	1	4	4	0	0
AFODION-302	101	106	5	1	3	4	1	0
AFODION-302	105	477	372	0	3	1	1	0
AFODION-302	105	158	53	1	3	3	1	0
AFODION-302	106	179	73	1	3	2	1	0
AFODION-302	107	477	370	0	4	4	0	0
AFODION-302	107	108	1	1	3	1	1	0
AFODION-302	108	477	369	0	3	1	0	0
AFODION-303	108	130	22	1	3	5	0	0
AFODION-303	108	113	5	1	3	4	1	0
AFODION-303	110	477	367	0	3	4	0	0
AFODION-303	110	477	367	0	3	2	0	0
AFODION-303	110	477	367	0	3	2	0	0
AFODION-303	111	257	146	1	3	5	1	0
AFODION-303	111	112	1	1	3	5	0	0
AFODION-303	111	112	1	1	4	5	1	0
AFODION-303	111	257	146	1	3	5	1	0
AFODION-303	111	172	61	1	3	1	0	0
AFODION-304	112	477	365	0	4	4	0	0
AFODION-304	113	477	364	0	3	4	0	0
AFODION-304	113	114	1	1	3	1	1	0
AFODION-304	114	115	1	1	3	1	1	0
AFODION-304	115	477	362	0	3	5	0	0
AFODION-304	115	116	1	1	3	1	0	0
AFODION-304	116	130	14	1	3	4	0	0
AFODION-304	116	136	20	1	3	1	0	0
AFODION-304	116	130	14	1	3	5	0	0
AFODION-304	117	477	360	0	3	1	1	0
AFODION-305	119	130	11	1	3	1	1	0
AFODION-305	119	477	358	0	3	1	0	0
AFODION-305	119	121	2	1	3	1	1	0
AFODION-305	120	156	36	1	3	5	1	0
AFODION-305	120	138	18	1	3	5	1	0
AFODION-305	120	477	357	0	3	1	0	0
AFODION-305	122	128	6	1	4	1	1	0
AFODION-305	122	477	355	0	3	1	0	0
AFODION-305	123	164	41	1	3	1	1	0
AFODION-305	125	128	3	1	3	4	1	0
AFODION-306	125	477	352	0	3	4	0	0
AFODION-306	127	128	1	1	3	5	1	0
AFODION-306	128	130	2	1	3	5	0	0
AFODION-306	128	477	349	0	3	1	0	0
AFODION-306	128	477	349	0	3	1	0	0
AFODION-306	128	206	78	1	3	2	1	0
AFODION-306	128	130	2	1	3	1	1	0
AFODION-306	129	477	348	0	3	1	0	0
AFODION-306	134	477	343	0	3	4	0	0
AFODION-306	135	477	342	0	3	1	0	0
AFODION-307	135	477	342	0	3	1	1	0
AFODION-307	135	142	7	1	3	1	1	0
AFODION-307	136	477	341	0	3	1	0	0
AFODION-307	136	477	341	0	3	4	0	0
AFODION-307	136	140	4	1	3	4	0	0
AFODION-307	137	139	2	1	3	4	1	0
AFODION-307	138	156	18	1	3	5	1	0
AFODION-307	138	477	339	0	3	1	0	0
AFODION-307	141	477	336	0	3	1	0	0
AFODION-307	141	477	336	0	3	5	0	0
AFODION-308	142	477	335	0	3	1	0	0
AFODION-308	142	477	335	0	3	1	0	0
AFODION-308	142	477	335	0	3	5	0	0
AFODION-308	142	143	1	1	3	1	1	0
AFODION-308	143	477	334	0	3	1	0	0
AFODION-308	143	477	334	0	3	5	0	0
AFODION-308	143	477	334	0	4	2	0	0
AFODION-308	148	477	329	0	3	5	0	0
AFODION-308	148	149	1	1	3	1	1	0
AFODION-308	149	477	328	0	3	1	0	0
AFODION-309	149	477	328	0	3	1	0	0
AFODION-309	149	477	328	0	3	4	0	0
AFODION-309	149	170	21	1	3	1	1	0
AFODION-309	150	477	327	0	3	1	0	0
AFODION-309	150	477	327	0	3	5	0	0
AFODION-309	150	477	327	0	3	4	0	0
AFODION-309	151	477	326	0	3	2	0	0
AFODION-309	151	186	35	1	3	1	1	0
AFODION-309	155	477	322	0	3	1	0	0
AFODION-309	157	477	320	0	3	1	0	0
AFODION-310	158	477	319	0	3	5	0	0
AFODION-310	158	201	43	1	3	4	1	0
AFODION-310	161	477	316	0	3	4	0	0
AFODION-310	161	477	316	0	3	5	0	0
AFODION-310	162	477	315	0	3	5	0	0
AFODION-310	163	477	314	0	3	1	0	0
AFODION-310	163	477	314	0	3	4	0	0
AFODION-310	163	170	7	1	3	1	1	0
AFODION-310	165	477	312	0	3	2	1	0
AFODION-310	165	477	312	0	3	1	0	0
AFODION-311	165	477	312	0	3	5	0	0
AFODION-311	168	171	3	1	3	5	1	0
AFODION-311	168	273	105	1	3	4	0	0
AFODION-311	169	477	308	0	3	4	0	0
AFODION-311	169	477	308	0	3	5	0	0
AFODION-311	170	477	307	0	4	4	0	0
AFODION-311	172	173	1	1	3	1	0	0
AFODION-311	174	477	303	0	3	4	0	0
AFODION-311	175	186	11	1	3	4	0	0
AFODION-311	175	477	302	0	3	5	0	0
AFODION-312	175	176	1	1	3	5	0	0
AFODION-312	175	477	302	0	4	4	0	0
AFODION-312	176	203	27	1	3	4	0	0
AFODION-312	176	477	301	0	3	4	0	0
AFODION-312	179	477	298	0	3	1	1	0
AFODION-312	179	477	298	0	3	4	0	0
AFODION-312	179	477	298	0	3	5	0	0
AFODION-312	182	192	10	1	3	4	0	0
AFODION-312	183	187	4	1	3	1	1	0
AFODION-312	184	477	293	0	3	1	1	0
AFODION-313	185	477	292	0	3	5	0	0
AFODION-313	185	191	6	1	3	1	1	0
AFODION-313	189	477	288	0	3	5	0	0
AFODION-313	190	193	3	1	4	2	1	0
AFODION-313	190	477	287	0	3	2	1	0
AFODION-313	190	198	8	1	3	4	1	0
AFODION-313	191	368	177	1	3	4	0	0
AFODION-313	191	477	286	0	3	4	0	0
AFODION-313	191	193	2	1	3	4	1	0
AFODION-313	192	477	285	0	3	4	0	0
AFODION-314	192	196	4	1	3	1	1	0
AFODION-314	193	477	284	0	3	5	0	0
AFODION-314	193	477	284	0	3	5	0	0
AFODION-314	193	477	284	0	3	2	1	0
AFODION-314	193	477	284	0	3	5	0	0
AFODION-314	194	202	8	1	3	4	1	0
AFODION-314	196	477	281	0	3	5	0	0
AFODION-314	196	213	17	1	3	4	1	0
AFODION-314	196	197	1	1	3	1	1	0
AFODION-314	197	477	280	0	3	1	0	0
AFODION-315	198	477	279	0	3	1	0	0
AFODION-315	198	477	279	0	3	4	0	0
AFODION-315	198	205	7	1	4	1	1	0
AFODION-315	198	199	1	1	3	1	1	0
AFODION-315	199	477	278	0	3	5	0	0
AFODION-315	199	477	278	0	3	2	0	0
AFODION-315	199	477	278	0	3	5	0	0
AFODION-315	199	477	278	0	4	2	0	0
AFODION-315	199	204	5	1	3	1	1	0
AFODION-315	200	477	277	0	3	5	0	0
AFODION-316	200	477	277	0	3	4	0	0
AFODION-316	201	477	276	0	3	5	0	0
AFODION-316	203	204	1	1	3	1	1	0
AFODION-316	204	218	14	1	3	4	1	0
AFODION-316	204	217	13	1	3	4	1	0
AFODION-316	205	218	13	1	3	1	1	0
AFODION-316	206	477	271	0	3	1	1	0
AFODION-316	208	213	5	1	3	1	1	0
AFODION-316	208	218	10	1	3	5	1	0
AFODION-316	210	477	267	0	3	5	0	0
AFODION-317	211	242	31	1	3	1	0	0
AFODION-317	212	477	265	0	3	1	0	0
AFODION-317	213	220	7	1	3	5	1	0
AFODION-317	216	220	4	1	3	4	1	0
AFODION-317	217	477	260	0	3	5	0	0
AFODION-317	217	230	13	1	3	4	1	0
AFODION-317	217	477	260	0	3	5	0	0
AFODION-317	217	238	21	1	3	1	1	0
AFODION-317	218	477	259	0	3	5	0	0
AFODION-317	218	477	259	0	3	5	0	0
AFODION-318	218	477	259	0	3	1	1	0
AFODION-318	220	477	257	0	3	4	0	0
AFODION-318	220	230	10	1	3	4	1	0
AFODION-318	225	477	252	0	3	1	1	0
AFODION-318	225	477	252	0	3	5	0	0
AFODION-318	227	477	250	0	3	5	0	0
AFODION-318	227	477	250	0	3	2	0	0
AFODION-318	231	260	29	1	4	1	1	0
AFODION-318	231	267	36	1	3	4	1	1
AFODION-318	235	477	242	0	3	1	0	0
AFODION-319	238	477	239	0	4	1	1	0
AFODION-319	239	477	238	0	3	5	0	0
AFODION-319	240	247	7	1	3	1	1	1
AFODION-319	248	265	17	1	3	5	1	0
AFODION-319	248	273	25	1	3	1	0	0
AFODION-319	248	273	25	1	3	1	0	0
AFODION-319	248	477	229	0	3	5	0	0
AFODION-319	249	477	228	0	3	1	0	0
AFODION-319	249	477	228	0	3	5	0	0
AFODION-319	250	477	227	0	3	5	0	0
AFODION-320	250	477	227	0	3	4	1	0
AFODION-320	251	255	4	1	3	1	1	0
AFODION-320	253	477	224	0	3	1	0	0
AFODION-320	253	255	2	1	3	1	0	0
AFODION-320	253	477	224	0	3	1	0	0
AFODION-320	255	477	222	0	3	5	0	0
AFODION-320	256	477	221	0	3	4	0	0
AFODION-320	256	477	221	0	3	5	0	0
AFODION-320	256	477	221	0	3	1	0	0
AFODION-320	261	477	216	0	3	1	1	0
AFODION-321	262	477	215	0	3	1	1	0
AFODION-321	263	477	214	0	4	4	1	1
AFODION-321	265	477	212	0	3	4	0	0
AFODION-321	265	477	212	0	3	4	0	0
AFODION-321	268	477	209	0	3	1	1	0
AFODION-321	269	477	208	0	3	1	1	0
AFODION-321	270	333	63	1	3	4	1	0
AFODION-321	270	477	207	0	3	1	0	0
AFODION-321	275	296	21	1	3	1	0	0
AFODION-321	276	477	201	0	4	4	0	0
AFODION-322	281	288	7	1	4	2	1	0
AFODION-322	282	477	195	0	3	1	0	0
AFODION-322	288	477	189	0	3	1	1	0
AFODION-322	288	290	2	1	3	1	1	0
AFODION-322	302	477	175	0	3	2	0	0
AFODION-322	302	477	175	0	3	1	0	0
AFODION-322	305	477	172	0	3	1	1	0
AFODION-322	306	477	171	0	3	2	0	0
AFODION-322	306	477	171	0	3	4	0	0
AFODION-322	309	477	168	0	3	5	1	0
AFODION-323	310	477	167	0	3	1	1	0
AFODION-323	315	477	162	0	5	4	0	0
AFODION-323	315	477	162	0	3	1	0	0
AFODION-323	317	477	160	0	3	1	0	0
AFODION-323	317	477	160	0	3	4	0	0
AFODION-323	318	477	159	0	3	2	0	0
AFODION-323	326	331	5	1	4	4	0	0
AFODION-323	330	345	15	1	3	1	1	0
AFODION-323	331	477	146	0	3	1	1	0
AFODION-323	332	477	145	0	3	1	0	0
AFODION-324	333	477	144	0	4	1	0	0
AFODION-324	333	477	144	0	3	1	0	0
AFODION-324	334	477	143	0	3	1	0	0
AFODION-324	338	339	1	1	3	1	1	0
AFODION-324	339	477	138	0	3	4	0	0
AFODION-324	339	477	138	0	3	4	0	0
AFODION-324	340	477	137	0	3	1	1	0
AFODION-324	344	477	133	0	3	1	1	0
AFODION-324	345	477	132	0	3	2	0	0
AFODION-324	348	477	129	0	3	5	0	0
AFODION-325	351	477	126	0	3	1	1	0
AFODION-325	351	352	1	1	3	1	0	0
AFODION-325	361	421	60	1	3	2	1	0
ANSPORTS-5	45	46	1	1	3	1	0	0
INIDAD-256	36	477	441	0	3	1	0	0
INIDAD-256	73	477	404	0	3	1	0	0
INIDAD-256	74	477	403	0	2	1	0	0
INIDAD-256	171	477	306	0	4	1	0	0
T-25	186	477	291	0	3	4	0	0
T-25	186	477	291	0	3	4	0	0
T-25	206	477	271	0	5	3	0	0
T-25	253	477	224	0	3	3	0	0
T-25	323	477	154	0	3	3	0	0
ILL-25	26	477	451	0	3	1	0	0
ILL-25	34	36	2	1	5	1	2	0
ILL-25	58	59	1	1	4	1	2	0
ILL-25	66	477	411	0	3	2	0	2
ILL-25	77	477	400	0	3	3	0	0
ILL-25	77	78	1	1	3	4	1	0
ILL-25	120	477	357	0	3	1	0	0
ILL-26	193	477	284	0	3	1	0	0
ILL-26	228	477	249	0	3	5	0	0
ILL-26	271	345	74	1	3	1	1	0
ILL-26	340	477	137	0	3	4	0	0
MA-568	1	2	1	1	3	4	1	0
MA-568	1	2	1	1	3	1	1	0
MA-569	1	2	1	1	3	4	1	0
MA-569	2	3	1	1	4	1	2	0
MA-569	3	4	1	1	3	2	1	0
MA-569	3	4	1	1	3	4	1	0
MA-569	4	7	3	1	3	4	1	0
MA-569	7	8	1	1	3	1	1	0
MA-569	7	8	1	1	3	1	1	0
MA-569	7	8	1	1	3	1	1	0
MA-569	8	23	15	1	4	4	1	0
MA-569	9	10	1	1	3	1	1	0
MA-570	9	31	22	1	3	1	1	0
MA-570	10	11	1	1	3	1	1	0
MA-570	10	11	1	1	3	1	1	0
MA-570	10	26	16	1	3	1	1	0
MA-570	15	16	1	1	3	1	1	0
MA-570	15	16	1	1	3	1	1	0
MA-570	17	25	8	1	4	1	1	0
MA-570	23	24	1	1	4	4	1	0
MA-570	23	24	1	1	4	4	1	0
MA-570	25	26	1	1	4	3	1	0
MA-571	27	28	1	1	3	3	1	0
MA-571	27	28	1	1	3	4	1	0
MA-571	28	29	1	1	4	4	1	0
MA-571	29	30	1	1	3	1	1	0
MA-571	31	477	446	0	3	1	1	0
MA-571	31	32	1	1	3	1	2	0
MA-571	35	477	442	0	3	1	0	0
MA-571	35	354	319	1	3	1	1	0
MA-571	35	36	1	1	3	4	1	0
MA-571	35	36	1	1	3	1	1	0
MA-572	35	36	1	1	3	4	1	0
MA-572	35	36	1	1	4	4	1	0
MA-572	38	45	7	1	3	4	1	0
MA-572	39	477	438	0	3	1	0	0
MA-572	39	74	35	1	3	1	1	0
MA-572	40	74	34	1	4	1	1	0
MA-572	41	42	1	1	3	1	1	0
MA-572	41	42	1	1	3	1	1	0
MA-572	43	49	6	1	3	3	1	0
MA-572	43	44	1	1	3	3	1	0
MA-573	43	195	152	1	3	4	2	0
MA-573	45	46	1	1	3	3	1	0
MA-573	46	47	1	1	4	1	1	0
MA-573	52	53	1	1	3	1	1	0
MA-573	53	54	1	1	3	1	1	0
MA-573	57	58	1	1	3	1	1	0
MA-573	60	73	13	1	4	4	1	1
MA-573	63	354	291	1	3	3	1	0
MA-573	63	477	414	0	3	1	1	0
MA-573	63	183	120	1	4	4	1	1
MA-574	64	183	119	1	4	1	1	0
MA-574	64	177	113	1	4	4	2	0
MA-574	66	413	347	1	3	2	1	0
MA-574	66	379	313	1	4	3	1	0
MA-574	70	71	1	1	3	1	1	0
MA-574	70	477	407	0	3	4	1	0
MA-574	71	72	1	1	3	1	1	0
MA-574	71	73	2	1	3	1	1	0
MA-574	73	477	404	0	3	2	0	0
MA-574	73	477	404	0	3	4	0	0
MA-575	73	74	1	1	3	1	1	0
MA-575	74	75	1	1	3	3	1	0
MA-575	77	333	256	1	3	1	1	1
MA-575	79	290	211	1	4	4	3	2
MA-575	87	88	1	1	3	4	2	0
MA-575	92	176	84	1	3	2	1	0
MA-575	94	204	110	1	3	2	1	0
MA-575	94	477	383	0	4	1	0	0
MA-575	95	113	18	1	4	1	1	1
MA-575	96	477	381	0	3	1	0	0
MA-576	97	477	380	0	3	4	1	0
MA-576	98	99	1	1	3	2	1	0
MA-576	98	99	1	1	4	3	0	0
MA-576	106	203	97	1	3	2	2	0
MA-576	106	107	1	1	4	4	1	0
MA-576	107	183	76	1	4	3	2	0
MA-576	108	477	369	0	4	3	1	0
MA-576	109	189	80	1	3	1	1	0
MA-576	109	477	368	0	3	1	1	0
MA-576	110	183	73	1	3	4	0	0
MA-577	112	226	114	1	3	4	1	0
MA-577	113	362	249	1	3	1	1	0
MA-577	119	477	358	0	3	4	1	0
MA-577	119	477	358	0	5	1	0	0
MA-577	121	354	233	1	3	1	1	0
MA-577	133	333	200	1	3	1	1	0
MA-577	134	477	343	0	3	1	0	0
MA-577	135	333	198	1	3	1	1	0
MA-577	135	141	6	1	3	4	1	0
MA-577	140	477	337	0	4	1	1	0
MA-578	142	248	106	1	3	4	1	0
MA-578	142	477	335	0	4	3	1	0
MA-578	144	477	333	0	3	1	1	0
MA-578	148	149	1	1	3	3	0	0
MA-578	148	368	220	1	3	1	1	0
MA-578	148	248	100	1	3	1	1	0
MA-578	150	227	77	1	3	1	1	0
MA-578	150	376	226	1	3	1	1	0
MA-578	154	477	323	0	3	1	0	0
MA-578	154	155	1	1	4	4	0	0
MA-579	157	394	237	1	4	4	1	0
MA-579	157	368	211	1	3	1	1	0
MA-579	162	199	37	1	4	4	1	0
MA-579	162	188	26	1	4	4	2	0
MA-579	163	176	13	1	3	1	1	0
MA-579	163	164	1	1	4	4	1	0
MA-579	164	165	1	1	3	1	1	0
MA-579	165	183	18	1	2	1	2	2
MA-579	168	183	15	1	2	1	2	2
MA-579	168	183	15	1	3	1	2	2
MA-580	175	248	73	1	3	1	1	0
MA-580	175	183	8	1	3	1	2	0
MA-580	176	308	132	1	4	4	2	1
MA-580	177	178	1	1	4	4	2	0
MA-580	178	179	1	1	3	1	1	0
MA-580	180	185	5	1	3	4	2	0
MA-580	181	182	1	1	3	1	1	0
MA-580	182	477	295	0	3	4	2	0
MA-580	185	188	3	1	3	4	2	0
MA-580	186	207	21	1	2	1	1	0
MA-581	188	212	24	1	4	4	2	0
MA-581	189	190	1	1	3	4	1	0
MA-581	190	477	287	0	3	1	0	0
MA-581	190	191	1	1	3	1	0	0
MA-581	192	260	68	1	3	4	1	0
MA-581	192	204	12	1	3	4	1	0
MA-581	192	403	211	1	3	4	1	0
MA-581	192	193	1	1	3	4	1	0
MA-581	193	205	12	1	3	4	1	0
MA-581	193	333	140	1	3	1	1	0
MA-582	193	199	6	1	3	4	2	0
MA-582	193	204	11	1	4	1	1	0
MA-582	193	204	11	1	4	1	1	0
MA-582	195	205	10	1	4	4	2	0
MA-582	195	205	10	1	4	4	1	0
MA-582	195	477	282	0	3	3	0	0
MA-582	195	198	3	1	3	1	1	0
MA-582	195	198	3	1	4	1	1	0
MA-582	195	198	3	1	4	1	1	0
MA-582	195	198	3	1	4	1	1	0
MA-583	195	198	3	1	3	1	1	0
MA-583	197	198	1	1	3	5	1	0
MA-583	197	198	1	1	3	5	1	0
MA-583	197	198	1	1	4	4	1	0
MA-583	197	198	1	1	4	4	1	0
MA-583	197	198	1	1	4	4	1	0
MA-583	197	198	1	1	4	4	1	0
MA-583	197	198	1	1	3	4	1	0
MA-583	198	199	1	1	4	4	0	0
MA-583	199	203	4	1	3	1	1	0
MA-584	199	203	4	1	4	4	1	0
MA-584	199	203	4	1	3	1	1	0
MA-584	203	477	274	0	4	5	0	0
MA-584	204	210	6	1	3	4	1	0
MA-584	204	205	1	1	3	1	1	0
MA-584	204	477	273	0	3	1	0	0
MA-584	204	205	1	1	4	5	1	0
MA-584	205	477	272	0	4	4	1	0
MA-584	205	206	1	1	4	4	1	0
MA-584	206	207	1	1	4	1	1	0
MA-585	207	211	4	1	3	1	1	0
MA-585	210	394	184	1	3	1	1	0
MA-585	219	220	1	1	3	1	1	0
MA-585	223	224	1	1	5	4	2	0
MA-585	226	334	108	1	4	3	2	0
MA-585	228	238	10	1	3	1	1	0
MA-585	229	274	45	1	3	4	1	1
MA-585	238	239	1	1	4	1	1	0
MA-585	238	239	1	1	3	4	1	0
MA-585	238	239	1	1	3	1	1	0
MA-586	238	239	1	1	4	1	1	0
MA-586	246	259	13	1	3	4	1	0
MA-586	247	477	230	0	3	1	1	0
MA-586	252	354	102	1	3	1	1	0
MA-586	254	275	21	1	3	1	1	0
MA-586	255	260	5	1	3	1	1	0
MA-586	259	260	1	1	3	1	1	0
MA-586	259	260	1	1	3	4	1	0
MA-586	259	393	134	1	3	1	1	0
MA-586	262	477	215	0	4	1	0	0
MA-587	263	334	71	1	3	4	2	0
MA-587	268	269	1	1	3	3	0	0
MA-587	268	288	20	1	3	1	1	0
MA-587	269	280	11	1	3	4	1	0
MA-587	269	477	208	0	4	4	0	0
MA-587	270	330	60	1	3	4	1	0
MA-587	273	289	16	1	4	4	1	0
MA-587	273	280	7	1	3	1	1	0
MA-587	274	275	1	1	3	1	1	0
MA-587	275	276	1	1	3	1	1	0
MA-588	275	276	1	1	3	4	1	0
MA-588	276	374	98	1	3	1	1	0
MA-588	276	351	75	1	3	1	1	0
MA-588	276	277	1	1	3	1	1	0
MA-588	277	351	74	1	3	2	1	0
MA-588	277	278	1	1	3	1	1	0
MA-588	277	280	3	1	3	1	1	0
MA-588	277	280	3	1	3	2	1	0
MA-588	277	345	68	1	2	1	1	0
MA-588	280	368	88	1	3	1	1	0
MA-589	282	283	1	1	4	1	1	0
MA-589	287	288	1	1	3	1	1	0
MA-589	287	368	81	1	3	4	1	0
MA-589	287	288	1	1	4	5	1	0
MA-589	288	394	106	1	3	4	1	0
MA-589	288	477	189	0	4	4	0	0
MA-589	289	290	1	1	4	3	1	0
MA-589	291	292	1	1	3	3	1	0
MA-589	294	477	183	0	4	3	0	0
MA-589	295	296	1	1	3	4	1	0
MA-590	301	477	176	0	3	1	0	0
MA-590	304	305	1	1	3	4	2	0
MA-590	306	308	2	1	3	4	2	1
MA-590	311	351	40	1	3	4	1	0
MA-590	315	316	1	1	3	1	1	2
MA-590	315	316	1	1	4	1	0	2
MA-590	316	319	3	1	3	1	1	0
MA-590	322	323	1	1	3	1	2	0
MA-590	322	394	72	1	5	3	2	0
MA-590	324	329	5	1	3	4	1	0
MA-591	324	347	23	1	4	4	1	0
MA-591	330	367	37	1	3	4	1	0
MA-591	330	331	1	1	3	1	1	0
MA-591	332	394	62	1	4	1	2	0
MA-591	332	333	1	1	4	3	0	0
MA-591	333	367	34	1	3	1	1	0
MA-591	333	351	18	1	3	2	1	0
MA-591	333	334	1	1	3	3	0	0
MA-591	334	335	1	1	3	4	1	0
MA-591	334	335	1	1	3	4	1	0
MA-592	336	337	1	1	4	4	1	0
MA-592	336	337	1	1	4	4	1	0
MA-592	336	337	1	1	4	4	0	0
MA-592	337	338	1	1	5	4	0	0
MA-592	337	477	140	0	4	4	0	0
MA-592	337	338	1	1	4	1	1	0
MA-592	337	401	64	1	4	4	1	0
MA-592	337	338	1	1	3	1	0	0
MA-592	337	406	69	1	3	4	1	0
MA-592	338	376	38	1	4	4	2	0
MA-593	343	436	93	1	4	4	1	0
MA-593	344	400	56	1	4	4	1	0
MA-593	345	477	132	0	4	4	0	0
MA-593	346	347	1	1	3	1	1	0
MA-593	348	477	129	0	3	4	0	0
MA-593	351	394	43	1	3	1	2	0
MA-593	352	477	125	0	3	4	0	0
MA-593	352	477	125	0	4	3	1	0
MA-593	354	355	1	1	3	3	1	0
MA-593	354	355	1	1	3	3	1	0
MA-594	354	477	123	0	3	1	0	0
MA-594	354	393	39	1	4	1	1	0
MA-594	355	366	11	1	3	4	1	0
MA-594	355	477	122	0	3	1	1	0
MA-594	355	477	122	0	4	1	2	0
MA-594	362	363	1	1	3	4	1	0
MA-594	362	363	1	1	3	1	1	0
OMI-14	16	477	461	0	3	4	1	0
OMI-14	16	17	1	1	3	4	1	0
OMI-14	35	92	57	1	3	4	1	0
OMI-14	37	38	1	1	3	1	1	0
OMI-15	37	477	440	0	3	1	0	0
OMI-15	38	125	87	1	4	1	2	0
OMI-15	43	477	434	0	3	1	0	0
OMI-15	44	477	433	0	4	4	0	0
OMI-15	44	477	433	0	3	3	0	0
OMI-15	45	46	1	1	3	4	1	0
OMI-15	45	46	1	1	3	1	1	0
OMI-15	45	125	80	1	3	4	1	0
OMI-15	47	125	78	1	3	4	1	0
OMI-15	47	125	78	1	3	4	1	0
OMI-16	47	125	78	1	3	4	1	0
OMI-16	47	125	78	1	3	4	1	0
OMI-16	47	125	78	1	3	4	1	0
OMI-16	47	125	78	1	3	4	1	0
OMI-16	47	118	71	1	3	4	1	0
OMI-16	47	118	71	1	3	4	1	1
OMI-16	47	477	430	0	3	4	1	0
OMI-16	50	51	1	1	4	4	1	1
OMI-16	56	118	62	1	3	5	1	0
OMI-16	59	73	14	1	3	5	0	0
OMI-17	65	118	53	1	3	1	1	0
OMI-17	70	477	407	0	4	5	0	0
OMI-17	72	477	405	0	4	4	0	0
OMI-17	79	112	33	1	3	4	1	0
OMI-17	84	98	14	1	4	1	1	0
OMI-17	86	477	391	0	5	5	0	0
OMI-17	100	270	170	1	4	5	1	0
OMI-17	112	118	6	1	3	1	1	0
OMI-17	114	116	2	1	3	4	1	0
OMI-17	115	143	28	1	4	5	1	0
OMI-18	116	477	361	0	3	4	1	0
OMI-18	127	477	350	0	4	2	0	0
OMI-18	142	148	6	1	3	4	1	0
OMI-18	148	477	329	0	3	4	1	0
OMI-18	174	175	1	1	1	4	1	0
OMI-18	176	179	3	1	3	4	1	0
OMI-18	179	180	1	1	4	4	1	0
OMI-18	199	477	278	0	3	2	1	0
OMI-18	199	477	278	0	3	2	0	0
OMI-18	199	477	278	0	3	2	0	0
OMI-19	199	477	278	0	3	2	0	0
OMI-19	199	477	278	0	3	2	0	0
OMI-19	199	477	278	0	3	2	0	0
OMI-19	199	477	278	0	3	2	0	0
OMI-19	203	477	274	0	3	2	0	0
OMI-19	214	249	35	1	3	1	1	0
OMI-19	234	254	20	1	3	1	0	0
OMI-19	252	253	1	1	3	1	1	0
OMI-19	252	253	1	1	3	1	1	0
OMI-19	260	263	3	1	1	1	1	0
OMI-20	263	264	1	1	3	4	1	0
OMI-20	267	268	1	1	3	3	0	0
OMI-20	267	291	24	1	3	2	1	0
OMI-20	270	477	207	0	3	4	1	0
OMI-20	281	290	9	1	3	4	0	0
OMI-20	291	292	1	1	4	1	1	0
OMI-20	294	295	1	1	3	4	1	0
OMI-20	303	304	1	1	3	1	1	0
OMI-20	305	306	1	1	3	4	1	0
OMI-20	316	477	161	0	3	1	1	0
OMI-21	317	477	160	0	4	4	0	0
OMI-21	327	477	150	0	3	4	0	0
OMI-21	327	477	150	0	4	3	0	0
OMI-21	329	477	148	0	3	4	1	0
OMI-21	329	477	148	0	3	1	1	0
OMI-21	332	477	145	0	3	1	1	0
OMI-21	340	477	137	0	3	4	1	1
ERGRID-134	75	477	402	0	3	1	1	0
ERGRID-134	267	268	1	1	4	1	1	0
ERGRID-134	267	268	1	1	3	4	1	0
ERGRID-135	294	477	183	0	4	4	1	0
ERGRID-135	294	477	183	0	5	4	1	0
ERGRID-135	347	477	130	0	5	5	0	0
ERGRID-135	350	353	3	1	3	1	1	0
LIDATOR-43	31	477	446	0	2	1	0	0
LIDATOR-43	71	72	1	1	3	1	1	0
LIDATOR-43	107	108	1	1	3	1	0	0
LIDATOR-43	128	129	1	1	3	1	0	0
LIDATOR-44	135	136	1	1	3	1	1	1
LIDATOR-44	189	190	1	1	3	1	0	1
LIDATOR-44	200	477	277	0	4	1	0	0
LIDATOR-44	217	232	15	1	3	1	0	0
LIDATOR-44	220	477	257	0	3	1	0	0
LIDATOR-44	227	477	250	0	3	1	0	0
LIDATOR-44	232	477	245	0	3	5	0	0
LIDATOR-44	236	477	241	0	3	4	0	0
LIDATOR-44	271	477	206	0	3	1	0	0
LIDATOR-44	325	477	152	0	3	1	0	1
LIDATOR-45	336	340	4	1	5	1	0	2
LIDATOR-45	345	346	1	1	3	1	0	1
LIDATOR-45	358	477	119	0	3	1	0	0
L-108	30	477	447	0	3	4	0	0
L-108	32	130	98	1	4	4	1	0
L-108	64	477	413	0	3	4	1	0
L-108	71	477	406	0	3	2	0	0
L-108	95	156	61	1	3	4	1	0
L-109	95	477	382	0	3	4	0	0
L-109	95	477	382	0	4	4	0	0
L-109	95	477	382	0	4	4	0	0
L-109	98	396	298	1	3	1	1	0
L-109	129	130	1	1	3	4	1	0
L-109	133	344	211	1	3	4	1	0
L-109	133	394	261	1	3	4	1	0
L-109	133	156	23	1	3	3	1	0
L-109	133	477	344	0	3	4	0	0
L-109	134	477	343	0	3	4	0	0
L-110	134	162	28	1	3	1	1	0
L-110	140	156	16	1	3	4	1	0
L-110	176	477	301	0	3	1	0	0
L-110	213	344	131	1	3	1	1	0
L-110	249	250	1	1	3	4	1	0
L-110	289	344	55	1	2	1	1	0
L-110	298	301	3	1	3	4	1	0
L-110	352	477	125	0	3	4	0	0
LOCITY-88	11	280	269	1	3	1	1	1
LOCITY-89	37	38	1	1	3	1	0	0
LOCITY-89	148	280	132	1	3	1	0	1
LOCITY-89	149	426	277	1	3	4	1	0
LOCITY-89	149	285	136	1	4	1	0	1
LOCITY-89	151	279	128	1	3	1	1	0
LOCITY-89	159	276	117	1	4	4	1	0
LOCITY-89	162	280	118	1	1	1	1	3
LOCITY-89	163	280	117	1	1	1	0	1
LOCITY-89	193	285	92	1	3	4	1	0
LOCITY-89	239	240	1	1	3	4	1	0
LOCITY-90	248	279	31	1	3	1	0	0
LOCITY-90	250	252	2	1	3	1	0	1
LOCITY-90	274	275	1	1	4	1	1	0
LOCITY-90	286	287	1	1	3	4	1	0
LOCITY-90	287	288	1	1	4	4	1	0
LOCITY-90	348	418	70	1	4	1	0	0
LOCITY-90	348	418	70	1	4	1	0	0
LTOOLS-17	233	272	39	1	3	1	1	0
LTOOLS-17	261	271	10	1	3	1	1	1
LTOOLS-17	263	264	1	1	3	1	1	0
LTOOLS-17	264	271	7	1	3	3	1	1
LTOOLS-17	271	273	2	1	3	3	1	0
LTOOLS-17	271	273	2	1	3	4	1	0
S-65	36	46	10	1	3	4	1	0
S-65	43	477	434	0	3	1	1	0
S-65	45	48	3	1	4	1	1	0
S-65	48	49	1	1	3	2	1	0
S-65	57	477	420	0	3	2	0	0
S-65	63	70	7	1	3	1	1	1
S-65	77	477	400	0	3	1	0	0
S-65	86	87	1	1	3	1	1	0
S-65	93	477	384	0	3	1	0	0
S-65	100	477	377	0	4	1	0	0
S-66	101	455	354	1	3	4	1	0
S-66	106	477	371	0	3	2	0	0
S-66	113	477	364	0	2	1	0	0
S-66	119	477	358	0	3	1	0	0
S-66	183	477	294	0	3	1	0	0
S-66	185	477	292	0	2	1	0	0
S-66	191	192	1	1	3	4	1	0
S-66	203	204	1	1	3	4	1	0
S-66	203	204	1	1	3	4	1	0
S-66	203	204	1	1	3	1	1	0
S-67	225	389	164	1	5	4	1	0
S-67	227	228	1	1	3	4	1	0
S-67	235	477	242	0	3	4	0	0
S-67	238	389	151	1	3	4	1	0
S-67	252	323	71	1	2	1	1	0
S-67	261	262	1	1	3	1	1	0
S-67	290	477	187	0	3	4	0	0
S-67	297	388	91	1	4	1	1	0
S-67	304	305	1	1	4	1	1	0
S-67	310	323	13	1	1	1	1	0
S-68	310	311	1	1	3	4	1	0
S-68	322	323	1	1	3	4	1	0
S-68	323	324	1	1	3	4	1	0
S-68	323	477	154	0	3	1	0	2
S-68	329	477	148	0	4	1	0	2
S-68	340	380	40	1	3	1	1	0
GON-49	25	477	452	0	3	1	0	0
GON-49	38	154	116	1	3	1	1	4
GON-49	44	45	1	1	3	1	1	1
GON-49	48	154	106	1	3	1	1	2
GON-49	48	154	106	1	3	1	1	4
GON-49	49	76	27	1	3	1	1	0
GON-50	51	230	179	1	3	1	1	1
GON-50	51	154	103	1	3	2	1	2
GON-50	53	229	176	1	3	1	0	0
GON-50	59	154	95	1	3	1	1	1
GON-50	76	77	1	1	3	3	1	1
GON-50	94	95	1	1	3	5	1	0
GON-50	94	95	1	1	3	5	1	0
GON-50	94	95	1	1	3	5	1	0
GON-50	94	95	1	1	3	5	1	0
GON-50	94	95	1	1	3	5	1	0
GON-51	94	95	1	1	3	5	1	0
GON-51	94	95	1	1	3	5	1	0
GON-51	94	95	1	1	3	5	1	0
GON-51	94	95	1	1	3	5	1	1
GON-51	94	95	1	1	3	5	1	0
GON-51	95	96	1	1	3	5	1	0
GON-51	95	96	1	1	3	5	1	0
GON-51	95	96	1	1	3	3	0	0
GON-51	108	118	10	1	3	1	1	0
GON-51	145	153	8	1	3	5	1	0
GON-52	147	148	1	1	3	1	0	0
GON-52	220	271	51	1	3	1	0	0
GON-52	228	229	1	1	4	4	1	0
GON-52	231	237	6	1	3	2	1	1
GON-52	237	238	1	1	3	3	1	0
GON-52	237	241	4	1	3	3	1	0
GON-52	241	242	1	1	3	3	1	2
GON-53	241	242	1	1	3	3	1	0
GON-53	242	243	1	1	3	2	1	1
GON-53	243	267	24	1	3	5	1	0
GON-53	250	251	1	1	3	5	1	0
GON-53	250	251	1	1	3	5	1	0
GON-53	250	251	1	1	3	5	1	0
GON-53	250	251	1	1	3	5	1	0
GON-53	287	317	30	1	3	4	2	2
GON-53	314	349	35	1	3	1	2	4
GON-53	317	349	32	1	3	4	2	2
GON-54	317	349	32	1	3	4	2	2
GON-54	332	477	145	0	4	1	0	2
GON-54	339	477	138	0	3	2	0	0
GON-54	361	367	6	1	3	1	1	2
AVER-1	129	130	1	1	3	3	1	0
AVER-2	129	130	1	1	3	3	1	0
AVER-2	129	213	84	1	3	3	1	0
AVER-2	129	213	84	1	3	3	1	0
AVER-2	129	130	1	1	3	1	1	0
AVER-2	129	130	1	1	3	4	1	0
AVER-2	129	130	1	1	3	4	1	0
AVER-2	129	213	84	1	3	4	1	0
EX-18	2	38	36	1	2	5	0	0
EX-18	4	133	129	1	3	4	0	0
EX-18	7	41	34	1	3	1	0	0
EX-18	8	143	135	1	3	3	0	0
EX-18	8	143	135	1	3	1	0	0
EX-19	10	147	137	1	3	4	0	0
EX-19	10	133	123	1	4	4	0	0
EX-19	10	133	123	1	4	4	0	0
EX-19	11	143	132	1	3	1	0	0
EX-19	15	133	118	1	3	1	0	0
EX-19	15	477	462	0	4	3	0	0
EX-19	16	133	117	1	3	1	0	0
EX-19	16	133	117	1	3	1	0	0
EX-19	16	133	117	1	3	1	0	0
EX-19	21	133	112	1	5	4	0	0
EX-20	22	143	121	1	3	1	0	0
EX-20	23	143	120	1	3	1	0	0
EX-20	27	151	124	1	3	1	0	0
EX-20	28	477	449	0	3	2	0	0
EX-20	28	143	115	1	3	1	0	0
EX-20	28	133	105	1	3	4	0	0
EX-20	32	133	101	1	3	1	0	0
EX-20	36	133	97	1	3	1	0	0
EX-20	37	93	56	1	3	1	0	0
EX-20	38	93	55	1	3	4	0	0
EX-21	38	93	55	1	3	4	0	0
EX-21	38	143	105	1	3	1	0	0
EX-21	38	93	55	1	3	4	0	0
EX-21	39	133	94	1	3	4	0	0
EX-21	40	133	93	1	3	1	0	0
EX-21	41	133	92	1	3	4	0	0
EX-21	41	133	92	1	3	4	0	0
EX-21	42	133	91	1	3	1	0	0
EX-21	42	93	51	1	3	4	0	0
EX-21	42	93	51	1	3	4	0	0
EX-22	43	133	90	1	3	4	0	0
EX-22	53	89	36	1	2	5	0	0
EX-22	53	89	36	1	2	1	0	0
EX-22	53	89	36	1	3	1	0	0
EX-22	54	92	38	1	4	4	0	0
EX-22	56	198	142	1	3	1	0	0
EX-22	57	477	420	0	3	4	0	0
EX-22	57	477	420	0	3	4	0	0
EX-22	57	133	76	1	3	4	0	0
EX-22	57	133	76	1	3	1	0	0
EX-23	61	89	28	1	1	1	0	0
EX-23	61	62	1	1	3	1	0	0
EX-23	61	477	416	0	3	1	0	0
EX-23	63	133	70	1	3	4	0	0
EX-23	63	133	70	1	3	1	1	0
EX-23	64	477	413	0	4	4	1	0
EX-23	64	211	147	1	4	4	1	0
EX-23	64	133	69	1	3	4	0	0
EX-23	64	143	79	1	3	1	0	0
EX-23	64	143	79	1	3	4	0	0
EX-24	65	133	68	1	3	2	0	0
EX-24	65	477	412	0	3	4	0	0
EX-24	66	477	411	0	3	1	0	0
EX-24	66	477	411	0	3	4	0	0
EX-24	67	93	26	1	5	4	0	0
EX-24	71	143	72	1	3	1	0	0
EX-24	72	133	61	1	3	1	0	0
EX-24	73	196	123	1	2	4	0	0
EX-24	73	477	404	0	1	1	0	0
EX-24	73	89	16	1	3	1	0	0
EX-25	75	133	58	1	4	1	0	0
EX-25	77	78	1	1	3	4	0	0
EX-25	77	78	1	1	3	4	0	0
EX-25	78	133	55	1	4	4	0	0
EX-25	78	151	73	1	3	1	0	0
EX-25	78	151	73	1	3	1	0	0
EX-25	79	477	398	0	3	1	0	0
EX-25	79	477	398	0	3	1	0	0
EX-25	79	477	398	0	3	1	0	0
EX-25	79	477	398	0	3	5	0	0
EX-26	79	143	64	1	3	4	0	0
EX-26	80	93	13	1	5	4	0	0
EX-26	80	93	13	1	3	2	0	0
EX-26	81	477	396	0	3	1	0	0
EX-26	84	477	393	0	3	1	0	0
EX-26	85	477	392	0	3	1	0	0
EX-26	85	214	129	1	3	1	0	0
EX-26	86	93	7	1	3	4	0	0
EX-26	87	93	6	1	4	2	0	0
EX-26	87	133	46	1	3	2	0	0
EX-27	88	93	5	1	3	2	0	0
EX-27	88	93	5	1	3	4	0	0
EX-27	88	135	47	1	3	1	0	0
EX-27	88	477	389	0	2	1	0	0
EX-27	88	477	389	0	3	1	0	0
EX-27	91	133	42	1	3	1	0	0
EX-27	92	196	104	1	2	1	0	0
EX-27	92	133	41	1	3	1	0	0
EX-27	93	133	40	1	3	4	1	0
EX-27	95	133	38	1	1	1	0	0
EX-28	95	232	137	1	1	1	0	0
EX-28	97	214	117	1	4	4	0	0
EX-28	98	143	45	1	3	2	0	0
EX-28	98	99	1	1	3	1	1	0
EX-28	99	477	378	0	3	5	0	0
EX-28	99	133	34	1	3	1	0	0
EX-28	100	143	43	1	3	4	0	0
EX-28	100	134	34	1	3	1	0	0
EX-28	101	133	32	1	3	2	0	0
EX-28	102	123	21	1	3	4	0	0
EX-29	102	185	83	1	3	1	0	0
EX-29	102	214	112	1	1	1	0	0
EX-29	106	143	37	1	3	2	0	0
EX-29	107	214	107	1	1	1	0	0
EX-29	107	477	370	0	3	4	0	0
EX-29	107	133	26	1	3	4	0	0
EX-29	108	477	369	0	1	1	0	0
EX-29	108	143	35	1	4	1	0	0
EX-29	109	113	4	1	3	1	1	0
EX-29	112	133	21	1	2	1	0	0
EX-30	113	214	101	1	3	1	0	0
EX-30	114	122	8	1	1	4	1	0
EX-30	114	211	97	1	1	1	0	0
EX-30	114	133	19	1	3	1	0	0
EX-30	114	214	100	1	3	1	0	0
EX-30	114	477	363	0	3	2	0	0
EX-30	114	122	8	1	3	4	1	0
EX-30	114	115	1	1	3	2	0	0
EX-30	114	477	363	0	3	2	0	0
EX-30	115	143	28	1	3	4	0	0
EX-31	115	135	20	1	1	1	0	0
EX-31	115	147	32	1	3	2	1	0
EX-31	115	133	18	1	3	1	0	0
EX-31	115	116	1	1	2	1	0	0
EX-31	115	143	28	1	3	1	0	0
EX-31	115	122	7	1	3	1	1	0
EX-31	116	117	1	1	3	1	0	0
EX-31	116	117	1	1	3	1	0	0
EX-31	116	133	17	1	3	1	0	0
EX-31	116	477	361	0	3	1	0	0
EX-32	116	211	95	1	3	1	0	0
EX-32	116	122	6	1	3	1	0	0
EX-32	116	214	98	1	3	1	0	0
EX-32	117	214	97	1	3	1	0	0
EX-32	117	211	94	1	3	1	0	0
EX-32	117	133	16	1	4	1	0	0
EX-32	117	192	75	1	3	1	0	0
EX-32	121	185	64	1	3	1	0	0
EX-32	121	122	1	1	3	4	0	0
EX-32	121	151	30	1	3	1	0	0
EX-33	121	185	64	1	3	1	0	0
EX-33	122	232	110	1	1	1	0	0
EX-33	122	477	355	0	3	1	0	0
EX-33	122	123	1	1	3	4	0	0
EX-33	122	477	355	0	2	1	0	0
EX-33	122	142	20	1	3	2	1	0
EX-33	124	214	90	1	3	1	0	0
EX-33	125	142	17	1	3	1	0	0
EX-33	126	133	7	1	1	2	1	0
EX-33	126	143	17	1	3	2	0	0
EX-34	126	142	16	1	3	1	1	0
EX-34	126	133	7	1	3	2	0	0
EX-34	126	151	25	1	1	1	0	0
EX-34	126	133	7	1	3	1	0	0
EX-34	126	477	351	0	3	1	0	0
EX-34	127	133	6	1	3	1	0	0
EX-34	127	477	350	0	3	1	0	0
EX-34	128	143	15	1	3	1	0	0
EX-34	129	477	348	0	3	1	0	0
EX-34	129	133	4	1	3	2	1	0
EX-35	129	141	12	1	3	1	1	0
EX-35	129	151	22	1	3	1	0	0
EX-35	129	143	14	1	4	2	1	0
EX-35	129	133	4	1	3	2	0	0
EX-35	130	133	3	1	3	1	0	0
EX-35	130	133	3	1	3	1	0	0
EX-35	130	477	347	0	3	4	0	0
EX-35	133	146	13	1	3	2	1	0
EX-35	133	146	13	1	3	2	1	0
EX-35	133	477	344	0	3	1	0	0
EX-36	133	134	1	1	3	1	1	0
EX-36	133	146	13	1	3	2	1	0
EX-36	133	134	1	1	3	1	0	0
EX-36	134	211	77	1	3	1	0	0
EX-36	134	146	12	1	3	1	1	0
EX-36	134	143	9	1	4	1	0	0
EX-36	135	146	11	1	3	1	0	1
EX-36	135	232	97	1	1	1	0	1
EX-36	135	477	342	0	4	4	1	0
EX-36	135	211	76	1	3	1	0	0
EX-37	135	211	76	1	3	4	0	0
EX-37	135	477	342	0	3	1	0	0
EX-37	136	477	341	0	3	1	0	0
EX-37	136	143	7	1	3	4	0	0
EX-37	136	211	75	1	3	1	0	0
EX-37	136	143	7	1	3	4	0	0
EX-37	136	211	75	1	3	4	0	0
EX-37	136	137	1	1	3	4	0	0
EX-37	137	477	340	0	3	1	0	0
EX-37	140	211	71	1	3	4	0	0
EX-38	140	477	337	0	4	4	1	0
EX-38	140	143	3	1	3	1	0	0
EX-38	140	142	2	1	3	1	1	0
EX-38	140	477	337	0	3	1	0	0
EX-38	141	477	336	0	3	3	0	0
EX-38	141	477	336	0	3	3	0	0
EX-38	141	211	70	1	3	1	0	0
EX-38	141	477	336	0	3	3	0	0
EX-38	141	477	336	0	3	3	0	0
EX-38	141	142	1	1	3	4	1	0
EX-39	141	477	336	0	3	4	0	0
EX-39	141	477	336	0	3	4	0	0
EX-39	141	477	336	0	3	4	0	0
EX-39	141	211	70	1	3	3	0	0
EX-39	141	185	44	1	3	4	1	0
EX-39	142	477	335	0	4	4	1	0
EX-39	142	176	34	1	3	1	0	0
EX-39	142	185	43	1	4	4	0	0
EX-39	142	143	1	1	4	1	0	0
EX-39	142	477	335	0	3	4	1	0
EX-40	143	144	1	1	3	4	0	0
EX-40	143	171	28	1	3	4	0	0
EX-40	143	477	334	0	4	4	1	0
EX-40	143	211	68	1	3	3	0	0
EX-40	143	477	334	0	4	1	0	0
EX-40	144	211	67	1	3	4	0	0
EX-40	144	149	5	1	3	2	0	0
EX-40	144	211	67	1	3	3	0	0
EX-40	144	211	67	1	3	1	0	0
EX-40	144	176	32	1	3	1	0	0
EX-41	144	477	333	0	4	1	0	0
EX-41	145	211	66	1	3	3	0	0
EX-41	147	477	330	0	4	4	1	0
EX-41	147	148	1	1	3	1	0	0
EX-41	148	171	23	1	3	1	0	0
EX-41	148	211	63	1	3	1	0	0
EX-41	149	477	328	0	4	2	0	0
EX-41	149	211	62	1	3	2	0	0
EX-41	149	211	62	1	4	1	0	0
EX-41	149	477	328	0	4	1	0	0
EX-42	149	211	62	1	3	1	0	0
EX-42	150	211	61	1	3	4	0	0
EX-42	150	477	327	0	3	1	0	0
EX-42	150	171	21	1	3	1	0	0
EX-42	150	176	26	1	3	2	0	0
EX-42	151	477	326	0	3	1	0	0
EX-42	151	211	60	1	3	4	0	0
EX-42	151	477	326	0	3	1	0	0
EX-42	151	477	326	0	3	1	0	0
EX-42	154	477	323	0	3	4	0	0
EX-43	154	211	57	1	3	3	0	0
EX-43	154	477	323	0	4	1	0	0
EX-43	154	211	57	1	3	3	0	0
EX-43	154	211	57	1	3	4	0	0
EX-43	154	477	323	0	3	1	0	0
EX-43	154	477	323	0	3	4	0	0
EX-43	155	477	322	0	3	1	0	0
EX-43	156	157	1	1	4	2	0	0
EX-43	156	185	29	1	3	1	0	0
EX-43	156	161	5	1	3	1	0	0
EX-44	157	477	320	0	4	4	0	0
EX-44	157	211	54	1	3	4	0	0
EX-44	157	211	54	1	3	3	0	0
EX-44	157	477	320	0	4	1	0	0
EX-44	158	211	53	1	3	4	0	0
EX-44	158	213	55	1	3	2	0	0
EX-44	161	477	316	0	3	1	0	0
EX-44	161	477	316	0	3	1	0	0
EX-44	161	196	35	1	3	1	0	0
EX-44	161	196	35	1	3	1	0	0
EX-45	161	477	316	0	3	1	0	0
EX-45	161	477	316	0	4	1	0	0
EX-45	162	232	70	1	1	1	0	0
EX-45	162	196	34	1	3	1	0	0
EX-45	162	477	315	0	3	4	1	0
EX-45	162	165	3	1	4	3	1	0
EX-45	163	211	48	1	3	1	0	0
EX-45	163	211	48	1	3	1	0	0
EX-45	163	211	48	1	3	1	0	0
EX-45	163	477	314	0	3	1	0	0
EX-46	163	477	314	0	3	1	0	0
EX-46	164	213	49	1	3	1	0	0
EX-46	164	211	47	1	3	1	0	0
EX-46	165	477	312	0	4	1	0	0
EX-46	169	477	308	0	3	3	0	0
EX-46	170	211	41	1	3	1	0	0
EX-46	170	232	62	1	3	1	0	0
EX-46	170	477	307	0	3	1	0	0
EX-46	170	477	307	0	4	1	0	0
EX-46	171	172	1	1	3	1	0	0
EX-47	171	211	40	1	1	1	0	0
EX-47	171	477	306	0	3	1	0	0
EX-47	171	214	43	1	3	1	1	0
EX-47	172	196	24	1	3	3	0	0
EX-47	172	192	20	1	1	1	1	0
EX-47	172	196	24	1	3	1	0	0
EX-47	172	173	1	1	3	1	0	0
EX-47	175	477	302	0	2	1	0	0
EX-47	175	477	302	0	2	1	0	0
EX-47	176	477	301	0	3	1	0	0
EX-48	176	477	301	0	3	1	0	0
EX-48	177	477	300	0	3	1	0	0
EX-48	178	477	299	0	3	1	0	0
EX-48	178	192	14	1	4	4	1	0
EX-48	178	185	7	1	3	1	0	0
EX-48	179	192	13	1	3	1	0	0
EX-48	179	232	53	1	2	1	0	0
EX-48	179	192	13	1	3	1	0	0
EX-48	179	211	32	1	3	1	0	0
EX-48	182	211	29	1	4	4	0	0
EX-49	183	189	6	1	3	1	1	0
EX-49	184	477	293	0	3	5	0	0
EX-49	184	185	1	1	3	1	0	0
EX-49	184	192	8	1	3	1	0	0
EX-49	185	477	292	0	3	3	0	0
EX-49	186	211	25	1	2	1	0	0
EX-49	188	477	289	0	3	1	0	0
EX-49	189	227	38	1	1	1	0	0
EX-49	189	211	22	1	3	1	0	0
EX-49	189	477	288	0	3	1	0	0
EX-50	191	477	286	0	4	1	0	0
EX-50	192	477	285	0	4	1	0	0
EX-50	192	211	19	1	3	1	0	0
EX-50	193	477	284	0	4	1	0	0
EX-50	193	477	284	0	3	1	0	0
EX-50	193	477	284	0	3	1	1	0
EX-50	196	211	15	1	3	1	0	0
EX-50	196	477	281	0	3	1	0	0
EX-50	196	477	281	0	3	1	0	0
EX-50	196	477	281	0	3	1	0	0
EX-51	197	477	280	0	3	1	0	0
EX-51	197	200	3	1	4	1	0	0
EX-51	197	477	280	0	3	1	0	0
EX-51	197	200	3	1	4	4	0	0
EX-51	198	211	13	1	4	4	0	0
EX-51	198	477	279	0	3	1	1	0
EX-51	198	201	3	1	3	5	0	0
EX-51	198	477	279	0	3	1	0	0
EX-51	198	477	279	0	3	1	0	0
EX-51	198	232	34	1	2	1	0	0
EX-52	199	211	12	1	3	4	0	0
EX-52	199	211	12	1	3	3	0	0
EX-52	199	477	278	0	3	1	0	0
EX-52	199	200	1	1	4	1	0	0
EX-52	200	211	11	1	3	4	0	0
EX-52	200	211	11	1	3	2	0	0
EX-52	200	211	11	1	3	4	0	0
EX-52	200	211	11	1	3	3	0	0
EX-52	200	211	11	1	3	1	0	0
EX-52	203	477	274	0	4	4	0	0
EX-53	203	232	29	1	3	3	0	0
EX-53	203	211	8	1	3	3	0	0
EX-53	203	477	274	0	3	1	0	0
EX-53	203	227	24	1	3	1	0	0
EX-53	203	477	274	0	3	1	0	0
EX-53	204	211	7	1	3	4	0	0
EX-53	204	477	273	0	3	4	1	0
EX-53	204	477	273	0	3	2	0	0
EX-53	204	477	273	0	4	4	1	0
EX-53	206	211	5	1	3	4	0	0
EX-54	206	211	5	1	3	1	0	0
EX-54	206	477	271	0	3	1	0	0
EX-54	206	211	5	1	3	1	0	0
EX-54	207	477	270	0	3	1	0	0
EX-54	210	211	1	1	4	1	0	0
EX-54	212	220	8	1	3	4	0	0
EX-54	212	477	265	0	3	1	0	0
EX-54	213	214	1	1	3	1	0	0
EX-54	217	227	10	1	3	1	0	0
EX-54	219	477	258	0	1	1	0	0
EX-55	220	477	257	0	4	4	1	0
EX-55	220	230	10	1	3	2	0	0
EX-55	220	221	1	1	3	4	0	0
EX-55	220	477	257	0	4	4	1	0
EX-55	220	221	1	1	1	1	0	0
EX-55	220	477	257	0	3	1	0	0
EX-55	221	477	256	0	4	1	0	0
EX-55	223	477	254	0	3	4	0	0
EX-55	223	477	254	0	3	1	0	0
EX-55	224	477	253	0	3	1	0	0
EX-56	224	477	253	0	3	1	0	0
EX-56	224	477	253	0	3	1	0	0
EX-56	224	477	253	0	3	1	0	0
EX-56	225	477	252	0	2	1	0	0
EX-56	225	477	252	0	3	1	0	0
EX-56	226	477	251	0	3	4	1	0
EX-56	226	477	251	0	3	4	1	0
EX-56	226	477	251	0	3	1	0	0
EX-56	227	232	5	1	3	1	0	0
EX-56	227	477	250	0	3	1	0	0
EX-57	227	477	250	0	3	4	1	0
EX-57	227	477	250	0	3	1	0	0
EX-57	227	477	250	0	3	1	0	0
EX-57	227	228	1	1	3	1	0	0
EX-57	228	229	1	1	3	2	0	0
EX-57	229	477	248	0	2	2	0	0
EX-57	229	477	248	0	3	2	0	0
EX-57	230	238	8	1	3	4	0	0
EX-57	231	477	246	0	3	1	0	0
EX-57	232	477	245	0	3	1	0	0
EX-58	232	477	245	0	4	1	0	0
EX-58	233	477	244	0	4	1	1	0
EX-58	233	477	244	0	3	2	0	0
EX-58	233	477	244	0	3	1	0	0
EX-58	234	477	243	0	4	1	0	0
EX-58	234	269	35	1	3	1	0	0
EX-58	234	477	243	0	3	1	0	0
EX-58	234	477	243	0	3	1	0	0
EX-58	234	477	243	0	3	1	0	0
EX-58	234	477	243	0	3	4	1	0
EX-59	235	477	242	0	3	1	0	0
EX-59	235	477	242	0	3	1	0	0
EX-59	238	477	239	0	3	1	0	0
EX-59	238	239	1	1	3	1	0	0
EX-59	238	477	239	0	3	4	0	0
EX-59	238	477	239	0	3	1	0	0
EX-59	238	477	239	0	3	1	0	0
EX-59	238	477	239	0	3	1	0	0
EX-59	238	239	1	1	3	1	0	0
EX-59	240	477	237	0	3	1	0	0
EX-60	241	477	236	0	3	1	0	0
EX-60	242	477	235	0	1	2	0	0
EX-60	245	477	232	0	3	1	0	0
EX-60	245	477	232	0	2	1	0	0
EX-60	246	477	231	0	1	1	0	0
EX-60	247	477	230	0	3	1	0	0
EX-60	248	477	229	0	3	1	0	0
EX-60	248	477	229	0	3	4	0	0
EX-60	250	477	227	0	3	4	0	0
EX-60	250	477	227	0	3	4	0	0
EX-61	254	477	223	0	3	4	1	0
EX-61	254	477	223	0	3	4	1	0
EX-61	254	477	223	0	3	1	0	0
EX-61	257	258	1	1	3	4	0	0
EX-61	257	477	220	0	3	4	0	0
EX-61	258	477	219	0	3	4	0	0
EX-61	259	269	10	1	3	2	0	0
EX-61	259	477	218	0	3	4	1	0
EX-61	260	477	217	0	3	1	0	0
EX-61	260	477	217	0	3	4	1	0
EX-62	260	477	217	0	3	4	0	0
EX-62	261	477	216	0	3	1	0	0
EX-62	261	477	216	0	3	4	0	0
EX-62	261	477	216	0	3	4	0	0
EX-62	261	477	216	0	3	2	0	0
EX-62	262	269	7	1	3	2	0	0
EX-62	262	477	215	0	3	4	0	0
EX-62	262	477	215	0	3	2	0	0
EX-62	266	477	211	0	4	4	1	0
EX-62	266	477	211	0	3	4	0	0
EX-63	267	477	210	0	3	1	0	0
EX-63	267	477	210	0	3	1	0	0
EX-63	267	477	210	0	3	4	1	0
EX-63	268	477	209	0	3	1	0	0
EX-63	268	477	209	0	3	1	0	0
EX-63	269	477	208	0	3	1	0	0
EX-63	271	477	206	0	1	1	0	0
EX-63	272	477	205	0	3	4	1	0
EX-63	273	477	204	0	3	4	1	0
EX-63	274	477	203	0	3	1	0	0
EX-64	275	477	202	0	4	4	1	0
EX-64	275	477	202	0	3	4	1	0
EX-64	275	477	202	0	3	1	0	0
EX-64	287	477	190	0	3	1	0	0
EX-64	287	477	190	0	3	1	0	0
EX-64	288	477	189	0	3	1	0	0
EX-64	289	477	188	0	3	1	0	0
EX-64	289	477	188	0	3	4	0	0
EX-64	289	477	188	0	3	4	0	0
EX-64	290	477	187	0	3	1	0	0
EX-65	294	477	183	0	3	1	0	0
EX-65	295	477	182	0	3	1	0	0
EX-65	295	477	182	0	3	1	0	0
EX-65	296	477	181	0	3	2	1	0
EX-65	304	477	173	0	3	4	0	0
EX-65	308	477	169	0	3	4	0	0
EX-65	310	311	1	1	3	2	0	0
EX-65	311	477	166	0	3	4	1	0
EX-65	316	477	161	0	3	1	0	0
EX-65	316	477	161	0	3	1	0	0
EX-66	316	477	161	0	3	2	0	0
EX-66	316	477	161	0	3	2	0	0
EX-66	317	318	1	1	3	1	0	0
EX-66	323	477	154	0	2	4	0	0
EX-66	323	338	15	1	3	1	1	0
EX-66	325	477	152	0	3	1	0	0
EX-66	326	477	151	0	3	1	0	0
EX-66	326	477	151	0	3	1	0	0
EX-66	329	477	148	0	3	1	0	0
EX-66	329	338	9	1	3	1	1	0
EX-67	331	477	146	0	1	1	0	0
EX-67	332	477	145	0	4	4	0	0
EX-67	332	477	145	0	1	1	0	0
EX-67	337	477	140	0	1	1	1	0
EX-67	360	477	117	0	4	3	0	0
IMSY-17	1	2	1	1	3	1	0	0
IMSY-17	7	8	1	1	3	1	0	1
IMSY-17	7	477	470	0	3	4	0	0
IMSY-17	16	81	65	1	3	1	0	0
IMSY-17	17	25	8	1	3	1	0	0
IMSY-17	17	477	460	0	3	1	0	2
IMSY-17	17	477	460	0	4	2	0	0
IMSY-17	20	128	108	1	3	4	0	0
IMSY-17	25	477	452	0	3	4	0	0
IMSY-17	29	477	448	0	3	2	0	1
IMSY-18	29	30	1	1	2	1	0	0
IMSY-18	33	42	9	1	4	4	0	0
IMSY-18	48	93	45	1	4	2	0	0
IMSY-18	65	477	412	0	4	4	0	0
IMSY-18	77	78	1	1	4	1	0	0
IMSY-18	77	128	51	1	4	1	0	0
IMSY-18	79	477	398	0	3	1	0	0
IMSY-18	80	477	397	0	4	1	0	0
IMSY-18	83	477	394	0	3	1	0	0
IMSY-18	91	92	1	1	3	1	0	0
IMSY-19	92	477	385	0	4	1	0	0
IMSY-19	100	104	4	1	3	1	0	0
IMSY-19	100	128	28	1	3	1	0	0
IMSY-19	120	121	1	1	3	1	0	0
IMSY-19	128	139	11	1	3	2	0	0
IMSY-19	152	153	1	1	4	1	0	0
IMSY-19	173	477	304	0	3	1	0	0
IMSY-19	173	185	12	1	3	1	0	0
IMSY-19	175	477	302	0	4	1	0	0
IMSY-19	206	253	47	1	3	5	0	0
IMSY-20	217	477	260	0	4	4	0	0
IMSY-20	218	477	259	0	3	1	0	0
IMSY-20	243	477	234	0	3	1	0	0
IMSY-20	251	252	1	1	3	1	0	0
IMSY-20	252	477	225	0	3	1	0	0
IMSY-20	255	442	187	1	3	1	0	0
IMSY-20	260	477	217	0	3	1	0	1
IMSY-20	260	297	37	1	3	4	0	0
IMSY-20	261	477	216	0	3	3	0	1
IMSY-20	275	477	202	0	3	1	0	0
IMSY-21	276	477	201	0	3	1	0	0
IMSY-21	276	477	201	0	3	1	0	0
IMSY-21	276	477	201	0	3	1	0	0
IMSY-21	291	477	186	0	3	1	0	0
IMSY-21	291	351	60	1	3	1	0	0
IMSY-21	292	477	185	0	3	1	0	0
IMSY-21	293	430	137	1	4	1	0	0
IMSY-21	296	297	1	1	3	1	0	0
IMSY-21	297	477	180	0	3	2	0	0
IMSY-21	318	477	159	0	3	4	0	0
IMSY-22	331	338	7	1	3	1	0	0
IMSY-22	335	338	3	1	3	1	0	0
IMSY-22	341	477	136	0	3	4	0	0
IMSY-22	341	477	136	0	3	4	0	0
IMSY-22	341	428	87	1	3	4	0	0
IMSY-22	341	428	87	1	3	4	0	0
IMSY-22	342	477	135	0	3	1	0	0
IMSY-22	342	343	1	1	3	4	0	0
IMSY-22	351	477	126	0	3	2	0	0
IMSY-22	351	477	126	0	3	1	0	0
IMSY-23	351	477	126	0	3	4	0	0
IMSY-23	351	477	126	0	3	1	0	0
CKET-651	2	477	475	0	4	1	0	1
CKET-651	11	25	14	1	4	4	1	1
CKET-651	12	21	9	1	4	1	1	0
CKET-651	15	477	462	0	4	1	0	0
CKET-652	16	269	253	1	4	2	0	0
CKET-652	16	17	1	1	3	4	0	1
CKET-652	21	29	8	1	3	1	2	0
CKET-652	22	36	14	1	4	1	1	4
CKET-652	32	33	1	1	3	1	1	0
CKET-652	32	52	20	1	1	1	1	0
CKET-652	33	45	12	1	3	1	3	0
CKET-652	35	52	17	1	3	4	2	1
CKET-652	35	145	110	1	1	1	1	0
CKET-652	35	36	1	1	1	1	1	0
CKET-653	35	36	1	1	3	1	3	0
CKET-653	36	477	441	0	3	1	0	0
CKET-653	37	38	1	1	4	4	0	0
CKET-653	38	90	52	1	3	1	2	0
CKET-653	40	41	1	1	3	1	0	0
CKET-653	42	46	4	1	3	1	0	0
CKET-653	42	477	435	0	3	4	0	0
CKET-653	44	45	1	1	3	1	0	1
CKET-653	45	477	432	0	4	4	0	0
CKET-653	51	269	218	1	4	5	1	0
CKET-654	53	54	1	1	1	1	1	0
CKET-654	60	99	39	1	4	4	1	0
CKET-654	63	92	29	1	4	1	1	0
CKET-654	63	87	24	1	4	1	1	0
CKET-654	73	175	102	1	3	1	0	1
CKET-654	82	86	4	1	2	1	1	0
CKET-654	86	94	8	1	4	1	2	0
CKET-654	88	92	4	1	3	1	0	0
CKET-654	95	96	1	1	4	4	1	0
CKET-654	105	108	3	1	2	1	0	0
CKET-655	108	268	160	1	4	4	1	0
CKET-655	109	145	36	1	2	1	3	0
CKET-655	142	145	3	1	3	1	1	0
CKET-655	144	145	1	1	3	1	3	0
CKET-655	146	477	331	0	4	2	0	1
CKET-655	147	148	1	1	4	4	1	0
CKET-655	148	149	1	1	5	4	1	0
CKET-655	148	149	1	1	3	4	1	0
CKET-655	154	477	323	0	3	4	0	0
CKET-655	155	477	322	0	3	2	0	0
CKET-656	160	161	1	1	4	4	2	1
CKET-656	161	477	316	0	4	4	0	0
CKET-656	171	174	3	1	3	4	1	0
CKET-656	173	477	304	0	4	4	1	0
CKET-656	175	184	9	1	3	1	2	0
CKET-656	178	189	11	1	4	4	2	1
CKET-656	183	184	1	1	4	1	0	1
CKET-656	189	269	80	1	4	1	0	0
CKET-656	199	202	3	1	4	1	3	0
CKET-656	200	340	140	1	4	5	2	0
CKET-657	204	267	63	1	3	1	1	0
CKET-657	204	205	1	1	3	1	1	1
CKET-657	204	477	273	0	4	1	0	0
CKET-657	205	206	1	1	3	1	1	0
CKET-657	205	207	2	1	3	1	2	0
CKET-657	212	247	35	1	4	4	2	0
CKET-657	217	218	1	1	4	4	2	0
CKET-657	217	218	1	1	4	2	2	0
CKET-657	218	375	157	1	5	2	2	0
CKET-657	221	222	1	1	5	4	1	0
CKET-658	228	240	12	1	4	4	2	0
CKET-658	236	273	37	1	5	4	1	0
CKET-658	240	241	1	1	3	4	0	0
CKET-658	241	308	67	1	4	3	1	0
CKET-658	248	252	4	1	4	1	2	0
CKET-658	253	477	224	0	4	4	0	0
CKET-658	255	288	33	1	3	1	3	0
CKET-658	256	330	74	1	4	4	2	0
CKET-658	259	263	4	1	3	1	2	2
CKET-658	259	260	1	1	3	1	2	1
CKET-659	259	477	218	0	3	1	0	0
CKET-659	259	260	1	1	3	1	0	0
CKET-659	259	260	1	1	3	1	0	0
CKET-659	261	262	1	1	3	1	0	2
CKET-659	267	268	1	1	4	3	3	0
CKET-659	273	274	1	1	3	4	1	0
CKET-659	273	274	1	1	3	3	1	0
CKET-659	279	282	3	1	4	4	0	0
CKET-659	283	284	1	1	4	3	1	0
CKET-659	290	291	1	1	4	1	2	0
CKET-660	293	307	14	1	3	4	2	1
CKET-660	294	295	1	1	4	4	2	1
CKET-660	295	308	13	1	3	1	2	1
CKET-660	296	298	2	1	2	1	2	0
CKET-660	298	302	4	1	4	1	2	0
CKET-660	302	303	1	1	5	4	3	0
CKET-660	302	303	1	1	3	1	2	0
CKET-660	302	306	4	1	3	1	2	1
CKET-660	303	338	35	1	4	1	0	1
CKET-660	304	305	1	1	5	3	2	0
CKET-661	305	307	2	1	5	1	2	0
CKET-661	309	477	168	0	3	1	0	1
CKET-661	310	477	167	0	4	4	0	0
CKET-661	311	477	166	0	4	1	0	0
CKET-661	322	324	2	1	3	1	3	0
CKET-661	327	381	54	1	3	4	2	0
CKET-661	331	336	5	1	3	1	1	2
CKET-661	335	341	6	1	3	1	2	0
CKET-661	338	477	139	0	4	4	1	1
CKET-661	339	438	99	1	3	1	0	0
CKET-662	340	341	1	1	3	3	1	0
CKET-662	341	342	1	1	4	4	2	0
CKET-662	343	477	134	0	4	1	0	1
CKET-662	344	345	1	1	3	1	3	0
CKET-662	362	363	1	1	3	3	3	0
CKET-662	362	365	3	1	3	3	0	0
DEN-24	94	477	383	0	4	1	0	0
S-62	4	5	1	1	3	1	3	0
S-62	8	9	1	1	1	1	0	0
S-62	37	38	1	1	4	5	2	0
S-62	38	39	1	1	4	2	2	0
S-62	43	107	64	1	3	1	1	0
S-62	58	106	48	1	3	1	1	1
S-62	84	92	8	1	3	1	1	0
S-62	105	106	1	1	3	4	1	0
S-62	120	121	1	1	3	4	1	2
S-62	148	151	3	1	3	4	1	0
S-63	168	169	1	1	3	1	0	0
S-63	185	189	4	1	3	1	0	0
S-63	233	477	244	0	3	3	1	1
S-63	273	287	14	1	3	3	1	0
S-63	290	291	1	1	4	1	2	0
S-63	318	319	1	1	3	1	0	0
S-63	323	324	1	1	4	4	0	2
S-63	331	332	1	1	3	3	1	0
S-63	344	477	133	0	3	1	0	0
S-63	352	353	1	1	3	1	0	0
-490	0	9	9	1	3	4	1	0
-490	0	14	14	1	3	1	1	1
-490	8	14	6	1	5	2	1	0
-490	9	14	5	1	3	1	1	0
-490	14	15	1	1	3	1	1	1
-491	18	74	56	1	3	4	1	0
-491	18	29	11	1	2	1	1	0
-491	24	29	5	1	4	4	1	0
-491	31	58	27	1	3	3	1	0
-491	35	36	1	1	4	5	1	0
-491	35	74	39	1	3	4	1	0
-491	36	45	9	1	1	1	1	1
-491	40	477	437	0	4	3	1	0
-491	43	44	1	1	3	1	1	0
-491	44	477	433	0	4	4	1	0
-492	46	58	12	1	3	1	1	0
-492	49	57	8	1	3	1	1	0
-492	50	60	10	1	4	4	1	0
-492	52	58	6	1	4	1	1	0
-492	65	66	1	1	3	1	1	0
-492	70	71	1	1	3	1	1	0
-492	73	142	69	1	4	5	1	0
-492	79	123	44	1	3	4	1	0
-492	80	81	1	1	4	1	1	0
-492	84	477	393	0	3	4	1	0
-493	93	318	225	1	3	1	1	0
-493	95	147	52	1	3	5	1	0
-493	98	140	42	1	4	4	1	0
-493	100	101	1	1	3	1	1	0
-493	107	108	1	1	1	1	0	0
-493	119	477	358	0	3	4	1	0
-493	126	127	1	1	3	1	0	0
-493	129	133	4	1	4	4	1	0
-493	140	351	211	1	4	4	1	0
-493	148	477	329	0	2	4	1	0
-494	149	155	6	1	3	1	0	0
-494	164	259	95	1	3	1	2	1
-494	169	171	2	1	3	1	0	0
-494	172	477	305	0	2	1	1	0
-494	189	477	288	0	3	1	1	0
-494	198	477	279	0	3	1	1	0
-494	208	477	269	0	3	1	1	1
-494	214	345	131	1	3	5	1	0
-494	220	259	39	1	2	1	2	2
-494	228	229	1	1	3	5	1	0
-495	228	229	1	1	3	5	1	0
-495	233	268	35	1	3	1	3	1
-495	234	235	1	1	1	4	1	1
-495	234	235	1	1	3	5	1	0
-495	235	268	33	1	3	1	3	0
-495	235	236	1	1	3	5	1	0
-495	244	245	1	1	3	5	1	0
-495	246	253	7	1	3	1	1	0
-495	249	477	228	0	3	1	2	0
-495	254	255	1	1	2	1	0	1
-496	254	255	1	1	1	1	0	1
-496	254	255	1	1	2	1	0	0
-496	260	261	1	1	1	1	0	0
-496	261	294	33	1	3	4	1	0
-496	263	346	83	1	3	1	1	1
-496	275	280	5	1	3	5	1	0
-496	275	477	202	0	3	1	0	0
-496	279	280	1	1	4	5	1	0
-496	284	477	193	0	3	1	1	0
-496	284	285	1	1	3	4	0	0
-497	287	319	32	1	3	1	1	1
-497	291	304	13	1	3	1	2	0
-497	295	477	182	0	3	4	1	0
-497	298	303	5	1	3	5	1	0
-497	302	306	4	1	3	1	2	3
-497	310	363	53	1	3	5	3	0
-497	314	315	1	1	3	5	1	1
-497	315	321	6	1	4	1	2	0
-497	316	317	1	1	4	5	1	0
-497	316	317	1	1	4	5	1	0
-498	317	318	1	1	5	5	1	0
-498	318	322	4	1	2	3	2	2
-498	320	321	1	1	5	3	1	0
-498	322	323	1	1	4	3	1	1
-498	323	324	1	1	3	1	2	1
-498	324	325	1	1	5	5	1	0
-498	325	335	10	1	3	1	2	1
-498	328	346	18	1	3	1	2	0
-498	334	335	1	1	4	5	1	1
-498	344	347	3	1	3	5	1	0
-499	344	345	1	1	3	5	0	0
-499	344	399	55	1	3	1	2	0
-499	347	348	1	1	3	5	1	0
-499	348	362	14	1	4	5	2	0
-499	350	351	1	1	1	1	1	0
-499	350	362	12	1	4	4	2	0
-499	351	370	19	1	4	4	1	0
-499	354	355	1	1	3	1	1	0
LANC-77	53	477	424	0	3	1	0	0
LANC-77	54	477	423	0	3	4	0	0
LANC-77	56	477	421	0	3	4	0	0
LANC-77	56	477	421	0	3	4	0	0
LANC-77	56	477	421	0	3	4	0	0
LANC-78	57	477	420	0	3	4	0	0
LANC-78	108	477	369	0	3	1	0	0
LANC-78	154	477	323	0	3	1	0	0
LANC-78	338	477	139	0	4	4	0	0
EAN-30	72	73	1	1	3	3	1	0
EAN-30	77	78	1	1	3	4	1	0
EAN-30	85	477	392	0	3	4	0	0
EAN-30	86	87	1	1	5	2	1	0
EAN-30	93	94	1	1	3	4	1	0
EAN-30	176	477	301	0	3	1	0	0
EAN-30	177	178	1	1	3	3	1	0
EAN-30	220	274	54	1	3	4	1	0
EAN-31	220	221	1	1	3	4	1	0
EAN-31	268	269	1	1	3	3	1	0
EAN-31	273	274	1	1	3	4	1	0
EAN-31	273	274	1	1	3	2	1	0
EAN-31	301	302	1	1	3	3	1	0
RCESC-212	1	2	1	1	3	1	0	0
RCESC-212	10	477	467	0	3	1	0	0
RCESC-213	10	43	33	1	2	1	1	0
RCESC-213	17	477	460	0	3	1	0	0
RCESC-213	22	29	7	1	3	4	1	0
RCESC-213	26	477	451	0	4	1	0	0
RCESC-213	29	42	13	1	3	4	1	0
RCESC-213	29	477	448	0	4	4	0	0
RCESC-213	43	45	2	1	3	4	1	0
RCESC-213	45	46	1	1	3	1	1	0
RCESC-213	51	477	426	0	5	1	0	0
RCESC-213	52	477	425	0	4	1	0	0
RCESC-214	59	385	326	1	3	4	1	0
RCESC-214	68	477	409	0	3	4	0	0
RCESC-214	72	477	405	0	4	1	0	0
RCESC-214	76	77	1	1	3	4	1	0
RCESC-214	93	477	384	0	3	1	0	0
RCESC-214	94	95	1	1	3	1	0	0
RCESC-214	129	477	348	0	3	1	0	0
RCESC-214	158	250	92	1	3	4	1	0
RCESC-214	162	477	315	0	3	1	1	0
RCESC-214	212	477	265	0	4	1	0	0
RCESC-215	249	250	1	1	5	1	1	0
RCESC-215	249	250	1	1	4	1	1	0
RCESC-215	250	251	1	1	4	1	1	0
RCESC-215	253	254	1	1	4	5	1	0
RCESC-215	275	477	202	0	3	1	0	0
RCESC-215	283	284	1	1	4	1	1	0
RCESC-215	284	477	193	0	4	1	0	0
RCESC-215	315	477	162	0	4	5	0	0
RCESC-215	316	477	161	0	3	1	0	0
RCESC-215	318	477	159	0	3	1	0	0
RCESC-216	327	477	150	0	3	1	0	0
RCESC-216	340	477	137	0	3	1	0	0
RCESC-216	344	477	133	0	3	1	0	0
RCESJ-168	35	44	9	1	4	5	1	0
RCESJ-168	38	477	439	0	2	5	1	0
RCESJ-169	44	45	1	1	3	1	0	0
RCESJ-169	91	92	1	1	4	5	0	0
RCESJ-169	113	121	8	1	3	4	0	0
RCESJ-169	116	477	361	0	3	1	0	0
RCESJ-169	127	477	350	0	3	1	0	0
RCESJ-169	149	477	328	0	3	5	0	2
RCESJ-169	159	160	1	1	3	1	0	2
RCESJ-169	168	169	1	1	3	1	0	2
RCESJ-169	178	179	1	1	3	1	0	0
RCESJ-169	219	477	258	0	3	1	0	0
RCESJ-170	226	477	251	0	3	2	0	0
RCESJ-170	248	477	229	0	3	1	1	0
RCESJ-170	256	477	221	0	3	1	0	0
RCESJ-170	318	477	159	0	3	1	0	0
RCESJ-170	329	477	148	0	4	4	0	0
C-11	102	103	1	1	3	1	1	0
C-11	168	169	1	1	3	1	0	0
C-11	181	182	1	1	3	1	0	0
C-11	181	191	10	1	3	1	0	0
C-11	181	182	1	1	3	4	0	0
C-11	304	305	1	1	3	1	0	0
C-11	344	345	1	1	3	1	0	0
LBEANS-51	145	146	1	1	3	4	1	0
LBEANS-51	145	146	1	1	3	4	1	0
LBEANS-51	145	146	1	1	3	4	1	0
LBEANS-51	160	161	1	1	3	4	1	1
LBEANS-51	229	230	1	1	3	4	1	2
LBEANS-51	249	250	1	1	3	1	1	1
LBEANS-52	253	260	7	1	3	1	1	1
LBEANS-52	280	426	146	1	3	5	1	1
LBEANS-52	281	426	145	1	3	5	1	0
LBEANS-52	297	392	95	1	3	1	0	0
LBEANS-52	304	337	33	1	3	1	0	1
LBEANS-52	327	426	99	1	2	4	1	0
LBEANS-52	359	383	24	1	3	1	1	1
LSCHEMA-5	75	477	402	0	3	5	0	0
LSCHEMA-5	141	162	21	1	3	1	0	0
LSCHEMA-5	210	217	7	1	4	1	1	1
LSCHEMA-5	233	477	244	0	3	1	0	0
LSCHEMA-5	241	477	236	0	4	2	0	0
RN-769	1	477	476	0	4	2	0	0
RN-769	1	477	476	0	3	5	0	1
RN-769	2	477	475	0	3	1	0	0
RN-769	2	12	10	1	3	5	1	0
RN-769	2	42	40	1	1	1	1	0
RN-769	3	28	25	1	4	1	4	0
RN-769	3	7	4	1	3	1	4	1
RN-770	3	477	474	0	3	1	0	0
RN-770	3	63	60	1	2	1	0	1
RN-770	3	4	1	1	2	1	0	1
RN-770	3	477	474	0	3	1	0	0
RN-770	3	7	4	1	3	5	1	0
RN-770	4	12	8	1	3	1	3	2
RN-770	4	115	111	1	3	1	0	1
RN-770	5	82	77	1	3	5	0	1
RN-770	5	226	221	1	3	5	0	1
RN-770	5	17	12	1	1	5	1	0
RN-771	7	477	470	0	1	1	0	0
RN-771	7	477	470	0	3	1	0	0
RN-771	7	477	470	0	3	4	0	0
RN-771	7	477	470	0	3	4	0	1
RN-771	7	8	1	1	3	5	0	0
RN-771	7	129	122	1	3	1	1	2
RN-771	7	8	1	1	3	5	3	0
RN-771	7	17	10	1	3	1	1	0
RN-771	7	8	1	1	2	1	1	0
RN-771	8	477	469	0	2	1	0	0
RN-772	8	477	469	0	3	5	0	0
RN-772	8	477	469	0	3	1	0	0
RN-772	8	9	1	1	5	4	1	0
RN-772	8	29	21	1	3	5	1	0
RN-772	8	12	4	1	3	5	1	0
RN-772	9	45	36	1	3	5	1	0
RN-772	9	477	468	0	4	1	0	0
RN-772	9	11	2	1	4	1	4	0
RN-772	9	37	28	1	3	4	4	0
RN-772	9	21	12	1	3	5	1	0
RN-773	9	477	468	0	4	1	0	0
RN-773	9	11	2	1	3	1	1	0
RN-773	10	51	41	1	4	5	0	1
RN-773	10	477	467	0	3	1	0	0
RN-773	10	86	76	1	3	1	3	1
RN-773	10	11	1	1	4	1	4	0
RN-773	10	63	53	1	4	1	4	0
RN-773	10	23	13	1	3	1	4	0
RN-773	10	21	11	1	1	1	1	2
RN-773	11	42	31	1	1	1	1	1
RN-774	11	17	6	1	3	1	1	1
RN-774	11	477	466	0	3	1	0	0
RN-774	11	25	14	1	3	1	1	0
RN-774	11	477	466	0	3	1	0	0
RN-774	11	477	466	0	2	1	0	0
RN-774	11	17	6	1	3	5	1	0
RN-774	11	398	387	1	3	5	0	0
RN-774	13	477	464	0	3	1	0	1
RN-774	13	204	191	1	3	1	3	0
RN-774	14	23	9	1	3	1	1	0
RN-775	14	17	3	1	3	1	1	2
RN-775	14	477	463	0	3	1	0	0
RN-775	14	477	463	0	3	5	0	0
RN-775	15	18	3	1	3	1	1	1
RN-775	15	302	287	1	3	5	1	1
RN-775	15	21	6	1	4	4	1	0
RN-775	15	477	462	0	3	1	0	0
RN-775	15	34	19	1	1	5	1	3
RN-775	15	16	1	1	3	1	3	0
RN-775	15	24	9	1	3	1	0	0
RN-776	15	25	10	1	3	1	1	0
RN-776	15	409	394	1	3	1	3	1
RN-776	15	29	14	1	3	1	0	0
RN-776	15	21	6	1	1	5	1	0
RN-776	16	93	77	1	3	1	2	1
RN-776	16	27	11	1	1	1	4	0
RN-776	16	22	6	1	3	1	1	0
RN-776	16	81	65	1	3	1	0	0
RN-776	17	477	460	0	3	1	0	0
RN-776	17	477	460	0	3	1	0	2
RN-777	17	35	18	1	3	1	0	0
RN-777	17	477	460	0	4	1	0	0
RN-777	17	477	460	0	4	1	0	0
RN-777	17	105	88	1	1	1	3	0
RN-777	17	19	2	1	1	5	1	0
RN-777	17	477	460	0	3	1	0	0
RN-777	17	18	1	1	3	5	0	0
RN-777	17	23	6	1	3	1	1	0
RN-777	18	32	14	1	3	5	1	1
RN-777	18	22	4	1	3	5	1	1
RN-778	18	29	11	1	3	5	1	0
RN-778	18	116	98	1	3	5	2	0
RN-778	18	22	4	1	1	5	3	1
RN-778	20	23	3	1	1	5	1	0
RN-778	21	25	4	1	3	5	1	0
RN-778	21	477	456	0	4	1	0	0
RN-778	21	109	88	1	3	1	4	1
RN-778	21	477	456	0	2	1	0	0
RN-778	21	22	1	1	3	5	1	0
RN-778	22	44	22	1	2	5	1	1
RN-779	22	28	6	1	2	1	2	0
RN-779	22	100	78	1	3	5	0	0
RN-779	22	30	8	1	1	5	0	0
RN-779	22	477	455	0	4	1	0	0
RN-779	22	334	312	1	1	1	4	1
RN-779	22	23	1	1	1	5	1	0
RN-779	22	23	1	1	3	1	2	1
RN-779	22	25	3	1	3	5	1	0
RN-779	22	24	2	1	4	5	1	1
RN-779	22	120	98	1	2	1	2	0
RN-780	23	477	454	0	3	5	0	1
RN-780	23	36	13	1	2	1	4	0
RN-780	23	30	7	1	3	1	0	0
RN-780	23	477	454	0	3	1	0	0
RN-780	23	99	76	1	3	1	2	1
RN-780	23	477	454	0	3	1	0	0
RN-780	23	24	1	1	3	1	3	0
RN-780	23	24	1	1	1	5	1	0
RN-780	23	24	1	1	3	1	0	0
RN-780	23	477	454	0	4	4	0	0
RN-781	23	105	82	1	3	5	4	0
RN-781	23	29	6	1	3	5	1	0
RN-781	23	241	218	1	3	2	0	2
RN-781	23	49	26	1	3	4	4	0
RN-781	23	25	2	1	3	5	1	3
RN-781	23	37	14	1	3	5	1	1
RN-781	24	31	7	1	3	5	1	0
RN-781	24	25	1	1	3	5	1	3
RN-781	24	123	99	1	3	1	2	0
RN-781	24	477	453	0	3	5	0	0
RN-782	25	477	452	0	3	1	0	0
RN-782	25	100	75	1	3	5	0	0
RN-782	25	29	4	1	3	5	1	1
RN-782	25	477	452	0	3	4	0	0
RN-782	25	412	387	1	3	4	3	1
RN-782	25	280	255	1	3	1	3	0
RN-782	25	477	452	0	2	1	0	0
RN-782	25	39	14	1	2	1	1	2
RN-782	25	30	5	1	3	1	1	0
RN-782	25	477	452	0	3	1	0	0
RN-783	25	109	84	1	3	1	2	1
RN-783	25	32	7	1	3	1	1	0
RN-783	25	32	7	1	2	1	0	0
RN-783	25	477	452	0	3	5	0	0
RN-783	25	477	452	0	3	5	0	0
RN-783	26	59	33	1	2	1	3	1
RN-783	27	52	25	1	3	5	1	0
RN-783	27	30	3	1	3	1	0	2
RN-783	28	41	13	1	2	5	1	1
RN-783	28	32	4	1	3	5	1	0
RN-784	28	32	4	1	1	5	1	1
RN-784	28	36	8	1	4	4	1	0
RN-784	28	30	2	1	3	5	1	0
RN-784	28	30	2	1	1	1	0	0
RN-784	28	477	449	0	3	4	0	0
RN-784	28	29	1	1	4	4	0	0
RN-784	28	29	1	1	4	4	0	0
RN-784	28	477	449	0	3	2	0	1
RN-784	28	477	449	0	3	5	0	0
RN-784	28	35	7	1	3	1	4	1
RN-785	28	36	8	1	3	1	1	0
RN-785	29	477	448	0	3	1	0	0
RN-785	29	30	1	1	3	5	0	0
RN-785	29	30	1	1	3	1	0	1
RN-785	29	39	10	1	3	5	0	0
RN-785	29	477	448	0	3	1	0	0
RN-785	29	57	28	1	3	5	1	1
RN-785	29	37	8	1	3	1	0	2
RN-785	29	241	212	1	3	5	0	2
RN-785	30	86	56	1	3	2	0	0
RN-786	30	36	6	1	3	5	1	2
RN-786	30	31	1	1	3	1	1	0
RN-786	30	31	1	1	3	1	0	1
RN-786	30	238	208	1	3	5	1	4
RN-786	30	477	447	0	3	1	0	0
RN-786	30	242	212	1	3	5	1	0
RN-786	30	36	6	1	3	1	1	0
RN-786	30	477	447	0	3	5	0	0
RN-786	30	32	2	1	3	5	1	0
RN-786	30	477	447	0	3	5	0	0
RN-787	30	477	447	0	3	5	0	0
RN-787	31	70	39	1	3	5	1	2
RN-787	31	477	446	0	1	1	1	0
RN-787	32	80	48	1	1	1	4	1
RN-787	32	33	1	1	2	4	0	0
RN-787	32	95	63	1	3	5	1	0
RN-787	32	35	3	1	1	1	1	3
RN-787	32	443	411	1	3	5	0	2
RN-787	32	105	73	1	2	1	0	1
RN-787	32	33	1	1	2	1	1	1
RN-788	32	35	3	1	3	1	1	1
RN-788	32	477	445	0	3	2	0	0
RN-788	32	477	445	0	3	1	0	0
RN-788	32	33	1	1	3	5	0	1
RN-788	32	477	445	0	3	1	0	0
RN-788	33	477	444	0	3	5	0	0
RN-788	33	477	444	0	3	5	0	0
RN-788	33	477	444	0	3	1	0	0
RN-788	33	477	444	0	4	1	0	0
RN-788	33	36	3	1	3	1	1	0
RN-789	33	37	4	1	3	1	4	1
RN-789	34	65	31	1	3	5	1	1
RN-789	34	132	98	1	3	5	1	0
RN-789	35	57	22	1	1	5	1	0
RN-789	35	127	92	1	3	1	2	0
RN-789	35	477	442	0	4	1	0	0
RN-789	35	477	442	0	3	1	0	0
RN-789	36	337	301	1	3	1	0	0
RN-789	36	477	441	0	3	5	0	0
RN-789	36	189	153	1	3	5	1	1
RN-790	36	140	104	1	3	5	2	2
RN-790	37	477	440	0	4	5	0	0
RN-790	37	477	440	0	3	5	0	0
RN-790	37	477	440	0	3	1	0	3
RN-790	37	424	387	1	3	5	1	1
RN-790	38	97	59	1	2	1	3	0
RN-790	38	42	4	1	1	1	1	1
RN-790	38	39	1	1	2	1	0	0
RN-790	38	477	439	0	3	1	0	0
RN-790	39	40	1	1	3	1	1	0
RN-791	39	477	438	0	4	4	0	1
RN-791	39	477	438	0	3	1	0	0
RN-791	39	477	438	0	3	1	0	1
RN-791	39	477	438	0	3	4	0	1
RN-791	39	42	3	1	2	5	1	0
RN-791	39	63	24	1	3	5	1	0
RN-791	39	51	12	1	3	5	1	0
RN-791	39	42	3	1	4	5	1	0
RN-791	40	47	7	1	2	3	1	0
RN-791	40	65	25	1	3	5	2	2
RN-792	41	45	4	1	1	5	1	0
RN-792	41	56	15	1	3	5	1	0
RN-792	42	477	435	0	4	1	0	0
RN-792	42	43	1	1	3	1	0	1
RN-792	43	477	434	0	1	1	0	0
RN-792	43	477	434	0	4	1	0	0
RN-792	43	44	1	1	3	1	0	0
RN-792	44	477	433	0	3	1	0	0
RN-792	44	58	14	1	3	5	1	0
RN-793	44	477	433	0	3	5	0	0
RN-793	44	101	57	1	3	5	1	2
RN-793	44	477	433	0	3	5	0	1
RN-793	44	135	91	1	3	5	1	1
RN-793	44	53	9	1	3	5	1	2
RN-793	45	276	231	1	3	5	0	1
RN-793	45	101	56	1	3	5	2	0
RN-793	45	48	3	1	4	1	3	0
RN-793	45	115	70	1	3	5	2	2
RN-794	46	50	4	1	1	5	1	0
RN-794	46	100	54	1	3	5	2	0
RN-794	46	52	6	1	1	1	1	0
RN-794	46	477	431	0	3	3	0	0
RN-794	46	66	20	1	3	1	1	0
RN-794	48	52	4	1	3	1	2	1
RN-794	49	93	44	1	3	5	1	1
RN-794	49	51	2	1	3	1	4	0
RN-794	50	213	163	1	3	4	1	0
RN-794	50	53	3	1	3	1	1	0
RN-795	51	477	426	0	3	4	0	0
RN-795	51	477	426	0	3	1	0	0
RN-795	51	73	22	1	3	1	1	0
RN-795	51	227	176	1	3	5	0	1
RN-795	51	58	7	1	3	5	1	0
RN-795	51	58	7	1	3	5	1	0
RN-795	51	112	61	1	3	1	2	0
RN-795	51	277	226	1	2	1	3	2
RN-795	52	59	7	1	2	1	1	2
RN-795	52	57	5	1	2	5	1	1
RN-796	52	141	89	1	3	5	2	0
RN-796	52	122	70	1	3	5	2	0
RN-796	52	151	99	1	2	1	2	1
RN-796	53	56	3	1	3	1	1	0
RN-796	53	477	424	0	4	1	0	1
RN-796	53	57	4	1	2	5	1	0
RN-796	53	107	54	1	4	4	1	0
RN-796	53	477	424	0	3	4	0	0
RN-796	53	99	46	1	3	4	0	0
RN-796	55	477	422	0	4	1	0	0
RN-797	56	477	421	0	3	4	1	0
RN-797	56	63	7	1	3	5	1	0
RN-797	56	99	43	1	3	5	2	0
RN-797	57	268	211	1	3	4	4	0
RN-797	57	477	420	0	3	4	0	1
RN-797	57	477	420	0	3	5	0	2
RN-797	57	477	420	0	3	5	0	1
RN-797	57	477	420	0	3	5	0	1
RN-797	57	477	420	0	3	5	0	1
RN-798	57	477	420	0	3	5	0	1
RN-798	57	477	420	0	3	5	0	1
RN-798	57	477	420	0	3	5	0	1
RN-798	57	58	1	1	3	5	0	2
RN-798	57	99	42	1	2	1	2	2
RN-798	58	59	1	1	5	1	1	0
RN-798	58	81	23	1	2	5	3	0
RN-798	59	70	11	1	3	5	0	1
RN-798	59	87	28	1	3	5	1	0
RN-798	59	185	126	1	3	1	0	1
RN-799	59	308	249	1	3	5	0	0
RN-799	59	477	418	0	3	1	0	1
RN-799	60	61	1	1	3	1	0	0
RN-799	60	214	154	1	3	1	0	1
RN-799	60	477	417	0	3	5	0	2
RN-799	61	63	2	1	4	1	1	1
RN-799	62	106	44	1	3	5	2	0
RN-799	63	64	1	1	4	4	0	1
RN-799	63	142	79	1	3	1	0	1
RN-799	60	72	12	1	3	5	1	1
RN-800	63	67	4	1	3	1	1	1
RN-800	63	477	414	0	3	1	0	0
RN-800	63	77	14	1	3	5	2	0
RN-800	64	65	1	1	3	5	1	0
RN-800	65	116	51	1	2	1	3	0
RN-800	65	116	51	1	2	1	2	0
RN-800	65	74	9	1	3	5	1	0
RN-800	65	477	412	0	3	5	0	1
RN-800	65	198	133	1	3	5	0	0
RN-800	65	66	1	1	4	4	0	0
RN-801	66	86	20	1	4	5	3	0
RN-801	66	67	1	1	4	1	1	0
RN-801	66	477	411	0	3	2	0	2
RN-801	66	93	27	1	3	5	2	0
RN-801	66	67	1	1	4	1	0	0
RN-801	67	234	167	1	2	5	1	2
RN-801	67	82	15	1	3	3	1	0
RN-801	67	102	35	1	2	5	0	1
RN-801	67	101	34	1	3	5	2	1
RN-801	68	477	409	0	3	1	0	0
RN-802	68	477	409	0	3	5	0	0
RN-802	68	477	409	0	3	4	0	0
RN-802	68	72	4	1	1	1	2	0
RN-802	68	70	2	1	3	1	0	0
RN-802	69	70	1	1	3	1	1	0
RN-802	70	126	56	1	3	1	3	0
RN-802	70	101	31	1	3	5	2	2
RN-802	71	76	5	1	3	4	2	1
RN-802	72	87	15	1	3	5	0	4
RN-803	72	477	405	0	3	5	0	0
RN-803	73	477	404	0	3	1	0	0
RN-803	73	81	8	1	3	1	2	0
RN-803	73	90	17	1	3	5	1	0
RN-803	74	477	403	0	3	1	0	0
RN-803	74	92	18	1	3	1	2	1
RN-803	74	477	403	0	3	1	0	0
RN-803	74	477	403	0	3	1	0	2
RN-803	74	477	403	0	3	5	0	0
RN-803	74	75	1	1	4	1	2	0
RN-804	74	76	2	1	3	1	2	0
RN-804	75	477	402	0	4	5	0	0
RN-804	75	477	402	0	3	5	0	0
RN-804	75	84	9	1	3	1	2	0
RN-804	75	85	10	1	3	5	0	1
RN-804	75	256	181	1	3	4	1	0
RN-804	76	477	401	0	2	4	0	0
RN-804	77	477	400	0	4	4	0	0
RN-804	77	96	19	1	3	5	2	2
RN-804	77	477	400	0	4	5	0	0
RN-805	77	477	400	0	3	4	0	2
RN-805	77	240	163	1	3	4	4	0
RN-805	78	477	399	0	3	5	0	0
RN-805	78	79	1	1	3	5	2	0
RN-805	78	79	1	1	3	1	4	0
RN-805	79	477	398	0	3	5	0	1
RN-805	79	477	398	0	3	1	0	0
RN-805	79	477	398	0	3	4	0	0
RN-805	79	477	398	0	3	3	0	0
RN-805	79	477	398	0	3	1	0	4
RN-806	79	105	26	1	3	5	2	1
RN-806	80	477	397	0	3	1	0	2
RN-806	57	84	27	1	2	1	2	0
RN-806	80	81	1	1	3	1	3	0
RN-806	80	109	29	1	2	5	2	2
RN-806	81	477	396	0	3	1	1	0
RN-806	81	477	396	0	3	1	0	0
RN-806	81	477	396	0	3	1	0	0
RN-806	81	84	3	1	1	1	4	3
RN-806	81	87	6	1	3	5	1	0
RN-807	81	82	1	1	1	5	1	0
RN-807	81	135	54	1	3	1	1	3
RN-807	81	84	3	1	2	3	1	0
RN-807	84	100	16	1	3	1	4	0
RN-807	84	477	393	0	3	5	0	0
RN-807	84	86	2	1	3	1	1	0
RN-807	85	87	2	1	3	4	1	0
RN-807	85	86	1	1	5	4	1	0
RN-807	85	477	392	0	3	5	0	0
RN-807	85	123	38	1	2	1	2	2
RN-808	85	136	51	1	2	3	2	2
RN-808	85	135	50	1	3	5	2	0
RN-808	85	91	6	1	4	4	1	0
RN-808	86	95	9	1	3	1	2	1
RN-808	86	477	391	0	3	3	0	0
RN-808	87	88	1	1	1	1	1	0
RN-808	87	88	1	1	1	1	1	0
RN-808	87	477	390	0	3	5	0	1
RN-808	87	398	311	1	3	5	0	1
RN-808	87	477	390	0	3	5	0	1
RN-809	88	91	3	1	2	3	2	1
RN-809	88	90	2	1	3	5	1	0
RN-809	88	89	1	1	3	5	0	1
RN-809	88	90	2	1	3	5	1	0
RN-809	88	477	389	0	3	4	0	0
RN-809	88	106	18	1	3	1	1	0
RN-809	88	114	26	1	3	5	0	2
RN-809	89	92	3	1	3	1	0	1
RN-809	89	477	388	0	4	1	0	1
RN-810	89	99	10	1	3	5	1	1
RN-810	90	387	297	1	4	5	2	0
RN-810	90	477	387	0	3	5	0	0
RN-810	90	178	88	1	3	5	1	1
RN-810	90	108	18	1	3	5	1	0
RN-810	91	477	386	0	4	1	0	0
RN-810	91	93	2	1	2	1	1	0
RN-810	91	95	4	1	3	5	4	0
RN-810	91	176	85	1	1	1	3	2
RN-810	91	92	1	1	3	3	0	2
RN-811	91	95	4	1	3	5	3	1
RN-811	92	109	17	1	4	5	2	1
RN-811	92	477	385	0	3	5	0	0
RN-811	92	121	29	1	3	5	2	0
RN-811	93	121	28	1	3	1	0	1
RN-811	93	94	1	1	3	1	2	0
RN-811	93	100	7	1	2	1	2	0
RN-811	93	94	1	1	3	5	1	0
RN-811	93	477	384	0	3	5	0	0
RN-811	94	95	1	1	3	1	2	0
RN-812	94	101	7	1	3	1	4	0
RN-812	94	477	383	0	3	4	0	0
RN-812	94	115	21	1	3	5	2	0
RN-812	95	135	40	1	3	4	1	2
RN-812	95	477	382	0	2	1	0	0
RN-812	95	108	13	1	3	1	0	1
RN-812	96	106	10	1	3	5	2	1
RN-812	98	100	2	1	2	1	2	0
RN-812	98	136	38	1	3	1	2	0
RN-812	98	232	134	1	4	5	4	0
RN-813	98	133	35	1	3	5	4	2
RN-813	98	477	379	0	3	1	0	0
RN-813	98	477	379	0	3	5	0	1
RN-813	98	100	2	1	1	1	2	0
RN-813	98	106	8	1	3	5	1	0
RN-813	98	220	122	1	3	5	2	0
RN-813	99	109	10	1	3	5	1	0
RN-813	99	103	4	1	4	5	2	0
RN-813	99	477	378	0	3	1	0	0
RN-814	99	115	16	1	3	4	2	0
RN-814	99	136	37	1	2	1	2	0
RN-814	99	102	3	1	3	1	2	0
RN-814	100	477	377	0	4	4	0	0
RN-814	100	477	377	0	3	4	0	0
RN-814	100	107	7	1	3	1	2	0
RN-814	100	477	377	0	5	4	0	0
RN-814	100	101	1	1	3	1	4	1
RN-814	100	477	377	0	3	1	0	0
RN-814	100	477	377	0	3	1	0	0
RN-815	100	477	377	0	4	5	0	0
RN-815	100	122	22	1	3	5	1	0
RN-815	101	116	15	1	3	5	2	0
RN-815	101	102	1	1	3	1	2	0
RN-815	101	102	1	1	4	1	2	1
RN-815	101	212	111	1	3	4	4	0
RN-815	101	103	2	1	3	1	4	1
RN-815	101	477	376	0	3	5	0	0
RN-815	101	477	376	0	4	4	0	0
RN-815	102	477	375	0	3	4	0	0
RN-816	102	319	217	1	3	5	2	0
RN-816	102	477	375	0	3	5	0	0
RN-816	103	105	2	1	3	1	1	0
RN-816	104	123	19	1	3	4	1	0
RN-816	104	106	2	1	3	1	2	0
RN-816	105	106	1	1	5	1	4	1
RN-816	105	134	29	1	3	1	2	0
RN-816	105	477	372	0	3	1	0	0
RN-816	106	477	371	0	3	1	0	1
RN-816	106	108	2	1	4	4	1	0
RN-817	106	477	371	0	4	2	0	1
RN-817	106	107	1	1	3	1	2	0
RN-817	107	477	370	0	3	5	0	0
RN-817	107	477	370	0	3	5	0	1
RN-817	107	477	370	0	4	1	0	0
RN-817	107	211	104	1	3	5	1	1
RN-817	107	112	5	1	3	5	2	0
RN-817	107	477	370	0	3	2	0	1
RN-817	108	140	32	1	3	1	3	0
RN-818	108	477	369	0	3	4	0	0
RN-818	108	109	1	1	3	1	0	0
RN-818	108	109	1	1	2	1	2	0
RN-818	108	114	6	1	2	1	3	0
RN-818	108	172	64	1	3	1	1	0
RN-818	108	109	1	1	3	4	1	0
RN-818	108	109	1	1	3	5	1	1
RN-818	108	120	12	1	2	1	2	0
RN-818	109	114	5	1	3	1	2	1
RN-818	109	110	1	1	3	1	2	0
RN-819	109	477	368	0	3	1	0	0
RN-819	109	144	35	1	3	4	1	4
RN-819	109	477	368	0	3	5	0	0
RN-819	109	477	368	0	2	1	2	2
RN-819	109	122	13	1	1	5	2	1
RN-819	110	119	9	1	2	5	2	0
RN-819	111	113	2	1	5	1	2	0
RN-819	112	151	39	1	2	1	2	2
RN-819	112	477	365	0	3	4	0	0
RN-820	112	477	365	0	3	3	0	4
RN-820	113	129	16	1	4	4	3	0
RN-820	113	129	16	1	1	1	1	1
RN-820	113	477	364	0	3	5	0	0
RN-820	113	116	3	1	3	5	2	0
RN-820	113	116	3	1	2	1	4	0
RN-820	114	141	27	1	3	5	2	1
RN-820	114	127	13	1	1	5	2	2
RN-820	114	116	2	1	4	1	2	0
RN-820	115	121	6	1	2	1	2	1
RN-821	115	116	1	1	3	1	3	0
RN-821	115	116	1	1	3	1	2	1
RN-821	115	120	5	1	3	5	3	0
RN-821	115	145	30	1	2	4	2	0
RN-821	115	176	61	1	3	4	2	0
RN-821	115	116	1	1	2	5	4	0
RN-821	115	116	1	1	3	1	0	1
RN-821	115	122	7	1	3	1	3	1
RN-821	115	430	315	1	3	4	1	2
RN-821	115	402	287	1	3	4	1	2
RN-822	116	240	124	1	2	5	0	1
RN-822	116	117	1	1	3	1	4	1
RN-822	116	121	5	1	2	1	3	0
RN-822	116	123	7	1	1	1	2	1
RN-822	116	477	361	0	3	1	0	0
RN-822	116	117	1	1	2	1	2	2
RN-822	116	122	6	1	3	4	3	0
RN-822	116	117	1	1	3	1	0	1
RN-822	116	119	3	1	2	5	2	0
RN-822	116	477	361	0	3	1	0	0
RN-823	116	337	221	1	2	1	0	0
RN-823	116	122	6	1	2	1	0	0
RN-823	117	127	10	1	3	1	4	0
RN-823	117	313	196	1	2	1	4	0
RN-823	117	477	360	0	2	4	0	0
RN-823	117	477	360	0	3	1	0	0
RN-823	118	134	16	1	2	1	2	0
RN-823	119	310	191	1	3	5	0	1
RN-823	119	310	191	1	3	4	0	1
RN-823	120	128	8	1	3	4	2	0
RN-824	120	154	34	1	3	5	1	0
RN-824	121	191	70	1	3	5	0	0
RN-824	122	231	109	1	2	4	2	1
RN-824	122	130	8	1	2	5	2	0
RN-824	123	130	7	1	3	1	4	0
RN-824	123	477	354	0	3	1	0	0
RN-824	123	477	354	0	1	1	0	0
RN-824	123	133	10	1	2	5	4	0
RN-824	123	140	17	1	3	1	1	1
RN-824	123	135	12	1	2	4	3	0
RN-825	123	170	47	1	3	4	0	1
RN-825	123	127	4	1	3	1	2	0
RN-825	126	206	80	1	3	1	0	0
RN-825	126	127	1	1	2	5	4	0
RN-825	126	477	351	0	3	4	0	0
RN-825	126	477	351	0	3	1	0	1
RN-825	126	477	351	0	3	2	0	1
RN-825	126	477	351	0	2	1	0	0
RN-825	127	477	350	0	3	1	0	2
RN-825	127	163	36	1	1	5	2	2
RN-826	127	128	1	1	3	4	2	0
RN-826	127	128	1	1	1	5	2	1
RN-826	127	477	350	0	4	1	0	0
RN-826	127	213	86	1	4	5	2	0
RN-826	127	128	1	1	3	1	2	0
RN-826	127	131	4	1	2	1	2	1
RN-826	128	134	6	1	3	1	2	0
RN-826	128	477	349	0	3	1	0	0
RN-826	128	130	2	1	3	1	1	1
RN-826	128	477	349	0	4	1	0	0
RN-827	128	269	141	1	3	5	1	3
RN-827	128	133	5	1	3	1	2	0
RN-827	128	130	2	1	1	1	0	0
RN-827	129	141	12	1	3	1	1	1
RN-827	129	130	1	1	2	3	2	2
RN-827	130	153	23	1	2	1	2	1
RN-827	130	477	347	0	3	1	0	0
RN-827	130	134	4	1	1	1	3	1
RN-827	130	283	153	1	3	1	0	0
RN-828	130	477	347	0	3	1	0	0
RN-828	130	477	347	0	3	2	0	1
RN-828	130	135	5	1	4	5	2	1
RN-828	131	142	11	1	5	5	1	0
RN-828	131	477	346	0	2	5	0	1
RN-828	131	215	84	1	4	5	2	2
RN-828	133	134	1	1	3	1	3	0
RN-828	133	238	105	1	3	5	0	2
RN-829	134	141	7	1	2	1	2	0
RN-829	134	477	343	0	3	1	0	0
RN-829	134	144	10	1	2	1	2	2
RN-829	134	136	2	1	3	1	2	0
RN-829	134	477	343	0	4	1	0	0
RN-829	134	410	276	1	4	4	3	0
RN-829	134	137	3	1	3	1	2	0
RN-829	134	142	8	1	1	1	2	0
RN-829	134	329	195	1	3	5	2	0
RN-829	134	319	185	1	2	5	2	1
RN-830	134	135	1	1	3	1	2	0
RN-830	134	200	66	1	2	5	2	0
RN-830	135	186	51	1	3	4	2	1
RN-830	135	319	184	1	2	5	3	1
RN-830	135	477	342	0	2	5	0	2
RN-830	135	477	342	0	3	4	0	0
RN-830	135	477	342	0	3	4	0	0
RN-830	135	477	342	0	3	5	0	1
RN-830	135	151	16	1	3	1	2	0
RN-830	135	148	13	1	3	1	0	0
RN-831	135	142	7	1	3	1	4	3
RN-831	136	477	341	0	3	1	0	0
RN-831	136	477	341	0	3	5	0	2
RN-831	136	477	341	0	3	5	0	2
RN-831	136	477	341	0	3	5	0	2
RN-831	136	143	7	1	3	1	2	0
RN-831	136	137	1	1	3	1	0	0
RN-831	136	213	77	1	3	1	2	0
RN-831	137	152	15	1	3	1	2	1
RN-832	137	477	340	0	3	2	0	0
RN-832	137	161	24	1	5	4	1	0
RN-832	137	161	24	1	4	4	1	0
RN-832	137	161	24	1	3	1	1	0
RN-832	137	161	24	1	3	1	0	3
RN-832	137	162	25	1	4	4	1	0
RN-832	137	172	35	1	3	1	2	1
RN-832	137	142	5	1	3	1	4	1
RN-832	138	477	339	0	3	1	0	0
RN-832	138	148	10	1	3	5	2	0
RN-833	138	205	67	1	2	1	2	2
RN-833	140	220	80	1	3	1	4	1
RN-833	140	141	1	1	2	1	2	0
RN-833	140	150	10	1	3	4	2	0
RN-833	140	142	2	1	4	5	0	1
RN-833	140	141	1	1	3	5	0	1
RN-833	140	142	2	1	3	1	1	1
RN-833	141	477	336	0	3	5	0	0
RN-833	141	148	7	1	2	1	3	4
RN-833	141	148	7	1	2	1	2	1
RN-834	141	477	336	0	2	1	0	0
RN-834	141	477	336	0	3	4	0	0
RN-834	141	152	11	1	2	5	2	1
RN-834	141	149	8	1	2	5	0	1
RN-834	142	143	1	1	3	1	4	1
RN-834	142	154	12	1	3	2	0	1
RN-834	142	143	1	1	1	1	4	1
RN-834	142	143	1	1	3	1	1	1
RN-834	142	151	9	1	2	5	2	0
RN-835	143	149	6	1	2	1	2	1
RN-835	143	144	1	1	3	5	1	0
RN-835	143	421	278	1	3	4	2	1
RN-835	143	477	334	0	3	1	0	0
RN-835	143	477	334	0	3	1	0	0
RN-835	143	477	334	0	3	1	0	0
RN-835	143	477	334	0	3	5	0	0
RN-835	143	144	1	1	2	1	2	0
RN-835	143	144	1	1	3	1	0	1
RN-835	143	158	15	1	3	1	4	3
RN-836	143	203	60	1	2	1	2	0
RN-836	143	196	53	1	3	4	1	0
RN-836	144	148	4	1	2	1	2	0
RN-836	144	162	18	1	3	4	1	2
RN-836	144	477	333	0	3	4	0	0
RN-836	144	154	10	1	3	1	2	0
RN-836	144	477	333	0	3	1	0	0
RN-836	144	150	6	1	3	1	2	1
RN-836	144	149	5	1	2	1	2	0
RN-836	145	148	3	1	2	1	2	2
RN-837	146	162	16	1	4	5	4	3
RN-837	147	148	1	1	2	1	0	2
RN-837	147	151	4	1	2	1	2	1
RN-837	148	477	329	0	3	1	0	0
RN-837	148	477	329	0	3	4	0	2
RN-837	148	151	3	1	3	1	1	1
RN-837	148	437	289	1	3	5	1	2
RN-837	149	150	1	1	2	1	2	0
RN-837	149	422	273	1	4	1	1	0
RN-837	149	178	29	1	3	1	2	0
RN-838	150	204	54	1	3	1	2	0
RN-838	150	477	327	0	3	4	0	0
RN-838	150	154	4	1	3	1	3	0
RN-838	150	191	41	1	1	1	1	1
RN-838	150	151	1	1	2	5	2	0
RN-838	150	189	39	1	3	1	0	1
RN-838	150	157	7	1	2	1	2	0
RN-838	151	477	326	0	3	4	0	0
RN-838	151	154	3	1	3	1	2	1
RN-838	154	155	1	1	3	4	2	0
RN-839	154	155	1	1	3	1	1	2
RN-839	154	170	16	1	2	1	1	2
RN-839	154	477	323	0	2	1	0	0
RN-839	155	477	322	0	3	5	0	2
RN-839	155	163	8	1	3	4	3	1
RN-839	155	477	322	0	2	1	0	0
RN-839	155	156	1	1	1	1	2	0
RN-839	155	212	57	1	3	1	3	0
RN-839	155	235	80	1	3	1	0	2
RN-839	155	218	63	1	3	1	2	1
RN-840	156	157	1	1	5	4	2	0
RN-840	156	177	21	1	1	1	4	0
RN-840	156	477	321	0	3	5	0	0
RN-840	156	212	56	1	3	1	2	1
RN-840	157	163	6	1	1	1	4	1
RN-840	157	162	5	1	3	1	4	2
RN-840	157	158	1	1	2	5	0	0
RN-840	157	218	61	1	3	1	2	0
RN-840	158	178	20	1	3	1	2	0
RN-841	160	164	4	1	3	1	2	0
RN-841	161	163	2	1	2	5	2	0
RN-841	161	172	11	1	4	3	2	0
RN-841	161	162	1	1	3	1	2	0
RN-841	161	178	17	1	2	4	0	0
RN-841	162	182	20	1	3	1	2	0
RN-841	161	477	316	0	3	1	0	0
RN-841	162	477	315	0	2	1	0	0
RN-841	162	211	49	1	2	1	2	2
RN-841	162	163	1	1	3	1	2	0
RN-842	162	163	1	1	2	1	0	2
RN-842	162	196	34	1	3	1	4	0
RN-842	162	163	1	1	4	5	4	1
RN-842	162	177	15	1	2	1	2	2
RN-842	163	477	314	0	3	1	0	0
RN-842	163	164	1	1	3	3	0	0
RN-842	164	165	1	1	3	1	2	1
RN-842	164	172	8	1	3	5	1	0
RN-842	164	165	1	1	2	1	0	0
RN-842	164	207	43	1	3	1	2	0
RN-843	164	477	313	0	3	1	0	0
RN-843	166	477	311	0	3	4	0	0
RN-843	166	477	311	0	3	1	0	0
RN-843	166	477	311	0	3	3	0	0
RN-843	169	210	41	1	4	1	3	1
RN-843	169	185	16	1	2	1	1	1
RN-843	169	199	30	1	4	1	1	0
RN-843	170	171	1	1	3	1	1	1
RN-843	170	176	6	1	3	1	1	0
RN-844	170	171	1	1	5	4	1	0
RN-844	170	171	1	1	5	4	1	0
RN-844	170	171	1	1	3	4	1	0
RN-844	170	175	5	1	3	1	4	0
RN-844	170	172	2	1	3	1	4	0
RN-844	171	172	1	1	3	1	1	0
RN-844	171	477	306	0	3	2	0	0
RN-844	171	477	306	0	3	1	0	0
RN-844	171	288	117	1	3	5	1	4
RN-844	171	291	120	1	3	5	1	1
RN-845	172	477	305	0	3	1	0	1
RN-845	172	179	7	1	3	1	4	0
RN-845	172	477	305	0	3	1	0	0
RN-845	172	477	305	0	3	1	0	0
RN-845	172	477	305	0	3	4	0	0
RN-845	172	179	7	1	3	1	2	0
RN-845	173	290	117	1	3	5	1	0
RN-845	175	176	1	1	3	1	4	1
RN-845	175	477	302	0	3	3	0	0
RN-845	175	183	8	1	3	1	2	0
RN-846	175	477	302	0	3	1	0	0
RN-846	175	176	1	1	3	4	1	0
RN-846	176	186	10	1	2	1	0	2
RN-846	176	477	301	0	3	1	0	1
RN-846	176	177	1	1	1	1	2	0
RN-846	176	182	6	1	3	5	2	1
RN-846	177	477	300	0	2	3	0	0
RN-846	177	477	300	0	5	4	0	2
RN-846	177	288	111	1	2	4	1	1
RN-846	177	179	2	1	3	1	2	0
RN-847	177	477	300	0	3	1	0	0
RN-847	178	186	8	1	3	1	1	1
RN-847	178	477	299	0	3	4	0	1
RN-847	178	191	13	1	3	1	4	0
RN-847	179	227	48	1	2	1	2	0
RN-847	179	477	298	0	1	1	0	0
RN-847	179	180	1	1	4	1	0	0
RN-847	179	477	298	0	5	4	0	0
RN-847	179	180	1	1	2	1	0	2
RN-847	179	477	298	0	2	5	0	1
RN-848	179	477	298	0	3	4	0	0
RN-848	179	180	1	1	4	5	3	0
RN-848	179	477	298	0	3	5	0	0
RN-848	179	477	298	0	4	4	0	0
RN-848	180	477	297	0	4	1	0	0
RN-848	180	182	2	1	3	5	2	1
RN-848	183	477	294	0	3	4	0	0
RN-848	183	477	294	0	3	1	0	0
RN-848	183	330	147	1	3	3	2	0
RN-848	183	383	200	1	3	3	1	0
RN-849	183	477	294	0	5	4	0	2
RN-849	183	191	8	1	3	1	2	0
RN-849	184	186	2	1	3	1	1	2
RN-849	184	477	293	0	3	1	0	0
RN-849	185	477	292	0	3	1	0	0
RN-849	185	477	292	0	3	5	0	0
RN-849	185	477	292	0	3	1	0	0
RN-849	185	186	1	1	3	1	0	2
RN-849	185	402	217	1	1	1	2	1
RN-849	186	477	291	0	3	5	0	0
RN-850	186	477	291	0	3	5	0	0
RN-850	187	199	12	1	3	4	2	0
RN-850	187	190	3	1	3	4	1	0
RN-850	188	477	289	0	3	5	0	0
RN-850	189	477	288	0	3	1	0	3
RN-850	189	477	288	0	3	1	0	0
RN-850	189	190	1	1	2	3	2	0
RN-850	189	190	1	1	3	1	0	1
RN-850	189	207	18	1	2	1	2	0
RN-850	190	477	287	0	3	1	0	1
RN-851	190	477	287	0	5	1	0	0
RN-851	190	196	6	1	3	1	2	0
RN-851	190	191	1	1	3	1	2	0
RN-851	190	296	106	1	3	1	0	2
RN-851	190	210	20	1	2	1	0	2
RN-851	190	193	3	1	3	1	4	0
RN-851	191	192	1	1	1	1	0	0
RN-851	191	207	16	1	3	4	1	0
RN-851	191	192	1	1	3	1	4	0
RN-851	191	477	286	0	3	5	0	0
RN-852	192	221	29	1	3	5	2	0
RN-852	192	221	29	1	3	1	2	0
RN-852	192	212	20	1	2	1	2	0
RN-852	192	353	161	1	3	5	1	1
RN-852	192	196	4	1	3	4	1	1
RN-852	192	210	18	1	3	1	0	0
RN-852	193	477	284	0	3	5	0	1
RN-852	193	477	284	0	3	5	0	1
RN-852	193	200	7	1	3	1	2	0
RN-852	193	477	284	0	3	4	0	0
RN-853	193	477	284	0	3	5	0	0
RN-853	193	477	284	0	3	5	0	0
RN-853	193	477	284	0	3	5	0	0
RN-853	193	477	284	0	3	5	0	0
RN-853	193	197	4	1	4	5	0	0
RN-853	193	244	51	1	3	1	3	1
RN-853	193	197	4	1	4	3	0	0
RN-853	194	477	283	0	4	1	0	0
RN-853	194	196	2	1	3	1	2	0
RN-853	196	197	1	1	3	1	0	0
RN-854	196	477	281	0	2	1	0	0
RN-854	196	205	9	1	1	1	2	1
RN-854	196	294	98	1	3	4	1	1
RN-854	197	477	280	0	3	2	0	0
RN-854	197	204	7	1	1	1	2	0
RN-854	197	206	9	1	2	3	2	0
RN-854	198	205	7	1	3	5	2	0
RN-854	198	477	279	0	3	1	0	0
RN-854	198	204	6	1	3	1	3	0
RN-854	198	431	233	1	4	5	3	0
RN-855	198	477	279	0	3	1	0	0
RN-855	198	477	279	0	3	5	0	0
RN-855	199	477	278	0	3	1	0	0
RN-855	200	477	277	0	3	1	0	0
RN-855	200	308	108	1	3	5	0	1
RN-855	200	406	206	1	4	5	2	0
RN-855	200	477	277	0	3	5	0	0
RN-855	200	477	277	0	3	5	0	0
RN-855	200	210	10	1	2	1	3	0
RN-855	200	224	24	1	3	4	4	1
RN-856	200	477	277	0	3	1	0	0
RN-856	202	477	275	0	3	1	0	0
RN-856	203	229	26	1	3	4	0	1
RN-856	203	477	274	0	3	4	0	0
RN-856	203	207	4	1	3	4	1	0
RN-856	203	368	165	1	3	1	1	0
RN-856	203	219	16	1	4	4	3	2
RN-856	203	299	96	1	3	5	1	2
RN-857	203	477	274	0	3	4	0	0
RN-857	204	207	3	1	3	1	2	0
RN-857	204	477	273	0	3	4	0	0
RN-857	204	205	1	1	3	2	0	1
RN-857	205	209	4	1	4	5	1	0
RN-857	205	221	16	1	3	1	2	1
RN-857	205	206	1	1	4	1	4	0
RN-857	205	477	272	0	3	1	0	0
RN-857	205	211	6	1	2	1	2	1
RN-858	205	206	1	1	3	1	0	0
RN-858	205	232	27	1	3	5	2	0
RN-858	205	289	84	1	3	5	1	0
RN-858	205	477	272	0	3	4	0	0
RN-858	206	210	4	1	4	4	2	0
RN-858	206	477	271	0	3	4	0	0
RN-858	206	477	271	0	3	4	0	0
RN-858	206	296	90	1	3	1	1	0
RN-858	206	220	14	1	3	5	2	0
RN-858	206	477	271	0	3	1	0	0
RN-859	206	283	77	1	3	5	1	0
RN-859	207	210	3	1	3	1	2	0
RN-859	207	213	6	1	3	1	2	0
RN-859	207	213	6	1	3	1	2	1
RN-859	207	213	6	1	3	1	2	1
RN-859	207	212	5	1	3	1	2	0
RN-859	207	208	1	1	3	1	1	1
RN-859	207	477	270	0	3	5	0	0
RN-859	207	477	270	0	3	5	0	0
RN-859	207	477	270	0	3	5	0	0
RN-860	208	212	4	1	2	1	2	0
RN-860	208	219	11	1	4	4	2	0
RN-860	210	477	267	0	3	4	0	0
RN-860	210	214	4	1	3	1	2	0
RN-860	210	477	267	0	4	4	0	1
RN-860	211	212	1	1	4	1	1	0
RN-860	211	212	1	1	1	1	2	0
RN-860	212	477	265	0	5	1	0	0
RN-860	212	214	2	1	3	1	2	0
RN-860	212	219	7	1	3	1	0	1
RN-861	212	213	1	1	3	1	2	0
RN-861	212	477	265	0	3	1	0	0
RN-861	213	228	15	1	3	1	4	0
RN-861	213	477	264	0	3	1	0	0
RN-861	213	226	13	1	5	1	3	0
RN-861	213	214	1	1	3	1	2	0
RN-861	213	266	53	1	3	4	1	0
RN-861	213	477	264	0	3	2	0	0
RN-861	213	291	78	1	3	4	2	0
RN-861	213	386	173	1	3	5	0	0
RN-862	214	215	1	1	3	1	2	0
RN-862	214	273	59	1	3	4	1	0
RN-862	214	477	263	0	3	1	0	0
RN-862	214	267	53	1	4	5	2	1
RN-862	214	217	3	1	4	5	2	1
RN-862	214	477	263	0	3	1	0	0
RN-862	214	218	4	1	4	5	1	0
RN-862	217	477	260	0	3	1	0	0
RN-862	217	263	46	1	3	1	2	0
RN-862	218	219	1	1	2	1	2	0
RN-863	218	255	37	1	3	1	2	0
RN-863	218	477	259	0	1	1	0	0
RN-863	218	235	17	1	3	1	1	1
RN-863	218	220	2	1	3	1	2	0
RN-863	219	477	258	0	3	4	0	0
RN-863	219	477	258	0	3	1	0	0
RN-863	219	447	228	1	4	1	0	1
RN-863	219	263	44	1	3	5	0	1
RN-863	220	247	27	1	4	4	2	0
RN-863	220	477	257	0	4	4	0	0
RN-864	220	228	8	1	3	1	4	0
RN-864	220	477	257	0	3	1	0	0
RN-864	220	240	20	1	3	5	2	0
RN-864	220	431	211	1	3	5	1	1
RN-864	220	277	57	1	4	4	1	0
RN-864	221	477	256	0	3	1	0	0
RN-864	221	477	256	0	4	3	0	0
RN-864	221	459	238	1	2	1	0	0
RN-864	221	260	39	1	3	1	2	0
RN-864	222	234	12	1	3	1	4	0
RN-865	222	225	3	1	3	1	0	0
RN-865	222	477	255	0	3	1	0	0
RN-865	224	260	36	1	2	1	2	0
RN-865	224	477	253	0	3	1	0	0
RN-865	224	477	253	0	4	1	0	0
RN-865	224	477	253	0	3	5	0	2
RN-865	224	227	3	1	3	1	2	0
RN-865	225	477	252	0	2	1	0	0
RN-865	225	263	38	1	3	5	1	0
RN-865	225	280	55	1	3	1	1	0
RN-866	225	477	252	0	3	1	0	1
RN-866	225	477	252	0	3	1	0	0
RN-866	225	477	252	0	3	5	0	1
RN-866	225	477	252	0	3	1	0	0
RN-866	225	254	29	1	3	1	1	0
RN-866	225	330	105	1	3	5	2	0
RN-866	225	283	58	1	3	1	3	0
RN-866	226	227	1	1	2	1	2	0
RN-866	226	227	1	1	3	1	0	0
RN-866	227	477	250	0	3	1	0	0
RN-867	227	477	250	0	3	4	0	1
RN-867	227	477	250	0	3	1	0	0
RN-867	227	317	90	1	3	1	1	0
RN-867	227	232	5	1	3	5	2	0
RN-867	227	477	250	0	3	1	0	0
RN-867	228	238	10	1	3	1	2	1
RN-867	228	477	249	0	2	1	0	1
RN-867	228	477	249	0	3	5	0	1
RN-867	228	477	249	0	3	5	0	1
RN-867	228	229	1	1	3	1	4	0
RN-868	228	255	27	1	2	4	2	1
RN-868	228	232	4	1	3	1	0	0
RN-868	229	477	248	0	3	1	0	0
RN-868	231	232	1	1	3	4	1	0
RN-868	231	477	246	0	3	4	0	0
RN-868	231	477	246	0	3	4	0	0
RN-868	231	305	74	1	3	5	0	1
RN-868	231	290	59	1	3	5	2	0
RN-868	232	477	245	0	3	4	0	0
RN-868	232	477	245	0	3	3	0	1
RN-869	232	477	245	0	3	1	0	1
RN-869	232	234	2	1	2	1	1	4
RN-869	232	477	245	0	3	4	0	0
RN-869	232	477	245	0	3	4	0	0
RN-869	232	477	245	0	3	1	0	0
RN-869	232	477	245	0	4	1	0	0
RN-869	232	266	34	1	3	5	2	1
RN-869	233	239	6	1	3	5	1	0
RN-869	233	249	16	1	3	5	1	2
RN-870	234	309	75	1	3	1	0	0
RN-870	234	477	243	0	3	1	0	1
RN-870	234	477	243	0	3	1	0	0
RN-870	234	477	243	0	3	1	0	0
RN-870	234	235	1	1	4	4	0	0
RN-870	234	238	4	1	3	5	1	1
RN-870	234	256	22	1	3	5	1	2
RN-870	235	477	242	0	4	5	0	0
RN-870	235	236	1	1	3	1	0	1
RN-870	235	252	17	1	3	1	4	0
RN-871	235	283	48	1	3	1	1	0
RN-871	235	477	242	0	3	1	0	0
RN-871	237	259	22	1	3	5	1	0
RN-871	238	254	16	1	3	2	0	0
RN-871	238	309	71	1	3	5	0	0
RN-871	238	239	1	1	3	1	3	0
RN-872	238	256	18	1	3	1	4	1
RN-872	238	239	1	1	3	5	1	0
RN-872	239	241	2	1	3	1	0	0
RN-872	239	240	1	1	4	1	2	1
RN-872	239	477	238	0	3	5	0	0
RN-872	240	260	20	1	2	1	2	0
RN-872	240	477	237	0	3	1	0	0
RN-872	240	477	237	0	3	1	0	0
RN-872	240	255	15	1	2	1	4	0
RN-873	240	247	7	1	3	1	1	1
RN-873	241	477	236	0	3	4	0	2
RN-873	241	276	35	1	4	4	1	1
RN-873	241	477	236	0	3	2	0	0
RN-873	241	270	29	1	3	2	1	0
RN-873	241	249	8	1	3	1	0	1
RN-873	242	477	235	0	3	2	0	0
RN-873	242	477	235	0	2	1	0	0
RN-873	242	343	101	1	3	1	1	1
RN-873	243	244	1	1	3	5	1	0
RN-874	244	245	1	1	3	5	1	0
RN-874	246	477	231	0	5	1	0	0
RN-874	246	266	20	1	3	1	2	0
RN-874	246	477	231	0	3	1	0	0
RN-874	246	477	231	0	3	5	0	1
RN-874	247	268	21	1	3	1	1	0
RN-874	247	477	230	0	1	1	0	0
RN-874	247	380	133	1	2	1	4	1
RN-874	247	256	9	1	5	1	1	1
RN-874	248	477	229	0	4	2	0	0
RN-875	248	276	28	1	4	4	1	2
RN-875	248	249	1	1	2	1	2	1
RN-875	249	268	19	1	5	1	2	0
RN-875	249	283	34	1	3	1	3	0
RN-875	249	281	32	1	3	1	0	0
RN-875	250	251	1	1	3	5	0	2
RN-875	252	276	24	1	3	4	2	0
RN-875	252	289	37	1	3	1	2	0
RN-876	252	273	21	1	3	5	1	0
RN-876	252	405	153	1	3	1	3	2
RN-876	252	353	101	1	3	2	1	1
RN-876	252	280	28	1	3	5	1	0
RN-876	253	477	224	0	3	1	0	0
RN-876	254	477	223	0	3	2	0	0
RN-876	254	477	223	0	3	4	0	2
RN-876	254	477	223	0	3	1	0	0
RN-876	254	255	1	1	3	1	1	0
RN-877	255	261	6	1	2	1	2	0
RN-877	255	256	1	1	4	1	1	1
RN-877	256	270	14	1	2	1	4	0
RN-877	256	287	31	1	3	1	1	0
RN-877	256	315	59	1	3	5	1	0
RN-877	256	283	27	1	3	5	1	0
RN-877	256	323	67	1	3	5	1	0
RN-877	256	477	221	0	3	1	0	0
RN-878	257	259	2	1	4	1	1	0
RN-878	257	259	2	1	4	1	1	0
RN-878	259	260	1	1	4	1	3	0
RN-878	259	421	162	1	3	5	1	0
RN-878	259	261	2	1	3	1	2	0
RN-878	251	274	23	1	3	5	2	0
RN-878	260	477	217	0	3	1	0	1
RN-878	260	261	1	1	4	1	2	0
RN-878	260	279	19	1	3	1	1	2
RN-878	260	477	217	0	3	4	0	0
RN-879	260	296	36	1	3	5	0	0
RN-879	261	262	1	1	3	5	1	0
RN-879	261	477	216	0	3	4	0	1
RN-879	261	477	216	0	3	5	0	2
RN-879	261	477	216	0	3	5	0	4
RN-879	261	477	216	0	3	5	0	2
RN-879	261	477	216	0	3	5	0	1
RN-879	261	277	16	1	3	1	3	0
RN-880	262	263	1	1	4	5	2	0
RN-880	262	429	167	1	3	1	3	0
RN-880	262	269	7	1	2	1	4	1
RN-880	262	434	172	1	3	5	1	0
RN-880	262	281	19	1	3	5	1	0
RN-880	262	275	13	1	3	5	1	0
RN-880	262	263	1	1	3	5	1	0
RN-881	262	288	26	1	4	1	3	0
RN-881	263	477	214	0	3	2	0	1
RN-881	263	331	68	1	4	1	4	0
RN-881	263	281	18	1	3	5	1	0
RN-881	263	295	32	1	3	1	1	0
RN-881	266	267	1	1	2	1	2	1
RN-881	266	267	1	1	3	4	0	1
RN-881	267	477	210	0	3	1	0	0
RN-881	267	278	11	1	4	1	1	0
RN-882	267	477	210	0	3	2	0	0
RN-882	267	419	152	1	3	5	1	1
RN-882	267	372	105	1	2	5	3	0
RN-882	267	477	210	0	3	5	0	0
RN-882	267	268	1	1	3	1	2	1
RN-882	267	477	210	0	3	4	0	0
RN-882	268	295	27	1	5	1	4	0
RN-882	269	282	13	1	3	5	1	1
RN-882	269	477	208	0	3	1	0	0
RN-882	269	270	1	1	4	1	1	1
RN-883	269	287	18	1	2	1	2	1
RN-883	270	373	103	1	3	1	4	1
RN-883	270	284	14	1	2	5	3	2
RN-883	270	477	207	0	3	5	0	0
RN-883	272	287	15	1	3	4	1	1
RN-883	272	477	205	0	5	4	0	0
RN-883	273	323	50	1	3	5	1	1
RN-883	273	346	73	1	3	5	0	0
RN-884	274	276	2	1	4	1	2	0
RN-884	275	477	202	0	3	4	0	1
RN-884	275	288	13	1	3	4	1	4
RN-884	275	280	5	1	4	1	2	2
RN-884	276	277	1	1	3	1	2	0
RN-884	276	281	5	1	3	1	2	3
RN-884	277	477	200	0	3	5	0	0
RN-884	277	278	1	1	3	5	0	1
RN-884	277	477	200	0	3	1	0	0
RN-884	277	477	200	0	3	2	0	1
RN-885	277	477	200	0	3	5	0	0
RN-885	277	477	200	0	3	2	0	1
RN-885	280	281	1	1	3	1	3	0
RN-885	280	302	22	1	2	1	1	0
RN-885	280	477	197	0	3	1	0	1
RN-885	280	318	38	1	3	1	1	0
RN-885	281	309	28	1	3	1	4	1
RN-885	281	477	196	0	3	5	0	0
RN-886	281	319	38	1	4	4	1	0
RN-886	281	283	2	1	5	1	1	0
RN-886	281	290	9	1	3	5	0	1
RN-886	281	477	196	0	3	4	0	1
RN-886	282	290	8	1	3	1	1	0
RN-886	282	309	27	1	3	1	4	0
RN-886	282	310	28	1	3	1	4	1
RN-886	282	388	106	1	3	5	1	1
RN-886	282	290	8	1	3	1	3	0
RN-886	283	287	4	1	1	1	3	0
RN-887	283	302	19	1	3	5	1	1
RN-887	284	295	11	1	3	5	1	2
RN-887	284	477	193	0	3	1	0	0
RN-887	287	315	28	1	3	5	1	0
RN-887	287	361	74	1	5	4	1	0
RN-887	288	289	1	1	2	1	2	0
RN-888	288	311	23	1	3	5	1	0
RN-888	288	322	34	1	3	5	1	1
RN-888	288	331	43	1	3	5	1	2
RN-888	288	414	126	1	3	5	0	0
RN-888	288	477	189	0	3	5	0	0
RN-888	288	345	57	1	3	5	1	0
RN-888	288	477	189	0	3	5	0	0
RN-888	288	414	126	1	3	5	0	0
RN-888	288	414	126	1	3	5	0	0
RN-888	288	414	126	1	3	5	0	0
RN-889	288	430	142	1	3	5	0	0
RN-889	288	417	129	1	3	5	1	0
RN-889	288	289	1	1	1	1	2	0
RN-889	288	305	17	1	3	5	2	0
RN-889	288	361	73	1	4	4	1	0
RN-889	289	477	188	0	4	4	0	0
RN-889	289	290	1	1	3	4	2	3
RN-889	289	305	16	1	4	1	1	1
RN-889	289	477	188	0	3	5	0	1
RN-889	289	290	1	1	1	4	1	3
RN-890	289	477	188	0	3	5	0	0
RN-890	289	392	103	1	2	1	3	0
RN-890	290	315	25	1	3	5	1	0
RN-890	290	477	187	0	3	4	0	0
RN-890	290	295	5	1	4	5	4	0
RN-890	290	306	16	1	4	5	2	0
RN-890	290	477	187	0	3	1	0	0
RN-890	290	291	1	1	5	5	4	0
RN-890	290	291	1	1	3	4	3	1
RN-890	290	291	1	1	4	5	0	1
RN-891	290	291	1	1	4	1	3	0
RN-891	290	477	187	0	3	1	0	1
RN-891	290	477	187	0	2	5	0	0
RN-891	290	477	187	0	1	5	0	0
RN-891	290	340	50	1	3	5	1	1
RN-891	291	301	10	1	4	4	3	1
RN-891	291	292	1	1	4	4	2	0
RN-891	291	477	186	0	2	1	0	1
RN-891	291	295	4	1	2	1	1	2
RN-892	291	477	186	0	3	4	0	0
RN-892	291	298	7	1	3	5	1	0
RN-892	291	294	3	1	3	1	1	2
RN-892	292	294	2	1	4	4	1	0
RN-892	293	477	184	0	4	4	0	1
RN-892	294	354	60	1	3	5	2	1
RN-892	294	410	116	1	3	4	1	1
RN-892	294	477	183	0	3	1	0	1
RN-892	294	296	2	1	3	1	1	0
RN-893	294	297	3	1	3	1	1	0
RN-893	294	477	183	0	3	4	0	0
RN-893	294	305	11	1	3	5	1	1
RN-893	294	314	20	1	3	5	2	0
RN-893	295	332	37	1	3	5	0	0
RN-893	295	477	182	0	3	1	0	0
RN-893	295	324	29	1	3	1	1	0
RN-893	295	296	1	1	4	1	2	0
RN-893	296	297	1	1	3	1	1	1
RN-894	296	477	181	0	3	5	0	0
RN-894	296	297	1	1	4	1	1	0
RN-894	296	477	181	0	4	1	0	0
RN-894	297	477	180	0	3	5	0	0
RN-894	297	301	4	1	4	5	3	0
RN-894	298	477	179	0	3	1	0	1
RN-894	298	477	179	0	3	5	0	0
RN-894	298	477	179	0	3	1	0	0
RN-894	299	332	33	1	3	1	1	1
RN-894	300	477	177	0	3	5	0	0
RN-895	301	302	1	1	1	1	3	1
RN-895	301	477	176	0	3	1	0	1
RN-895	301	477	176	0	3	1	0	0
RN-895	301	323	22	1	3	5	1	0
RN-895	301	305	4	1	4	4	1	0
RN-895	301	407	106	1	3	5	1	1
RN-895	302	309	7	1	4	4	1	0
RN-895	302	477	175	0	3	1	0	0
RN-895	302	477	175	0	4	1	0	0
RN-896	302	388	86	1	3	1	4	0
RN-896	302	346	44	1	3	5	1	0
RN-896	302	348	46	1	3	5	1	0
RN-896	303	325	22	1	3	4	1	2
RN-896	304	477	173	0	3	4	0	2
RN-896	304	477	173	0	3	4	0	1
RN-896	305	449	144	1	3	4	1	4
RN-896	308	309	1	1	3	4	4	1
RN-897	308	309	1	1	5	1	4	0
RN-897	308	477	169	0	4	1	0	0
RN-897	308	477	169	0	3	5	0	0
RN-897	308	477	169	0	3	5	0	1
RN-897	309	331	22	1	5	4	1	0
RN-897	309	331	22	1	5	4	1	0
RN-897	309	310	1	1	5	4	1	0
RN-897	309	310	1	1	5	4	4	1
RN-897	309	477	168	0	3	4	0	0
RN-897	309	477	168	0	3	1	0	0
RN-898	309	477	168	0	3	5	0	0
RN-898	309	477	168	0	3	2	0	0
RN-898	310	477	167	0	3	5	0	0
RN-898	310	477	167	0	2	1	0	0
RN-898	310	325	15	1	2	1	2	1
RN-898	311	338	27	1	4	4	1	0
RN-898	311	330	19	1	4	5	3	0
RN-898	311	315	4	1	2	5	2	0
RN-898	311	312	1	1	3	5	2	0
RN-898	311	331	20	1	3	5	1	0
RN-899	311	312	1	1	1	1	2	3
RN-899	311	477	166	0	3	1	0	0
RN-899	311	323	12	1	3	1	1	1
RN-899	312	477	165	0	3	1	0	0
RN-899	312	338	26	1	3	1	1	2
RN-899	312	477	165	0	3	4	0	0
RN-899	312	313	1	1	4	4	0	0
RN-899	312	315	3	1	4	4	1	0
RN-899	312	315	3	1	4	4	0	0
RN-899	312	315	3	1	4	4	0	0
RN-900	312	477	165	0	4	4	0	0
RN-900	312	313	1	1	3	1	3	0
RN-900	312	382	70	1	3	5	0	0
RN-900	313	319	6	1	3	4	0	0
RN-900	313	319	6	1	3	1	0	0
RN-900	313	477	164	0	3	1	0	1
RN-900	313	477	164	0	3	1	0	0
RN-900	313	344	31	1	3	4	1	0
RN-900	315	343	28	1	4	1	4	0
RN-901	315	332	17	1	3	1	1	0
RN-901	315	477	162	0	3	1	0	0
RN-901	315	477	162	0	3	1	0	0
RN-901	315	339	24	1	3	5	0	1
RN-901	315	477	162	0	3	2	0	0
RN-901	316	345	29	1	3	5	1	1
RN-901	316	436	120	1	3	2	1	1
RN-901	316	477	161	0	3	1	0	0
RN-901	316	477	161	0	3	4	0	0
RN-901	316	338	22	1	3	1	1	1
RN-902	317	318	1	1	3	1	0	1
RN-902	317	477	160	0	3	4	0	1
RN-902	317	477	160	0	3	1	0	0
RN-902	318	477	159	0	3	2	0	1
RN-902	318	323	5	1	3	1	0	1
RN-902	318	339	21	1	3	1	1	1
RN-902	318	323	5	1	3	4	0	0
RN-902	318	477	159	0	3	1	0	0
RN-902	319	320	1	1	3	1	0	0
RN-902	319	320	1	1	3	1	0	0
RN-903	319	331	12	1	3	1	2	0
RN-903	319	477	158	0	3	4	0	1
RN-903	319	347	28	1	1	5	1	0
RN-903	320	477	157	0	3	1	0	0
RN-903	322	331	9	1	3	5	1	0
RN-903	322	477	155	0	3	4	0	0
RN-903	322	333	11	1	3	4	4	1
RN-903	323	372	49	1	3	5	1	0
RN-903	323	368	45	1	3	5	1	0
RN-903	323	477	154	0	2	1	0	0
RN-904	323	350	27	1	3	1	4	0
RN-904	324	337	13	1	3	4	1	0
RN-904	324	325	1	1	3	1	1	0
RN-904	324	477	153	0	3	1	0	0
RN-904	324	331	7	1	3	1	1	0
RN-904	324	477	153	0	3	4	0	0
RN-904	324	477	153	0	3	1	0	0
RN-904	325	477	152	0	3	1	0	1
RN-904	326	477	151	0	3	5	0	0
RN-904	326	477	151	0	3	5	0	1
RN-905	326	477	151	0	3	4	0	0
RN-905	326	344	18	1	4	4	1	0
RN-905	327	477	150	0	4	4	0	0
RN-905	328	382	54	1	3	2	0	0
RN-905	329	330	1	1	3	5	1	0
RN-905	329	477	148	0	3	5	0	0
RN-905	329	331	2	1	2	1	3	0
RN-905	329	338	9	1	1	5	1	0
RN-905	329	330	1	1	1	5	1	0
RN-905	330	477	147	0	3	5	0	0
RN-906	330	413	83	1	3	5	1	2
RN-906	330	331	1	1	4	4	1	0
RN-906	330	363	33	1	3	1	0	1
RN-906	330	477	147	0	3	1	0	0
RN-906	330	477	147	0	3	1	0	0
RN-906	330	399	69	1	3	1	0	1
RN-906	330	477	147	0	3	4	0	2
RN-906	331	332	1	1	3	1	3	1
RN-906	331	477	146	0	3	4	0	1
RN-906	332	333	1	1	4	4	4	0
RN-907	332	477	145	0	4	1	0	0
RN-907	332	338	6	1	2	1	3	2
RN-907	332	351	19	1	3	5	1	0
RN-907	333	477	144	0	3	1	0	0
RN-907	333	392	59	1	3	5	1	2
RN-907	333	351	18	1	3	5	1	3
RN-907	334	477	143	0	4	4	0	0
RN-908	337	477	140	0	3	1	0	0
RN-908	337	477	140	0	3	4	0	1
RN-908	337	477	140	0	3	1	0	1
RN-908	338	477	139	0	3	4	0	0
RN-908	338	351	13	1	3	1	3	1
RN-908	339	340	1	1	3	4	4	2
RN-908	339	393	54	1	3	5	1	1
RN-908	339	422	83	1	3	4	3	0
RN-908	339	477	138	0	3	1	0	1
RN-908	339	348	9	1	3	5	1	1
RN-909	340	348	8	1	3	5	1	0
RN-909	341	477	136	0	4	4	0	0
RN-909	341	477	136	0	5	4	0	0
RN-909	341	477	136	0	5	4	0	0
RN-909	341	348	7	1	4	4	1	1
RN-909	341	477	136	0	3	4	0	0
RN-909	341	477	136	0	4	4	0	0
RN-909	341	477	136	0	3	4	0	0
RN-909	342	395	53	1	3	1	3	0
RN-910	342	477	135	0	3	4	0	0
RN-910	343	477	134	0	3	1	0	0
RN-910	343	477	134	0	3	1	0	0
RN-910	343	414	71	1	3	5	0	0
RN-910	343	344	1	1	3	5	0	0
RN-910	343	477	134	0	3	1	0	0
RN-910	343	477	134	0	3	4	0	0
RN-910	344	355	11	1	4	1	2	0
RN-910	344	477	133	0	4	1	0	0
RN-911	344	477	133	0	3	5	0	0
RN-911	344	477	133	0	3	5	0	0
RN-911	345	477	132	0	3	4	0	0
RN-911	345	346	1	1	3	1	1	1
RN-911	345	477	132	0	3	4	0	0
RN-911	345	388	43	1	3	5	1	0
RN-911	345	351	6	1	3	5	1	0
RN-911	346	417	71	1	3	1	3	1
RN-911	346	477	131	0	3	4	0	0
RN-912	346	404	58	1	3	4	0	1
RN-912	346	422	76	1	3	4	3	1
RN-912	347	348	1	1	4	4	3	0
RN-912	347	477	130	0	4	4	0	0
RN-912	347	477	130	0	4	4	0	0
RN-912	347	350	3	1	3	5	3	1
RN-912	347	352	5	1	3	5	2	0
RN-912	347	477	130	0	3	4	0	0
RN-912	347	477	130	0	3	4	0	0
RN-912	347	353	6	1	3	5	1	0
RN-913	347	353	6	1	3	4	1	1
RN-913	348	353	5	1	3	5	1	1
RN-913	348	354	6	1	3	5	0	1
RN-913	348	477	129	0	3	4	0	0
RN-913	348	477	129	0	3	4	0	0
RN-913	348	477	129	0	3	4	0	0
RN-913	348	477	129	0	3	4	0	0
RN-913	349	477	128	0	3	5	0	0
RN-913	349	429	80	1	3	4	3	0
RN-913	349	424	75	1	3	4	3	1
RN-914	349	477	128	0	5	4	0	0
RN-914	350	386	36	1	2	1	4	1
RN-914	350	352	2	1	3	1	0	2
RN-914	351	477	126	0	3	1	0	1
RN-914	351	477	126	0	3	4	0	0
RN-914	351	386	35	1	3	5	1	0
RN-914	351	367	16	1	3	5	1	0
RN-914	352	477	125	0	2	1	0	0
RN-914	352	400	48	1	3	1	1	0
RN-915	352	431	79	1	3	4	3	1
RN-915	352	477	125	0	3	1	1	4
RN-915	352	354	2	1	3	5	1	0
RN-915	353	477	124	0	3	1	0	0
RN-915	353	355	2	1	4	1	3	0
RN-915	357	417	60	1	5	5	1	0
RN-915	358	477	119	0	3	1	0	0
RN-915	360	477	117	0	3	5	0	0
RN-915	360	477	117	0	3	5	0	0
RN-916	362	477	115	0	3	1	0	0
RN-916	362	371	9	1	3	1	1	2
RN-916	362	371	9	1	1	1	0	0
TUS-59	14	15	1	1	1	1	1	1
TUS-59	15	16	1	1	1	1	0	0
TUS-60	15	16	1	1	2	1	1	0
TUS-60	17	477	460	0	3	4	0	1
TUS-60	26	207	181	1	1	4	1	0
TUS-60	26	71	45	1	3	4	1	1
TUS-60	26	207	181	1	3	1	1	0
TUS-60	26	52	26	1	3	4	1	0
TUS-60	26	207	181	1	3	4	1	0
TUS-60	26	200	174	1	3	4	1	0
TUS-60	28	477	449	0	5	4	0	0
TUS-60	28	194	166	1	1	1	1	1
TUS-61	29	194	165	1	3	1	1	0
TUS-61	31	233	202	1	5	4	1	0
TUS-61	31	477	446	0	3	2	0	0
TUS-61	32	322	290	1	3	4	0	0
TUS-61	48	52	4	1	2	1	1	0
TUS-61	48	150	102	1	5	1	1	0
TUS-61	51	59	8	1	3	1	1	1
TUS-61	51	52	1	1	3	1	0	1
TUS-61	63	71	8	1	1	4	1	0
TUS-61	65	90	25	1	4	1	1	0
TUS-62	71	137	66	1	3	2	1	0
TUS-62	73	93	20	1	2	1	1	0
TUS-62	94	95	1	1	1	1	1	0
TUS-62	94	95	1	1	3	1	1	0
TUS-62	94	477	383	0	4	4	0	0
TUS-62	100	477	377	0	2	4	0	0
TUS-62	101	477	376	0	3	1	0	0
TUS-62	102	477	375	0	3	1	0	0
TUS-62	102	477	375	0	3	4	0	0
TUS-62	102	477	375	0	3	1	0	0
TUS-63	119	137	18	1	3	3	1	2
TUS-63	119	349	230	1	3	4	0	2
TUS-63	122	477	355	0	3	2	0	0
TUS-63	130	477	347	0	3	5	0	0
TUS-63	135	139	4	1	4	1	1	1
TUS-63	135	199	64	1	2	4	1	1
TUS-63	135	477	342	0	4	5	0	1
TUS-63	178	477	299	0	3	2	0	0
TUS-63	183	185	2	1	3	4	0	0
TUS-63	185	194	9	1	3	1	1	0
TUS-64	190	235	45	1	3	2	1	0
TUS-64	197	198	1	1	4	1	1	1
TUS-64	200	232	32	1	3	4	1	0
TUS-64	202	225	23	1	2	4	1	1
TUS-64	203	477	274	0	3	3	0	0
TUS-64	205	206	1	1	3	4	0	0
TUS-64	206	229	23	1	2	1	1	0
TUS-64	209	212	3	1	1	1	1	1
TUS-64	209	347	138	1	3	4	0	2
TUS-64	209	287	78	1	3	2	0	1
TUS-65	209	349	140	1	3	4	0	1
TUS-65	210	477	267	0	3	2	0	0
TUS-65	212	477	265	0	3	1	0	0
TUS-65	212	477	265	0	3	4	0	1
TUS-65	212	477	265	0	3	4	0	1
TUS-65	214	477	263	0	3	4	0	0
TUS-65	220	231	11	1	1	1	1	0
TUS-65	221	232	11	1	2	2	1	4
TUS-66	226	234	8	1	3	1	1	2
TUS-66	226	228	2	1	3	1	1	0
TUS-66	227	228	1	1	3	5	1	0
TUS-66	228	229	1	1	3	1	0	0
TUS-66	232	477	245	0	3	1	0	0
TUS-66	232	477	245	0	4	4	0	1
TUS-66	232	477	245	0	4	4	0	1
TUS-66	232	477	245	0	4	4	0	1
TUS-66	233	234	1	1	3	3	1	0
TUS-66	233	241	8	1	3	3	1	0
TUS-67	234	477	243	0	4	4	0	1
TUS-67	235	236	1	1	3	1	1	0
TUS-67	235	236	1	1	3	1	1	0
TUS-67	235	369	134	1	3	3	0	1
TUS-67	235	477	242	0	4	4	0	0
TUS-67	237	477	240	0	3	2	0	0
TUS-67	237	314	77	1	3	1	0	1
TUS-67	237	427	190	1	3	4	1	0
TUS-67	238	477	239	0	3	2	0	0
TUS-67	240	427	187	1	3	2	1	0
TUS-68	241	464	223	1	3	2	0	0
TUS-68	241	346	105	1	3	2	1	4
TUS-68	241	343	102	1	3	5	1	1
TUS-68	241	367	126	1	3	5	1	2
TUS-68	241	287	46	1	3	5	0	1
TUS-68	241	477	236	0	3	2	0	0
TUS-68	241	373	132	1	3	1	1	0
TUS-68	243	287	44	1	3	5	0	1
TUS-68	243	408	165	1	3	4	1	2
TUS-68	248	477	229	0	3	4	0	0
TUS-69	249	268	19	1	4	4	1	0
TUS-69	255	477	222	0	3	2	0	0
TUS-69	256	477	221	0	4	4	0	1
TUS-69	260	477	217	0	4	4	0	0
TUS-69	268	269	1	1	4	1	1	0
TUS-69	272	477	205	0	3	2	0	0
TUS-69	272	347	75	1	3	4	0	1
TUS-69	272	477	205	0	3	4	0	0
TUS-69	272	343	71	1	3	4	1	0
TUS-70	272	273	1	1	1	1	0	0
TUS-70	272	315	43	1	3	4	1	2
TUS-70	272	362	90	1	3	4	0	1
TUS-70	274	477	203	0	4	4	1	0
TUS-70	274	477	203	0	3	1	0	0
TUS-70	274	477	203	0	3	4	1	0
TUS-70	282	477	195	0	4	3	0	0
TUS-70	282	283	1	1	3	4	1	0
TUS-70	287	346	59	1	3	4	1	4
TUS-70	297	477	180	0	3	4	0	0
TUS-71	303	309	6	1	4	1	1	0
TUS-71	305	306	1	1	3	1	0	0
TUS-71	308	318	10	1	3	3	1	0
TUS-71	314	343	29	1	3	1	1	2
TUS-71	314	346	32	1	3	2	1	0
TUS-71	315	318	3	1	1	1	1	0
TUS-71	317	343	26	1	3	4	1	1
TUS-71	317	333	16	1	3	4	1	0
TUS-71	317	319	2	1	3	1	1	0
TUS-71	318	343	25	1	1	1	1	1
TUS-72	318	347	29	1	3	1	1	0
TUS-72	319	371	52	1	2	1	1	0
TUS-72	320	333	13	1	3	4	1	0
TUS-72	323	349	26	1	3	4	1	4
TUS-72	329	466	137	1	3	2	1	1
TUS-72	331	333	2	1	3	4	1	0
TUS-72	331	477	146	0	3	4	0	0
TUS-72	331	349	18	1	3	1	1	1
TUS-72	332	338	6	1	3	4	0	1
TUS-72	333	343	10	1	1	1	1	0
TUS-73	335	343	8	1	3	1	1	0
TUS-73	343	372	29	1	3	4	1	0
TUS-73	343	368	25	1	3	4	1	0
TUS-73	343	368	25	1	3	4	1	0
TUS-73	343	352	9	1	3	4	0	1
TUS-73	348	363	15	1	3	1	1	0
TUS-73	348	352	4	1	3	3	1	0
TUS-73	349	371	22	1	3	1	1	1
TUS-73	350	363	13	1	3	4	1	0
TUS-73	351	356	5	1	1	1	1	2
TUS-74	352	477	125	0	5	1	0	0
TUS-74	352	364	12	1	3	1	0	0
TUS-74	352	477	125	0	3	4	0	0
TUS-74	352	477	125	0	3	5	0	0
TUS-74	354	464	110	1	3	2	0	0
TUS-74	356	477	121	0	3	2	0	1
TUS-74	356	363	7	1	2	1	1	0
TUS-74	358	368	10	1	5	1	1	0
TUS-74	359	371	12	1	3	4	1	0
TUS-74	362	455	93	1	3	2	1	2
TUS-75	362	367	5	1	3	4	1	0
PPELIN-312	1	477	476	0	4	1	0	0
PPELIN-312	1	2	1	1	3	1	0	0
PPELIN-312	3	36	33	1	2	1	0	0
PPELIN-312	4	10	6	1	3	1	1	0
PPELIN-312	4	477	473	0	3	1	0	0
PPELIN-312	7	12	5	1	3	1	1	0
PPELIN-313	7	477	470	0	4	1	0	0
PPELIN-313	8	477	469	0	3	1	0	0
PPELIN-313	9	477	468	0	3	1	0	0
PPELIN-313	9	477	468	0	3	1	0	0
PPELIN-313	10	477	467	0	3	1	0	0
PPELIN-313	10	477	467	0	3	2	0	0
PPELIN-313	11	12	1	1	3	5	1	0
PPELIN-313	11	477	466	0	3	4	1	0
PPELIN-313	11	30	19	1	3	5	1	0
PPELIN-313	11	477	466	0	3	5	0	0
PPELIN-314	11	94	83	1	3	5	1	0
PPELIN-314	11	38	27	1	3	5	1	0
PPELIN-314	11	114	103	1	3	5	1	0
PPELIN-314	11	477	466	0	3	5	0	0
PPELIN-314	11	87	76	1	3	5	1	0
PPELIN-314	11	37	26	1	3	5	1	0
PPELIN-314	11	38	27	1	3	5	1	0
PPELIN-314	11	38	27	1	3	5	1	0
PPELIN-314	11	169	158	1	3	5	0	0
PPELIN-314	11	172	161	1	3	5	1	0
PPELIN-315	11	44	33	1	3	5	1	0
PPELIN-315	11	51	40	1	3	5	1	0
PPELIN-315	11	51	40	1	3	5	1	0
PPELIN-315	11	44	33	1	3	5	1	0
PPELIN-315	11	58	47	1	3	5	1	0
PPELIN-315	11	172	161	1	3	5	1	0
PPELIN-315	11	100	89	1	3	5	1	0
PPELIN-315	11	32	21	1	3	5	1	0
PPELIN-315	11	72	61	1	3	5	1	0
PPELIN-315	11	72	61	1	3	5	1	0
PPELIN-316	11	87	76	1	3	5	1	0
PPELIN-316	11	88	77	1	3	5	1	0
PPELIN-316	11	88	77	1	3	5	1	0
PPELIN-316	11	167	156	1	3	5	1	0
PPELIN-316	11	51	40	1	3	5	1	0
PPELIN-316	11	82	71	1	3	5	0	0
PPELIN-316	13	15	2	1	3	1	1	0
PPELIN-316	14	477	463	0	3	1	0	0
PPELIN-316	14	477	463	0	3	4	0	0
PPELIN-316	15	18	3	1	3	1	1	0
PPELIN-317	16	477	461	0	3	4	0	0
PPELIN-317	16	38	22	1	3	1	1	3
PPELIN-317	16	17	1	1	3	1	1	0
PPELIN-317	17	477	460	0	3	4	0	0
PPELIN-317	18	19	1	1	4	1	1	0
PPELIN-317	18	63	45	1	3	1	0	0
PPELIN-317	18	477	459	0	3	1	0	0
PPELIN-317	19	52	33	1	3	1	1	0
PPELIN-317	20	477	457	0	3	4	0	0
PPELIN-317	20	23	3	1	4	5	1	0
PPELIN-318	20	67	47	1	3	1	2	0
PPELIN-318	21	23	2	1	3	5	1	0
PPELIN-318	21	139	118	1	4	4	1	1
PPELIN-318	21	24	3	1	3	1	1	0
PPELIN-318	22	35	13	1	3	4	1	0
PPELIN-318	22	30	8	1	3	4	2	0
PPELIN-318	22	73	51	1	3	1	0	0
PPELIN-318	22	28	6	1	3	3	1	0
PPELIN-318	23	477	454	0	3	2	0	0
PPELIN-318	23	30	7	1	3	1	1	0
PPELIN-319	24	25	1	1	3	1	1	0
PPELIN-319	26	477	451	0	3	4	0	0
PPELIN-319	28	39	11	1	3	4	1	0
PPELIN-319	28	477	449	0	2	1	1	0
PPELIN-319	29	62	33	1	3	2	1	0
PPELIN-319	29	60	31	1	3	1	0	0
PPELIN-319	30	80	50	1	3	2	1	0
PPELIN-319	30	477	447	0	3	1	0	0
PPELIN-319	31	44	13	1	3	4	1	0
PPELIN-319	31	477	446	0	4	1	0	0
PPELIN-320	31	477	446	0	4	4	0	0
PPELIN-320	31	477	446	0	2	1	0	0
PPELIN-320	31	37	6	1	3	1	1	0
PPELIN-320	32	477	445	0	1	1	0	0
PPELIN-320	35	44	9	1	4	1	1	0
PPELIN-320	36	477	441	0	3	1	0	1
PPELIN-320	37	431	394	1	3	4	0	0
PPELIN-320	37	50	13	1	4	1	1	0
PPELIN-320	37	38	1	1	3	4	1	0
PPELIN-320	37	50	13	1	3	1	1	1
PPELIN-321	37	477	440	0	3	4	0	0
PPELIN-321	37	188	151	1	4	4	1	0
PPELIN-321	37	39	2	1	5	4	2	0
PPELIN-321	38	39	1	1	3	1	1	0
PPELIN-321	38	41	3	1	3	4	1	0
PPELIN-321	38	186	148	1	4	1	1	0
PPELIN-321	38	477	439	0	3	1	0	0
PPELIN-321	39	41	2	1	3	1	1	0
PPELIN-321	40	179	139	1	3	5	1	0
PPELIN-321	41	477	436	0	3	4	0	0
PPELIN-322	42	477	435	0	3	1	0	0
PPELIN-322	42	43	1	1	3	4	1	0
PPELIN-322	42	43	1	1	3	4	1	0
PPELIN-322	42	477	435	0	3	1	0	0
PPELIN-322	42	121	79	1	4	1	1	0
PPELIN-322	42	477	435	0	5	1	0	0
PPELIN-322	43	44	1	1	3	1	1	0
PPELIN-322	43	477	434	0	3	4	0	0
PPELIN-322	43	44	1	1	4	1	1	1
PPELIN-322	43	477	434	0	3	4	0	0
PPELIN-323	44	477	433	0	3	1	0	0
PPELIN-323	44	477	433	0	3	4	0	0
PPELIN-323	44	477	433	0	3	4	0	0
PPELIN-323	44	477	433	0	4	1	0	0
PPELIN-323	44	50	6	1	3	1	1	0
PPELIN-323	44	477	433	0	3	1	0	1
PPELIN-323	45	51	6	1	3	4	1	1
PPELIN-323	45	46	1	1	1	1	1	0
PPELIN-323	45	477	432	0	3	1	0	2
PPELIN-323	45	51	6	1	2	1	1	1
PPELIN-324	46	49	3	1	3	1	1	0
PPELIN-324	46	48	2	1	3	1	1	0
PPELIN-324	47	58	11	1	2	1	1	4
PPELIN-324	48	64	16	1	3	1	1	0
PPELIN-324	48	49	1	1	3	1	0	0
PPELIN-324	49	53	4	1	3	5	1	0
PPELIN-324	49	56	7	1	3	4	1	0
PPELIN-324	49	477	428	0	2	1	0	0
PPELIN-324	50	477	427	0	3	1	0	0
PPELIN-324	50	55	5	1	3	2	1	0
PPELIN-325	50	477	427	0	3	1	1	0
PPELIN-325	51	477	426	0	3	4	0	2
PPELIN-325	51	477	426	0	3	4	0	0
PPELIN-325	51	421	370	1	3	1	1	2
PPELIN-325	52	69	17	1	3	4	1	0
PPELIN-325	52	58	6	1	3	1	1	1
PPELIN-325	53	477	424	0	2	1	0	0
PPELIN-325	53	477	424	0	4	1	0	0
PPELIN-325	53	58	5	1	3	1	0	0
PPELIN-325	53	477	424	0	3	4	0	0
PPELIN-326	53	54	1	1	3	1	0	0
PPELIN-326	54	477	423	0	3	1	0	0
PPELIN-326	54	477	423	0	4	5	0	0
PPELIN-326	54	477	423	0	4	5	0	0
PPELIN-326	54	477	423	0	3	2	1	0
PPELIN-326	56	57	1	1	3	1	1	0
PPELIN-326	56	477	421	0	3	1	0	0
PPELIN-326	56	477	421	0	3	1	0	0
PPELIN-326	56	477	421	0	5	1	0	0
PPELIN-326	57	477	420	0	4	1	0	1
PPELIN-327	57	58	1	1	3	1	0	3
PPELIN-327	57	60	3	1	3	1	1	0
PPELIN-327	57	66	9	1	2	1	0	1
PPELIN-327	58	60	2	1	3	1	1	1
PPELIN-327	58	113	55	1	3	1	1	0
PPELIN-327	59	477	418	0	3	4	0	0
PPELIN-327	59	477	418	0	3	1	0	0
PPELIN-327	59	64	5	1	3	5	1	0
PPELIN-327	60	61	1	1	3	1	1	1
PPELIN-327	60	64	4	1	3	5	1	0
PPELIN-328	60	477	417	0	3	1	0	0
PPELIN-328	60	69	9	1	3	4	1	0
PPELIN-328	60	477	417	0	3	4	0	1
PPELIN-328	60	62	2	1	4	4	1	0
PPELIN-328	60	62	2	1	3	1	1	1
PPELIN-328	61	163	102	1	3	1	1	0
PPELIN-328	61	65	4	1	2	1	1	2
PPELIN-328	62	477	415	0	3	4	0	0
PPELIN-328	62	477	415	0	3	4	0	0
PPELIN-328	62	66	4	1	3	1	1	0
PPELIN-329	62	78	16	1	4	1	1	1
PPELIN-329	63	69	6	1	3	4	1	0
PPELIN-329	63	322	259	1	2	1	0	2
PPELIN-329	63	477	414	0	3	1	0	1
PPELIN-329	64	477	413	0	3	5	0	0
PPELIN-329	64	65	1	1	3	5	1	0
PPELIN-329	64	65	1	1	3	5	1	0
PPELIN-329	64	477	413	0	3	5	0	0
PPELIN-329	64	477	413	0	4	4	0	0
PPELIN-329	64	65	1	1	3	5	1	0
PPELIN-330	64	65	1	1	3	1	1	0
PPELIN-330	64	477	413	0	3	1	0	0
PPELIN-330	65	66	1	1	3	4	1	0
PPELIN-330	65	66	1	1	3	5	1	0
PPELIN-330	65	66	1	1	3	1	1	0
PPELIN-330	65	477	412	0	3	1	0	0
PPELIN-330	65	68	3	1	3	5	1	1
PPELIN-330	65	157	92	1	4	4	1	2
PPELIN-330	65	477	412	0	2	5	1	0
PPELIN-330	66	68	2	1	2	1	1	1
PPELIN-331	66	77	11	1	3	1	1	0
PPELIN-331	66	114	48	1	2	1	1	0
PPELIN-331	67	112	45	1	3	1	1	1
PPELIN-331	68	87	19	1	3	1	0	0
PPELIN-331	70	72	2	1	3	4	1	0
PPELIN-331	70	72	2	1	3	4	1	0
PPELIN-331	70	477	407	0	3	4	0	0
PPELIN-331	70	477	407	0	3	4	0	1
PPELIN-331	70	477	407	0	3	4	0	0
PPELIN-331	70	477	407	0	3	4	0	0
PPELIN-332	71	477	406	0	2	4	1	0
PPELIN-332	71	73	2	1	3	1	1	0
PPELIN-332	71	72	1	1	3	1	1	1
PPELIN-332	71	477	406	0	2	1	0	0
PPELIN-332	71	94	23	1	3	1	1	0
PPELIN-332	71	108	37	1	3	1	1	0
PPELIN-332	71	72	1	1	3	1	0	0
PPELIN-332	72	477	405	0	2	1	0	0
PPELIN-332	72	73	1	1	3	5	1	0
PPELIN-332	72	78	6	1	3	1	0	1
PPELIN-333	72	73	1	1	3	5	1	0
PPELIN-333	72	75	3	1	3	4	1	1
PPELIN-333	72	94	22	1	3	1	1	0
PPELIN-333	72	477	405	0	3	1	0	0
PPELIN-333	72	477	405	0	3	4	0	1
PPELIN-333	73	90	17	1	4	4	1	0
PPELIN-333	73	176	103	1	3	4	1	0
PPELIN-333	73	74	1	1	3	5	1	0
PPELIN-333	73	477	404	0	3	4	0	0
PPELIN-333	73	74	1	1	3	5	1	0
PPELIN-334	73	77	4	1	3	4	1	1
PPELIN-334	73	477	404	0	3	4	0	0
PPELIN-334	73	477	404	0	3	2	0	0
PPELIN-334	74	75	1	1	3	1	1	1
PPELIN-334	74	90	16	1	3	1	1	0
PPELIN-334	75	76	1	1	4	1	1	0
PPELIN-334	75	477	402	0	3	5	0	0
PPELIN-334	75	107	32	1	3	1	1	2
PPELIN-334	77	177	100	1	3	2	1	3
PPELIN-334	77	477	400	0	3	5	0	0
PPELIN-335	77	99	22	1	1	1	1	1
PPELIN-335	77	477	400	0	3	1	0	1
PPELIN-335	78	167	89	1	3	4	1	0
PPELIN-335	78	477	399	0	3	4	0	0
PPELIN-335	78	79	1	1	3	4	0	0
PPELIN-335	78	83	5	1	3	2	1	2
PPELIN-335	79	107	28	1	1	1	1	1
PPELIN-335	80	81	1	1	3	4	1	0
PPELIN-335	80	477	397	0	4	1	0	0
PPELIN-335	81	477	396	0	3	5	0	0
PPELIN-336	81	477	396	0	3	5	0	0
PPELIN-336	81	477	396	0	3	1	0	0
PPELIN-336	81	83	2	1	3	4	1	0
PPELIN-336	82	477	395	0	3	1	0	0
PPELIN-336	83	88	5	1	3	4	1	0
PPELIN-336	84	477	393	0	3	4	0	0
PPELIN-336	85	477	392	0	3	4	0	1
PPELIN-336	85	97	12	1	3	4	1	1
PPELIN-336	85	477	392	0	3	2	0	0
PPELIN-336	85	477	392	0	3	1	0	0
PPELIN-337	86	477	391	0	4	1	0	0
PPELIN-337	86	477	391	0	3	4	0	0
PPELIN-337	87	97	10	1	3	1	0	1
PPELIN-337	87	477	390	0	3	1	0	0
PPELIN-337	88	90	2	1	3	4	1	1
PPELIN-337	89	105	16	1	3	4	1	0
PPELIN-337	90	477	387	0	3	1	0	0
PPELIN-337	91	117	26	1	3	2	2	0
PPELIN-337	91	477	386	0	3	1	0	0
PPELIN-337	91	227	136	1	3	1	0	0
PPELIN-338	91	477	386	0	3	1	0	0
PPELIN-338	92	477	385	0	3	1	0	0
PPELIN-338	92	113	21	1	3	4	1	2
PPELIN-338	92	477	385	0	3	2	0	0
PPELIN-338	93	102	9	1	3	1	1	0
PPELIN-338	93	477	384	0	3	1	0	0
PPELIN-338	94	477	383	0	2	1	0	0
PPELIN-338	94	477	383	0	3	5	0	0
PPELIN-338	95	130	35	1	3	4	2	1
PPELIN-338	95	477	382	0	3	1	0	0
PPELIN-339	97	477	380	0	3	1	0	0
PPELIN-339	98	106	8	1	3	1	1	1
PPELIN-339	98	477	379	0	3	1	0	0
PPELIN-339	98	477	379	0	3	1	0	0
PPELIN-339	98	477	379	0	3	1	0	0
PPELIN-339	98	105	7	1	3	1	1	0
PPELIN-339	98	477	379	0	3	4	0	0
PPELIN-339	98	99	1	1	3	1	0	0
PPELIN-339	99	129	30	1	3	1	0	0
PPELIN-339	99	107	8	1	4	1	1	0
PPELIN-340	100	101	1	1	3	1	0	0
PPELIN-340	100	115	15	1	3	1	1	1
PPELIN-340	101	477	376	0	3	1	0	0
PPELIN-340	101	102	1	1	3	1	1	0
PPELIN-340	102	115	13	1	3	1	1	1
PPELIN-340	102	109	7	1	3	1	1	0
PPELIN-340	103	104	1	1	1	1	0	0
PPELIN-340	105	477	372	0	3	1	0	0
PPELIN-340	105	477	372	0	4	1	0	0
PPELIN-340	105	477	372	0	4	1	0	0
PPELIN-341	106	477	371	0	3	1	0	0
PPELIN-341	106	112	6	1	3	1	2	0
PPELIN-341	106	117	11	1	3	4	2	0
PPELIN-341	106	477	371	0	1	1	0	1
PPELIN-341	107	135	28	1	3	3	0	0
PPELIN-341	107	112	5	1	3	1	1	1
PPELIN-341	108	113	5	1	3	1	1	0
PPELIN-341	108	112	4	1	5	4	1	0
PPELIN-341	109	477	368	0	2	1	0	0
PPELIN-341	109	133	24	1	3	1	1	1
PPELIN-342	109	477	368	0	3	5	0	0
PPELIN-342	112	477	365	0	3	4	0	0
PPELIN-342	112	260	148	1	4	2	2	0
PPELIN-342	112	115	3	1	4	1	1	0
PPELIN-342	112	477	365	0	3	2	0	1
PPELIN-342	112	477	365	0	3	2	0	1
PPELIN-342	112	477	365	0	4	1	0	0
PPELIN-342	112	477	365	0	3	1	0	0
PPELIN-342	114	115	1	1	3	5	1	0
PPELIN-342	114	477	363	0	4	1	0	0
PPELIN-343	114	144	30	1	2	1	1	0
PPELIN-343	115	135	20	1	5	1	1	0
PPELIN-343	116	121	5	1	1	1	2	0
PPELIN-343	116	117	1	1	1	1	1	1
PPELIN-343	116	117	1	1	3	1	0	0
PPELIN-343	116	120	4	1	3	1	1	1
PPELIN-343	117	477	360	0	3	1	0	0
PPELIN-343	118	477	359	0	4	2	0	0
PPELIN-343	121	477	356	0	3	2	2	0
PPELIN-343	121	477	356	0	5	1	0	0
PPELIN-344	122	477	355	0	2	1	0	0
PPELIN-344	123	128	5	1	3	1	1	0
PPELIN-344	123	126	3	1	3	1	1	0
PPELIN-344	123	185	62	1	5	1	1	0
PPELIN-344	125	477	352	0	3	5	0	0
PPELIN-344	126	477	351	0	4	1	0	0
PPELIN-344	127	477	350	0	4	4	2	0
PPELIN-344	127	130	3	1	3	1	1	0
PPELIN-344	127	477	350	0	3	1	0	0
PPELIN-344	128	408	280	1	1	1	0	0
PPELIN-345	128	142	14	1	2	1	1	0
PPELIN-345	129	477	348	0	3	1	0	0
PPELIN-345	130	477	347	0	4	1	0	0
PPELIN-345	131	132	1	1	2	1	0	0
PPELIN-345	132	477	345	0	3	2	0	0
PPELIN-345	133	477	344	0	3	1	0	0
PPELIN-345	133	477	344	0	3	1	0	0
PPELIN-345	133	477	344	0	3	1	0	0
PPELIN-345	133	477	344	0	4	1	0	0
PPELIN-345	133	477	344	0	3	2	2	0
PPELIN-346	133	142	9	1	3	1	0	0
PPELIN-346	134	477	343	0	3	1	0	0
PPELIN-346	134	477	343	0	3	1	0	0
PPELIN-346	134	137	3	1	3	1	1	0
PPELIN-346	135	477	342	0	2	1	0	0
PPELIN-346	135	140	5	1	3	1	0	0
PPELIN-346	135	137	2	1	3	1	1	1
PPELIN-346	135	191	56	1	3	4	1	0
PPELIN-346	136	477	341	0	4	1	0	0
PPELIN-346	136	477	341	0	3	1	0	0
PPELIN-347	136	477	341	0	3	1	1	0
PPELIN-347	137	477	340	0	3	2	0	0
PPELIN-347	137	477	340	0	2	1	0	0
PPELIN-347	138	477	339	0	3	1	0	0
PPELIN-347	139	477	338	0	2	5	0	0
PPELIN-347	140	147	7	1	3	1	1	0
PPELIN-347	140	163	23	1	5	2	1	0
PPELIN-347	140	477	337	0	3	1	0	1
PPELIN-347	140	142	2	1	2	1	1	2
PPELIN-347	140	477	337	0	3	4	1	0
PPELIN-348	141	477	336	0	2	1	0	0
PPELIN-348	141	477	336	0	1	1	0	0
PPELIN-348	141	147	6	1	3	1	1	0
PPELIN-348	141	477	336	0	3	1	0	0
PPELIN-348	141	143	2	1	4	1	1	1
PPELIN-348	141	143	2	1	2	1	0	3
PPELIN-348	141	477	336	0	3	1	0	0
PPELIN-348	141	434	293	1	3	4	2	0
PPELIN-348	142	477	335	0	3	1	0	0
PPELIN-348	142	144	2	1	1	1	1	0
PPELIN-349	142	186	44	1	3	1	1	0
PPELIN-349	142	143	1	1	5	1	1	0
PPELIN-349	142	477	335	0	3	1	1	0
PPELIN-349	142	477	335	0	3	1	0	0
PPELIN-349	142	477	335	0	3	1	0	0
PPELIN-349	142	477	335	0	3	1	0	0
PPELIN-349	143	147	4	1	3	1	1	0
PPELIN-349	143	144	1	1	3	4	1	0
PPELIN-349	143	477	334	0	3	1	0	0
PPELIN-349	143	477	334	0	2	1	0	0
PPELIN-350	144	170	26	1	3	1	0	0
PPELIN-350	144	145	1	1	3	4	1	0
PPELIN-350	144	151	7	1	3	4	1	0
PPELIN-350	144	477	333	0	3	1	0	0
PPELIN-350	144	477	333	0	3	4	0	0
PPELIN-350	145	477	332	0	2	1	0	0
PPELIN-350	147	148	1	1	3	1	1	0
PPELIN-350	147	477	330	0	2	1	0	0
PPELIN-350	148	149	1	1	3	5	1	0
PPELIN-350	148	197	49	1	3	1	0	0
PPELIN-351	148	185	37	1	3	4	1	0
PPELIN-351	148	477	329	0	3	4	0	2
PPELIN-351	149	477	328	0	3	1	0	0
PPELIN-351	149	157	8	1	3	1	1	0
PPELIN-351	149	477	328	0	3	1	0	0
PPELIN-351	149	477	328	0	1	1	0	0
PPELIN-351	149	477	328	0	3	1	0	0
PPELIN-351	150	157	7	1	3	1	1	0
PPELIN-351	151	477	326	0	3	4	0	0
PPELIN-351	151	165	14	1	3	1	1	0
PPELIN-352	151	172	21	1	3	1	1	0
PPELIN-352	151	155	4	1	3	1	1	0
PPELIN-352	151	164	13	1	3	1	1	0
PPELIN-352	151	155	4	1	3	1	0	0
PPELIN-352	151	477	326	0	3	1	0	0
PPELIN-352	154	477	323	0	3	1	0	0
PPELIN-352	155	157	2	1	3	1	1	0
PPELIN-352	155	477	322	0	4	5	1	1
PPELIN-352	155	164	9	1	4	4	2	1
PPELIN-352	155	477	322	0	4	4	0	0
PPELIN-353	155	477	322	0	1	1	1	0
PPELIN-353	156	157	1	1	3	1	1	0
PPELIN-353	156	157	1	1	3	1	0	1
PPELIN-353	156	477	321	0	3	1	0	0
PPELIN-353	156	477	321	0	3	1	0	0
PPELIN-353	158	169	11	1	3	5	1	0
PPELIN-353	160	477	317	0	3	1	0	0
PPELIN-353	160	477	317	0	2	1	0	0
PPELIN-353	163	167	4	1	3	1	1	0
PPELIN-353	163	165	2	1	3	1	1	0
PPELIN-354	163	477	314	0	3	4	0	0
PPELIN-354	164	172	8	1	3	1	0	0
PPELIN-354	164	477	313	0	3	1	0	1
PPELIN-354	164	477	313	0	3	5	0	0
PPELIN-354	164	477	313	0	5	4	0	0
PPELIN-354	165	477	312	0	4	4	1	0
PPELIN-354	166	477	311	0	3	1	0	0
PPELIN-354	166	167	1	1	3	1	1	1
PPELIN-354	167	477	310	0	3	2	0	0
PPELIN-354	168	255	87	1	3	4	1	0
PPELIN-355	168	477	309	0	4	2	0	0
PPELIN-355	169	477	308	0	3	4	0	0
PPELIN-355	169	477	308	0	3	2	0	0
PPELIN-355	169	186	17	1	3	1	2	1
PPELIN-355	170	171	1	1	3	1	1	0
PPELIN-355	170	176	6	1	3	1	1	0
PPELIN-355	170	176	6	1	3	4	1	0
PPELIN-355	170	212	42	1	3	4	1	0
PPELIN-355	170	260	90	1	3	4	1	0
PPELIN-355	171	318	147	1	3	1	0	0
PPELIN-356	172	176	4	1	3	1	1	0
PPELIN-356	175	477	302	0	3	4	0	0
PPELIN-356	175	477	302	0	3	2	0	1
PPELIN-356	175	192	17	1	3	2	1	2
PPELIN-356	175	477	302	0	4	1	0	0
PPELIN-356	177	477	300	0	3	1	0	0
PPELIN-356	178	203	25	1	3	2	1	1
PPELIN-356	178	190	12	1	3	1	1	0
PPELIN-356	179	180	1	1	3	1	0	0
PPELIN-356	179	220	41	1	3	2	1	0
PPELIN-357	179	185	6	1	3	1	2	0
PPELIN-357	179	197	18	1	3	1	0	0
PPELIN-357	180	477	297	0	3	2	0	0
PPELIN-357	181	182	1	1	4	1	1	0
PPELIN-357	182	477	295	0	2	1	0	0
PPELIN-357	182	383	201	1	3	4	1	0
PPELIN-357	183	477	294	0	3	2	0	0
PPELIN-357	183	477	294	0	3	4	0	0
PPELIN-357	183	191	8	1	3	1	0	0
PPELIN-357	183	477	294	0	3	1	0	0
PPELIN-358	183	199	16	1	3	4	1	0
PPELIN-358	183	184	1	1	3	1	1	0
PPELIN-358	184	477	293	0	4	4	0	0
PPELIN-358	184	190	6	1	4	3	1	0
PPELIN-358	185	477	292	0	4	1	0	0
PPELIN-358	185	186	1	1	3	1	0	1
PPELIN-358	185	191	6	1	3	4	2	0
PPELIN-358	186	203	17	1	3	4	2	1
PPELIN-358	186	477	291	0	1	1	0	0
PPELIN-358	186	187	1	1	3	1	0	0
PPELIN-359	186	477	291	0	3	4	0	0
PPELIN-359	186	477	291	0	4	1	0	0
PPELIN-359	189	477	288	0	4	1	0	0
PPELIN-359	189	193	4	1	3	1	1	0
PPELIN-359	189	477	288	0	3	4	0	0
PPELIN-359	189	220	31	1	3	5	1	0
PPELIN-359	189	477	288	0	3	4	0	0
PPELIN-359	189	477	288	0	3	1	0	0
PPELIN-359	189	477	288	0	4	1	0	0
PPELIN-359	189	477	288	0	4	1	0	1
PPELIN-360	190	192	2	1	4	2	1	0
PPELIN-360	190	197	7	1	3	1	0	0
PPELIN-360	190	477	287	0	3	5	0	0
PPELIN-360	190	477	287	0	3	1	0	0
PPELIN-360	191	192	1	1	4	4	1	1
PPELIN-360	191	477	286	0	3	4	0	0
PPELIN-360	191	192	1	1	4	4	2	0
PPELIN-360	191	477	286	0	1	1	1	0
PPELIN-360	191	477	286	0	3	4	0	0
PPELIN-360	191	357	166	1	3	4	1	1
PPELIN-361	191	270	79	1	3	5	1	0
PPELIN-361	191	477	286	0	3	5	1	0
PPELIN-361	191	477	286	0	3	5	1	0
PPELIN-361	191	477	286	0	3	5	1	0
PPELIN-361	191	477	286	0	4	1	0	0
PPELIN-361	191	204	13	1	3	4	0	0
PPELIN-361	191	312	121	1	3	1	1	1
PPELIN-361	192	477	285	0	3	2	0	0
PPELIN-361	192	213	21	1	4	1	1	0
PPELIN-361	192	197	5	1	3	1	0	0
PPELIN-362	193	477	284	0	3	1	1	0
PPELIN-362	193	204	11	1	3	4	1	0
PPELIN-362	193	213	20	1	3	1	0	0
PPELIN-362	193	477	284	0	3	5	1	0
PPELIN-362	193	477	284	0	3	1	0	1
PPELIN-362	195	199	4	1	3	1	2	1
PPELIN-362	196	477	281	0	3	5	0	0
PPELIN-362	196	199	3	1	4	4	1	0
PPELIN-362	196	211	15	1	3	4	2	1
PPELIN-362	197	388	191	1	3	4	1	4
PPELIN-363	197	477	280	0	3	1	0	0
PPELIN-363	197	212	15	1	2	1	1	1
PPELIN-363	197	198	1	1	3	1	0	2
PPELIN-363	197	268	71	1	3	1	2	1
PPELIN-363	198	269	71	1	3	1	2	1
PPELIN-363	198	206	8	1	3	4	1	0
PPELIN-363	198	200	2	1	4	4	1	0
PPELIN-363	199	203	4	1	3	4	2	0
PPELIN-363	199	477	278	0	3	4	0	0
PPELIN-363	199	213	14	1	3	4	2	0
PPELIN-364	199	477	278	0	3	4	0	0
PPELIN-364	200	477	277	0	4	1	0	0
PPELIN-364	200	477	277	0	3	4	0	0
PPELIN-364	200	206	6	1	3	4	1	0
PPELIN-364	200	477	277	0	3	4	0	0
PPELIN-364	200	477	277	0	3	4	0	0
PPELIN-364	201	393	192	1	3	1	1	0
PPELIN-364	202	477	275	0	3	3	0	0
PPELIN-364	202	477	275	0	3	3	0	0
PPELIN-364	203	477	274	0	3	4	1	0
PPELIN-365	203	477	274	0	3	1	0	0
PPELIN-365	204	477	273	0	3	2	0	0
PPELIN-365	204	206	2	1	3	4	1	0
PPELIN-365	204	214	10	1	4	2	1	2
PPELIN-365	204	268	64	1	4	2	1	2
PPELIN-365	204	211	7	1	4	1	1	0
PPELIN-365	204	205	1	1	3	1	2	1
PPELIN-365	204	477	273	0	3	1	0	0
PPELIN-365	204	477	273	0	4	1	0	0
PPELIN-365	204	477	273	0	4	1	0	0
PPELIN-366	205	477	272	0	3	4	0	0
PPELIN-366	205	206	1	1	4	4	1	0
PPELIN-366	205	206	1	1	4	4	1	0
PPELIN-366	205	225	20	1	3	1	0	0
PPELIN-366	206	477	271	0	3	1	0	0
PPELIN-366	206	216	10	1	4	4	1	0
PPELIN-366	207	212	5	1	3	4	1	0
PPELIN-366	207	477	270	0	3	4	1	0
PPELIN-366	207	212	5	1	3	1	2	1
PPELIN-366	209	477	268	0	3	1	0	0
PPELIN-367	210	477	267	0	3	5	0	0
PPELIN-367	210	477	267	0	3	4	0	0
PPELIN-367	210	212	2	1	2	1	2	0
PPELIN-367	211	477	266	0	3	1	0	0
PPELIN-367	211	477	266	0	3	4	0	0
PPELIN-367	211	477	266	0	3	1	0	0
PPELIN-367	212	477	265	0	3	4	0	0
PPELIN-367	212	221	9	1	3	4	1	0
PPELIN-367	212	214	2	1	3	4	1	0
PPELIN-367	213	214	1	1	3	4	2	0
PPELIN-368	213	477	264	0	3	1	0	0
PPELIN-368	213	221	8	1	3	5	1	1
PPELIN-368	213	324	111	1	1	1	1	0
PPELIN-368	217	219	2	1	3	1	1	0
PPELIN-368	217	221	4	1	4	4	1	0
PPELIN-368	217	477	260	0	3	1	0	0
PPELIN-368	218	219	1	1	3	1	2	0
PPELIN-368	218	225	7	1	4	1	2	0
PPELIN-368	218	477	259	0	3	1	1	0
PPELIN-368	219	252	33	1	3	4	1	1
PPELIN-369	219	332	113	1	4	4	1	0
PPELIN-369	219	260	41	1	4	1	2	0
PPELIN-369	219	220	1	1	4	1	0	2
PPELIN-369	219	477	258	0	3	4	0	0
PPELIN-369	219	477	258	0	4	4	0	0
PPELIN-369	220	477	257	0	3	4	0	0
PPELIN-369	220	477	257	0	4	4	1	1
PPELIN-369	220	221	1	1	3	4	1	0
PPELIN-369	220	254	34	1	3	1	2	0
PPELIN-369	221	229	8	1	3	4	1	0
PPELIN-370	221	225	4	1	3	4	1	0
PPELIN-370	221	228	7	1	3	4	2	1
PPELIN-370	221	228	7	1	3	4	1	2
PPELIN-370	221	228	7	1	3	5	1	0
PPELIN-370	221	260	39	1	2	1	2	0
PPELIN-370	222	477	255	0	5	4	0	0
PPELIN-370	222	477	255	0	5	4	0	0
PPELIN-370	223	225	2	1	3	1	2	0
PPELIN-370	224	477	253	0	3	5	0	0
PPELIN-370	225	281	56	1	4	4	2	0
PPELIN-371	225	228	3	1	4	4	2	0
PPELIN-371	225	226	1	1	3	1	0	0
PPELIN-371	225	231	6	1	4	4	2	0
PPELIN-371	225	477	252	0	2	1	0	0
PPELIN-371	225	477	252	0	2	1	1	0
PPELIN-371	226	291	65	1	1	1	0	0
PPELIN-371	226	477	251	0	3	4	0	0
PPELIN-371	226	227	1	1	3	1	1	0
PPELIN-371	226	477	251	0	3	1	0	0
PPELIN-371	226	477	251	0	1	1	0	0
PPELIN-372	227	477	250	0	3	1	0	0
PPELIN-372	227	269	42	1	5	1	2	1
PPELIN-372	227	228	1	1	5	1	0	1
PPELIN-372	227	229	2	1	3	1	2	0
PPELIN-372	227	477	250	0	3	4	1	0
PPELIN-372	227	477	250	0	3	1	0	0
PPELIN-372	227	231	4	1	3	1	1	0
PPELIN-372	227	477	250	0	3	1	0	0
PPELIN-372	227	228	1	1	3	1	0	0
PPELIN-372	228	477	249	0	3	1	0	0
PPELIN-373	228	477	249	0	3	4	0	0
PPELIN-373	228	477	249	0	3	1	0	0
PPELIN-373	229	231	2	1	3	4	1	0
PPELIN-373	230	256	26	1	3	4	1	1
PPELIN-373	231	233	2	1	3	4	1	0
PPELIN-373	231	233	2	1	3	4	1	0
PPELIN-373	231	477	246	0	5	1	0	0
PPELIN-373	231	233	2	1	3	4	1	0
PPELIN-373	231	233	2	1	3	1	2	0
PPELIN-373	231	477	246	0	1	1	0	0
PPELIN-374	232	237	5	1	3	4	1	0
PPELIN-374	232	233	1	1	3	1	1	0
PPELIN-374	232	477	245	0	3	4	0	3
PPELIN-374	233	477	244	0	3	1	0	0
PPELIN-374	234	477	243	0	4	4	1	0
PPELIN-374	235	241	6	1	3	4	2	0
PPELIN-374	235	477	242	0	4	2	0	0
PPELIN-374	235	477	242	0	1	1	0	0
PPELIN-374	240	477	237	0	3	1	0	0
PPELIN-374	240	246	6	1	3	1	2	0
PPELIN-375	241	477	236	0	3	5	0	0
PPELIN-375	241	477	236	0	3	1	0	1
PPELIN-375	241	249	8	1	3	4	0	0
PPELIN-375	242	244	2	1	4	1	2	1
PPELIN-375	242	477	235	0	3	1	0	0
PPELIN-375	243	477	234	0	3	4	0	0
PPELIN-375	244	477	233	0	4	2	0	0
PPELIN-375	244	477	233	0	3	2	0	0
PPELIN-375	245	282	37	1	3	4	1	2
PPELIN-375	245	252	7	1	3	1	0	0
PPELIN-376	245	477	232	0	3	4	0	1
PPELIN-376	245	266	21	1	4	1	2	1
PPELIN-376	245	477	232	0	3	1	0	0
PPELIN-376	245	477	232	0	5	1	1	0
PPELIN-376	246	477	231	0	5	1	0	0
PPELIN-376	246	477	231	0	3	1	0	0
PPELIN-376	247	477	230	0	3	5	0	0
PPELIN-376	248	252	4	1	3	1	1	0
PPELIN-376	248	270	22	1	3	3	1	1
PPELIN-376	249	477	228	0	3	1	0	0
PPELIN-377	250	252	2	1	3	1	0	0
PPELIN-377	250	477	227	0	4	4	0	1
PPELIN-377	251	477	226	0	4	5	0	0
PPELIN-377	252	477	225	0	3	1	1	0
PPELIN-377	253	254	1	1	3	4	1	0
PPELIN-377	253	477	224	0	3	4	0	0
PPELIN-377	253	254	1	1	3	4	1	0
PPELIN-377	254	477	223	0	3	1	0	0
PPELIN-377	256	477	221	0	3	5	0	0
PPELIN-377	256	310	54	1	3	1	0	1
PPELIN-378	259	477	218	0	3	2	0	0
PPELIN-378	260	261	1	1	3	1	1	0
PPELIN-378	260	477	217	0	3	1	0	0
PPELIN-378	260	477	217	0	3	1	0	0
PPELIN-378	261	477	216	0	3	5	0	0
PPELIN-378	261	477	216	0	3	4	0	1
PPELIN-378	262	263	1	1	3	4	1	0
PPELIN-378	262	477	215	0	3	1	0	0
PPELIN-378	266	267	1	1	3	1	1	1
PPELIN-378	263	477	214	0	3	1	0	0
PPELIN-379	267	273	6	1	3	4	1	0
PPELIN-379	267	273	6	1	3	4	1	0
PPELIN-379	268	344	76	1	3	4	1	0
PPELIN-379	268	477	209	0	3	1	1	0
PPELIN-379	269	270	1	1	3	1	1	0
PPELIN-379	269	477	208	0	3	4	0	0
PPELIN-379	269	270	1	1	3	4	2	0
PPELIN-379	270	477	207	0	3	4	0	0
PPELIN-379	270	477	207	0	5	1	0	0
PPELIN-379	270	477	207	0	3	1	0	0
PPELIN-380	270	275	5	1	3	4	1	1
PPELIN-380	271	477	206	0	3	4	0	0
PPELIN-380	272	477	205	0	3	2	0	1
PPELIN-380	273	477	204	0	3	4	0	0
PPELIN-380	273	282	9	1	3	4	1	0
PPELIN-380	274	294	20	1	3	1	0	0
PPELIN-380	274	477	203	0	3	1	0	0
PPELIN-380	274	477	203	0	3	1	0	1
PPELIN-380	276	477	201	0	4	1	0	0
PPELIN-380	280	477	197	0	2	1	0	0
PPELIN-381	283	316	33	1	3	4	2	1
PPELIN-381	288	289	1	1	2	1	0	0
PPELIN-381	289	290	1	1	1	4	0	0
PPELIN-381	289	477	188	0	4	4	0	0
PPELIN-381	289	395	106	1	4	4	1	0
PPELIN-381	289	317	28	1	3	1	1	0
PPELIN-381	289	477	188	0	2	1	1	0
PPELIN-381	291	477	186	0	2	1	1	0
PPELIN-381	291	298	7	1	3	1	1	0
PPELIN-381	291	477	186	0	3	1	0	0
PPELIN-382	291	477	186	0	3	1	0	0
PPELIN-382	294	298	4	1	3	1	1	0
PPELIN-382	294	316	22	1	3	1	1	0
PPELIN-382	294	477	183	0	3	1	0	0
PPELIN-382	294	311	17	1	3	1	1	1
PPELIN-382	294	309	15	1	2	4	1	0
PPELIN-382	295	477	182	0	3	1	1	0
PPELIN-382	296	477	181	0	3	1	0	0
PPELIN-382	298	477	179	0	3	1	0	0
PPELIN-382	298	477	179	0	4	4	1	0
PPELIN-383	298	477	179	0	3	1	0	0
PPELIN-383	299	477	178	0	2	1	0	0
PPELIN-383	301	477	176	0	1	1	1	0
PPELIN-383	301	477	176	0	3	1	0	0
PPELIN-383	301	477	176	0	3	1	0	0
PPELIN-383	301	302	1	1	4	3	0	1
PPELIN-383	302	308	6	1	3	3	0	1
PPELIN-383	302	308	6	1	3	3	1	0
PPELIN-383	303	394	91	1	4	1	1	0
PPELIN-383	303	306	3	1	3	1	1	0
PPELIN-384	303	431	128	1	3	2	1	1
PPELIN-384	304	477	173	0	3	1	0	0
PPELIN-384	304	477	173	0	3	1	0	0
PPELIN-384	304	477	173	0	2	3	0	0
PPELIN-384	305	477	172	0	3	1	0	0
PPELIN-384	305	477	172	0	3	1	0	0
PPELIN-384	305	310	5	1	3	1	1	0
PPELIN-384	305	321	16	1	3	1	1	2
PPELIN-384	308	310	2	1	3	2	1	0
PPELIN-384	308	309	1	1	3	1	1	2
PPELIN-385	308	309	1	1	3	1	1	0
PPELIN-385	308	477	169	0	3	5	0	0
PPELIN-385	308	477	169	0	3	5	0	0
PPELIN-385	308	477	169	0	3	5	0	0
PPELIN-385	308	477	169	0	3	5	0	0
PPELIN-385	310	477	167	0	3	1	0	0
PPELIN-385	311	477	166	0	3	2	0	3
PPELIN-385	312	477	165	0	3	4	0	0
PPELIN-385	312	316	4	1	3	1	2	0
PPELIN-385	314	477	163	0	3	1	0	0
PPELIN-386	315	477	162	0	2	1	0	0
PPELIN-386	315	477	162	0	5	1	0	0
PPELIN-386	316	477	161	0	3	4	0	0
PPELIN-386	318	330	12	1	3	1	1	0
PPELIN-386	318	358	40	1	3	1	1	0
PPELIN-386	319	329	10	1	3	4	1	0
PPELIN-386	319	477	158	0	1	1	1	0
PPELIN-386	319	477	158	0	3	3	0	0
PPELIN-386	319	320	1	1	3	1	0	0
PPELIN-386	320	329	9	1	4	4	1	0
PPELIN-387	322	477	155	0	3	1	0	0
PPELIN-387	322	329	7	1	3	1	1	0
PPELIN-387	323	477	154	0	2	1	2	0
PPELIN-387	323	477	154	0	3	1	0	0
PPELIN-387	324	477	153	0	4	1	0	0
PPELIN-387	324	372	48	1	3	1	1	0
PPELIN-387	324	338	14	1	3	1	1	0
PPELIN-387	325	477	152	0	3	1	1	0
PPELIN-387	325	477	152	0	3	1	1	0
PPELIN-387	326	347	21	1	4	1	2	0
PPELIN-388	327	394	67	1	5	4	1	0
PPELIN-388	329	337	8	1	3	1	1	2
PPELIN-388	329	353	24	1	3	4	1	0
PPELIN-388	330	387	57	1	3	2	0	0
PPELIN-388	331	477	146	0	3	4	0	0
PPELIN-388	331	477	146	0	3	4	0	0
PPELIN-388	331	429	98	1	2	1	1	0
PPELIN-388	332	393	61	1	4	4	1	0
PPELIN-388	332	477	145	0	2	3	0	0
PPELIN-388	332	477	145	0	4	1	0	0
PPELIN-389	332	477	145	0	3	1	0	0
PPELIN-389	333	477	144	0	3	1	0	0
PPELIN-389	334	337	3	1	3	4	1	0
PPELIN-389	334	337	3	1	3	1	1	0
PPELIN-389	336	477	141	0	3	4	0	0
PPELIN-389	336	477	141	0	4	1	0	0
PPELIN-389	336	477	141	0	3	1	0	0
PPELIN-389	336	477	141	0	3	4	0	3
PPELIN-389	337	393	56	1	4	1	1	0
PPELIN-389	337	477	140	0	3	1	0	0
PPELIN-390	337	477	140	0	3	1	0	0
PPELIN-390	338	477	139	0	3	1	0	0
PPELIN-390	339	347	8	1	3	4	2	0
PPELIN-390	340	477	137	0	3	1	0	0
PPELIN-390	345	477	132	0	3	1	0	0
PPELIN-390	345	477	132	0	3	1	0	0
PPELIN-390	346	477	131	0	3	1	0	0
PPELIN-390	346	477	131	0	3	4	0	0
PPELIN-390	347	477	130	0	3	1	0	0
PPELIN-390	347	477	130	0	4	1	0	0
PPELIN-391	348	398	50	1	3	1	1	0
PPELIN-391	348	477	129	0	3	4	0	0
PPELIN-391	349	477	128	0	3	4	0	0
PPELIN-391	350	477	127	0	3	2	0	0
PPELIN-391	350	365	15	1	3	4	1	0
PPELIN-391	351	477	126	0	2	1	0	0
PPELIN-391	352	477	125	0	5	1	1	0
PPELIN-391	352	477	125	0	3	4	0	0
PPELIN-391	352	358	6	1	3	1	1	0
PPELIN-391	353	394	41	1	3	5	1	0
PPELIN-392	355	393	38	1	3	5	1	0
PPELIN-392	356	477	121	0	3	1	0	0
PPELIN-392	357	477	120	0	3	1	0	0
PPELIN-392	358	477	119	0	3	1	0	0
PPELIN-392	359	477	118	0	3	4	0	0
PPELIN-392	359	477	118	0	3	4	0	0
PPELIN-392	360	477	117	0	3	2	0	0
PPELIN-392	361	477	116	0	3	1	0	0
PPELIN-392	362	389	27	1	3	1	1	0
PPELIN-392	363	477	114	0	3	1	0	0
OKEEPER-296	3	17	14	1	3	1	0	0
OKEEPER-296	7	18	11	1	4	1	2	0
OKEEPER-296	8	477	469	0	4	4	0	0
OKEEPER-296	16	423	407	1	2	5	0	0
OKEEPER-296	17	50	33	1	3	4	3	0
OKEEPER-296	17	150	133	1	3	5	3	1
OKEEPER-296	18	477	459	0	4	1	0	0
OKEEPER-297	24	297	273	1	3	5	0	0
OKEEPER-297	27	129	102	1	1	4	1	0
OKEEPER-297	28	477	449	0	3	1	0	0
OKEEPER-297	30	477	447	0	1	1	0	0
OKEEPER-297	32	477	445	0	3	1	0	0
OKEEPER-297	32	477	445	0	3	1	0	0
OKEEPER-297	33	51	18	1	3	1	0	0
OKEEPER-297	42	477	435	0	2	1	0	0
OKEEPER-297	42	50	8	1	5	1	3	0
OKEEPER-297	42	274	232	1	3	5	0	0
OKEEPER-298	42	130	88	1	3	5	1	0
OKEEPER-298	44	45	1	1	3	5	1	0
OKEEPER-298	49	127	78	1	1	1	2	1
OKEEPER-298	50	177	127	1	3	4	0	1
OKEEPER-298	51	477	426	0	3	1	0	0
OKEEPER-298	52	477	425	0	3	1	0	1
OKEEPER-298	52	477	425	0	3	1	0	0
OKEEPER-298	58	477	419	0	3	1	0	0
OKEEPER-298	59	119	60	1	4	1	3	0
OKEEPER-298	59	477	418	0	3	1	0	0
OKEEPER-299	60	477	417	0	4	4	0	0
OKEEPER-299	60	477	417	0	3	1	0	1
OKEEPER-299	62	63	1	1	3	1	3	0
OKEEPER-299	63	142	79	1	4	1	3	0
OKEEPER-299	65	112	47	1	3	2	3	1
OKEEPER-299	66	477	411	0	3	1	0	0
OKEEPER-299	67	477	410	0	3	1	0	0
OKEEPER-299	67	84	17	1	3	1	2	0
OKEEPER-299	67	84	17	1	4	1	1	0
OKEEPER-299	67	105	38	1	4	4	2	0
OKEEPER-300	75	477	402	0	3	4	2	0
OKEEPER-300	76	84	8	1	5	1	2	0
OKEEPER-300	80	106	26	1	3	3	2	0
OKEEPER-300	80	477	397	0	3	1	0	1
OKEEPER-300	80	477	397	0	3	1	0	1
OKEEPER-300	80	477	397	0	4	4	0	0
OKEEPER-300	82	95	13	1	3	1	2	0
OKEEPER-300	84	115	31	1	3	1	3	0
OKEEPER-300	84	477	393	0	3	1	0	0
OKEEPER-300	84	165	81	1	3	1	3	0
OKEEPER-301	84	477	393	0	3	1	0	0
OKEEPER-301	84	477	393	0	3	1	0	0
OKEEPER-301	85	128	43	1	3	4	3	0
OKEEPER-301	85	86	1	1	5	1	0	0
OKEEPER-301	86	87	1	1	3	1	1	0
OKEEPER-301	89	477	388	0	4	4	0	0
OKEEPER-301	92	98	6	1	3	1	1	1
OKEEPER-301	93	105	12	1	4	3	2	0
OKEEPER-301	93	477	384	0	3	1	0	1
OKEEPER-301	95	158	63	1	3	4	3	0
OKEEPER-302	107	477	370	0	4	4	1	0
OKEEPER-302	109	422	313	1	1	4	3	4
OKEEPER-302	109	184	75	1	3	5	3	4
OKEEPER-302	109	477	368	0	3	5	0	0
OKEEPER-302	112	477	365	0	3	1	0	0
OKEEPER-302	112	113	1	1	1	1	2	0
OKEEPER-302	113	477	364	0	3	1	0	1
OKEEPER-302	116	117	1	1	3	1	3	0
OKEEPER-302	122	416	294	1	1	5	3	4
OKEEPER-302	122	372	250	1	1	5	3	4
OKEEPER-303	122	218	96	1	3	5	3	1
OKEEPER-303	122	234	112	1	3	5	3	1
OKEEPER-303	122	309	187	1	3	5	3	2
OKEEPER-303	122	228	106	1	3	5	3	1
OKEEPER-303	126	421	295	1	4	1	2	0
OKEEPER-303	127	128	1	1	4	5	0	0
OKEEPER-303	128	477	349	0	2	1	0	0
OKEEPER-303	128	477	349	0	4	4	0	0
OKEEPER-303	128	129	1	1	3	1	2	0
OKEEPER-303	128	134	6	1	3	1	3	0
OKEEPER-304	129	217	88	1	3	1	0	1
OKEEPER-304	132	135	3	1	5	1	3	0
OKEEPER-304	132	190	58	1	4	1	1	0
OKEEPER-304	133	149	16	1	3	4	3	0
OKEEPER-304	134	137	3	1	3	4	1	0
OKEEPER-304	136	477	341	0	3	1	0	0
OKEEPER-304	136	434	298	1	4	5	3	0
OKEEPER-304	138	477	339	0	3	5	0	1
OKEEPER-304	139	477	338	0	4	5	0	0
OKEEPER-304	139	477	338	0	3	5	0	0
OKEEPER-305	140	141	1	1	1	1	2	0
OKEEPER-305	140	142	2	1	1	1	2	0
OKEEPER-305	148	477	329	0	3	1	2	0
OKEEPER-305	148	477	329	0	3	1	0	2
OKEEPER-305	148	477	329	0	3	1	0	0
OKEEPER-305	152	477	325	0	4	1	0	0
OKEEPER-305	155	477	322	0	2	1	0	0
OKEEPER-305	157	285	128	1	4	1	1	0
OKEEPER-305	158	477	319	0	4	4	0	0
OKEEPER-305	161	175	14	1	2	1	2	1
OKEEPER-306	162	176	14	1	4	4	0	0
OKEEPER-306	163	208	45	1	4	3	1	0
OKEEPER-306	163	212	49	1	4	3	3	0
OKEEPER-306	163	165	2	1	5	4	2	0
OKEEPER-306	165	477	312	0	4	3	0	0
OKEEPER-306	168	477	309	0	4	5	1	0
OKEEPER-306	169	176	7	1	3	2	2	0
OKEEPER-306	170	207	37	1	4	3	1	0
OKEEPER-306	172	200	28	1	5	4	1	0
OKEEPER-306	175	477	302	0	4	1	0	0
OKEEPER-307	178	179	1	1	1	4	1	0
OKEEPER-307	178	315	137	1	4	4	1	0
OKEEPER-307	179	208	29	1	3	1	2	0
OKEEPER-307	179	190	11	1	4	5	1	0
OKEEPER-307	183	198	15	1	4	5	2	0
OKEEPER-307	183	477	294	0	2	1	0	0
OKEEPER-307	183	477	294	0	3	1	0	0
OKEEPER-307	183	199	16	1	5	4	3	0
OKEEPER-307	183	190	7	1	5	4	1	0
OKEEPER-307	183	190	7	1	4	1	1	0
OKEEPER-308	184	246	62	1	3	5	3	1
OKEEPER-308	185	477	292	0	4	1	0	0
OKEEPER-308	185	210	25	1	4	1	1	0
OKEEPER-308	185	199	14	1	5	4	2	0
OKEEPER-308	186	191	5	1	4	4	1	0
OKEEPER-308	189	217	28	1	4	4	1	0
OKEEPER-308	192	477	285	0	3	1	0	0
OKEEPER-308	193	194	1	1	3	3	1	0
OKEEPER-308	193	477	284	0	2	1	0	0
OKEEPER-308	195	297	102	1	4	5	0	0
OKEEPER-309	196	197	1	1	4	4	0	0
OKEEPER-309	197	477	280	0	3	2	0	1
OKEEPER-309	197	477	280	0	3	2	0	1
OKEEPER-309	198	199	1	1	5	1	2	1
OKEEPER-309	200	207	7	1	4	4	3	0
OKEEPER-309	200	208	8	1	4	4	1	0
OKEEPER-309	200	477	277	0	3	1	0	0
OKEEPER-309	200	207	7	1	4	4	2	0
OKEEPER-309	200	259	59	1	3	4	1	0
OKEEPER-309	203	477	274	0	3	1	0	0
OKEEPER-310	203	477	274	0	3	1	0	0
OKEEPER-310	203	477	274	0	5	4	0	1
OKEEPER-310	204	477	273	0	4	1	0	0
OKEEPER-310	204	225	21	1	3	5	1	0
OKEEPER-310	205	214	9	1	2	1	1	0
OKEEPER-310	206	210	4	1	3	1	1	0
OKEEPER-310	210	285	75	1	3	4	0	0
OKEEPER-310	210	477	267	0	4	4	0	0
OKEEPER-310	211	477	266	0	3	4	0	0
OKEEPER-310	212	240	28	1	3	4	1	1
OKEEPER-311	218	219	1	1	4	4	2	0
OKEEPER-311	218	247	29	1	4	4	1	0
OKEEPER-311	218	477	259	0	2	1	0	0
OKEEPER-311	218	290	72	1	2	1	2	0
OKEEPER-311	219	477	258	0	3	2	1	0
OKEEPER-311	220	477	257	0	4	4	0	0
OKEEPER-311	220	246	26	1	4	4	1	0
OKEEPER-311	222	228	6	1	4	1	1	0
OKEEPER-311	224	477	253	0	3	1	0	0
OKEEPER-311	225	226	1	1	3	1	0	0
OKEEPER-312	225	228	3	1	4	3	3	0
OKEEPER-312	226	227	1	1	3	1	0	0
OKEEPER-312	228	402	174	1	3	5	1	1
OKEEPER-312	228	253	25	1	3	5	1	0
OKEEPER-312	231	477	246	0	3	4	1	0
OKEEPER-312	231	311	80	1	1	1	2	0
OKEEPER-312	232	477	245	0	4	1	0	0
OKEEPER-312	234	247	13	1	2	1	2	0
OKEEPER-312	235	477	242	0	4	1	2	0
OKEEPER-312	236	477	241	0	3	4	0	0
OKEEPER-313	238	239	1	1	3	5	0	0
OKEEPER-313	239	249	10	1	3	1	2	0
OKEEPER-313	239	240	1	1	3	1	0	0
OKEEPER-313	239	477	238	0	3	1	1	0
OKEEPER-313	240	477	237	0	4	4	0	0
OKEEPER-313	241	477	236	0	4	1	0	0
OKEEPER-313	242	249	7	1	4	3	1	0
OKEEPER-313	242	256	14	1	5	2	1	0
OKEEPER-313	247	477	230	0	3	1	0	0
OKEEPER-313	249	477	228	0	3	1	0	0
OKEEPER-314	249	342	93	1	4	2	1	0
OKEEPER-314	252	477	225	0	3	5	0	2
OKEEPER-314	252	256	4	1	5	4	1	0
OKEEPER-314	253	477	224	0	3	5	0	0
OKEEPER-314	253	256	3	1	2	1	1	0
OKEEPER-314	253	477	224	0	2	1	1	0
OKEEPER-314	254	264	10	1	4	4	1	0
OKEEPER-314	254	477	223	0	3	4	0	0
OKEEPER-314	256	267	11	1	2	1	1	0
OKEEPER-314	256	258	2	1	4	1	0	1
OKEEPER-315	261	477	216	0	3	5	1	0
OKEEPER-315	261	262	1	1	4	1	0	0
OKEEPER-315	263	325	62	1	4	4	2	2
OKEEPER-315	268	277	9	1	3	5	3	0
OKEEPER-315	268	287	19	1	3	5	3	0
OKEEPER-315	268	313	45	1	1	5	3	0
OKEEPER-315	268	308	40	1	1	1	3	0
OKEEPER-315	270	280	10	1	4	5	1	0
OKEEPER-315	271	477	206	0	5	1	0	0
OKEEPER-315	274	284	10	1	3	4	2	0
OKEEPER-316	274	389	115	1	4	2	1	0
OKEEPER-316	280	284	4	1	3	4	1	0
OKEEPER-316	281	315	34	1	3	1	3	0
OKEEPER-316	281	296	15	1	4	4	1	0
OKEEPER-316	282	477	195	0	4	4	0	0
OKEEPER-316	284	288	4	1	3	1	1	0
OKEEPER-316	284	477	193	0	4	4	0	0
OKEEPER-316	285	402	117	1	4	2	1	0
OKEEPER-316	285	304	19	1	3	4	1	0
OKEEPER-316	285	477	192	0	3	4	1	0
OKEEPER-317	287	477	190	0	3	5	0	0
OKEEPER-317	287	375	88	1	1	5	3	2
OKEEPER-317	287	330	43	1	3	4	2	0
OKEEPER-317	287	310	23	1	3	4	2	1
OKEEPER-317	287	352	65	1	3	4	2	0
OKEEPER-317	287	310	23	1	3	4	2	0
OKEEPER-317	287	388	101	1	3	4	2	0
OKEEPER-317	288	320	32	1	4	4	1	0
OKEEPER-317	288	477	189	0	3	1	1	0
OKEEPER-317	291	464	173	1	3	4	1	0
OKEEPER-318	291	378	87	1	4	4	1	0
OKEEPER-318	296	331	35	1	3	1	0	3
OKEEPER-318	297	477	180	0	2	1	0	2
OKEEPER-318	300	331	31	1	4	4	1	0
OKEEPER-318	301	340	39	1	3	5	0	0
OKEEPER-318	304	477	173	0	2	1	0	0
OKEEPER-318	312	477	165	0	3	1	0	0
OKEEPER-318	315	477	162	0	3	4	0	0
OKEEPER-318	315	477	162	0	3	4	0	1
OKEEPER-318	316	477	161	0	3	1	0	1
OKEEPER-319	317	320	3	1	4	4	1	0
OKEEPER-319	318	477	159	0	4	4	0	0
OKEEPER-319	319	477	158	0	1	1	0	0
OKEEPER-319	322	330	8	1	3	5	2	0
OKEEPER-319	323	330	7	1	4	1	2	0
OKEEPER-319	323	378	55	1	3	4	2	0
OKEEPER-319	324	477	153	0	4	4	1	0
OKEEPER-319	325	371	46	1	5	3	2	0
OKEEPER-319	325	477	152	0	3	4	2	0
OKEEPER-319	327	329	2	1	3	1	0	0
OKEEPER-320	328	477	149	0	3	5	0	0
OKEEPER-320	328	477	149	0	3	5	0	0
OKEEPER-320	328	378	50	1	3	5	2	0
OKEEPER-320	329	371	42	1	4	4	1	0
OKEEPER-320	329	409	80	1	1	5	1	2
OKEEPER-320	329	366	37	1	4	5	1	0
OKEEPER-320	336	477	141	0	3	1	0	0
OKEEPER-320	337	477	140	0	4	1	1	0
OKEEPER-320	338	344	6	1	5	4	1	0
OKEEPER-320	340	380	40	1	3	2	1	1
OKEEPER-321	341	372	31	1	5	1	3	0
OKEEPER-321	344	477	133	0	1	1	1	0
OKEEPER-321	344	345	1	1	3	1	1	0
OKEEPER-321	345	477	132	0	1	1	0	0
OKEEPER-321	346	347	1	1	4	1	0	1
OKEEPER-321	346	477	131	0	4	1	0	0
OKEEPER-321	346	353	7	1	4	4	1	0
OKEEPER-321	348	367	19	1	2	1	3	0
OKEEPER-321	350	382	32	1	3	1	1	0
OKEEPER-321	350	353	3	1	4	4	1	0
OKEEPER-322	351	477	126	0	2	1	0	0
OKEEPER-322	351	477	126	0	2	1	0	1
OKEEPER-322	351	367	16	1	3	5	2	0
OKEEPER-322	353	385	32	1	1	5	3	2
OKEEPER-322	353	421	68	1	1	5	3	1
OKEEPER-322	353	372	19	1	1	5	3	1
OKEEPER-322	353	372	19	1	3	5	3	0
OKEEPER-322	353	477	124	0	3	1	0	1
OKEEPER-322	353	366	13	1	4	4	2	0
OKEEPER-322	353	389	36	1	4	4	2	0
OKEEPER-323	355	356	1	1	3	3	3	0
OKEEPER-323	362	477	115	0	3	1	0	0
